id,url,index,confidence,xmin,ymin,xmax,ymax,w,h,ponies
1007197.png,https://derpicdn.net/img/view/2015/10/21/1007197.png,0,0.989433885,0,38,1024,1376,1024,1338,applejack
1007197.png,https://derpicdn.net/img/view/2015/10/21/1007197.png,0,0.989433885,0,98,1024,1316,1024,1218,applejack
1007197.png,https://derpicdn.net/img/view/2015/10/21/1007197.png,0,0.989433885,0,98,1024,1316,1024,1218,applejack
1007720.png,https://derpicdn.net/img/view/2015/10/22/1007720.png,0,0.961497605,0,123,1193,1685,1193,1562,applejack
1007720.png,https://derpicdn.net/img/view/2015/10/22/1007720.png,0,0.961497605,0,192,1193,1612,1193,1420,applejack
1007720.png,https://derpicdn.net/img/view/2015/10/22/1007720.png,0,0.961497605,0,192,1193,1612,1193,1420,applejack
1007731.png,https://derpicdn.net/img/view/2015/10/22/1007731.png,0,0.99815309,69,0,717,626,648,626,applejack
1007731.png,https://derpicdn.net/img/view/2015/10/22/1007731.png,0,0.99815309,100,9,686,595,586,586,applejack
1007731.png,https://derpicdn.net/img/view/2015/10/22/1007731.png,0,0.99815309,100,9,686,595,586,586,applejack
1010293.png,https://derpicdn.net/img/view/2015/10/26/1010293.png,0,0.954587579,101,0,553,442,452,442,applejack
1010293.png,https://derpicdn.net/img/view/2015/10/26/1010293.png,0,0.954587579,121,11,531,421,410,410,applejack
1010293.png,https://derpicdn.net/img/view/2015/10/26/1010293.png,0,0.954587579,121,11,531,421,410,410,applejack
1013920.jpg,https://derpicdn.net/img/view/2015/11/1/1013920.jpg,0,0.966442049,398,193,824,619,426,426,applejack
1013920.jpg,https://derpicdn.net/img/view/2015/11/1/1013920.jpg,0,0.966442049,418,213,804,599,386,386,applejack
1013920.jpg,https://derpicdn.net/img/view/2015/11/1/1013920.jpg,0,0.966442049,418,213,804,599,386,386,applejack
1015104.png,https://derpicdn.net/img/view/2015/11/2/1015104.png,0,0.995498598,224,17,528,321,304,304,applejack
1015104.png,https://derpicdn.net/img/view/2015/11/2/1015104.png,0,0.995498598,238,31,514,307,276,276,applejack
1015104.png,https://derpicdn.net/img/view/2015/11/2/1015104.png,0,0.995498598,238,31,514,307,276,276,applejack
1016813.png,https://derpicdn.net/img/view/2015/11/5/1016813.png,0,0.991234601,0,0,1133,1203,1133,1203,applejack
1016813.png,https://derpicdn.net/img/view/2015/11/5/1016813.png,0,0.991234601,28,0,1133,1145,1105,1145,applejack
1016813.png,https://derpicdn.net/img/view/2015/11/5/1016813.png,0,0.991234601,28,0,1133,1145,1105,1145,applejack
1020938.png,https://derpicdn.net/img/view/2015/11/11/1020938.png,0,0.998850942,469,106,1171,808,702,702,applejack
1020938.png,https://derpicdn.net/img/view/2015/11/11/1020938.png,0,0.998850942,499,137,1139,777,640,640,applejack
1020938.png,https://derpicdn.net/img/view/2015/11/11/1020938.png,0,0.998850942,499,137,1139,777,640,640,applejack
102097.jpg,https://derpicdn.net/img/view/2012/9/19/102097.jpg,0,0.998066366,104,0,514,375,410,375,applejack
102097.jpg,https://derpicdn.net/img/view/2012/9/19/102097.jpg,0,0.998066366,123,0,495,356,372,356,applejack
102097.jpg,https://derpicdn.net/img/view/2012/9/19/102097.jpg,0,0.998066366,123,0,495,356,372,356,applejack
1024394.png,https://derpicdn.net/img/view/2015/11/17/1024394.png,0,0.996784806,96,0,962,827,866,827,applejack
1024394.png,https://derpicdn.net/img/view/2015/11/17/1024394.png,0,0.996784806,135,0,923,788,788,788,applejack
1024394.png,https://derpicdn.net/img/view/2015/11/17/1024394.png,0,0.996784806,135,0,923,788,788,788,applejack
1025457.png,https://derpicdn.net/img/view/2015/11/18/1025457.png,0,0.999785721,313,22,1091,800,778,778,applejack
1025457.png,https://derpicdn.net/img/view/2015/11/18/1025457.png,0,0.999785721,349,59,1055,765,706,706,applejack
1025457.png,https://derpicdn.net/img/view/2015/11/18/1025457.png,0,0.999785721,349,59,1055,765,706,706,applejack
1027153.png,https://derpicdn.net/img/view/2015/11/21/1027153.png,0,0.960928023,2,15,662,675,660,660,applejack
1027153.png,https://derpicdn.net/img/view/2015/11/21/1027153.png,0,0.960928023,32,46,630,644,598,598,applejack
1027153.png,https://derpicdn.net/img/view/2015/11/21/1027153.png,0,0.960928023,32,46,630,644,598,598,applejack
1027635.png,https://derpicdn.net/img/view/2015/11/22/1027635.png,0,0.995897055,446,0,1098,528,652,528,applejack
1027635.png,https://derpicdn.net/img/view/2015/11/22/1027635.png,0,0.995897055,477,0,1067,497,590,497,applejack
1027635.png,https://derpicdn.net/img/view/2015/11/22/1027635.png,0,0.995897055,477,0,1067,497,590,497,applejack
1039914.png,https://derpicdn.net/img/view/2015/12/8/1039914.png,0,0.993067741,96,0,386,289,290,289,applejack
1043727.png,https://derpicdn.net/img/view/2015/12/13/1043727.png,0,0.921105444,322,16,786,480,464,464,applejack
1043918.png,https://derpicdn.net/img/view/2015/12/13/1043918.png,0,0.970266104,334,0,1202,818,868,818,applejack
1047802.png,https://derpicdn.net/img/view/2015/12/19/1047802.png,0,0.996038556,252,0,960,689,708,689,applejack
1048986.png,https://derpicdn.net/img/view/2015/12/20/1048986.png,0,0.9936077,796,791,1836,1831,1040,1040,applejack
106261.jpg,https://derpicdn.net/img/view/2012/9/25/106261.jpg,0,0.9433164,0,0,722,799,722,799,applejack
1063149.png,https://derpicdn.net/img/view/2016/1/10/1063149.png,0,0.979792774,98,63,500,487,402,424,applejack
1066936.png,https://derpicdn.net/img/view/2016/1/15/1066936.png,0,0.993844867,447,81,915,549,468,468,applejack
1076983.png,https://derpicdn.net/img/view/2016/1/31/1076983.png,0,0.960846364,0,31,1077,1167,1077,1136,applejack
1081770.png,https://derpicdn.net/img/view/2016/2/6/1081770.png,0,0.993924677,210,0,664,453,454,453,applejack
1082320.png,https://derpicdn.net/img/view/2016/2/7/1082320.png,0,0.993601084,239,77,639,477,400,400,applejack
1084235.png,https://derpicdn.net/img/view/2016/2/9/1084235.png,0,0.992938757,0,0,2017,1815,2017,1815,applejack
1088032.png,https://derpicdn.net/img/view/2016/2/14/1088032.png,0,0.972035706,570,169,1400,999,830,830,applejack
1100843.png,https://derpicdn.net/img/view/2016/3/2/1100843.png,0,0.970798612,0,0,1127,1385,1127,1385,applejack
1102772.jpg,https://derpicdn.net/img/view/2016/3/6/1102772.jpg,0,0.994873762,455,0,923,464,468,464,applejack
1103045.png,https://derpicdn.net/img/view/2016/3/6/1103045.png,0,0.958634257,0,29,850,1017,850,988,applejack
1104923.png,https://derpicdn.net/img/view/2016/3/8/1104923.png,0,0.981792331,1245,567,1579,901,334,334,applejack
1113498.jpg,https://derpicdn.net/img/view/2016/3/21/1113498.jpg,0,0.984884858,952,0,1444,470,492,470,applejack
1114298.png,https://derpicdn.net/img/view/2016/3/22/1114298.png,0,0.952776313,0,0,1467,1465,1467,1465,applejack
1127024.png,https://derpicdn.net/img/view/2016/4/7/1127024.png,0,0.969575346,869,0,2073,1159,1204,1159,applejack
1127324.png,https://derpicdn.net/img/view/2016/4/8/1127324.png,0,0.991463184,186,1631,1202,2647,1016,1016,applejack
1127324.png,https://derpicdn.net/img/view/2016/4/8/1127324.png,1,0.953159809,1703,78,3083,1458,1380,1380,applejack
1132655.png,https://derpicdn.net/img/view/2016/4/15/1132655.png,0,0.986673176,6,26,574,594,568,568,applejack
1135420.png,https://derpicdn.net/img/view/2016/4/19/1135420.png,0,0.93029952,128,41,648,561,520,520,applejack
1149951.jpg,https://derpicdn.net/img/view/2016/5/9/1149951.jpg,0,0.994794607,192,29,538,375,346,346,applejack
1150330.jpg,https://derpicdn.net/img/view/2016/5/9/1150330.jpg,0,0.986918271,64,0,1182,1093,1118,1093,applejack
1153050.png,https://derpicdn.net/img/view/2016/5/13/1153050.png,0,0.996636629,258,18,534,294,276,276,applejack
1153316.png,https://derpicdn.net/img/view/2016/5/13/1153316.png,0,0.972142577,30,48,486,500,456,452,applejack
1153316.png,https://derpicdn.net/img/view/2016/5/13/1153316.png,1,0.928906798,0,0,392,392,392,392,applejack
1155091.png,https://derpicdn.net/img/view/2016/5/15/1155091.png,0,0.987764716,643,114,1721,1192,1078,1078,applejack
1158809.jpg,https://derpicdn.net/img/view/2016/5/21/1158809.jpg,0,0.933286905,179,0,1100,994,921,994,applejack
1161475.png,https://derpicdn.net/img/view/2016/5/23/1161475.png,0,0.940956533,124,175,1062,1100,938,925,applejack
1164774.png,https://derpicdn.net/img/view/2016/5/28/1164774.png,0,0.992780685,508,0,1022,497,514,497,applejack
1165119.png,https://derpicdn.net/img/view/2016/5/28/1165119.png,0,0.977063715,149,0,691,508,542,508,applejack
1165854.png,https://derpicdn.net/img/view/2016/5/29/1165854.png,0,0.997899115,585,272,1377,1064,792,792,applejack
1174426.png,https://derpicdn.net/img/view/2016/6/9/1174426.png,0,0.988644838,263,137,833,707,570,570,applejack
1175488.png,https://derpicdn.net/img/view/2016/6/11/1175488.png,0,0.977756321,59,73,425,439,366,366,applejack
1181355.png,https://derpicdn.net/img/view/2016/6/18/1181355.png,0,0.999413371,1145,0,1967,744,822,744,applejack
1192579.png,https://derpicdn.net/img/view/2016/7/3/1192579.png,0,0.97715348,335,36,717,418,382,382,applejack
1197965.png,https://derpicdn.net/img/view/2016/7/10/1197965.png,0,0.997512639,361,4,719,362,358,358,applejack
1205347.png,https://derpicdn.net/img/view/2016/7/20/1205347.png,0,0.996231496,841,1057,1127,1343,286,286,applejack
1213727.png,https://derpicdn.net/img/view/2016/7/31/1213727.png,0,0.970754862,260,0,1364,1009,1104,1009,applejack
1216650.png,https://derpicdn.net/img/view/2016/8/4/1216650.png,0,0.979956746,2197,0,4683,2075,2486,2075,applejack
1220292.png,https://derpicdn.net/img/view/2016/8/8/1220292.png,0,0.985508204,49,0,491,424,442,424,applejack
1230234.png,https://derpicdn.net/img/view/2016/8/21/1230234.png,0,0.967923045,781,484,1381,1084,600,600,applejack
1235632.png,https://derpicdn.net/img/view/2016/8/28/1235632.png,0,0.984422863,0,0,562,603,562,603,applejack
1237845.png,https://derpicdn.net/img/view/2016/8/30/1237845.png,0,0.997634947,1329,0,2361,1007,1032,1007,applejack
1238086.png,https://derpicdn.net/img/view/2016/8/31/1238086.png,0,0.916862786,572,0,1500,807,928,807,applejack
1241071.png,https://derpicdn.net/img/view/2016/9/3/1241071.png,0,0.998551965,628,0,1468,712,840,712,applejack
125076.jpg,https://derpicdn.net/img/view/2012/10/17/125076.jpg,0,0.988724649,155,0,371,211,216,211,applejack
1252336.png,https://derpicdn.net/img/view/2016/9/18/1252336.png,0,0.967947602,278,165,1644,1531,1366,1366,applejack
1258842.png,https://derpicdn.net/img/view/2016/9/26/1258842.png,0,0.994938374,773,0,2108,1304,1335,1304,applejack
1260034.png,https://derpicdn.net/img/view/2016/9/28/1260034.png,0,0.998600483,579,0,1173,566,594,566,applejack
1260687.png,https://derpicdn.net/img/view/2016/9/28/1260687.png,0,0.994193435,208,19,596,407,388,388,applejack
1260690.png,https://derpicdn.net/img/view/2016/9/28/1260690.png,0,0.99118948,206,14,598,406,392,392,applejack
1260691.png,https://derpicdn.net/img/view/2016/9/28/1260691.png,0,0.992838979,209,20,595,406,386,386,applejack
1264107.png,https://derpicdn.net/img/view/2016/10/3/1264107.png,0,0.999474823,225,7,561,343,336,336,applejack
1266753.png,https://derpicdn.net/img/view/2016/10/7/1266753.png,0,0.982767582,68,0,1204,1024,1136,1024,applejack
1268469.png,https://derpicdn.net/img/view/2016/10/8/1268469.png,0,0.998518884,306,0,1944,1592,1638,1592,applejack
1268547.png,https://derpicdn.net/img/view/2016/10/9/1268547.png,0,0.978139639,32,0,390,364,358,364,applejack
1268710.png,https://derpicdn.net/img/view/2016/10/9/1268710.png,0,0.982605636,0,171,678,969,678,798,applejack
1269637.png,https://derpicdn.net/img/view/2016/10/10/1269637.png,0,0.996678948,179,71,1081,973,902,902,applejack
1270281.png,https://derpicdn.net/img/view/2016/10/11/1270281.png,0,0.995913029,561,12,1273,724,712,712,applejack
1280840.png,https://derpicdn.net/img/view/2016/10/24/1280840.png,0,0.983654261,143,0,733,580,590,580,applejack
1284114.png,https://derpicdn.net/img/view/2016/10/29/1284114.png,0,0.949939489,0,0,639,662,639,662,applejack
1284530.png,https://derpicdn.net/img/view/2016/10/30/1284530.png,0,0.999595523,432,0,1184,741,752,741,applejack
1287786.png,https://derpicdn.net/img/view/2016/11/3/1287786.png,0,0.990333796,166,0,554,381,388,381,applejack
1294855.png,https://derpicdn.net/img/view/2016/11/13/1294855.png,0,0.979436159,703,0,1800,1037,1097,1037,applejack
1295116.png,https://derpicdn.net/img/view/2016/11/13/1295116.png,0,0.998761415,505,0,1553,1001,1048,1001,applejack
1296179.png,https://derpicdn.net/img/view/2016/11/15/1296179.png,0,0.978402257,360,0,2100,1746,1740,1746,applejack
1300994.png,https://derpicdn.net/img/view/2016/11/22/1300994.png,0,0.995316803,225,222,571,568,346,346,applejack
1304332.png,https://derpicdn.net/img/view/2016/11/27/1304332.png,0,0.94800806,195,732,427,964,232,232,applejack
1309394.png,https://derpicdn.net/img/view/2016/12/4/1309394.png,0,0.989495814,96,0,580,468,484,468,applejack
1312996.png,https://derpicdn.net/img/view/2016/12/9/1312996.png,0,0.943246663,557,255,971,669,414,414,applejack
1319841.png,https://derpicdn.net/img/view/2016/12/18/1319841.png,0,0.960980296,0,87,822,1025,822,938,applejack
1323677.png,https://derpicdn.net/img/view/2016/12/23/1323677.png,0,0.985891581,173,0,1500,1200,1327,1200,applejack
1324914.png,https://derpicdn.net/img/view/2016/12/25/1324914.png,0,0.991904438,627,352,2953,2678,2326,2326,applejack
1326298.png,https://derpicdn.net/img/view/2016/12/27/1326298.png,0,0.998718798,133,0,721,551,588,551,applejack
1326458.png,https://derpicdn.net/img/view/2016/12/27/1326458.png,0,0.952395141,112,25,400,313,288,288,applejack
1327452.png,https://derpicdn.net/img/view/2016/12/29/1327452.png,0,0.997824728,142,19,442,319,300,300,applejack
1328323.png,https://derpicdn.net/img/view/2016/12/30/1328323.png,0,0.984879017,58,0,416,357,358,357,applejack
1329485.png,https://derpicdn.net/img/view/2017/1/1/1329485.png,0,0.954713047,176,33,626,483,450,450,applejack
1333065.png,https://derpicdn.net/img/view/2017/1/6/1333065.png,0,0.992358685,264,60,476,272,212,212,applejack
1342687.png,https://derpicdn.net/img/view/2017/1/19/1342687.png,0,0.990891516,676,0,1984,1053,1308,1053,applejack
1345497.png,https://derpicdn.net/img/view/2017/1/22/1345497.png,0,0.984680593,109,0,1800,1732,1691,1732,applejack
1349214.png,https://derpicdn.net/img/view/2017/1/27/1349214.png,0,0.979658127,531,0,1145,599,614,599,applejack
1350732.png,https://derpicdn.net/img/view/2017/1/29/1350732.png,0,0.995692253,106,19,1118,1031,1012,1012,applejack
1350821.png,https://derpicdn.net/img/view/2017/1/29/1350821.png,0,0.994839191,1320,260,2492,1432,1172,1172,applejack
1350822.png,https://derpicdn.net/img/view/2017/1/29/1350822.png,0,0.997507691,1366,316,2508,1458,1142,1142,applejack
1351427.png,https://derpicdn.net/img/view/2017/1/30/1351427.png,0,0.991339803,291,14,617,340,326,326,applejack
1352484.png,https://derpicdn.net/img/view/2017/2/1/1352484.png,0,0.980750978,12,0,658,631,646,631,applejack
1353277.png,https://derpicdn.net/img/view/2017/2/2/1353277.png,0,0.989905059,379,35,967,623,588,588,applejack
1353669.png,https://derpicdn.net/img/view/2017/2/2/1353669.png,0,0.98589319,110,0,1482,1080,1372,1080,applejack
1358911.png,https://derpicdn.net/img/view/2017/2/9/1358911.png,0,0.970135689,38,14,1042,1018,1004,1004,applejack
1359064.png,https://derpicdn.net/img/view/2017/2/9/1359064.png,0,0.998754978,42,6,496,460,454,454,applejack
1371333.png,https://derpicdn.net/img/view/2017/2/23/1371333.png,0,0.986618757,313,117,547,351,234,234,applejack
137883.png,https://derpicdn.net/img/view/2012/10/31/137883.png,0,0.947681725,204,48,586,430,382,382,applejack
1382551.png,https://derpicdn.net/img/view/2017/3/8/1382551.png,0,0.999235988,1381,348,2411,1378,1030,1030,applejack
1382558.png,https://derpicdn.net/img/view/2017/3/8/1382558.png,0,0.999457657,1386,347,2412,1373,1026,1026,applejack
1385125.png,https://derpicdn.net/img/view/2017/3/12/1385125.png,0,0.972447515,247,0,879,552,632,552,applejack
1391446.png,https://derpicdn.net/img/view/2017/3/19/1391446.png,0,0.979339778,827,24,2419,1616,1592,1592,applejack
1393315.png,https://derpicdn.net/img/view/2017/3/21/1393315.png,0,0.983985007,610,0,1484,865,874,865,applejack
1399113.png,https://derpicdn.net/img/view/2017/3/29/1399113.png,0,0.995979249,163,41,1099,977,936,936,applejack
1400475.png,https://derpicdn.net/img/view/2017/3/31/1400475.png,0,0.961730778,41,155,1203,1317,1162,1162,applejack
1405147.png,https://derpicdn.net/img/view/2017/4/6/1405147.png,0,0.996674657,608,15,1786,1193,1178,1178,applejack
1406906.png,https://derpicdn.net/img/view/2017/4/8/1406906.png,0,0.993397593,0,0,714,697,714,697,applejack
1407150.png,https://derpicdn.net/img/view/2017/4/8/1407150.png,0,0.984519303,1147,0,2801,1506,1654,1506,applejack
1410225.png,https://derpicdn.net/img/view/2017/4/13/1410225.png,0,0.999665856,244,7,620,383,376,376,applejack
1413755.png,https://derpicdn.net/img/view/2017/4/17/1413755.png,0,0.994659126,483,24,1061,602,578,578,applejack
1421320.png,https://derpicdn.net/img/view/2017/4/25/1421320.png,0,0.905076921,120,21,1376,1277,1256,1256,applejack
1426511.png,https://derpicdn.net/img/view/2017/5/1/1426511.png,0,0.997838855,284,207,1196,1119,912,912,applejack
1426514.png,https://derpicdn.net/img/view/2017/5/1/1426514.png,0,0.998770833,464,0,1510,1027,1046,1027,applejack
1429337.png,https://derpicdn.net/img/view/2017/5/5/1429337.png,0,0.967447698,236,0,516,251,280,251,applejack
1441439.png,https://derpicdn.net/img/view/2017/5/20/1441439.png,0,0.991595864,193,876,909,1592,716,716,applejack
1441798.png,https://derpicdn.net/img/view/2017/5/21/1441798.png,0,0.989449024,210,1655,1178,2623,968,968,applejack
1441798.png,https://derpicdn.net/img/view/2017/5/21/1441798.png,1,0.980127394,1757,154,3017,1414,1260,1260,applejack
1442614.png,https://derpicdn.net/img/view/2017/5/21/1442614.png,0,0.996364474,58,0,1012,942,954,942,applejack
1461251.png,https://derpicdn.net/img/view/2017/6/14/1461251.png,0,0.997651577,381,270,717,606,336,336,applejack
1462501.png,https://derpicdn.net/img/view/2017/6/15/1462501.png,0,0.984427273,0,0,2129,2102,2129,2102,applejack
1464838.png,https://derpicdn.net/img/view/2017/6/18/1464838.png,0,0.999476731,452,217,902,667,450,450,applejack
1466860.png,https://derpicdn.net/img/view/2017/6/20/1466860.png,0,0.977728844,11,0,455,430,444,430,applejack
1478362.png,https://derpicdn.net/img/view/2017/7/4/1478362.png,0,0.993255436,239,33,505,299,266,266,applejack
1480278.png,https://derpicdn.net/img/view/2017/7/6/1480278.png,0,0.990698755,442,86,1296,940,854,854,applejack
1489033.png,https://derpicdn.net/img/view/2017/7/18/1489033.png,0,0.981999099,728,0,1436,654,708,654,applejack
1491460.png,https://derpicdn.net/img/view/2017/7/21/1491460.png,0,0.98136431,292,25,712,445,420,420,applejack
1492729.png,https://derpicdn.net/img/view/2017/7/23/1492729.png,0,0.984221041,133,27,591,485,458,458,applejack
1494629.png,https://derpicdn.net/img/view/2017/7/25/1494629.png,0,0.969686091,829,146,1757,1074,928,928,applejack
1498008.png,https://derpicdn.net/img/view/2017/7/30/1498008.png,0,0.945657909,455,0,957,465,502,465,applejack
1498424.png,https://derpicdn.net/img/view/2017/7/30/1498424.png,0,0.96399641,55,11,605,561,550,550,applejack
1500887.png,https://derpicdn.net/img/view/2017/8/2/1500887.png,0,0.995128214,120,0,800,570,680,570,applejack
1503754.png,https://derpicdn.net/img/view/2017/8/5/1503754.png,0,0.998112202,0,296,715,1030,715,734,applejack
1504442.png,https://derpicdn.net/img/view/2017/8/6/1504442.png,0,0.994159818,1758,0,2826,839,1068,839,applejack
1504690.png,https://derpicdn.net/img/view/2017/8/6/1504690.png,0,0.989532232,0,0,685,665,685,665,applejack
1505329.png,https://derpicdn.net/img/view/2017/8/7/1505329.png,0,0.997916102,510,0,1258,746,748,746,applejack
1515244.png,https://derpicdn.net/img/view/2017/8/20/1515244.png,0,0.997889876,740,0,1642,830,902,830,applejack
1519425.png,https://derpicdn.net/img/view/2017/8/25/1519425.png,1,0.976522386,1158,0,1644,456,486,456,applejack
1524316.png,https://derpicdn.net/img/view/2017/8/31/1524316.png,0,0.941264272,355,0,1611,1224,1256,1224,applejack
1526163.png,https://derpicdn.net/img/view/2017/9/2/1526163.png,0,0.99888742,0,0,874,837,874,837,applejack
1530448.png,https://derpicdn.net/img/view/2017/9/8/1530448.png,0,0.965704203,32,0,384,330,352,330,applejack
1537754.png,https://derpicdn.net/img/view/2017/9/17/1537754.png,0,0.992633045,193,157,2691,2655,2498,2498,applejack
1539962.png,https://derpicdn.net/img/view/2017/9/20/1539962.png,0,0.99484545,1206,0,1476,269,270,269,applejack
1539962.png,https://derpicdn.net/img/view/2017/9/20/1539962.png,1,0.990894437,0,0,275,279,275,279,applejack
1539962.png,https://derpicdn.net/img/view/2017/9/20/1539962.png,2,0.9908306,605,7,861,263,256,256,applejack
1539962.png,https://derpicdn.net/img/view/2017/9/20/1539962.png,3,0.986442864,917,11,1169,263,252,252,applejack
1539962.png,https://derpicdn.net/img/view/2017/9/20/1539962.png,4,0.983669996,0,251,274,543,274,292,applejack
1539962.png,https://derpicdn.net/img/view/2017/9/20/1539962.png,5,0.978978992,893,245,1185,537,292,292,applejack
1539962.png,https://derpicdn.net/img/view/2017/9/20/1539962.png,6,0.978213787,292,254,568,530,276,276,applejack
1539962.png,https://derpicdn.net/img/view/2017/9/20/1539962.png,8,0.962340117,593,504,869,768,276,264,applejack
1539962.png,https://derpicdn.net/img/view/2017/9/20/1539962.png,9,0.951640368,907,509,1173,768,266,259,applejack
1547177.png,https://derpicdn.net/img/view/2017/9/28/1547177.png,0,0.958476365,973,0,2631,1556,1658,1556,applejack
1547681.png,https://derpicdn.net/img/view/2017/9/29/1547681.png,0,0.991016924,587,108,879,400,292,292,applejack
1551091.png,https://derpicdn.net/img/view/2017/10/3/1551091.png,0,0.992390513,294,31,682,419,388,388,applejack
1566051.png,https://derpicdn.net/img/view/2017/10/20/1566051.png,0,0.941868782,32,29,1304,1301,1272,1272,applejack
1579974.png,https://derpicdn.net/img/view/2017/11/6/1579974.png,0,0.928258002,186,3,500,317,314,314,applejack
1587486.png,https://derpicdn.net/img/view/2017/11/16/1587486.png,0,0.976857305,226,48,466,288,240,240,applejack
1592133.png,https://derpicdn.net/img/view/2017/11/22/1592133.png,0,0.991900563,108,0,718,562,610,562,applejack
1593591.png,https://derpicdn.net/img/view/2017/11/25/1593591.png,0,0.960297108,0,27,1072,1101,1072,1074,applejack
1593591.png,https://derpicdn.net/img/view/2017/11/25/1593591.png,1,0.956628144,941,420,1600,1194,659,774,applejack
1596403.png,https://derpicdn.net/img/view/2017/11/28/1596403.png,0,0.998404741,360,19,682,341,322,322,applejack
1596905.png,https://derpicdn.net/img/view/2017/11/29/1596905.png,0,0.910799265,416,0,1562,969,1146,969,applejack
1604173.png,https://derpicdn.net/img/view/2017/12/10/1604173.png,0,0.951289535,56,8,680,676,624,668,applejack
1620232.png,https://derpicdn.net/img/view/2017/12/31/1620232.png,0,0.982893884,0,13,765,923,765,910,applejack
1620845.png,https://derpicdn.net/img/view/2017/12/31/1620845.png,0,0.991828561,429,0,809,364,380,364,applejack
1626258.png,https://derpicdn.net/img/view/2018/1/7/1626258.png,0,0.997201681,296,0,854,556,558,556,applejack
1626394.png,https://derpicdn.net/img/view/2018/1/7/1626394.png,0,0.971955419,575,138,1105,668,530,530,applejack
1629822.png,https://derpicdn.net/img/view/2018/1/11/1629822.png,0,0.994442046,450,0,1132,680,682,680,applejack
1636393.png,https://derpicdn.net/img/view/2018/1/20/1636393.png,0,0.998786092,58,623,798,1363,740,740,applejack
1636393.png,https://derpicdn.net/img/view/2018/1/20/1636393.png,1,0.96403414,1002,6,1438,442,436,436,applejack
1637068.png,https://derpicdn.net/img/view/2018/1/20/1637068.png,0,0.932279289,169,0,819,634,650,634,applejack
1638134.png,https://derpicdn.net/img/view/2018/1/22/1638134.png,0,0.997934401,62,14,668,620,606,606,applejack
1640674.png,https://derpicdn.net/img/view/2018/1/25/1640674.png,0,0.979825616,251,9,507,265,256,256,applejack
1646862.png,https://derpicdn.net/img/view/2018/2/2/1646862.png,0,0.989388168,79,0,687,474,608,474,applejack
1647083.png,https://derpicdn.net/img/view/2018/2/3/1647083.png,0,0.944950581,101,53,349,301,248,248,applejack
1648378.png,https://derpicdn.net/img/view/2018/2/4/1648378.png,0,0.992958188,640,37,1358,755,718,718,applejack
1654284.png,https://derpicdn.net/img/view/2018/2/12/1654284.png,0,0.991114795,968,31,1952,1015,984,984,applejack
1661379.png,https://derpicdn.net/img/view/2018/2/20/1661379.png,0,0.968318462,94,0,1580,1457,1486,1457,applejack
1661808.png,https://derpicdn.net/img/view/2018/2/21/1661808.png,0,0.997796535,615,0,1509,862,894,862,applejack
1667556.png,https://derpicdn.net/img/view/2018/2/27/1667556.png,0,0.909261227,525,5,2001,1481,1476,1476,applejack
1671434.png,https://derpicdn.net/img/view/2018/3/4/1671434.png,0,0.999442637,92,474,460,842,368,368,applejack
1672002.png,https://derpicdn.net/img/view/2018/3/5/1672002.png,0,0.99589473,834,0,2156,1265,1322,1265,applejack
1677475.png,https://derpicdn.net/img/view/2018/3/11/1677475.png,0,0.975587487,77,0,900,811,823,811,applejack
1679462.png,https://derpicdn.net/img/view/2018/3/13/1679462.png,0,0.995348334,101,3,779,681,678,678,applejack
1681853.png,https://derpicdn.net/img/view/2018/3/16/1681853.png,0,0.936267138,55,66,589,600,534,534,applejack
1691892.png,https://derpicdn.net/img/view/2018/3/27/1691892.png,0,0.987970233,552,438,3000,3000,2448,2562,applejack
1699437.png,https://derpicdn.net/img/view/2018/4/5/1699437.png,0,0.907907486,32,0,1820,1718,1788,1718,applejack
1702384.png,https://derpicdn.net/img/view/2018/4/8/1702384.png,0,0.997779071,392,17,902,527,510,510,applejack
1702815.png,https://derpicdn.net/img/view/2018/4/8/1702815.png,0,0.951319516,753,174,2149,1570,1396,1396,applejack
1715692.png,https://derpicdn.net/img/view/2018/4/24/1715692.png,0,0.954745531,403,0,813,397,410,397,applejack
1716908.png,https://derpicdn.net/img/view/2018/4/25/1716908.png,0,0.956364632,20,0,496,462,476,462,applejack
1719740.png,https://derpicdn.net/img/view/2018/4/29/1719740.png,0,0.941796899,877,456,1693,1272,816,816,applejack
1724972.png,https://derpicdn.net/img/view/2018/5/5/1724972.png,0,0.986269474,0,0,2115,2203,2115,2203,applejack
1725037.png,https://derpicdn.net/img/view/2018/5/5/1725037.png,0,0.993000329,962,533,1582,1153,620,620,applejack
1725062.png,https://derpicdn.net/img/view/2018/5/5/1725062.png,0,0.996984661,335,440,1305,1410,970,970,applejack
1725090.png,https://derpicdn.net/img/view/2018/5/5/1725090.png,0,0.985715926,331,0,2829,2410,2498,2410,applejack
1726306.png,https://derpicdn.net/img/view/2018/5/6/1726306.png,0,0.974883616,0,0,2226,2032,2226,2032,applejack
1726322.png,https://derpicdn.net/img/view/2018/5/6/1726322.png,0,0.921382666,38,211,1933,2139,1895,1928,applejack
1729545.png,https://derpicdn.net/img/view/2018/5/10/1729545.png,0,0.99976939,280,0,1516,1196,1236,1196,applejack
1732892.png,https://derpicdn.net/img/view/2018/5/14/1732892.png,0,0.979062259,0,97,982,1201,982,1104,applejack
1734624.png,https://derpicdn.net/img/view/2018/5/17/1734624.png,0,0.99454397,115,25,383,293,268,268,applejack
1735861.png,https://derpicdn.net/img/view/2018/5/18/1735861.png,1,0.988677263,1062,0,1724,610,662,610,applejack
1736955.png,https://derpicdn.net/img/view/2018/5/20/1736955.png,0,0.990937412,82,133,1144,1195,1062,1062,applejack
1757285.png,https://derpicdn.net/img/view/2018/6/14/1757285.png,0,0.992622852,1025,8,2751,1734,1726,1726,applejack
1759411.png,https://derpicdn.net/img/view/2018/6/17/1759411.png,0,0.992789984,152,64,638,550,486,486,applejack
1759429.png,https://derpicdn.net/img/view/2018/6/17/1759429.png,0,0.985079706,0,0,1152,710,1152,710,applejack
1762485.png,https://derpicdn.net/img/view/2018/6/21/1762485.png,0,0.994808793,621,0,1483,825,862,825,applejack
1764431.png,https://derpicdn.net/img/view/2018/6/23/1764431.png,0,0.987379909,870,0,2135,1166,1265,1166,applejack
1768707.png,https://derpicdn.net/img/view/2018/6/29/1768707.png,0,0.963528812,453,237,739,523,286,286,applejack
1768707.png,https://derpicdn.net/img/view/2018/6/29/1768707.png,1,0.962352931,6,41,336,371,330,330,applejack
1774742.png,https://derpicdn.net/img/view/2018/7/7/1774742.png,0,0.960132182,1209,134,1825,750,616,616,applejack
1775060.png,https://derpicdn.net/img/view/2018/7/7/1775060.png,0,0.910494506,1904,0,3120,1162,1216,1162,applejack
1777835.png,https://derpicdn.net/img/view/2018/7/10/1777835.png,0,0.997986913,921,680,1467,1226,546,546,applejack
177845.png,https://derpicdn.net/img/view/2012/12/9/177845.png,0,0.977005661,35,0,621,479,586,479,applejack
1779114.png,https://derpicdn.net/img/view/2018/7/12/1779114.png,0,0.931785405,309,140,925,756,616,616,applejack
1787382.png,https://derpicdn.net/img/view/2018/7/23/1787382.png,0,0.989528716,268,80,828,640,560,560,applejack
1791440.png,https://derpicdn.net/img/view/2018/7/28/1791440.png,0,0.996180773,314,197,872,755,558,558,applejack
1795527.png,https://derpicdn.net/img/view/2018/8/1/1795527.png,0,0.999343634,159,0,1107,933,948,933,applejack
1802793.png,https://derpicdn.net/img/view/2018/8/10/1802793.png,1,0.966588914,306,161,880,735,574,574,applejack
1803123.png,https://derpicdn.net/img/view/2018/8/10/1803123.png,0,0.996099174,0,0,1012,1023,1012,1023,applejack
1803791.png,https://derpicdn.net/img/view/2018/8/11/1803791.png,0,0.947974563,24,1,366,343,342,342,applejack
18052.jpg,https://derpicdn.net/img/view/2012/6/24/18052.jpg,0,0.989918709,331,0,623,288,292,288,applejack
1805240.png,https://derpicdn.net/img/view/2018/8/12/1805240.png,0,0.995603263,205,21,1603,1419,1398,1398,applejack
1811436.png,https://derpicdn.net/img/view/2018/8/20/1811436.png,0,0.979632795,308,0,1644,1348,1336,1348,applejack
1815253.png,https://derpicdn.net/img/view/2018/8/24/1815253.png,0,0.928622305,0,199,2229,2657,2229,2458,applejack
1816380.png,https://derpicdn.net/img/view/2018/8/26/1816380.png,0,0.996408761,0,47,785,879,785,832,applejack
1826863.png,https://derpicdn.net/img/view/2018/9/7/1826863.png,0,0.996642411,2652,51,3406,805,754,754,applejack
1827278.png,https://derpicdn.net/img/view/2018/9/7/1827278.png,0,0.971779644,552,366,1392,1206,840,840,applejack
1830354.png,https://derpicdn.net/img/view/2018/9/11/1830354.png,0,0.983245492,88,0,424,333,336,333,applejack
1840309.png,https://derpicdn.net/img/view/2018/9/24/1840309.png,0,0.95767957,33,0,1579,1477,1546,1477,applejack
1841671.png,https://derpicdn.net/img/view/2018/9/26/1841671.png,0,0.995616615,525,205,807,487,282,282,applejack
1861643.png,https://derpicdn.net/img/view/2018/10/20/1861643.png,0,0.992870212,1243,0,2701,1180,1458,1180,applejack
1863208.png,https://derpicdn.net/img/view/2018/10/22/1863208.png,0,0.955762744,655,141,1735,1221,1080,1080,applejack
1864181.png,https://derpicdn.net/img/view/2018/10/23/1864181.png,0,0.995748639,4,0,286,268,282,268,applejack
1866678.png,https://derpicdn.net/img/view/2018/10/26/1866678.png,0,0.99705106,561,5,965,409,404,404,applejack
1880774.png,https://derpicdn.net/img/view/2018/11/12/1880774.png,0,0.998246133,352,0,1076,714,724,714,applejack
1883786.png,https://derpicdn.net/img/view/2018/11/16/1883786.png,0,0.999133945,726,43,2000,1317,1274,1274,applejack
1887775.png,https://derpicdn.net/img/view/2018/11/21/1887775.png,0,0.993123829,157,124,2255,2222,2098,2098,applejack
1890284.png,https://derpicdn.net/img/view/2018/11/25/1890284.png,0,0.993446529,112,0,684,550,572,550,applejack
1895887.png,https://derpicdn.net/img/view/2018/12/2/1895887.png,0,0.951446056,395,0,1511,1046,1116,1046,applejack
1896110.png,https://derpicdn.net/img/view/2018/12/2/1896110.png,0,0.965880871,292,0,1138,830,846,830,applejack
1902320.png,https://derpicdn.net/img/view/2018/12/8/1902320.png,0,0.956551552,1115,258,2267,1410,1152,1152,applejack
1904948.png,https://derpicdn.net/img/view/2018/12/11/1904948.png,0,0.998380065,1418,62,2850,1494,1432,1432,applejack
1911607.png,https://derpicdn.net/img/view/2018/12/17/1911607.png,0,0.960258365,76,110,542,576,466,466,applejack
1911812.png,https://derpicdn.net/img/view/2018/12/18/1911812.png,0,0.987473965,860,0,1946,1083,1086,1083,applejack
1916200.png,https://derpicdn.net/img/view/2018/12/23/1916200.png,0,0.980195105,42,0,922,710,880,710,applejack
1917631.png,https://derpicdn.net/img/view/2018/12/24/1917631.png,0,0.990384102,581,0,1113,520,532,520,applejack
1917869.png,https://derpicdn.net/img/view/2018/12/24/1917869.png,0,0.970507681,470,0,2904,2217,2434,2217,applejack
1920067.png,https://derpicdn.net/img/view/2018/12/27/1920067.png,0,0.961325288,0,265,1461,1795,1461,1530,applejack
1921954.png,https://derpicdn.net/img/view/2018/12/30/1921954.png,0,0.9460271,0,0,750,833,750,833,applejack
1928542.png,https://derpicdn.net/img/view/2019/1/6/1928542.png,0,0.998162627,0,22,1351,1468,1351,1446,applejack
1937819.png,https://derpicdn.net/img/view/2019/1/17/1937819.png,0,0.987505198,488,228,1294,1034,806,806,applejack
1944168.png,https://derpicdn.net/img/view/2019/1/25/1944168.png,0,0.96397388,68,0,4160,3907,4092,3907,applejack
1944192.png,https://derpicdn.net/img/view/2019/1/25/1944192.png,0,0.982175589,120,0,1036,816,916,816,applejack
1951213.png,https://derpicdn.net/img/view/2019/2/2/1951213.png,0,0.940875053,182,71,636,525,454,454,applejack
1951964.png,https://derpicdn.net/img/view/2019/2/3/1951964.png,0,0.998322964,529,0,1111,568,582,568,applejack
1953418.png,https://derpicdn.net/img/view/2019/2/4/1953418.png,0,0.972863734,2468,574,3798,1904,1330,1330,applejack
1953693.png,https://derpicdn.net/img/view/2019/2/4/1953693.png,0,0.959927738,615,0,1781,1116,1166,1116,applejack
1955526.png,https://derpicdn.net/img/view/2019/2/7/1955526.png,0,0.97980547,120,42,1000,984,880,942,applejack
1957163.png,https://derpicdn.net/img/view/2019/2/9/1957163.png,0,0.979927182,121,43,1000,983,879,940,applejack
1958322.png,https://derpicdn.net/img/view/2019/2/10/1958322.png,0,0.988392591,40,337,3180,3477,3140,3140,applejack
1958853.png,https://derpicdn.net/img/view/2019/2/11/1958853.png,0,0.993317544,332,0,888,532,556,532,applejack
1966802.png,https://derpicdn.net/img/view/2019/2/20/1966802.png,0,0.971489072,499,38,981,520,482,482,applejack
1967547.png,https://derpicdn.net/img/view/2019/2/21/1967547.png,0,0.925395906,519,42,1439,962,920,920,applejack
1968559.png,https://derpicdn.net/img/view/2019/2/22/1968559.png,0,0.95605576,8,3,850,857,842,854,applejack
1969544.png,https://derpicdn.net/img/view/2019/2/23/1969544.png,0,0.985113144,38,0,660,589,622,589,applejack
1970831.png,https://derpicdn.net/img/view/2019/2/24/1970831.png,0,0.960112333,136,0,840,670,704,670,applejack
1971626.png,https://derpicdn.net/img/view/2019/2/25/1971626.png,0,0.982639909,0,0,1949,1870,1949,1870,applejack
1975766.png,https://derpicdn.net/img/view/2019/3/2/1975766.png,0,0.906818986,507,37,969,499,462,462,applejack
1975899.png,https://derpicdn.net/img/view/2019/3/2/1975899.png,0,0.995378077,196,0,946,683,750,683,applejack
1983145.png,https://derpicdn.net/img/view/2019/3/11/1983145.png,0,0.999248564,278,42,744,508,466,466,applejack
1983145.png,https://derpicdn.net/img/view/2019/3/11/1983145.png,1,0.98533833,1255,60,1723,528,468,468,applejack
1990873.png,https://derpicdn.net/img/view/2019/3/20/1990873.png,0,0.993607402,80,0,858,611,778,611,applejack
2007155.png,https://derpicdn.net/img/view/2019/4/9/2007155.png,0,0.978734195,339,35,891,587,552,552,applejack
2008690.png,https://derpicdn.net/img/view/2019/4/11/2008690.png,0,0.98800534,0,0,4676,4535,4676,4535,applejack
2015502.png,https://derpicdn.net/img/view/2019/4/18/2015502.png,0,0.990345001,0,0,634,664,634,664,applejack
2022227.png,https://derpicdn.net/img/view/2019/4/24/2022227.png,0,0.998479605,3108,374,5660,3028,2552,2654,applejack
2022227.png,https://derpicdn.net/img/view/2019/4/24/2022227.png,1,0.982030809,204,930,2592,3318,2388,2388,applejack
2023259.png,https://derpicdn.net/img/view/2019/4/26/2023259.png,0,0.990912259,0,0,958,976,958,976,applejack
2029628.png,https://derpicdn.net/img/view/2019/5/3/2029628.png,0,0.98695147,103,0,635,510,532,510,applejack
2031742.png,https://derpicdn.net/img/view/2019/5/5/2031742.png,1,0.99549824,1113,0,1499,369,386,369,applejack
2034795.png,https://derpicdn.net/img/view/2019/5/9/2034795.png,0,0.948121309,0,0,1393,1403,1393,1403,applejack
2036474.png,https://derpicdn.net/img/view/2019/5/11/2036474.png,0,0.927466154,296,0,1400,1019,1104,1019,applejack
2048623.png,https://derpicdn.net/img/view/2019/5/25/2048623.png,0,0.972345114,685,0,1657,929,972,929,applejack
2051675.png,https://derpicdn.net/img/view/2019/5/28/2051675.png,0,0.992435992,263,248,1103,1088,840,840,applejack
2055391.png,https://derpicdn.net/img/view/2019/6/1/2055391.png,1,0.942330241,58,6,388,336,330,330,applejack
2059970.png,https://derpicdn.net/img/view/2019/6/7/2059970.png,0,0.93965894,1091,0,1841,708,750,708,applejack
2060884.png,https://derpicdn.net/img/view/2019/6/8/2060884.png,0,0.955366731,742,586,2264,2108,1522,1522,applejack
2061122.png,https://derpicdn.net/img/view/2019/6/9/2061122.png,0,0.994324028,211,28,469,286,258,258,applejack
2063218.png,https://derpicdn.net/img/view/2019/6/11/2063218.png,0,0.996405423,0,0,633,615,633,615,applejack
2070692.png,https://derpicdn.net/img/view/2019/6/20/2070692.png,0,0.987611592,64,0,942,856,878,856,applejack
2076701.png,https://derpicdn.net/img/view/2019/6/27/2076701.png,0,0.986034334,241,0,904,604,663,604,applejack
2083261.png,https://derpicdn.net/img/view/2019/7/5/2083261.png,0,0.976253569,5753,120,6291,658,538,538,applejack
2083261.png,https://derpicdn.net/img/view/2019/7/5/2083261.png,1,0.904598236,3619,75,4235,691,616,616,applejack
2083883.png,https://derpicdn.net/img/view/2019/7/5/2083883.png,0,0.91068095,0,136,2162,2440,2162,2304,applejack
2086724.png,https://derpicdn.net/img/view/2019/7/8/2086724.png,0,0.993494987,411,0,1145,674,734,674,applejack
2090310.png,https://derpicdn.net/img/view/2019/7/13/2090310.png,0,0.99833554,296,0,714,415,418,415,applejack
2095351.png,https://derpicdn.net/img/view/2019/7/18/2095351.png,0,0.954026937,0,0,943,764,943,764,applejack
2100368.png,https://derpicdn.net/img/view/2019/7/24/2100368.png,0,0.998073936,172,0,658,460,486,460,applejack
2106146.png,https://derpicdn.net/img/view/2019/8/1/2106146.png,0,0.991630852,7,23,635,651,628,628,applejack
2106841.png,https://derpicdn.net/img/view/2019/8/2/2106841.png,0,0.97697717,163,0,773,514,610,514,applejack
2119228.png,https://derpicdn.net/img/view/2019/8/16/2119228.png,0,0.99941653,710,206,1840,1336,1130,1130,applejack
2119648.png,https://derpicdn.net/img/view/2019/8/16/2119648.png,0,0.994822443,793,153,1303,663,510,510,applejack
2119810.png,https://derpicdn.net/img/view/2019/8/16/2119810.png,0,0.991398752,355,150,1425,1220,1070,1070,applejack
2119812.png,https://derpicdn.net/img/view/2019/8/16/2119812.png,0,0.993582606,96,85,1328,1317,1232,1232,applejack
2119814.png,https://derpicdn.net/img/view/2019/8/16/2119814.png,0,0.980474174,1273,1597,2489,2813,1216,1216,applejack
2123444.png,https://derpicdn.net/img/view/2019/8/20/2123444.png,0,0.989044428,931,0,2417,1361,1486,1361,applejack
2126386.png,https://derpicdn.net/img/view/2019/8/24/2126386.png,0,0.914577425,120,123,660,663,540,540,applejack
2127116.png,https://derpicdn.net/img/view/2019/8/25/2127116.png,0,0.9765504,829,19,1811,1001,982,982,applejack
2128157.png,https://derpicdn.net/img/view/2019/8/26/2128157.png,0,0.987544,0,18,736,778,736,760,applejack
2143141.png,https://derpicdn.net/img/view/2019/9/13/2143141.png,0,0.987857461,286,11,750,475,464,464,applejack
2151821.png,https://derpicdn.net/img/view/2019/9/24/2151821.png,0,0.994584143,1449,263,2941,1755,1492,1492,applejack
2155777.png,https://derpicdn.net/img/view/2019/9/29/2155777.png,0,0.976623654,0,0,791,792,791,792,applejack
2156193.png,https://derpicdn.net/img/view/2019/9/29/2156193.png,0,0.960333765,30,0,1206,1158,1176,1158,applejack
2165669.png,https://derpicdn.net/img/view/2019/10/11/2165669.png,0,0.982581496,0,64,1754,2086,1754,2022,applejack
2168486.png,https://derpicdn.net/img/view/2019/10/14/2168486.png,0,0.90043962,0,0,765,808,765,808,applejack
2173192.png,https://derpicdn.net/img/view/2019/10/19/2173192.png,0,0.928424835,214,0,822,517,608,517,applejack
2192351.png,https://derpicdn.net/img/view/2019/11/10/2192351.png,0,0.998494208,159,4,455,300,296,296,applejack
2204324.png,https://derpicdn.net/img/view/2019/11/24/2204324.png,0,0.94787997,12,93,794,875,782,782,applejack
2215447.png,https://derpicdn.net/img/view/2019/12/8/2215447.png,0,0.979905427,130,38,740,648,610,610,applejack
2215686.png,https://derpicdn.net/img/view/2019/12/8/2215686.png,0,0.983273149,2405,1258,2937,1790,532,532,applejack
2215686.png,https://derpicdn.net/img/view/2019/12/8/2215686.png,1,0.906471074,0,849,2153,3153,2153,2304,applejack
2218393.png,https://derpicdn.net/img/view/2019/12/11/2218393.png,0,0.991357923,575,0,1239,545,664,545,applejack
2221835.png,https://derpicdn.net/img/view/2019/12/16/2221835.png,0,0.969171345,0,63,2200,2331,2200,2268,applejack
2223453.png,https://derpicdn.net/img/view/2019/12/18/2223453.png,0,0.989132285,339,0,1297,796,958,796,applejack
2233168.png,https://derpicdn.net/img/view/2019/12/29/2233168.png,0,0.962693691,0,0,850,1172,850,1172,applejack
2237633.jpg,https://derpicdn.net/img/view/2020/1/3/2237633.jpg,0,0.935358346,382,85,802,505,420,420,applejack
2242956.png,https://derpicdn.net/img/view/2020/1/9/2242956.png,0,0.997515678,0,24,1093,1132,1093,1108,applejack
2251250.png,https://derpicdn.net/img/view/2020/1/19/2251250.png,0,0.982254446,0,132,744,1006,744,874,applejack
2251816.jpg,https://derpicdn.net/img/view/2020/1/19/2251816.jpg,0,0.994816065,287,116,1335,1164,1048,1048,applejack
2253784.jpg,https://derpicdn.net/img/view/2020/1/22/2253784.jpg,0,0.998686433,555,100,1961,1506,1406,1406,applejack
2253965.png,https://derpicdn.net/img/view/2020/1/22/2253965.png,0,0.968463182,242,39,1504,1301,1262,1262,applejack
2256762.jpg,https://derpicdn.net/img/view/2020/1/25/2256762.jpg,0,0.98596859,590,436,1520,1366,930,930,applejack
2258177.png,https://derpicdn.net/img/view/2020/1/27/2258177.png,0,0.977613688,305,0,1249,831,944,831,applejack
2260818.jpg,https://derpicdn.net/img/view/2020/1/30/2260818.jpg,0,0.997142315,322,98,1178,954,856,856,applejack
2261686.png,https://derpicdn.net/img/view/2020/1/31/2261686.png,0,0.924595475,369,366,1013,1010,644,644,applejack
2264156.png,https://derpicdn.net/img/view/2020/2/2/2264156.png,0,0.97216773,576,1057,1916,2397,1340,1340,applejack
2264203.png,https://derpicdn.net/img/view/2020/2/2/2264203.png,0,0.996484518,224,5,484,265,260,260,applejack
2266616.jpg,https://derpicdn.net/img/view/2020/2/5/2266616.jpg,0,0.979373157,675,87,1923,1335,1248,1248,applejack
2271774.jpg,https://derpicdn.net/img/view/2020/2/12/2271774.jpg,0,0.997359395,307,0,1301,950,994,950,applejack
2272362.png,https://derpicdn.net/img/view/2020/2/12/2272362.png,0,0.983202279,605,0,1201,592,596,592,applejack
2272362.png,https://derpicdn.net/img/view/2020/2/12/2272362.png,1,0.93266201,345,54,823,532,478,478,applejack
2274580.jpg,https://derpicdn.net/img/view/2020/2/15/2274580.jpg,0,0.956053257,24,0,2018,1913,1994,1913,applejack
2274603.png,https://derpicdn.net/img/view/2020/2/15/2274603.png,0,0.999113917,820,0,1664,874,844,874,applejack
2276995.jpg,https://derpicdn.net/img/view/2020/2/17/2276995.jpg,0,0.997598588,284,0,1060,744,776,744,applejack
2278686.png,https://derpicdn.net/img/view/2020/2/19/2278686.png,0,0.990960777,292,0,1048,735,756,735,applejack
2278749.png,https://derpicdn.net/img/view/2020/2/20/2278749.png,0,0.991506755,292,0,1048,735,756,735,applejack
2282181.png,https://derpicdn.net/img/view/2020/2/23/2282181.png,0,0.946310222,437,38,833,434,396,396,applejack
2283825.png,https://derpicdn.net/img/view/2020/2/26/2283825.png,0,0.948421896,329,231,1273,1175,944,944,applejack
2283827.png,https://derpicdn.net/img/view/2020/2/26/2283827.png,0,0.995642602,278,55,1414,1191,1136,1136,applejack
2285872.jpg,https://derpicdn.net/img/view/2020/2/29/2285872.jpg,0,0.975249052,325,0,673,342,348,342,applejack
2286066.png,https://derpicdn.net/img/view/2020/2/29/2286066.png,0,0.96984154,287,136,1121,970,834,834,applejack
2287463.jpg,https://derpicdn.net/img/view/2020/3/1/2287463.jpg,0,0.988820791,1267,351,2029,1113,762,762,applejack
2290288.jpg,https://derpicdn.net/img/view/2020/3/5/2290288.jpg,0,0.963753343,49,0,1231,1129,1182,1129,applejack
2291970.png,https://derpicdn.net/img/view/2020/3/7/2291970.png,0,0.96918416,1137,109,3125,2097,1988,1988,applejack
2292052.jpg,https://derpicdn.net/img/view/2020/3/7/2292052.jpg,0,0.990445793,1200,493,1762,1055,562,562,applejack
2295139.png,https://derpicdn.net/img/view/2020/3/11/2295139.png,0,0.996980965,851,943,1593,1685,742,742,applejack
2295748.png,https://derpicdn.net/img/view/2020/3/12/2295748.png,0,0.994530737,106,0,636,510,530,510,applejack
2296260.png,https://derpicdn.net/img/view/2020/3/13/2296260.png,0,0.946890593,449,108,829,488,380,380,applejack
2303315.png,https://derpicdn.net/img/view/2020/3/22/2303315.png,0,0.926512539,316,0,946,595,630,595,applejack
2309248.png,https://derpicdn.net/img/view/2020/3/29/2309248.png,0,0.99082607,0,0,1221,1289,1221,1289,applejack
2311400.png,https://derpicdn.net/img/view/2020/4/1/2311400.png,0,0.954799235,2175,160,3511,1496,1336,1336,applejack
2314246.png,https://derpicdn.net/img/view/2020/4/4/2314246.png,0,0.99910289,1011,0,2687,1451,1676,1451,applejack
2318466.png,https://derpicdn.net/img/view/2020/4/10/2318466.png,0,0.962262213,88,1,672,585,584,584,applejack
2326790.jpg,https://derpicdn.net/img/view/2020/4/20/2326790.jpg,0,0.996081889,260,122,1196,1058,936,936,applejack
2327096.png,https://derpicdn.net/img/view/2020/4/20/2327096.png,0,0.963217318,194,0,2468,2185,2274,2185,applejack
2330591.jpg,https://derpicdn.net/img/view/2020/4/24/2330591.jpg,0,0.962175667,81,0,1993,1545,1912,1545,applejack
2336130.png,https://derpicdn.net/img/view/2020/5/1/2336130.png,0,0.974474788,178,604,1396,1822,1218,1218,applejack
2339293.png,https://derpicdn.net/img/view/2020/5/4/2339293.png,0,0.998747706,922,17,3134,2229,2212,2212,applejack
2342840.jpg,https://derpicdn.net/img/view/2020/5/8/2342840.jpg,0,0.999072194,332,8,776,452,444,444,applejack
2344812.jpg,https://derpicdn.net/img/view/2020/5/10/2344812.jpg,0,0.97197926,0,0,1533,1257,1533,1257,applejack
234679.png,https://derpicdn.net/img/view/2013/2/6/234679.png,0,0.97406584,128,0,638,503,510,503,applejack
2350718.png,https://derpicdn.net/img/view/2020/5/17/2350718.png,0,0.996292651,1043,307,2063,1327,1020,1020,applejack
2353482.png,https://derpicdn.net/img/view/2020/5/20/2353482.png,0,0.93173486,554,228,1644,1318,1090,1090,applejack
2354085.jpg,https://derpicdn.net/img/view/2020/5/21/2354085.jpg,0,0.986769199,287,16,683,412,396,396,applejack
2600.png,https://derpicdn.net/img/view/2012/1/29/2600.png,0,0.988331437,497,45,967,515,470,470,applejack
285924.jpg,https://derpicdn.net/img/view/2013/4/2/285924.jpg,0,0.998786271,702,36,1050,384,348,348,applejack
29262.png,https://derpicdn.net/img/view/2012/7/2/29262.png,0,0.993063152,204,34,590,420,386,386,applejack
297983.png,https://derpicdn.net/img/view/2013/4/14/297983.png,0,0.996928573,172,41,482,351,310,310,applejack
306702.png,https://derpicdn.net/img/view/2013/4/23/306702.png,0,0.980974972,0,0,488,528,488,528,applejack
311302.png,https://derpicdn.net/img/view/2013/4/29/311302.png,1,0.97549659,0,33,425,499,425,466,applejack
318314.png,https://derpicdn.net/img/view/2013/5/6/318314.png,0,0.999215961,528,0,964,423,436,423,applejack
336494.png,https://derpicdn.net/img/view/2013/5/30/336494.png,0,0.969574749,1915,299,3357,1741,1442,1442,applejack
341105.png,https://derpicdn.net/img/view/2013/6/5/341105.png,0,0.990735352,239,41,507,309,268,268,applejack
344202.png,https://derpicdn.net/img/view/2013/6/9/344202.png,0,0.975919962,525,0,1587,1060,1062,1060,applejack
349655.png,https://derpicdn.net/img/view/2013/6/16/349655.png,0,0.989044845,262,93,674,505,412,412,applejack
358430.png,https://derpicdn.net/img/view/2013/6/27/358430.png,0,0.987121105,148,0,540,379,392,379,applejack
361680.png,https://derpicdn.net/img/view/2013/7/1/361680.png,0,0.945116103,0,0,1884,1878,1884,1878,applejack
394875.png,https://derpicdn.net/img/view/2013/8/8/394875.png,0,0.995183408,41,19,485,463,444,444,applejack
395652.png,https://derpicdn.net/img/view/2013/8/9/395652.png,0,0.996334672,126,0,474,316,348,316,applejack
408047.png,https://derpicdn.net/img/view/2013/8/23/408047.png,0,0.998864174,1613,0,3319,1547,1706,1547,applejack
411056.png,https://derpicdn.net/img/view/2013/8/26/411056.png,0,0.91827029,485,168,861,544,376,376,applejack
414361.png,https://derpicdn.net/img/view/2013/8/30/414361.png,0,0.957721651,429,691,1137,1399,708,708,applejack
422478.png,https://derpicdn.net/img/view/2013/9/8/422478.png,1,0.991101623,431,0,697,206,266,206,applejack
426974.jpg,https://derpicdn.net/img/view/2013/9/13/426974.jpg,0,0.962324023,54,0,426,362,372,362,applejack
437068.png,https://derpicdn.net/img/view/2013/9/28/437068.png,0,0.969388545,22,0,466,434,444,434,applejack
437798.png,https://derpicdn.net/img/view/2013/9/29/437798.png,0,0.95458442,2,11,1311,1467,1309,1456,applejack
442902.png,https://derpicdn.net/img/view/2013/10/6/442902.png,0,0.999452174,249,2,667,420,418,418,applejack
452954.png,https://derpicdn.net/img/view/2013/10/20/452954.png,0,0.993533313,0,139,917,1113,917,974,applejack
454812.png,https://derpicdn.net/img/view/2013/10/23/454812.png,0,0.967431128,453,0,898,407,445,407,applejack
457740.png,https://derpicdn.net/img/view/2013/10/27/457740.png,0,0.987050176,242,33,428,219,186,186,applejack
489417.png,https://derpicdn.net/img/view/2013/12/4/489417.png,0,0.980407834,76,46,588,558,512,512,applejack
506177.png,https://derpicdn.net/img/view/2013/12/25/506177.png,0,0.942686558,280,40,598,358,318,318,applejack
510211.png,https://derpicdn.net/img/view/2013/12/30/510211.png,0,0.983938456,175,0,769,585,594,585,applejack
512116.png,https://derpicdn.net/img/view/2014/1/1/512116.png,0,0.993388295,267,2,675,410,408,408,applejack
517556.png,https://derpicdn.net/img/view/2014/1/7/517556.png,0,0.960757494,151,0,453,293,302,293,applejack
520635.png,https://derpicdn.net/img/view/2014/1/11/520635.png,0,0.902914047,256,7,560,311,304,304,applejack
528574.png,https://derpicdn.net/img/view/2014/1/19/528574.png,0,0.997665644,507,105,2125,1723,1618,1618,applejack
529712.png,https://derpicdn.net/img/view/2014/1/20/529712.png,0,0.996224821,318,555,474,711,156,156,applejack
532398.png,https://derpicdn.net/img/view/2014/1/23/532398.png,0,0.984932601,97,20,553,476,456,456,applejack
545785.png,https://derpicdn.net/img/view/2014/2/7/545785.png,0,0.956681967,0,0,791,807,791,807,applejack
558946.jpg,https://derpicdn.net/img/view/2014/2/22/558946.jpg,0,0.992872059,0,0,1026,895,1026,895,applejack
563196.png,https://derpicdn.net/img/view/2014/2/28/563196.png,0,0.990558028,146,0,972,770,826,770,applejack
571217.png,https://derpicdn.net/img/view/2014/3/10/571217.png,0,0.987341285,129,0,613,438,484,438,applejack
571787.png,https://derpicdn.net/img/view/2014/3/11/571787.png,0,0.988658607,240,48,960,768,720,720,applejack
578224.png,https://derpicdn.net/img/view/2014/3/17/578224.png,0,0.986700773,5,0,393,387,388,387,applejack
584465.png,https://derpicdn.net/img/view/2014/3/24/584465.png,0,0.999090552,78,0,574,454,496,454,applejack
588717.png,https://derpicdn.net/img/view/2014/3/30/588717.png,0,0.927590132,201,86,873,758,672,672,applejack
599174.jpg,https://derpicdn.net/img/view/2014/4/13/599174.jpg,0,0.988672078,79,0,585,489,506,489,applejack
606326.png,https://derpicdn.net/img/view/2014/4/21/606326.png,0,0.994380534,113,50,623,560,510,510,applejack
606588.jpg,https://derpicdn.net/img/view/2014/4/21/606588.jpg,0,0.923909783,0,0,1071,986,1071,986,applejack
613781.jpg,https://derpicdn.net/img/view/2014/4/30/613781.jpg,0,0.99924016,181,44,501,364,320,320,applejack
618832.png,https://derpicdn.net/img/view/2014/5/6/618832.png,0,0.952065885,188,130,664,606,476,476,applejack
622796.png,https://derpicdn.net/img/view/2014/5/10/622796.png,0,0.998409212,6,0,478,467,472,467,applejack
62777.jpg,https://derpicdn.net/img/view/2012/7/31/62777.jpg,0,0.980955362,328,8,686,366,358,358,applejack
637934.png,https://derpicdn.net/img/view/2014/5/27/637934.png,0,0.95672667,92,180,724,785,632,605,applejack
646297.png,https://derpicdn.net/img/view/2014/6/6/646297.png,0,0.994920969,820,0,1280,450,460,450,applejack
650893.png,https://derpicdn.net/img/view/2014/6/12/650893.png,0,0.967967808,0,104,3814,4190,3814,4086,applejack
653427.jpg,https://derpicdn.net/img/view/2014/6/15/653427.jpg,0,0.999434769,564,0,1216,628,652,628,applejack
657305.png,https://derpicdn.net/img/view/2014/6/20/657305.png,0,0.905672729,46,74,1734,1762,1688,1688,applejack
674704.png,https://derpicdn.net/img/view/2014/7/14/674704.png,0,0.999739826,526,74,968,516,442,442,applejack
674932.png,https://derpicdn.net/img/view/2014/7/14/674932.png,0,0.999287605,158,0,516,352,358,352,applejack
675782.png,https://derpicdn.net/img/view/2014/7/15/675782.png,0,0.955491841,75,0,653,499,578,499,applejack
680487.jpg,https://derpicdn.net/img/view/2014/7/21/680487.jpg,0,0.992819607,194,0,440,228,246,228,applejack
685107.png,https://derpicdn.net/img/view/2014/7/28/685107.png,0,0.960931361,0,0,474,533,474,533,applejack
691079.png,https://derpicdn.net/img/view/2014/8/4/691079.png,0,0.982321382,494,245,1178,929,684,684,applejack
700520.png,https://derpicdn.net/img/view/2014/8/15/700520.png,0,0.99715662,223,0,515,291,292,291,applejack
700565.png,https://derpicdn.net/img/view/2014/8/15/700565.png,0,0.927285016,344,0,996,630,652,630,applejack
714127.png,https://derpicdn.net/img/view/2014/9/3/714127.png,0,0.932095587,149,408,1779,2038,1630,1630,applejack
718229.png,https://derpicdn.net/img/view/2014/9/8/718229.png,0,0.960908651,182,0,578,387,396,387,applejack
720.png,https://derpicdn.net/img/view/2012/1/17/720.png,0,0.976682007,172,0,654,443,482,443,applejack
726121.jpg,https://derpicdn.net/img/view/2014/9/20/726121.jpg,0,0.991867423,222,20,808,606,586,586,applejack
734186.png,https://derpicdn.net/img/view/2014/10/2/734186.png,0,0.997490227,162,14,696,548,534,534,applejack
739376.png,https://derpicdn.net/img/view/2014/10/9/739376.png,0,0.978241682,122,20,332,230,210,210,applejack
743697.png,https://derpicdn.net/img/view/2014/10/15/743697.png,0,0.938642502,168,3,660,495,492,492,applejack
751648.png,https://derpicdn.net/img/view/2014/10/27/751648.png,0,0.999814808,702,33,1540,871,838,838,applejack
765748.png,https://derpicdn.net/img/view/2014/11/16/765748.png,0,0.990821302,372,0,852,473,480,473,applejack
770170.png,https://derpicdn.net/img/view/2014/11/23/770170.png,0,0.993968844,26,0,488,481,462,481,applejack
77121.png,https://derpicdn.net/img/view/2012/8/18/77121.png,0,0.99302429,221,0,701,463,480,463,applejack
779324.png,https://derpicdn.net/img/view/2014/12/6/779324.png,0,0.999156952,108,4,300,196,192,192,applejack
787737.png,https://derpicdn.net/img/view/2014/12/18/787737.png,0,0.998409808,530,0,5524,4790,4994,4790,applejack
797753.jpg,https://derpicdn.net/img/view/2015/1/2/797753.jpg,0,0.962020874,321,411,659,749,338,338,applejack
800379.png,https://derpicdn.net/img/view/2015/1/6/800379.png,0,0.92941761,504,182,1302,980,798,798,applejack
805280.png,https://derpicdn.net/img/view/2015/1/13/805280.png,0,0.982291043,155,0,533,361,378,361,applejack
806896.png,https://derpicdn.net/img/view/2015/1/15/806896.png,0,0.970682204,95,94,497,496,402,402,applejack
808819.png,https://derpicdn.net/img/view/2015/1/18/808819.png,0,0.987646222,111,0,807,688,696,688,applejack
808915.png,https://derpicdn.net/img/view/2015/1/18/808915.png,0,0.962480247,0,56,1738,1794,1738,1738,applejack
810442.png,https://derpicdn.net/img/view/2015/1/20/810442.png,0,0.998339355,341,160,1049,868,708,708,applejack
810494.png,https://derpicdn.net/img/view/2015/1/20/810494.png,0,0.922146618,30,0,1110,1080,1080,1080,applejack
819758.png,https://derpicdn.net/img/view/2015/2/2/819758.png,0,0.997543335,635,0,800,162,165,162,applejack
819758.png,https://derpicdn.net/img/view/2015/2/2/819758.png,1,0.996982455,626,239,798,411,172,172,applejack
819758.png,https://derpicdn.net/img/view/2015/2/2/819758.png,2,0.995193005,479,410,651,582,172,172,applejack
819758.png,https://derpicdn.net/img/view/2015/2/2/819758.png,3,0.989755154,395,0,553,156,158,156,applejack
819758.png,https://derpicdn.net/img/view/2015/2/2/819758.png,4,0.978945673,0,0,194,183,194,183,applejack
819758.png,https://derpicdn.net/img/view/2015/2/2/819758.png,5,0.935239077,345,468,525,648,180,180,applejack
826956.png,https://derpicdn.net/img/view/2015/2/12/826956.png,0,0.999140382,243,0,697,430,454,430,applejack
830260.png,https://derpicdn.net/img/view/2015/2/16/830260.png,0,0.999337494,237,32,717,512,480,480,applejack
837524.png,https://derpicdn.net/img/view/2015/2/26/837524.png,0,0.993464887,375,40,911,576,536,536,applejack
840525.png,https://derpicdn.net/img/view/2015/3/2/840525.png,0,0.923485756,2012,320,3250,1558,1238,1238,applejack
841878.png,https://derpicdn.net/img/view/2015/3/4/841878.png,0,0.999010324,239,78,955,794,716,716,applejack
843008.png,https://derpicdn.net/img/view/2015/3/5/843008.png,0,0.935733438,156,0,972,765,816,765,applejack
846094.png,https://derpicdn.net/img/view/2015/3/9/846094.png,0,0.994393229,815,0,1389,525,574,525,applejack
85108.png,https://derpicdn.net/img/view/2012/8/28/85108.png,0,0.979496717,3314,2510,4052,3248,738,738,applejack
85108.png,https://derpicdn.net/img/view/2012/8/28/85108.png,1,0.977186739,3616,1316,4382,2082,766,766,applejack
85108.png,https://derpicdn.net/img/view/2012/8/28/85108.png,2,0.976489365,1308,2457,2046,3195,738,738,applejack
85108.png,https://derpicdn.net/img/view/2012/8/28/85108.png,3,0.96701175,2689,0,3373,649,684,649,applejack
85108.png,https://derpicdn.net/img/view/2012/8/28/85108.png,4,0.9603706,3903,2537,4500,3195,597,658,applejack
85108.png,https://derpicdn.net/img/view/2012/8/28/85108.png,5,0.905371428,54,1078,892,1916,838,838,applejack
854284.jpg,https://derpicdn.net/img/view/2015/3/21/854284.jpg,0,0.958635628,0,24,669,706,669,682,applejack
854284.jpg,https://derpicdn.net/img/view/2015/3/21/854284.jpg,1,0.925186038,750,47,1184,481,434,434,applejack
854284.jpg,https://derpicdn.net/img/view/2015/3/21/854284.jpg,2,0.922226012,787,596,1271,1080,484,484,applejack
854374.png,https://derpicdn.net/img/view/2015/3/21/854374.png,0,0.999035418,250,20,794,564,544,544,applejack
858820.png,https://derpicdn.net/img/view/2015/3/28/858820.png,0,0.979759336,19,28,511,520,492,492,applejack
872195.png,https://derpicdn.net/img/view/2015/4/12/872195.png,0,0.972202718,209,295,2400,2527,2191,2232,applejack
872435.png,https://derpicdn.net/img/view/2015/4/12/872435.png,0,0.985219777,0,84,1280,1642,1280,1558,applejack
879711.png,https://derpicdn.net/img/view/2015/4/21/879711.png,0,0.991699576,170,0,600,424,430,424,applejack
881322.jpg,https://derpicdn.net/img/view/2015/4/24/881322.jpg,0,0.997347236,804,0,1406,560,602,560,applejack
886180.png,https://derpicdn.net/img/view/2015/4/30/886180.png,0,0.981351614,2,0,492,467,490,467,applejack
889189.png,https://derpicdn.net/img/view/2015/5/4/889189.png,0,0.957939804,903,0,2351,1277,1448,1277,applejack
891136.png,https://derpicdn.net/img/view/2015/5/7/891136.png,0,0.994837046,0,0,923,900,923,900,applejack
895505.png,https://derpicdn.net/img/view/2015/5/14/895505.png,0,0.992292464,192,75,538,421,346,346,applejack
898145.png,https://derpicdn.net/img/view/2015/5/17/898145.png,0,0.998768151,236,33,1006,803,770,770,applejack
901740.png,https://derpicdn.net/img/view/2015/5/22/901740.png,0,0.99634546,0,0,1572,1440,1572,1440,applejack
905136.png,https://derpicdn.net/img/view/2015/5/27/905136.png,0,0.999206483,173,0,1285,1002,1112,1002,applejack
912971.jpg,https://derpicdn.net/img/view/2015/6/8/912971.jpg,0,0.989884794,141,9,813,681,672,672,applejack
922566.png,https://derpicdn.net/img/view/2015/6/23/922566.png,0,0.971464872,766,399,980,613,214,214,applejack
92633.png,https://derpicdn.net/img/view/2012/9/8/92633.png,0,0.909812808,288,0,1042,730,754,730,applejack
926336.png,https://derpicdn.net/img/view/2015/6/29/926336.png,1,0.925937891,0,409,168,603,168,194,applejack
926336.png,https://derpicdn.net/img/view/2015/6/29/926336.png,2,0.922843993,204,163,392,351,188,188,applejack
931807.png,https://derpicdn.net/img/view/2015/7/7/931807.png,0,0.998207033,184,263,1818,1897,1634,1634,applejack
93530.png,https://derpicdn.net/img/view/2012/9/9/93530.png,0,0.970434725,3038,0,8320,4473,5282,4473,applejack
949347.png,https://derpicdn.net/img/view/2015/8/3/949347.png,0,0.998850405,188,0,394,202,206,202,applejack
950226.png,https://derpicdn.net/img/view/2015/8/4/950226.png,0,0.991944969,201,214,1111,1124,910,910,applejack
954009.png,https://derpicdn.net/img/view/2015/8/9/954009.png,0,0.946739495,69,60,913,904,844,844,applejack
957368.png,https://derpicdn.net/img/view/2015/8/14/957368.png,0,0.996816516,1049,0,1863,807,814,807,applejack
957370.png,https://derpicdn.net/img/view/2015/8/14/957370.png,0,0.997199655,1054,3,1848,797,794,794,applejack
958827.png,https://derpicdn.net/img/view/2015/8/16/958827.png,0,0.946873188,1300,243,1704,647,404,404,applejack
96471.jpg,https://derpicdn.net/img/view/2012/9/12/96471.jpg,0,0.994945467,217,0,700,456,483,456,applejack
968047.png,https://derpicdn.net/img/view/2015/8/29/968047.png,0,0.997856319,883,0,1511,583,628,583,applejack
971453.png,https://derpicdn.net/img/view/2015/9/2/971453.png,0,0.993765712,181,0,645,412,464,412,applejack
971844.jpg,https://derpicdn.net/img/view/2015/9/3/971844.jpg,0,0.991419613,111,31,349,269,238,238,applejack
97326.png,https://derpicdn.net/img/view/2012/9/13/97326.png,0,0.993196249,68,0,402,281,334,281,applejack
978293.png,https://derpicdn.net/img/view/2015/9/12/978293.png,0,0.998325169,308,55,862,609,554,554,applejack
980697.png,https://derpicdn.net/img/view/2015/9/15/980697.png,0,0.995463729,361,14,933,586,572,572,applejack
980764.png,https://derpicdn.net/img/view/2015/9/15/980764.png,0,0.991444826,365,17,933,585,568,568,applejack
984633.png,https://derpicdn.net/img/view/2015/9/21/984633.png,0,0.953263402,0,0,3000,3145,3000,3145,applejack
986717.png,https://derpicdn.net/img/view/2015/9/24/986717.png,0,0.999336779,20,0,672,524,652,524,applejack
987022.png,https://derpicdn.net/img/view/2015/9/24/987022.png,0,0.967926204,342,498,1880,2000,1538,1502,applejack
989240.png,https://derpicdn.net/img/view/2015/9/27/989240.png,0,0.989169419,287,0,643,340,356,340,applejack
991573.png,https://derpicdn.net/img/view/2015/9/30/991573.png,0,0.984834373,88,0,496,386,408,386,applejack
993399.png,https://derpicdn.net/img/view/2015/10/3/993399.png,0,0.95308888,502,170,1106,774,604,604,applejack
995541.png,https://derpicdn.net/img/view/2015/10/5/995541.png,0,0.968257308,15,0,565,525,550,525,applejack
995726.png,https://derpicdn.net/img/view/2015/10/6/995726.png,0,0.9636935,32,112,1012,1092,980,980,applejack
1000096.png,https://derpicdn.net/img/view/2015/10/11/1000096.png,0,0.93282634,373,0,1431,1016,1058,1016,applejack
1004380.jpg,https://derpicdn.net/img/view/2015/10/17/1004380.jpg,0,0.978961766,4,16,502,562,498,546,applejack
1005845.png,https://derpicdn.net/img/view/2015/10/19/1005845.png,0,0.986635923,132,0,1428,1292,1296,1292,applejack
1007222.png,https://derpicdn.net/img/view/2015/10/22/1007222.png,0,0.993520141,188,0,742,546,554,546,applejack
1007624.png,https://derpicdn.net/img/view/2015/10/22/1007624.png,0,0.9730708,87,79,565,557,478,478,applejack
1009267.png,https://derpicdn.net/img/view/2015/10/24/1009267.png,0,0.901910782,328,432,1468,1572,1140,1140,applejack
1010760.png,https://derpicdn.net/img/view/2015/10/28/1010760.png,0,0.999072433,0,178,1169,1414,1169,1236,applejack
1014299.png,https://derpicdn.net/img/view/2015/11/1/1014299.png,0,0.983009219,262,3,674,415,412,412,applejack
1022425.png,https://derpicdn.net/img/view/2015/11/14/1022425.png,0,0.971803069,194,0,946,711,752,711,applejack
1022425.png,https://derpicdn.net/img/view/2015/11/14/1022425.png,0,0.971803069,194,0,946,711,752,711,applejack
1022857.png,https://derpicdn.net/img/view/2015/11/14/1022857.png,0,0.999035656,149,7,841,699,692,692,applejack
1028352.jpg,https://derpicdn.net/img/view/2015/11/23/1028352.jpg,0,0.986036599,77,76,423,422,346,346,applejack
1031267.png,https://derpicdn.net/img/view/2015/11/27/1031267.png,0,0.961678147,442,467,834,859,392,392,applejack
1040935.png,https://derpicdn.net/img/view/2015/12/10/1040935.png,0,0.995071173,77,0,635,502,558,502,applejack
1041942.png,https://derpicdn.net/img/view/2015/12/11/1041942.png,0,0.985278487,0,1,693,775,693,774,applejack
1042373.png,https://derpicdn.net/img/view/2015/12/12/1042373.png,0,0.988312483,0,83,558,699,558,616,applejack
1042879.png,https://derpicdn.net/img/view/2015/12/12/1042879.png,0,0.994940162,234,0,642,395,408,395,applejack
1042920.png,https://derpicdn.net/img/view/2015/12/12/1042920.png,0,0.99826628,63,247,351,535,288,288,applejack
1042920.png,https://derpicdn.net/img/view/2015/12/12/1042920.png,0,0.99826628,63,247,351,535,288,288,applejack
104677.png,https://derpicdn.net/img/view/2012/9/23/104677.png,0,0.987060368,290,123,698,531,408,408,applejack
1057436.png,https://derpicdn.net/img/view/2016/1/1/1057436.png,0,0.99547565,160,67,852,759,692,692,applejack
1057521.png,https://derpicdn.net/img/view/2016/1/1/1057521.png,0,0.965549588,555,926,755,1126,200,200,applejack
1057837.png,https://derpicdn.net/img/view/2016/1/2/1057837.png,0,0.986358583,1727,375,3487,2135,1760,1760,applejack
1058798.png,https://derpicdn.net/img/view/2016/1/3/1058798.png,0,0.992592514,0,0,1485,1238,1485,1238,applejack
1060.jpg,https://derpicdn.net/img/view/2012/1/21/1060.jpg,0,0.951995552,0,0,548,603,548,603,applejack
1062647.jpg,https://derpicdn.net/img/view/2016/1/9/1062647.jpg,0,0.988666952,206,0,494,267,288,267,applejack
1063332.png,https://derpicdn.net/img/view/2016/1/10/1063332.png,0,0.974371552,198,0,496,297,298,297,applejack
1065319.png,https://derpicdn.net/img/view/2016/1/12/1065319.png,0,0.957570612,58,0,772,690,714,690,applejack
1067185.png,https://derpicdn.net/img/view/2016/1/15/1067185.png,0,0.959575891,313,53,853,593,540,540,applejack
1073560.png,https://derpicdn.net/img/view/2016/1/25/1073560.png,0,0.950968087,902,98,2840,2036,1938,1938,applejack
10778.jpg,https://derpicdn.net/img/view/2012/6/19/10778.jpg,0,0.973141193,258,0,662,397,404,397,applejack
1081333.png,https://derpicdn.net/img/view/2016/2/6/1081333.png,0,0.96098429,290,233,838,781,548,548,applejack
1081341.png,https://derpicdn.net/img/view/2016/2/6/1081341.png,0,0.999264657,370,0,900,512,530,512,applejack
1091934.png,https://derpicdn.net/img/view/2016/2/19/1091934.png,0,0.909415483,99,99,695,695,596,596,applejack
1092190.jpg,https://derpicdn.net/img/view/2016/2/19/1092190.jpg,0,0.911129475,133,0,435,293,302,293,applejack
1099018.jpg,https://derpicdn.net/img/view/2016/2/29/1099018.jpg,0,0.974845946,355,45,1423,1113,1068,1068,applejack
1108940.png,https://derpicdn.net/img/view/2016/3/14/1108940.png,0,0.991723061,888,258,2040,1410,1152,1152,applejack
1112500.png,https://derpicdn.net/img/view/2016/3/19/1112500.png,0,0.998651028,282,37,834,589,552,552,applejack
1115495.png,https://derpicdn.net/img/view/2016/3/24/1115495.png,0,0.993923247,200,71,776,647,576,576,applejack
1121601.png,https://derpicdn.net/img/view/2016/4/1/1121601.png,0,0.995527506,71,0,1525,1264,1454,1264,applejack
1132273.png,https://derpicdn.net/img/view/2016/4/15/1132273.png,0,0.915769041,212,88,1600,1542,1388,1454,applejack
1134108.png,https://derpicdn.net/img/view/2016/4/17/1134108.png,0,0.984031498,55,4,755,704,700,700,applejack
1134108.png,https://derpicdn.net/img/view/2016/4/17/1134108.png,0,0.984031498,55,4,755,704,700,700,applejack
1137560.jpg,https://derpicdn.net/img/view/2016/4/22/1137560.jpg,0,0.922756195,98,24,470,396,372,372,applejack
1155616.png,https://derpicdn.net/img/view/2016/5/16/1155616.png,0,0.999520302,214,66,856,708,642,642,applejack
1157752.jpg,https://derpicdn.net/img/view/2016/5/19/1157752.jpg,0,0.999440134,167,1,1195,1029,1028,1028,applejack
1165681.jpg,https://derpicdn.net/img/view/2016/5/29/1165681.jpg,0,0.989404917,559,51,1055,547,496,496,applejack
1165681.jpg,https://derpicdn.net/img/view/2016/5/29/1165681.jpg,0,0.989404917,559,51,1055,547,496,496,applejack
1166077.png,https://derpicdn.net/img/view/2016/5/30/1166077.png,0,0.926099956,0,9,375,411,375,402,applejack
1166195.png,https://derpicdn.net/img/view/2016/5/30/1166195.png,0,0.990811467,1339,153,2323,1137,984,984,applejack
1168213.jpg,https://derpicdn.net/img/view/2016/6/1/1168213.jpg,0,0.997440815,114,31,566,483,452,452,applejack
1181213.png,https://derpicdn.net/img/view/2016/6/18/1181213.png,0,0.97901082,223,2,889,668,666,666,applejack
1188377.png,https://derpicdn.net/img/view/2016/6/28/1188377.png,0,0.994884312,20,0,494,469,474,469,applejack
119590.png,https://derpicdn.net/img/view/2012/10/11/119590.png,0,0.99514389,898,243,1500,911,602,668,applejack
119590.png,https://derpicdn.net/img/view/2012/10/11/119590.png,1,0.987330794,0,183,643,857,643,674,applejack
1197461.png,https://derpicdn.net/img/view/2016/7/10/1197461.png,0,0.978388548,236,6,1072,842,836,836,applejack
121430.jpg,https://derpicdn.net/img/view/2012/10/13/121430.jpg,0,0.993766725,315,59,1551,1295,1236,1236,applejack
1224141.png,https://derpicdn.net/img/view/2016/8/13/1224141.png,0,0.980773866,553,8,1661,1116,1108,1108,applejack
12259.jpg,https://derpicdn.net/img/view/2012/6/20/12259.jpg,0,0.963785768,135,16,819,700,684,684,applejack
1231288.png,https://derpicdn.net/img/view/2016/8/22/1231288.png,0,0.993745387,842,448,2020,1626,1178,1178,applejack
1248797.png,https://derpicdn.net/img/view/2016/9/14/1248797.png,0,0.998603225,779,0,1673,879,894,879,applejack
1263865.png,https://derpicdn.net/img/view/2016/10/3/1263865.png,0,0.993299663,0,0,2387,2275,2387,2275,applejack
1266626.png,https://derpicdn.net/img/view/2016/10/6/1266626.png,0,0.965521991,0,0,1123,1244,1123,1244,applejack
1277936.png,https://derpicdn.net/img/view/2016/10/21/1277936.png,0,0.996803343,257,115,753,611,496,496,applejack
1280614.png,https://derpicdn.net/img/view/2016/10/24/1280614.png,0,0.935410798,306,18,660,372,354,354,applejack
1290628.png,https://derpicdn.net/img/view/2016/11/7/1290628.png,0,0.995673418,495,0,2447,1947,1952,1947,applejack
12930.png,https://derpicdn.net/img/view/2012/6/20/12930.png,0,0.945419192,516,45,924,453,408,408,applejack
1323016.png,https://derpicdn.net/img/view/2016/12/22/1323016.png,0,0.999698937,267,117,1261,1111,994,994,applejack
1326043.png,https://derpicdn.net/img/view/2016/12/27/1326043.png,0,0.926286221,111,0,715,534,604,534,applejack
1335383.png,https://derpicdn.net/img/view/2017/1/9/1335383.png,0,0.98596859,0,38,964,1014,964,976,applejack
1339393.png,https://derpicdn.net/img/view/2017/1/14/1339393.png,0,0.993693233,665,0,2005,1395,1340,1395,applejack
1349945.png,https://derpicdn.net/img/view/2017/1/28/1349945.png,0,0.997521162,82,43,1648,1609,1566,1566,applejack
1351425.png,https://derpicdn.net/img/view/2017/1/30/1351425.png,0,0.97003603,1351,390,1909,948,558,558,applejack
1357431.png,https://derpicdn.net/img/view/2017/2/7/1357431.png,0,0.928120136,44,410,634,1000,590,590,applejack
1360683.png,https://derpicdn.net/img/view/2017/2/12/1360683.png,0,0.967018902,203,32,703,532,500,500,applejack
1362525.png,https://derpicdn.net/img/view/2017/2/14/1362525.png,0,0.978723526,214,14,1800,1702,1586,1688,applejack
1363342.png,https://derpicdn.net/img/view/2017/2/15/1363342.png,0,0.971450448,1804,0,5134,3179,3330,3179,applejack
1368103.png,https://derpicdn.net/img/view/2017/2/20/1368103.png,0,0.997271717,90,3,1036,949,946,946,applejack
1377857.png,https://derpicdn.net/img/view/2017/3/3/1377857.png,0,0.991453469,32,0,460,418,428,418,applejack
1380783.png,https://derpicdn.net/img/view/2017/3/6/1380783.png,0,0.997995794,54,96,642,684,588,588,applejack
1382161.png,https://derpicdn.net/img/view/2017/3/8/1382161.png,0,0.988737404,973,105,1995,1127,1022,1022,applejack
1386132.png,https://derpicdn.net/img/view/2017/3/13/1386132.png,0,0.991461337,5,0,765,662,760,662,applejack
1391085.png,https://derpicdn.net/img/view/2017/3/19/1391085.png,0,0.900846124,140,55,792,707,652,652,applejack
1398832.png,https://derpicdn.net/img/view/2017/3/29/1398832.png,0,0.995258272,0,0,3059,3115,3059,3115,applejack
1408065.png,https://derpicdn.net/img/view/2017/4/10/1408065.png,0,0.999385297,550,10,1080,540,530,530,applejack
1416037.png,https://derpicdn.net/img/view/2017/4/19/1416037.png,0,0.993486226,31,0,925,872,894,872,applejack
1417868.png,https://derpicdn.net/img/view/2017/4/21/1417868.png,0,0.980331361,379,0,2577,2027,2198,2027,applejack
1419228.png,https://derpicdn.net/img/view/2017/4/23/1419228.png,0,0.933131516,462,98,1070,706,608,608,applejack
1425488.png,https://derpicdn.net/img/view/2017/4/30/1425488.png,0,0.978850007,382,70,768,456,386,386,applejack
1426940.png,https://derpicdn.net/img/view/2017/5/2/1426940.png,0,0.994299233,1120,27,2026,933,906,906,applejack
1428685.png,https://derpicdn.net/img/view/2017/5/4/1428685.png,0,0.980716527,20,74,950,1004,930,930,applejack
1433615.png,https://derpicdn.net/img/view/2017/5/10/1433615.png,0,0.998358071,339,0,807,453,468,453,applejack
1437825.png,https://derpicdn.net/img/view/2017/5/16/1437825.png,0,0.992238104,124,0,734,603,610,603,applejack
1437825.png,https://derpicdn.net/img/view/2017/5/16/1437825.png,0,0.992238104,124,0,734,603,610,603,applejack
1439844.png,https://derpicdn.net/img/view/2017/5/18/1439844.png,0,0.947864592,296,186,728,618,432,432,applejack
1441953.png,https://derpicdn.net/img/view/2017/5/21/1441953.png,0,0.984913409,65,2,527,464,462,462,applejack
1449237.png,https://derpicdn.net/img/view/2017/5/29/1449237.png,0,0.987260163,104,37,846,779,742,742,applejack
1451994.png,https://derpicdn.net/img/view/2017/6/2/1451994.png,0,0.999537885,259,0,1049,682,790,682,applejack
1453354.png,https://derpicdn.net/img/view/2017/6/3/1453354.png,0,0.960836649,208,0,916,561,708,561,applejack
1456001.png,https://derpicdn.net/img/view/2017/6/7/1456001.png,0,0.977175117,615,0,2597,1946,1982,1946,applejack
1462238.png,https://derpicdn.net/img/view/2017/6/15/1462238.png,0,0.937058806,131,0,1019,876,888,876,applejack
1462238.png,https://derpicdn.net/img/view/2017/6/15/1462238.png,0,0.937058806,131,0,1019,876,888,876,applejack
1464173.png,https://derpicdn.net/img/view/2017/6/17/1464173.png,0,0.999270737,755,0,1231,450,476,450,applejack
1468676.png,https://derpicdn.net/img/view/2017/6/22/1468676.png,0,0.955242574,0,0,816,822,816,822,applejack
1469529.png,https://derpicdn.net/img/view/2017/6/23/1469529.png,0,0.930317223,145,25,701,581,556,556,applejack
1470034.png,https://derpicdn.net/img/view/2017/6/23/1470034.png,0,0.992581844,938,75,1362,499,424,424,applejack
1470950.png,https://derpicdn.net/img/view/2017/6/25/1470950.png,0,0.979819238,53,0,363,304,310,304,applejack
1472061.png,https://derpicdn.net/img/view/2017/6/26/1472061.png,0,0.999819875,3222,0,5228,1925,2006,1925,applejack
1476343.png,https://derpicdn.net/img/view/2017/7/1/1476343.png,0,0.981100261,357,2,691,336,334,334,applejack
1476343.png,https://derpicdn.net/img/view/2017/7/1/1476343.png,1,0.974336445,36,27,316,307,280,280,applejack
1476886.png,https://derpicdn.net/img/view/2017/7/2/1476886.png,0,0.977247953,260,177,412,329,152,152,applejack
1479116.png,https://derpicdn.net/img/view/2017/7/5/1479116.png,0,0.957650483,711,0,1193,460,482,460,applejack
1479140.png,https://derpicdn.net/img/view/2017/7/5/1479140.png,0,0.957663417,711,0,1193,460,482,460,applejack
1485756.png,https://derpicdn.net/img/view/2017/7/14/1485756.png,0,0.985836744,0,29,464,493,464,464,applejack
1485779.png,https://derpicdn.net/img/view/2017/7/14/1485779.png,0,0.996951103,243,280,493,530,250,250,applejack
1486519.png,https://derpicdn.net/img/view/2017/7/15/1486519.png,0,0.97962141,530,0,1420,773,890,773,applejack
1488701.png,https://derpicdn.net/img/view/2017/7/17/1488701.png,0,0.992531002,856,155,1826,1125,970,970,applejack
1494789.png,https://derpicdn.net/img/view/2017/7/25/1494789.png,0,0.997863472,11,0,347,310,336,310,applejack
1497915.png,https://derpicdn.net/img/view/2017/7/29/1497915.png,0,0.980447173,0,0,1280,1593,1280,1593,applejack
1500329.png,https://derpicdn.net/img/view/2017/8/1/1500329.png,0,0.997835338,243,0,2289,2025,2046,2025,applejack
1506514.png,https://derpicdn.net/img/view/2017/8/9/1506514.png,0,0.989666998,411,33,1009,631,598,598,applejack
1508735.png,https://derpicdn.net/img/view/2017/8/12/1508735.png,0,0.985635459,558,0,1456,783,898,783,applejack
1511337.png,https://derpicdn.net/img/view/2017/8/15/1511337.png,0,0.978923738,1014,0,1870,770,856,770,applejack
1513350.png,https://derpicdn.net/img/view/2017/8/18/1513350.png,0,0.998899698,479,0,1663,1065,1184,1065,applejack
1514741.png,https://derpicdn.net/img/view/2017/8/19/1514741.png,0,0.999321878,14,0,620,579,606,579,applejack
1514751.png,https://derpicdn.net/img/view/2017/8/19/1514751.png,0,0.992345095,0,0,372,384,372,384,applejack
1515234.png,https://derpicdn.net/img/view/2017/8/20/1515234.png,0,0.991743982,349,0,939,577,590,577,applejack
15153.png,https://derpicdn.net/img/view/2012/6/22/15153.png,0,0.99361515,1955,136,4105,2310,2150,2174,applejack
1526.jpg,https://derpicdn.net/img/view/2012/1/23/1526.jpg,0,0.984583557,5,71,323,389,318,318,applejack
1534693.png,https://derpicdn.net/img/view/2017/9/13/1534693.png,0,0.977327287,202,16,612,426,410,410,applejack
1542768.png,https://derpicdn.net/img/view/2017/9/23/1542768.png,0,0.913187563,251,0,1540,1291,1289,1291,applejack
1545008.png,https://derpicdn.net/img/view/2017/9/26/1545008.png,0,0.927192986,0,295,941,1389,941,1094,applejack
1546297.png,https://derpicdn.net/img/view/2017/9/27/1546297.png,0,0.997426271,412,0,814,396,402,396,applejack
1549002.png,https://derpicdn.net/img/view/2017/10/1/1549002.png,0,0.999185383,956,16,2874,1934,1918,1918,applejack
1549246.png,https://derpicdn.net/img/view/2017/10/1/1549246.png,0,0.90904814,172,240,568,636,396,396,applejack
1550397.png,https://derpicdn.net/img/view/2017/10/2/1550397.png,0,0.912645102,99,84,497,482,398,398,applejack
1551583.png,https://derpicdn.net/img/view/2017/10/4/1551583.png,0,0.999202847,596,19,2424,1847,1828,1828,applejack
1570017.png,https://derpicdn.net/img/view/2017/10/25/1570017.png,0,0.991294265,789,0,1330,533,541,533,applejack
1570058.png,https://derpicdn.net/img/view/2017/10/25/1570058.png,0,0.989431024,74,25,506,457,432,432,applejack
1589416.png,https://derpicdn.net/img/view/2017/11/18/1589416.png,0,0.997408628,371,0,839,436,468,436,applejack
1590163.png,https://derpicdn.net/img/view/2017/11/19/1590163.png,0,0.972306192,705,0,1149,410,444,410,applejack
1590577.png,https://derpicdn.net/img/view/2017/11/20/1590577.png,0,0.977589428,0,21,497,639,497,618,applejack
1591573.png,https://derpicdn.net/img/view/2017/11/21/1591573.png,0,0.994839251,276,0,984,656,708,656,applejack
1593010.png,https://derpicdn.net/img/view/2017/11/24/1593010.png,0,0.930881441,357,34,837,514,480,480,applejack
1602923.png,https://derpicdn.net/img/view/2017/12/8/1602923.png,0,0.912243307,46,142,752,848,706,706,applejack
1604730.png,https://derpicdn.net/img/view/2017/12/10/1604730.png,0,0.977008104,278,41,834,597,556,556,applejack
1607461.png,https://derpicdn.net/img/view/2017/12/14/1607461.png,0,0.990262389,529,50,833,354,304,304,applejack
1612816.png,https://derpicdn.net/img/view/2017/12/21/1612816.png,0,0.983836293,0,35,1211,1257,1211,1222,applejack
1615584.png,https://derpicdn.net/img/view/2017/12/25/1615584.png,0,0.982010782,1027,410,1781,1164,754,754,applejack
1615584.png,https://derpicdn.net/img/view/2017/12/25/1615584.png,0,0.982010782,1027,410,1781,1164,754,754,applejack
1615939.png,https://derpicdn.net/img/view/2017/12/25/1615939.png,0,0.999045253,39,4,373,338,334,334,applejack
1618679.png,https://derpicdn.net/img/view/2017/12/29/1618679.png,0,0.995478094,544,0,1072,524,528,524,applejack
1618934.png,https://derpicdn.net/img/view/2017/12/29/1618934.png,0,0.981805623,592,9,1232,649,640,640,applejack
1625716.png,https://derpicdn.net/img/view/2018/1/6/1625716.png,0,0.985413134,197,285,447,535,250,250,applejack
1625716.png,https://derpicdn.net/img/view/2018/1/6/1625716.png,1,0.958193243,417,266,659,508,242,242,applejack
1627380.png,https://derpicdn.net/img/view/2018/1/8/1627380.png,0,0.997451723,908,102,2400,1594,1492,1492,applejack
1628540.png,https://derpicdn.net/img/view/2018/1/10/1628540.png,0,0.998247266,0,141,331,477,331,336,applejack
1628540.png,https://derpicdn.net/img/view/2018/1/10/1628540.png,2,0.997066617,928,132,1262,466,334,334,applejack
1628753.png,https://derpicdn.net/img/view/2018/1/10/1628753.png,0,0.964066744,328,0,1120,773,792,773,applejack
1632711.png,https://derpicdn.net/img/view/2018/1/15/1632711.png,0,0.996814013,21,4,711,694,690,690,applejack
1632716.png,https://derpicdn.net/img/view/2018/1/15/1632716.png,0,0.989590406,100,2,536,438,436,436,applejack
1638699.png,https://derpicdn.net/img/view/2018/1/23/1638699.png,0,0.970330477,243,20,777,554,534,534,applejack
1638699.png,https://derpicdn.net/img/view/2018/1/23/1638699.png,0,0.970330477,243,20,777,554,534,534,applejack
1638995.png,https://derpicdn.net/img/view/2018/1/23/1638995.png,0,0.984363973,177,16,687,526,510,510,applejack
1638995.png,https://derpicdn.net/img/view/2018/1/23/1638995.png,0,0.984363973,177,16,687,526,510,510,applejack
1652597.png,https://derpicdn.net/img/view/2018/2/10/1652597.png,0,0.965744853,123,45,695,617,572,572,applejack
1660459.png,https://derpicdn.net/img/view/2018/2/19/1660459.png,0,0.998517394,1311,0,4123,2692,2812,2692,applejack
1667406.png,https://derpicdn.net/img/view/2018/2/27/1667406.png,0,0.994928539,640,295,1692,1347,1052,1052,applejack
1669916.png,https://derpicdn.net/img/view/2018/3/2/1669916.png,0,0.986967683,366,6,678,318,312,312,applejack
1672464.png,https://derpicdn.net/img/view/2018/3/5/1672464.png,0,0.947556734,42,0,676,603,634,603,applejack
1681382.png,https://derpicdn.net/img/view/2018/3/15/1681382.png,0,0.941086352,1253,189,2881,1817,1628,1628,applejack
1685482.png,https://derpicdn.net/img/view/2018/3/20/1685482.png,0,0.923255146,246,24,704,482,458,458,applejack
1685482.png,https://derpicdn.net/img/view/2018/3/20/1685482.png,0,0.923255146,246,24,704,482,458,458,applejack
1685616.png,https://derpicdn.net/img/view/2018/3/20/1685616.png,0,0.99921149,353,167,809,623,456,456,applejack
1687239.png,https://derpicdn.net/img/view/2018/3/22/1687239.png,0,0.993769288,189,0,437,205,248,205,applejack
1696715.png,https://derpicdn.net/img/view/2018/4/1/1696715.png,0,0.970413983,894,101,2152,1359,1258,1258,applejack
1706186.png,https://derpicdn.net/img/view/2018/4/12/1706186.png,0,0.998314381,234,0,836,593,602,593,applejack
1720054.png,https://derpicdn.net/img/view/2018/4/29/1720054.png,0,0.999650478,2268,0,4286,1971,2018,1971,applejack
1721074.png,https://derpicdn.net/img/view/2018/4/30/1721074.png,0,0.992267251,1268,101,2056,889,788,788,applejack
1721751.png,https://derpicdn.net/img/view/2018/5/1/1721751.png,0,0.942650139,1304,0,2430,967,1126,967,applejack
1733429.png,https://derpicdn.net/img/view/2018/5/15/1733429.png,0,0.995779932,326,143,860,677,534,534,applejack
1739136.png,https://derpicdn.net/img/view/2018/5/22/1739136.png,0,0.912687242,0,0,334,319,334,319,applejack
1749487.png,https://derpicdn.net/img/view/2018/6/4/1749487.png,0,0.992791057,70,0,1074,940,1004,940,applejack
1752755.png,https://derpicdn.net/img/view/2018/6/8/1752755.png,0,0.948917508,65,0,908,853,843,853,applejack
1755067.png,https://derpicdn.net/img/view/2018/6/11/1755067.png,0,0.98229754,317,10,611,304,294,294,applejack
1756338.png,https://derpicdn.net/img/view/2018/6/12/1756338.png,0,0.984591424,60,0,610,464,550,464,applejack
1757027.png,https://derpicdn.net/img/view/2018/6/13/1757027.png,0,0.951918364,325,0,2427,1788,2102,1788,applejack
1762781.png,https://derpicdn.net/img/view/2018/6/21/1762781.png,0,0.927841365,225,105,835,715,610,610,applejack
1771090.png,https://derpicdn.net/img/view/2018/7/2/1771090.png,0,0.998668492,184,0,1734,1549,1550,1549,applejack
1771438.png,https://derpicdn.net/img/view/2018/7/2/1771438.png,0,0.996489823,50,37,550,537,500,500,applejack
1771689.png,https://derpicdn.net/img/view/2018/7/3/1771689.png,0,0.993824661,176,0,970,775,794,775,applejack
1777300.png,https://derpicdn.net/img/view/2018/7/10/1777300.png,0,0.940863311,557,233,1181,857,624,624,applejack
1788134.png,https://derpicdn.net/img/view/2018/7/24/1788134.png,0,0.997963727,715,0,1975,1238,1260,1238,applejack
1799842.png,https://derpicdn.net/img/view/2018/8/6/1799842.png,0,0.967674673,524,0,922,307,398,307,applejack
1806074.png,https://derpicdn.net/img/view/2018/8/13/1806074.png,0,0.994964898,21,274,2163,2416,2142,2142,applejack
1813336.png,https://derpicdn.net/img/view/2018/8/22/1813336.png,0,0.995215833,1,0,281,264,280,264,applejack
1819328.png,https://derpicdn.net/img/view/2018/8/29/1819328.png,0,0.982213616,539,36,1077,574,538,538,applejack
1821737.png,https://derpicdn.net/img/view/2018/9/1/1821737.png,0,0.991454124,167,0,1157,976,990,976,applejack
1822224.png,https://derpicdn.net/img/view/2018/9/1/1822224.png,0,0.999667466,38,94,650,706,612,612,applejack
1827348.png,https://derpicdn.net/img/view/2018/9/8/1827348.png,0,0.991925955,577,359,1359,1141,782,782,applejack
1830178.png,https://derpicdn.net/img/view/2018/9/11/1830178.png,5,0.913655996,0,29,224,253,224,224,applejack
1830178.png,https://derpicdn.net/img/view/2018/9/11/1830178.png,5,0.913655996,0,29,224,253,224,224,applejack
1835816.png,https://derpicdn.net/img/view/2018/9/18/1835816.png,0,0.9940117,26,24,250,248,224,224,applejack
1835816.png,https://derpicdn.net/img/view/2018/9/18/1835816.png,1,0.971152961,248,41,480,273,232,232,applejack
1836813.png,https://derpicdn.net/img/view/2018/9/20/1836813.png,0,0.960507393,278,21,684,427,406,406,applejack
1838763.png,https://derpicdn.net/img/view/2018/9/22/1838763.png,0,0.995576978,226,5,610,389,384,384,applejack
1843602.png,https://derpicdn.net/img/view/2018/9/29/1843602.png,0,0.989809155,38,0,504,435,466,435,applejack
1844190.png,https://derpicdn.net/img/view/2018/9/29/1844190.png,0,0.97529155,1076,0,1772,659,696,659,applejack
1844193.png,https://derpicdn.net/img/view/2018/9/29/1844193.png,0,0.994175315,166,13,668,515,502,502,applejack
1844194.png,https://derpicdn.net/img/view/2018/9/29/1844194.png,0,0.957350075,865,143,1537,815,672,672,applejack
1847805.png,https://derpicdn.net/img/view/2018/10/4/1847805.png,0,0.994667053,361,0,1271,686,910,686,applejack
1848930.png,https://derpicdn.net/img/view/2018/10/5/1848930.png,0,0.989684582,201,0,1009,791,808,791,applejack
1859485.png,https://derpicdn.net/img/view/2018/10/18/1859485.png,0,0.995592773,0,0,945,1054,945,1054,applejack
1860726.png,https://derpicdn.net/img/view/2018/10/19/1860726.png,0,0.951339185,20,0,962,849,942,849,applejack
1863159.png,https://derpicdn.net/img/view/2018/10/22/1863159.png,0,0.996167064,289,0,1367,925,1078,925,applejack
1863878.png,https://derpicdn.net/img/view/2018/10/23/1863878.png,0,0.988896251,194,0,1042,838,848,838,applejack
1866881.png,https://derpicdn.net/img/view/2018/10/26/1866881.png,0,0.904759824,90,139,422,471,332,332,applejack
1866945.png,https://derpicdn.net/img/view/2018/10/27/1866945.png,0,0.996017039,1369,20,1927,578,558,558,applejack
1866945.png,https://derpicdn.net/img/view/2018/10/27/1866945.png,1,0.98808521,750,625,1396,1271,646,646,applejack
1867485.png,https://derpicdn.net/img/view/2018/10/27/1867485.png,0,0.991814971,285,279,631,625,346,346,applejack
1875376.png,https://derpicdn.net/img/view/2018/11/5/1875376.png,0,0.978369296,0,0,516,500,516,500,applejack
1875376.png,https://derpicdn.net/img/view/2018/11/5/1875376.png,0,0.978369296,0,0,516,500,516,500,applejack
1878780.png,https://derpicdn.net/img/view/2018/11/10/1878780.png,0,0.915405929,347,0,2023,1592,1676,1592,applejack
1879775.png,https://derpicdn.net/img/view/2018/11/11/1879775.png,0,0.961241424,409,3,855,449,446,446,applejack
1888935.png,https://derpicdn.net/img/view/2018/11/23/1888935.png,0,0.984971166,377,30,1173,826,796,796,applejack
1889455.png,https://derpicdn.net/img/view/2018/11/23/1889455.png,0,0.98162353,345,57,1017,729,672,672,applejack
1889981.png,https://derpicdn.net/img/view/2018/11/24/1889981.png,0,0.99896574,455,49,1095,689,640,640,applejack
1893199.png,https://derpicdn.net/img/view/2018/11/28/1893199.png,0,0.997578382,278,40,620,382,342,342,applejack
1914767.png,https://derpicdn.net/img/view/2018/12/21/1914767.png,0,0.99009794,92,0,524,387,432,387,applejack
1914767.png,https://derpicdn.net/img/view/2018/12/21/1914767.png,0,0.99009794,92,0,524,387,432,387,applejack
1925481.png,https://derpicdn.net/img/view/2019/1/3/1925481.png,0,0.982287347,0,0,1095,1126,1095,1126,applejack
1927872.png,https://derpicdn.net/img/view/2019/1/6/1927872.png,0,0.96764648,748,0,2000,1324,1252,1324,applejack
1933547.png,https://derpicdn.net/img/view/2019/1/12/1933547.png,0,0.998962045,515,0,1619,961,1104,961,applejack
1933547.png,https://derpicdn.net/img/view/2019/1/12/1933547.png,1,0.947533429,1377,58,2493,1174,1116,1116,applejack
1937793.png,https://derpicdn.net/img/view/2019/1/17/1937793.png,0,0.998874068,370,0,1888,1410,1518,1410,applejack
1944422.png,https://derpicdn.net/img/view/2019/1/25/1944422.png,0,0.980861962,980,189,2638,1847,1658,1658,applejack
1945.jpg,https://derpicdn.net/img/view/2012/1/24/1945.jpg,0,0.982887149,529,496,1297,1264,768,768,applejack
1950979.png,https://derpicdn.net/img/view/2019/2/2/1950979.png,0,0.991331935,34,0,1232,1113,1198,1113,applejack
1951332.png,https://derpicdn.net/img/view/2019/2/2/1951332.png,0,0.968667805,506,15,1608,1117,1102,1102,applejack
1951443.png,https://derpicdn.net/img/view/2019/2/2/1951443.png,0,0.979107261,1405,261,1991,847,586,586,applejack
1954602.png,https://derpicdn.net/img/view/2019/2/5/1954602.png,0,0.932117224,591,479,1407,1295,816,816,applejack
1959855.png,https://derpicdn.net/img/view/2019/2/12/1959855.png,0,0.953720391,717,491,1975,1749,1258,1258,applejack
1960484.png,https://derpicdn.net/img/view/2019/2/12/1960484.png,0,0.998847485,303,0,969,639,666,639,applejack
1960484.png,https://derpicdn.net/img/view/2019/2/12/1960484.png,0,0.998847485,303,0,969,639,666,639,applejack
1962282.png,https://derpicdn.net/img/view/2019/2/14/1962282.png,0,0.994473517,352,44,834,526,482,482,applejack
1965468.png,https://derpicdn.net/img/view/2019/2/18/1965468.png,0,0.950313747,0,0,1591,1542,1591,1542,applejack
1965795.png,https://derpicdn.net/img/view/2019/2/19/1965795.png,0,0.975219905,0,0,563,574,563,574,applejack
1969207.png,https://derpicdn.net/img/view/2019/2/22/1969207.png,0,0.954158127,340,64,1740,1464,1400,1400,applejack
1969836.png,https://derpicdn.net/img/view/2019/2/23/1969836.png,0,0.971547425,3746,1295,5420,2969,1674,1674,applejack
1969836.png,https://derpicdn.net/img/view/2019/2/23/1969836.png,0,0.971547425,3746,1295,5420,2969,1674,1674,applejack
1978735.png,https://derpicdn.net/img/view/2019/3/6/1978735.png,0,0.920978844,132,0,832,678,700,678,applejack
1982440.png,https://derpicdn.net/img/view/2019/3/10/1982440.png,0,0.95658195,323,0,2050,1892,1727,1892,applejack
2000563.png,https://derpicdn.net/img/view/2019/4/2/2000563.png,0,0.992957056,549,0,1519,881,970,881,applejack
2006274.png,https://derpicdn.net/img/view/2019/4/8/2006274.png,0,0.999796927,894,611,1486,1203,592,592,applejack
2012283.png,https://derpicdn.net/img/view/2019/4/14/2012283.png,0,0.946875215,195,63,969,837,774,774,applejack
2013881.png,https://derpicdn.net/img/view/2019/4/16/2013881.png,0,0.975024641,127,0,685,531,558,531,applejack
2030157.png,https://derpicdn.net/img/view/2019/5/3/2030157.png,0,0.972613513,84,94,688,698,604,604,applejack
2032766.png,https://derpicdn.net/img/view/2019/5/6/2032766.png,0,0.959691703,204,78,1310,1184,1106,1106,applejack
2034329.png,https://derpicdn.net/img/view/2019/5/9/2034329.png,0,0.978750825,66,0,1160,974,1094,974,applejack
2034806.png,https://derpicdn.net/img/view/2019/5/9/2034806.png,0,0.99888587,1640,0,3404,1689,1764,1689,applejack
2039005.png,https://derpicdn.net/img/view/2019/5/14/2039005.png,0,0.916359842,114,157,528,571,414,414,applejack
2039094.png,https://derpicdn.net/img/view/2019/5/14/2039094.png,0,0.912394643,115,0,409,292,294,292,applejack
2041590.png,https://derpicdn.net/img/view/2019/5/17/2041590.png,0,0.926536739,88,60,548,520,460,460,applejack
2042823.png,https://derpicdn.net/img/view/2019/5/19/2042823.png,0,0.997937977,37,18,593,574,556,556,applejack
2045212.png,https://derpicdn.net/img/view/2019/5/21/2045212.png,0,0.985909998,186,10,408,232,222,222,applejack
2054654.png,https://derpicdn.net/img/view/2019/5/31/2054654.png,0,0.990583241,150,0,1256,1056,1106,1056,applejack
2054825.png,https://derpicdn.net/img/view/2019/6/1/2054825.png,0,0.985476255,239,28,585,374,346,346,applejack
2057147.png,https://derpicdn.net/img/view/2019/6/3/2057147.png,0,0.993157506,556,151,2346,1941,1790,1790,applejack
2057288.png,https://derpicdn.net/img/view/2019/6/3/2057288.png,0,0.997233808,163,0,797,580,634,580,applejack
2058098.png,https://derpicdn.net/img/view/2019/6/4/2058098.png,0,0.9882496,56,23,798,765,742,742,applejack
2058116.png,https://derpicdn.net/img/view/2019/6/5/2058116.png,0,0.954017401,542,418,1124,1000,582,582,applejack
2058863.png,https://derpicdn.net/img/view/2019/6/6/2058863.png,0,0.973720908,84,0,650,590,566,590,applejack
2058975.png,https://derpicdn.net/img/view/2019/6/6/2058975.png,0,0.99863863,134,0,554,386,420,386,applejack
2061121.png,https://derpicdn.net/img/view/2019/6/9/2061121.png,0,0.996021926,209,28,473,292,264,264,applejack
2061842.png,https://derpicdn.net/img/view/2019/6/9/2061842.png,0,0.979976118,0,0,878,856,878,856,applejack
2063398.png,https://derpicdn.net/img/view/2019/6/12/2063398.png,0,0.984921873,0,0,213,194,213,194,applejack
2063398.png,https://derpicdn.net/img/view/2019/6/12/2063398.png,0,0.984921873,0,0,213,194,213,194,applejack
2065606.png,https://derpicdn.net/img/view/2019/6/15/2065606.png,0,0.916016877,0,195,595,811,595,616,applejack
2065991.png,https://derpicdn.net/img/view/2019/6/15/2065991.png,0,0.995343804,708,0,1018,310,310,310,applejack
2065991.png,https://derpicdn.net/img/view/2019/6/15/2065991.png,1,0.994483888,23,0,393,336,370,336,applejack
2076389.png,https://derpicdn.net/img/view/2019/6/27/2076389.png,0,0.999562562,465,0,1073,586,608,586,applejack
2076462.png,https://derpicdn.net/img/view/2019/6/27/2076462.png,0,0.994374871,3,0,1595,1566,1592,1566,applejack
2077343.png,https://derpicdn.net/img/view/2019/6/28/2077343.png,0,0.996525526,409,0,821,394,412,394,applejack
2093637.png,https://derpicdn.net/img/view/2019/7/16/2093637.png,0,0.995475352,399,54,1237,892,838,838,applejack
2094051.png,https://derpicdn.net/img/view/2019/7/17/2094051.png,0,0.924706578,457,206,1223,972,766,766,applejack
2094052.png,https://derpicdn.net/img/view/2019/7/17/2094052.png,0,0.951919734,501,257,1163,919,662,662,applejack
2104217.png,https://derpicdn.net/img/view/2019/7/29/2104217.png,0,0.999750316,1030,0,2400,1327,1370,1327,applejack
2110513.png,https://derpicdn.net/img/view/2019/8/6/2110513.png,0,0.985593915,0,29,524,557,524,528,applejack
2119816.png,https://derpicdn.net/img/view/2019/8/16/2119816.png,0,0.990401566,1015,397,1973,1355,958,958,applejack
2126078.png,https://derpicdn.net/img/view/2019/8/24/2126078.png,0,0.991959393,109,0,1523,1383,1414,1383,applejack
2135355.png,https://derpicdn.net/img/view/2019/9/3/2135355.png,0,0.99727124,0,0,662,593,662,593,applejack
2135355.png,https://derpicdn.net/img/view/2019/9/3/2135355.png,0,0.99727124,0,0,662,593,662,593,applejack
2138612.png,https://derpicdn.net/img/view/2019/9/7/2138612.png,0,0.939963639,129,0,1123,973,994,973,applejack
2140221.png,https://derpicdn.net/img/view/2019/9/9/2140221.png,0,0.951634943,476,92,1866,1512,1390,1420,applejack
2144368.png,https://derpicdn.net/img/view/2019/9/15/2144368.png,0,0.945772469,548,47,1562,1061,1014,1014,applejack
2145048.png,https://derpicdn.net/img/view/2019/9/15/2145048.png,0,0.99105078,140,25,714,599,574,574,applejack
2146679.png,https://derpicdn.net/img/view/2019/9/17/2146679.png,0,0.953350186,208,0,1033,811,825,811,applejack
2149942.png,https://derpicdn.net/img/view/2019/9/22/2149942.png,0,0.966641843,0,3080,3392,6726,3392,3646,applejack
2154613.png,https://derpicdn.net/img/view/2019/9/28/2154613.png,0,0.995497525,397,322,2157,2082,1760,1760,applejack
2162050.png,https://derpicdn.net/img/view/2019/10/6/2162050.png,0,0.995827258,1132,1940,2426,3234,1294,1294,applejack
2162286.png,https://derpicdn.net/img/view/2019/10/7/2162286.png,0,0.989608467,1268,303,2702,1737,1434,1434,applejack
2163401.png,https://derpicdn.net/img/view/2019/10/8/2163401.png,0,0.95422101,206,0,1390,1177,1184,1177,applejack
216575.png,https://derpicdn.net/img/view/2013/1/18/216575.png,0,0.923563838,412,10,1554,1152,1142,1142,applejack
217247.jpg,https://derpicdn.net/img/view/2013/1/19/217247.jpg,0,0.987855732,686,81,1848,1243,1162,1162,applejack
2190101.png,https://derpicdn.net/img/view/2019/11/8/2190101.png,0,0.959376574,131,0,978,870,847,870,applejack
2192929.png,https://derpicdn.net/img/view/2019/11/11/2192929.png,0,0.975755036,449,4,903,458,454,454,applejack
2197545.png,https://derpicdn.net/img/view/2019/11/16/2197545.png,0,0.975948691,44,0,500,444,456,444,applejack
2205927.png,https://derpicdn.net/img/view/2019/11/26/2205927.png,0,0.997118294,620,26,988,394,368,368,applejack
2206412.png,https://derpicdn.net/img/view/2019/11/26/2206412.png,0,0.999515772,333,0,1469,1008,1136,1008,applejack
2209312.png,https://derpicdn.net/img/view/2019/11/30/2209312.png,0,0.987391114,285,345,875,935,590,590,applejack
2211220.png,https://derpicdn.net/img/view/2019/12/3/2211220.png,0,0.971631825,1547,529,2123,1105,576,576,applejack
2216071.png,https://derpicdn.net/img/view/2019/12/8/2216071.png,0,0.966365278,535,59,1600,1141,1065,1082,applejack
2230069.png,https://derpicdn.net/img/view/2019/12/25/2230069.png,0,0.996501148,138,81,582,525,444,444,applejack
22387.jpg,https://derpicdn.net/img/view/2012/6/27/22387.jpg,0,0.996392787,136,14,398,276,262,262,applejack
2247119.jpg,https://derpicdn.net/img/view/2020/1/14/2247119.jpg,0,0.937127888,0,56,1041,1192,1041,1136,applejack
2248167.png,https://derpicdn.net/img/view/2020/1/15/2248167.png,0,0.995963454,674,116,1346,788,672,672,applejack
2265786.jpg,https://derpicdn.net/img/view/2020/2/4/2265786.jpg,0,0.984019041,214,0,1160,903,946,903,applejack
2269465.jpg,https://derpicdn.net/img/view/2020/2/9/2269465.jpg,1,0.927313328,324,594,564,834,240,240,applejack
2273690.jpg,https://derpicdn.net/img/view/2020/2/14/2273690.jpg,0,0.978637159,61,3,647,589,586,586,applejack
2278826.jpg,https://derpicdn.net/img/view/2020/2/20/2278826.jpg,0,0.975786448,38,340,1456,1732,1418,1392,applejack
2283204.png,https://derpicdn.net/img/view/2020/2/25/2283204.png,0,0.989611924,383,0,999,614,616,614,applejack
2283349.jpg,https://derpicdn.net/img/view/2020/2/25/2283349.jpg,0,0.979709983,270,54,738,522,468,468,applejack
2291503.jpg,https://derpicdn.net/img/view/2020/3/6/2291503.jpg,0,0.986668587,33,7,763,737,730,730,applejack
2293591.png,https://derpicdn.net/img/view/2020/3/9/2293591.png,0,0.993300498,385,148,1617,1380,1232,1232,applejack
2293874.jpg,https://derpicdn.net/img/view/2020/3/9/2293874.jpg,0,0.999515653,193,10,919,736,726,726,applejack
2295656.jpg,https://derpicdn.net/img/view/2020/3/12/2295656.jpg,0,0.978554904,1550,203,2460,1113,910,910,applejack
2295919.jpg,https://derpicdn.net/img/view/2020/3/12/2295919.jpg,0,0.986115217,294,63,672,441,378,378,applejack
2298328.png,https://derpicdn.net/img/view/2020/3/15/2298328.png,0,0.988097608,101,0,1641,1471,1540,1471,applejack
2301222.jpg,https://derpicdn.net/img/view/2020/3/19/2301222.jpg,0,0.96763134,198,0,970,763,772,763,applejack
2302832.png,https://derpicdn.net/img/view/2020/3/21/2302832.png,0,0.998356998,828,0,1338,407,510,407,applejack
2308596.png,https://derpicdn.net/img/view/2020/3/29/2308596.png,0,0.972065985,2214,294,3684,1764,1470,1470,applejack
2315529.png,https://derpicdn.net/img/view/2020/4/6/2315529.png,0,0.993243635,312,137,748,573,436,436,applejack
2318962.png,https://derpicdn.net/img/view/2020/4/10/2318962.png,0,0.998814404,88,22,576,510,488,488,applejack
2320725.png,https://derpicdn.net/img/view/2020/4/12/2320725.png,0,0.969901085,611,1084,3141,3614,2530,2530,applejack
2320725.png,https://derpicdn.net/img/view/2020/4/12/2320725.png,0,0.969901085,611,1084,3141,3614,2530,2530,applejack
2323437.jpg,https://derpicdn.net/img/view/2020/4/15/2323437.jpg,0,0.963134825,0,0,1255,1240,1255,1240,applejack
2324362.png,https://derpicdn.net/img/view/2020/4/17/2324362.png,0,0.990851223,242,109,2602,2469,2360,2360,applejack
2326472.png,https://derpicdn.net/img/view/2020/4/19/2326472.png,0,0.965192616,191,142,901,852,710,710,applejack
2333989.jpg,https://derpicdn.net/img/view/2020/4/28/2333989.jpg,0,0.977765262,934,98,1952,1116,1018,1018,applejack
2334861.jpg,https://derpicdn.net/img/view/2020/4/29/2334861.jpg,0,0.991447687,970,0,2434,1431,1464,1431,applejack
2337309.png,https://derpicdn.net/img/view/2020/5/2/2337309.png,0,0.947860539,738,0,1814,835,1076,835,applejack
2337309.png,https://derpicdn.net/img/view/2020/5/2/2337309.png,0,0.947860539,738,0,1814,835,1076,835,applejack
2340778.png,https://derpicdn.net/img/view/2020/5/6/2340778.png,0,0.953679085,406,0,1480,1058,1074,1058,applejack
2348612.png,https://derpicdn.net/img/view/2020/5/14/2348612.png,0,0.946731329,329,158,2925,2754,2596,2596,applejack
2348995.jpg,https://derpicdn.net/img/view/2020/5/15/2348995.jpg,0,0.997678161,217,17,425,225,208,208,applejack
2348995.jpg,https://derpicdn.net/img/view/2020/5/15/2348995.jpg,1,0.993711591,319,550,633,864,314,314,applejack
2349124.jpg,https://derpicdn.net/img/view/2020/5/15/2349124.jpg,0,0.97160244,145,24,395,274,250,250,applejack
2349124.jpg,https://derpicdn.net/img/view/2020/5/15/2349124.jpg,0,0.97160244,145,24,395,274,250,250,applejack
2528.png,https://derpicdn.net/img/view/2012/1/28/2528.png,0,0.998713195,106,0,856,577,750,577,applejack
255103.png,https://derpicdn.net/img/view/2013/2/25/255103.png,0,0.965404809,94,21,608,535,514,514,applejack
256339.png,https://derpicdn.net/img/view/2013/2/26/256339.png,0,0.9884547,506,257,862,613,356,356,applejack
256339.png,https://derpicdn.net/img/view/2013/2/26/256339.png,1,0.914784491,44,402,452,810,408,408,applejack
26456.png,https://derpicdn.net/img/view/2012/6/30/26456.png,0,0.979882419,842,134,2324,1616,1482,1482,applejack
26470.png,https://derpicdn.net/img/view/2012/6/30/26470.png,0,0.993879259,136,0,568,422,432,422,applejack
272498.png,https://derpicdn.net/img/view/2013/3/17/272498.png,0,0.957551539,38,13,276,251,238,238,applejack
274364.png,https://derpicdn.net/img/view/2013/3/19/274364.png,0,0.996381819,45,28,413,396,368,368,applejack
274364.png,https://derpicdn.net/img/view/2013/3/19/274364.png,0,0.996381819,45,28,413,396,368,368,applejack
277555.png,https://derpicdn.net/img/view/2013/3/23/277555.png,0,0.923586249,8,0,536,481,528,481,applejack
288529.png,https://derpicdn.net/img/view/2013/4/5/288529.png,0,0.997005522,380,0,926,510,546,510,applejack
290876.png,https://derpicdn.net/img/view/2013/4/7/290876.png,0,0.997438848,353,271,801,719,448,448,applejack
3010.jpg,https://derpicdn.net/img/view/2012/2/13/3010.jpg,0,0.934467018,126,16,448,338,322,322,applejack
310906.png,https://derpicdn.net/img/view/2013/4/28/310906.png,0,0.999218404,109,0,707,568,598,568,applejack
312499.png,https://derpicdn.net/img/view/2013/4/30/312499.png,0,0.999174178,834,49,2088,1303,1254,1254,applejack
315450.png,https://derpicdn.net/img/view/2013/5/3/315450.png,0,0.997071207,896,153,1906,1163,1010,1010,applejack
318609.png,https://derpicdn.net/img/view/2013/5/7/318609.png,0,0.989654899,110,10,470,370,360,360,applejack
321489.jpg,https://derpicdn.net/img/view/2013/5/10/321489.jpg,0,0.994386137,339,20,611,292,272,272,applejack
321714.png,https://derpicdn.net/img/view/2013/5/11/321714.png,0,0.990336537,332,0,1566,1107,1234,1107,applejack
325667.png,https://derpicdn.net/img/view/2013/5/15/325667.png,0,0.997434378,1332,139,2642,1449,1310,1310,applejack
327079.png,https://derpicdn.net/img/view/2013/5/17/327079.png,0,0.941953123,1528,197,2464,1133,936,936,applejack
327079.png,https://derpicdn.net/img/view/2013/5/17/327079.png,0,0.941953123,1528,197,2464,1133,936,936,applejack
328878.png,https://derpicdn.net/img/view/2013/5/19/328878.png,0,0.990562499,333,57,609,333,276,276,applejack
337514.png,https://derpicdn.net/img/view/2013/5/31/337514.png,0,0.935884833,69,13,391,335,322,322,applejack
338090.png,https://derpicdn.net/img/view/2013/6/1/338090.png,0,0.993944526,417,347,1381,1311,964,964,applejack
345287.png,https://derpicdn.net/img/view/2013/6/10/345287.png,0,0.967024744,0,0,2141,2622,2141,2622,applejack
354311.png,https://derpicdn.net/img/view/2013/6/22/354311.png,0,0.988561094,302,25,720,443,418,418,applejack
360352.png,https://derpicdn.net/img/view/2013/6/30/360352.png,0,0.942267239,54,188,4486,5106,4432,4918,applejack
36231.png,https://derpicdn.net/img/view/2012/7/7/36231.png,0,0.971791863,0,211,1172,1471,1172,1260,applejack
36723.png,https://derpicdn.net/img/view/2012/7/8/36723.png,0,0.983316004,139,0,2003,1780,1864,1780,applejack
374193.png,https://derpicdn.net/img/view/2013/7/14/374193.png,0,0.998729885,181,0,577,375,396,375,applejack
376365.jpg,https://derpicdn.net/img/view/2013/7/17/376365.jpg,0,0.999361992,392,333,708,649,316,316,applejack
376365.jpg,https://derpicdn.net/img/view/2013/7/17/376365.jpg,1,0.992055953,883,456,1207,780,324,324,applejack
389343.png,https://derpicdn.net/img/view/2013/8/2/389343.png,0,0.967959702,93,0,1207,1103,1114,1103,applejack
393791.png,https://derpicdn.net/img/view/2013/8/7/393791.png,0,0.998983443,274,0,780,483,506,483,applejack
394885.png,https://derpicdn.net/img/view/2013/8/8/394885.png,0,0.993295252,45,5,481,441,436,436,applejack
399941.png,https://derpicdn.net/img/view/2013/8/14/399941.png,0,0.998437703,148,0,504,319,356,319,applejack
404549.png,https://derpicdn.net/img/view/2013/8/19/404549.png,0,0.954814076,49,0,517,465,468,465,applejack
413.jpg,https://derpicdn.net/img/view/2012/1/16/413.jpg,0,0.99322778,312,368,782,838,470,470,applejack
414338.jpg,https://derpicdn.net/img/view/2013/8/30/414338.jpg,0,0.980702996,1053,80,2139,1166,1086,1086,applejack
419300.png,https://derpicdn.net/img/view/2013/9/5/419300.png,0,0.999492526,80,0,360,263,280,263,applejack
425965.png,https://derpicdn.net/img/view/2013/9/12/425965.png,0,0.994826317,473,97,1243,867,770,770,applejack
426552.jpg,https://derpicdn.net/img/view/2013/9/13/426552.jpg,0,0.993744671,80,0,336,245,256,245,applejack
444974.png,https://derpicdn.net/img/view/2013/10/9/444974.png,0,0.986375868,1909,251,2957,1299,1048,1048,applejack
444974.png,https://derpicdn.net/img/view/2013/10/9/444974.png,0,0.986375868,1909,251,2957,1299,1048,1048,applejack
448932.jpg,https://derpicdn.net/img/view/2013/10/14/448932.jpg,0,0.977526546,426,0,786,360,360,360,applejack
449268.jpg,https://derpicdn.net/img/view/2013/10/15/449268.jpg,0,0.954542994,109,65,500,431,391,366,applejack
449286.png,https://derpicdn.net/img/view/2013/10/15/449286.png,0,0.96208781,117,0,1879,1598,1762,1598,applejack
452805.png,https://derpicdn.net/img/view/2013/10/20/452805.png,0,0.991014838,376,120,618,362,242,242,applejack
456847.png,https://derpicdn.net/img/view/2013/10/26/456847.png,0,0.970067203,535,0,1687,1137,1152,1137,applejack
471981.png,https://derpicdn.net/img/view/2013/11/13/471981.png,0,0.978519619,86,11,262,187,176,176,applejack
471981.png,https://derpicdn.net/img/view/2013/11/13/471981.png,0,0.978519619,86,11,262,187,176,176,applejack
472498.jpg,https://derpicdn.net/img/view/2013/11/14/472498.jpg,0,0.995160818,302,1,678,377,376,376,applejack
477357.jpg,https://derpicdn.net/img/view/2013/11/21/477357.jpg,0,0.96828264,145,90,560,509,415,419,applejack
478487.png,https://derpicdn.net/img/view/2013/11/22/478487.png,0,0.990472913,40,0,488,415,448,415,applejack
488595.jpg,https://derpicdn.net/img/view/2013/12/3/488595.jpg,0,0.990723729,173,0,650,476,477,476,applejack
499076.png,https://derpicdn.net/img/view/2013/12/17/499076.png,0,0.915299773,213,0,611,379,398,379,applejack
505654.png,https://derpicdn.net/img/view/2013/12/24/505654.png,0,0.994066715,368,321,790,743,422,422,applejack
507268.png,https://derpicdn.net/img/view/2013/12/27/507268.png,0,0.999177396,133,2,341,210,208,208,applejack
507268.png,https://derpicdn.net/img/view/2013/12/27/507268.png,0,0.999177396,133,2,341,210,208,208,applejack
50774.jpg,https://derpicdn.net/img/view/2012/7/20/50774.jpg,0,0.96754384,153,0,375,200,222,200,applejack
510320.png,https://derpicdn.net/img/view/2013/12/30/510320.png,0,0.999018073,401,0,1267,793,866,793,applejack
511291.jpg,https://derpicdn.net/img/view/2013/12/31/511291.jpg,0,0.995484889,60,139,696,775,636,636,applejack
535346.png,https://derpicdn.net/img/view/2014/1/26/535346.png,0,0.976089478,22,31,250,250,228,219,applejack
543151.png,https://derpicdn.net/img/view/2014/2/4/543151.png,0,0.963995934,759,265,1337,843,578,578,applejack
547874.png,https://derpicdn.net/img/view/2014/2/9/547874.png,0,0.935530424,392,219,714,541,322,322,applejack
549602.png,https://derpicdn.net/img/view/2014/2/11/549602.png,0,0.994835675,293,66,533,306,240,240,applejack
551383.png,https://derpicdn.net/img/view/2014/2/14/551383.png,0,0.997714639,401,106,769,474,368,368,applejack
580757.png,https://derpicdn.net/img/view/2014/3/21/580757.png,0,0.994372666,306,0,686,377,380,377,applejack
584485.png,https://derpicdn.net/img/view/2014/3/24/584485.png,0,0.995977104,328,15,898,585,570,570,applejack
584651.png,https://derpicdn.net/img/view/2014/3/25/584651.png,0,0.998613417,657,7,1403,753,746,746,applejack
596534.png,https://derpicdn.net/img/view/2014/4/9/596534.png,0,0.946925104,49,89,407,447,358,358,applejack
598.png,https://derpicdn.net/img/view/2012/1/17/598.png,0,0.962734878,0,6,460,470,460,464,applejack
598325.png,https://derpicdn.net/img/view/2014/4/12/598325.png,0,0.998509943,235,155,533,453,298,298,applejack
601617.png,https://derpicdn.net/img/view/2014/4/16/601617.png,0,0.993236125,575,0,1551,955,976,955,applejack
605168.png,https://derpicdn.net/img/view/2014/4/20/605168.png,0,0.994295061,208,92,564,448,356,356,applejack
605833.png,https://derpicdn.net/img/view/2014/4/20/605833.png,0,0.979790509,0,216,4100,5928,4100,5712,applejack
606294.jpg,https://derpicdn.net/img/view/2014/4/21/606294.jpg,0,0.998358667,416,361,732,677,316,316,applejack
609905.png,https://derpicdn.net/img/view/2014/4/26/609905.png,0,0.998115361,405,0,1357,912,952,912,applejack
613689.png,https://derpicdn.net/img/view/2014/4/30/613689.png,0,0.997040629,399,120,819,540,420,420,applejack
616065.png,https://derpicdn.net/img/view/2014/5/3/616065.png,0,0.99936825,215,0,539,307,324,307,applejack
618572.png,https://derpicdn.net/img/view/2014/5/5/618572.png,0,0.993321776,718,192,1530,1004,812,812,applejack
618779.png,https://derpicdn.net/img/view/2014/5/6/618779.png,0,0.974755585,6,41,794,863,788,822,applejack
621253.jpg,https://derpicdn.net/img/view/2014/5/9/621253.jpg,0,0.999312282,823,668,1325,1170,502,502,applejack
633258.png,https://derpicdn.net/img/view/2014/5/22/633258.png,0,0.947224915,182,0,956,748,774,748,applejack
646929.png,https://derpicdn.net/img/view/2014/6/6/646929.png,0,0.933114231,203,0,645,427,442,427,applejack
651396.png,https://derpicdn.net/img/view/2014/6/12/651396.png,0,0.992875397,206,36,588,418,382,382,applejack
656904.png,https://derpicdn.net/img/view/2014/6/19/656904.png,0,0.991187692,66,0,420,343,354,343,applejack
656904.png,https://derpicdn.net/img/view/2014/6/19/656904.png,0,0.991187692,66,0,420,343,354,343,applejack
667859.png,https://derpicdn.net/img/view/2014/7/5/667859.png,0,0.990727007,191,1129,681,1619,490,490,applejack
684569.png,https://derpicdn.net/img/view/2014/7/27/684569.png,0,0.944724441,211,171,1253,1213,1042,1042,applejack
689859.png,https://derpicdn.net/img/view/2014/8/3/689859.png,0,0.999399245,97,0,475,370,378,370,applejack
69518.png,https://derpicdn.net/img/view/2012/8/8/69518.png,0,0.985744178,295,28,725,458,430,430,applejack
695205.png,https://derpicdn.net/img/view/2014/8/9/695205.png,0,0.979809403,121,0,579,455,458,455,applejack
698734.jpg,https://derpicdn.net/img/view/2014/8/13/698734.jpg,0,0.997855127,771,179,1681,1089,910,910,applejack
698734.jpg,https://derpicdn.net/img/view/2014/8/13/698734.jpg,0,0.997855127,771,179,1681,1089,910,910,applejack
700660.png,https://derpicdn.net/img/view/2014/8/16/700660.png,0,0.99727571,400,13,994,607,594,594,applejack
707160.jpg,https://derpicdn.net/img/view/2014/8/24/707160.jpg,0,0.983919382,130,0,366,233,236,233,applejack
714613.png,https://derpicdn.net/img/view/2014/9/4/714613.png,0,0.907954872,438,0,1284,750,846,750,applejack
732057.png,https://derpicdn.net/img/view/2014/9/29/732057.png,0,0.994657636,16,0,600,558,584,558,applejack
738280.png,https://derpicdn.net/img/view/2014/10/7/738280.png,0,0.987341642,670,20,1822,1172,1152,1152,applejack
744163.png,https://derpicdn.net/img/view/2014/10/16/744163.png,0,0.93470484,904,84,1456,636,552,552,applejack
745268.png,https://derpicdn.net/img/view/2014/10/18/745268.png,0,0.986804843,204,3,800,599,596,596,applejack
761261.png,https://derpicdn.net/img/view/2014/11/9/761261.png,0,0.944866419,70,32,284,246,214,214,applejack
764033.png,https://derpicdn.net/img/view/2014/11/13/764033.png,0,0.910675347,0,547,4500,5647,4500,5100,applejack
765252.png,https://derpicdn.net/img/view/2014/11/15/765252.png,0,0.9863258,139,0,389,222,250,222,applejack
768407.jpg,https://derpicdn.net/img/view/2014/11/20/768407.jpg,0,0.974901915,877,300,2553,1976,1676,1676,applejack
771165.png,https://derpicdn.net/img/view/2014/11/24/771165.png,0,0.991416037,512,542,1388,1418,876,876,applejack
775472.png,https://derpicdn.net/img/view/2014/12/1/775472.png,0,0.999095082,247,72,783,608,536,536,applejack
7808.jpg,https://derpicdn.net/img/view/2012/6/18/7808.jpg,0,0.990815639,428,404,728,704,300,300,applejack
781535.png,https://derpicdn.net/img/view/2014/12/9/781535.png,0,0.969527364,378,0,802,362,424,362,applejack
782325.jpg,https://derpicdn.net/img/view/2014/12/10/782325.jpg,0,0.982803106,398,13,692,307,294,294,applejack
791168.png,https://derpicdn.net/img/view/2014/12/23/791168.png,0,0.97891289,375,0,1359,940,984,940,applejack
805345.png,https://derpicdn.net/img/view/2015/1/13/805345.png,0,0.969041049,1262,0,1996,547,734,547,applejack
809089.png,https://derpicdn.net/img/view/2015/1/18/809089.png,0,0.990601897,323,21,1283,981,960,960,applejack
815741.png,https://derpicdn.net/img/view/2015/1/27/815741.png,0,0.996181071,217,12,597,392,380,380,applejack
827801.png,https://derpicdn.net/img/view/2015/2/13/827801.png,0,0.992875934,195,0,869,668,674,668,applejack
830800.png,https://derpicdn.net/img/view/2015/2/17/830800.png,0,0.999574363,210,482,532,804,322,322,applejack
830800.png,https://derpicdn.net/img/view/2015/2/17/830800.png,1,0.993666172,117,0,609,459,492,459,applejack
834731.png,https://derpicdn.net/img/view/2015/2/22/834731.png,0,0.995799899,304,0,1910,1598,1606,1598,applejack
843048.png,https://derpicdn.net/img/view/2015/3/5/843048.png,0,0.973442733,330,36,652,358,322,322,applejack
843048.png,https://derpicdn.net/img/view/2015/3/5/843048.png,0,0.973442733,330,36,652,358,322,322,applejack
848161.png,https://derpicdn.net/img/view/2015/3/12/848161.png,0,0.996489465,217,0,1107,889,890,889,applejack
849359.jpg,https://derpicdn.net/img/view/2015/3/14/849359.jpg,0,0.904449821,742,0,2748,1993,2006,1993,applejack
85877.png,https://derpicdn.net/img/view/2012/8/29/85877.png,0,0.972329438,1388,0,2414,712,1026,712,applejack
861464.png,https://derpicdn.net/img/view/2015/3/31/861464.png,0,0.98955369,54,0,452,369,398,369,applejack
861464.png,https://derpicdn.net/img/view/2015/3/31/861464.png,0,0.98955369,54,0,452,369,398,369,applejack
887665.png,https://derpicdn.net/img/view/2015/5/2/887665.png,0,0.999177456,160,0,458,284,298,284,applejack
901942.png,https://derpicdn.net/img/view/2015/5/22/901942.png,0,0.992596686,236,32,568,364,332,332,applejack
901942.png,https://derpicdn.net/img/view/2015/5/22/901942.png,0,0.992596686,236,32,568,364,332,332,applejack
907657.png,https://derpicdn.net/img/view/2015/5/31/907657.png,0,0.997649491,164,0,960,750,796,750,applejack
912842.png,https://derpicdn.net/img/view/2015/6/8/912842.png,0,0.99716723,284,0,1256,961,972,961,applejack
919484.png,https://derpicdn.net/img/view/2015/6/18/919484.png,0,0.982366204,186,0,484,285,298,285,applejack
923474.png,https://derpicdn.net/img/view/2015/6/25/923474.png,0,0.983471513,59,0,1297,1133,1238,1133,applejack
92422.png,https://derpicdn.net/img/view/2012/9/8/92422.png,0,0.985412419,152,7,672,527,520,520,applejack
924814.png,https://derpicdn.net/img/view/2015/6/27/924814.png,0,0.997054517,56,0,536,479,480,479,applejack
960765.png,https://derpicdn.net/img/view/2015/8/19/960765.png,0,0.952078342,75,0,679,558,604,558,applejack
961055.png,https://derpicdn.net/img/view/2015/8/19/961055.png,0,0.994634569,175,28,381,234,206,206,applejack
961376.png,https://derpicdn.net/img/view/2015/8/20/961376.png,0,0.967764914,378,0,2704,2092,2326,2092,applejack
968314.png,https://derpicdn.net/img/view/2015/8/29/968314.png,0,0.974314511,305,80,921,696,616,616,applejack
969882.png,https://derpicdn.net/img/view/2015/8/31/969882.png,0,0.97470504,156,34,486,364,330,330,applejack
973041.png,https://derpicdn.net/img/view/2015/9/5/973041.png,0,0.977479398,0,108,902,1176,902,1068,applejack
988379.jpg,https://derpicdn.net/img/view/2015/9/26/988379.jpg,0,0.983889639,8,0,286,268,278,268,applejack
988379.jpg,https://derpicdn.net/img/view/2015/9/26/988379.jpg,0,0.983889639,8,0,286,268,278,268,applejack
993107.png,https://derpicdn.net/img/view/2015/10/2/993107.png,0,0.985533297,123,135,575,587,452,452,applejack
994443.png,https://derpicdn.net/img/view/2015/10/4/994443.png,0,0.991110861,96,46,1100,1050,1004,1004,applejack
995688.png,https://derpicdn.net/img/view/2015/10/6/995688.png,0,0.997372985,107,65,409,367,302,302,applejack
999824.png,https://derpicdn.net/img/view/2015/10/11/999824.png,0,0.915495455,0,0,432,415,432,415,applejack
1007026.png,https://derpicdn.net/img/view/2015/10/21/1007026.png,0,0.995998561,3192,0,8369,6030,5177,6030,applejack
1053490.png,https://derpicdn.net/img/view/2015/12/27/1053490.png,0,0.988047779,899,342,1673,1116,774,774,applejack
1067201.png,https://derpicdn.net/img/view/2016/1/15/1067201.png,1,0.910850167,1442,165,2088,811,646,646,applejack
1068397.png,https://derpicdn.net/img/view/2016/1/17/1068397.png,0,0.959996343,2029,138,2893,1002,864,864,applejack
1070122.png,https://derpicdn.net/img/view/2016/1/20/1070122.png,0,0.957315564,493,218,777,502,284,284,applejack
1075725.png,https://derpicdn.net/img/view/2016/1/29/1075725.png,0,0.955259144,1172,20,2278,1126,1106,1106,applejack
1081999.png,https://derpicdn.net/img/view/2016/2/7/1081999.png,0,0.981632471,338,802,824,1288,486,486,applejack
1086934.png,https://derpicdn.net/img/view/2016/2/13/1086934.png,0,0.9453457,5063,0,8000,2923,2937,2923,applejack
110485.jpg,https://derpicdn.net/img/view/2012/9/30/110485.jpg,1,0.988781333,175,634,445,904,270,270,applejack
1115406.png,https://derpicdn.net/img/view/2016/3/23/1115406.png,0,0.975026667,26,17,570,561,544,544,applejack
1155417.png,https://derpicdn.net/img/view/2016/5/16/1155417.png,0,0.989421487,429,2,815,388,386,386,applejack
1164161.jpg,https://derpicdn.net/img/view/2016/5/27/1164161.jpg,0,0.982479155,385,15,1033,663,648,648,applejack
1164839.png,https://derpicdn.net/img/view/2016/5/28/1164839.png,0,0.981987655,3,0,349,322,346,322,applejack
1165767.png,https://derpicdn.net/img/view/2016/5/29/1165767.png,0,0.922712624,59,0,455,372,396,372,applejack
1169000.jpg,https://derpicdn.net/img/view/2016/6/3/1169000.jpg,0,0.980556011,0,0,535,582,535,582,applejack
1174437.png,https://derpicdn.net/img/view/2016/6/9/1174437.png,0,0.993852973,310,150,866,706,556,556,applejack
1175987.png,https://derpicdn.net/img/view/2016/6/11/1175987.png,0,0.942493856,512,158,800,446,288,288,applejack
1183214.png,https://derpicdn.net/img/view/2016/6/21/1183214.png,0,0.990323901,321,130,847,656,526,526,applejack
1192447.png,https://derpicdn.net/img/view/2016/7/3/1192447.png,0,0.971694648,49,76,633,660,584,584,applejack
1201301.png,https://derpicdn.net/img/view/2016/7/15/1201301.png,0,0.996126652,488,0,1328,837,840,837,applejack
1210069.png,https://derpicdn.net/img/view/2016/7/27/1210069.png,0,0.952672124,0,251,3551,3845,3551,3594,applejack
1218802.png,https://derpicdn.net/img/view/2016/8/6/1218802.png,0,0.957606196,45,41,396,415,351,374,applejack
122629.png,https://derpicdn.net/img/view/2012/10/14/122629.png,0,0.99460113,134,0,548,348,414,348,applejack
122629.png,https://derpicdn.net/img/view/2012/10/14/122629.png,1,0.99406451,666,51,1024,411,358,360,applejack
1230238.png,https://derpicdn.net/img/view/2016/8/21/1230238.png,0,0.965007126,785,485,1381,1081,596,596,applejack
1238069.png,https://derpicdn.net/img/view/2016/8/30/1238069.png,0,0.960674644,1023,0,2059,926,1036,926,applejack
124038.jpg,https://derpicdn.net/img/view/2012/10/16/124038.jpg,0,0.999688625,173,0,567,363,394,363,applejack
1268025.png,https://derpicdn.net/img/view/2016/10/8/1268025.png,0,0.9232952,88,164,936,1062,848,898,applejack
1268973.png,https://derpicdn.net/img/view/2016/10/9/1268973.png,0,0.988844693,19,0,753,656,734,656,applejack
128755.jpg,https://derpicdn.net/img/view/2012/10/21/128755.jpg,0,0.974143744,0,104,464,574,464,470,applejack
1293986.png,https://derpicdn.net/img/view/2016/11/12/1293986.png,0,0.928459406,32,0,264,237,232,237,applejack
1294852.png,https://derpicdn.net/img/view/2016/11/13/1294852.png,0,0.99627471,121,42,777,698,656,656,applejack
1311887.png,https://derpicdn.net/img/view/2016/12/7/1311887.png,0,0.970138907,59,0,511,426,452,426,applejack
1316944.png,https://derpicdn.net/img/view/2016/12/13/1316944.png,0,0.998349786,126,0,558,431,432,431,applejack
1321835.png,https://derpicdn.net/img/view/2016/12/21/1321835.png,0,0.993548155,0,0,3274,3285,3274,3285,applejack
1349900.png,https://derpicdn.net/img/view/2017/1/28/1349900.png,0,0.995430052,11,0,983,928,972,928,applejack
1355825.png,https://derpicdn.net/img/view/2017/2/5/1355825.png,0,0.986754,16,155,1120,1259,1104,1104,applejack
1357759.png,https://derpicdn.net/img/view/2017/2/8/1357759.png,0,0.997801185,958,0,1388,384,430,384,applejack
1357759.png,https://derpicdn.net/img/view/2017/2/8/1357759.png,2,0.972847819,0,0,443,396,443,396,applejack
1376697.png,https://derpicdn.net/img/view/2017/3/1/1376697.png,0,0.986753285,0,0,1036,1060,1036,1060,applejack
1377862.png,https://derpicdn.net/img/view/2017/3/3/1377862.png,0,0.988177776,481,0,847,351,366,351,applejack
1377862.png,https://derpicdn.net/img/view/2017/3/3/1377862.png,1,0.953058422,56,8,388,340,332,332,applejack
1377862.png,https://derpicdn.net/img/view/2017/3/3/1377862.png,2,0.936454594,30,580,418,968,388,388,applejack
1379525.png,https://derpicdn.net/img/view/2017/3/5/1379525.png,0,0.996199131,354,0,692,324,338,324,applejack
1383069.png,https://derpicdn.net/img/view/2017/3/9/1383069.png,0,0.916203678,1343,283,2147,1087,804,804,applejack
1408440.png,https://derpicdn.net/img/view/2017/4/10/1408440.png,0,0.950351238,3984,509,5562,2087,1578,1578,applejack
1408802.png,https://derpicdn.net/img/view/2017/4/11/1408802.png,0,0.967782378,0,0,621,560,621,560,applejack
1415618.png,https://derpicdn.net/img/view/2017/4/18/1415618.png,0,0.996667027,2225,0,3141,912,916,912,applejack
1415970.png,https://derpicdn.net/img/view/2017/4/19/1415970.png,0,0.921431065,163,103,993,933,830,830,applejack
1421675.png,https://derpicdn.net/img/view/2017/4/25/1421675.png,0,0.988981009,1246,171,2074,999,828,828,applejack
1422377.png,https://derpicdn.net/img/view/2017/4/26/1422377.png,0,0.986485541,23,0,435,398,412,398,applejack
1422945.png,https://derpicdn.net/img/view/2017/4/27/1422945.png,0,0.981942654,6206,157,7546,1497,1340,1340,applejack
1422945.png,https://derpicdn.net/img/view/2017/4/27/1422945.png,1,0.940085709,2498,2287,4976,4765,2478,2478,applejack
1437169.png,https://derpicdn.net/img/view/2017/5/15/1437169.png,0,0.964117229,45,0,1333,1230,1288,1230,applejack
1443465.png,https://derpicdn.net/img/view/2017/5/22/1443465.png,0,0.996093273,390,26,1006,642,616,616,applejack
1452004.png,https://derpicdn.net/img/view/2017/6/2/1452004.png,0,0.98630017,443,52,1115,724,672,672,applejack
1454515.png,https://derpicdn.net/img/view/2017/6/5/1454515.png,0,0.998867035,333,83,697,447,364,364,applejack
1457258.png,https://derpicdn.net/img/view/2017/6/9/1457258.png,0,0.949868143,0,0,1267,1170,1267,1170,applejack
1466332.png,https://derpicdn.net/img/view/2017/6/20/1466332.png,0,0.987677276,230,0,1198,925,968,925,applejack
1471789.png,https://derpicdn.net/img/view/2017/6/26/1471789.png,0,0.993664026,170,0,512,335,342,335,applejack
1472030.png,https://derpicdn.net/img/view/2017/6/26/1472030.png,0,0.995333135,4185,0,7079,2524,2894,2524,applejack
1480057.png,https://derpicdn.net/img/view/2017/7/6/1480057.png,0,0.983499408,514,0,1818,1230,1304,1230,applejack
1485723.png,https://derpicdn.net/img/view/2017/7/14/1485723.png,0,0.984151483,121,0,395,249,274,249,applejack
1485723.png,https://derpicdn.net/img/view/2017/7/14/1485723.png,2,0.939787984,18,458,202,600,184,142,applejack
1488187.png,https://derpicdn.net/img/view/2017/7/17/1488187.png,0,0.911604524,221,0,797,531,576,531,applejack
1492135.png,https://derpicdn.net/img/view/2017/7/22/1492135.png,0,0.982662857,179,54,660,574,481,520,applejack
14994.png,https://derpicdn.net/img/view/2012/6/22/14994.png,0,0.911194026,259,176,877,794,618,618,applejack
1501673.png,https://derpicdn.net/img/view/2017/8/3/1501673.png,0,0.982298613,10,0,218,211,208,211,applejack
1501673.png,https://derpicdn.net/img/view/2017/8/3/1501673.png,1,0.907250166,0,44,214,278,214,234,applejack
1508187.png,https://derpicdn.net/img/view/2017/8/11/1508187.png,0,0.975610256,348,226,1384,1262,1036,1036,applejack
1509358.png,https://derpicdn.net/img/view/2017/8/13/1509358.png,0,0.958212733,45,269,669,893,624,624,applejack
1511331.png,https://derpicdn.net/img/view/2017/8/15/1511331.png,0,0.937883019,330,48,1656,1374,1326,1326,applejack
1511543.png,https://derpicdn.net/img/view/2017/8/15/1511543.png,0,0.985943377,550,148,1190,788,640,640,applejack
1519506.png,https://derpicdn.net/img/view/2017/8/25/1519506.png,0,0.965836227,1015,308,2133,1426,1118,1118,applejack
1562369.png,https://derpicdn.net/img/view/2017/10/16/1562369.png,0,0.980981767,264,52,1214,1002,950,950,applejack
1570595.png,https://derpicdn.net/img/view/2017/10/26/1570595.png,0,0.981627166,117,0,597,463,480,463,applejack
1586954.png,https://derpicdn.net/img/view/2017/11/15/1586954.png,0,0.975882709,219,35,729,545,510,510,applejack
1590105.png,https://derpicdn.net/img/view/2017/11/19/1590105.png,0,0.997707903,156,0,766,557,610,557,applejack
1590353.png,https://derpicdn.net/img/view/2017/11/20/1590353.png,0,0.957613945,0,154,1809,2134,1809,1980,applejack
1593466.png,https://derpicdn.net/img/view/2017/11/24/1593466.png,0,0.997577786,394,0,958,559,564,559,applejack
1597429.png,https://derpicdn.net/img/view/2017/11/30/1597429.png,0,0.999793887,107,13,431,337,324,324,applejack
1598499.png,https://derpicdn.net/img/view/2017/12/1/1598499.png,0,0.993740916,48,0,550,501,502,501,applejack
1602544.png,https://derpicdn.net/img/view/2017/12/7/1602544.png,0,0.976167083,99,133,763,797,664,664,applejack
1604662.png,https://derpicdn.net/img/view/2017/12/10/1604662.png,0,0.994664967,879,253,1283,657,404,404,applejack
1615062.png,https://derpicdn.net/img/view/2017/12/24/1615062.png,0,0.984285057,98,48,840,790,742,742,applejack
1621602.png,https://derpicdn.net/img/view/2018/1/1/1621602.png,0,0.992853582,251,0,1769,1232,1518,1232,applejack
1629052.png,https://derpicdn.net/img/view/2018/1/10/1629052.png,0,0.906838775,574,87,1654,1167,1080,1080,applejack
1630123.png,https://derpicdn.net/img/view/2018/1/12/1630123.png,0,0.987515688,397,14,875,492,478,478,applejack
1630139.png,https://derpicdn.net/img/view/2018/1/12/1630139.png,0,0.976198912,0,0,716,669,716,669,applejack
1635963.png,https://derpicdn.net/img/view/2018/1/19/1635963.png,0,0.923295975,693,106,1677,1090,984,984,applejack
1636003.png,https://derpicdn.net/img/view/2018/1/19/1636003.png,0,0.969679415,328,0,576,242,248,242,applejack
1636714.png,https://derpicdn.net/img/view/2018/1/20/1636714.png,0,0.992445946,0,0,1410,1321,1410,1321,applejack
1637601.png,https://derpicdn.net/img/view/2018/1/21/1637601.png,0,0.999114811,344,0,712,385,368,385,applejack
1639054.png,https://derpicdn.net/img/view/2018/1/23/1639054.png,0,0.985999703,0,55,753,819,753,764,applejack
1641747.png,https://derpicdn.net/img/view/2018/1/27/1641747.png,0,0.906877637,0,0,2667,3007,2667,3007,applejack
1646675.png,https://derpicdn.net/img/view/2018/2/2/1646675.png,0,0.995854795,296,0,798,495,502,495,applejack
1648449.png,https://derpicdn.net/img/view/2018/2/4/1648449.png,0,0.999796212,400,0,1680,1226,1280,1226,applejack
1650735.png,https://derpicdn.net/img/view/2018/2/7/1650735.png,0,0.950374544,292,129,916,753,624,624,applejack
1653044.png,https://derpicdn.net/img/view/2018/2/11/1653044.png,0,0.998706162,0,0,436,416,436,416,applejack
1656082.png,https://derpicdn.net/img/view/2018/2/14/1656082.png,0,0.969993889,56,0,1360,1260,1304,1260,applejack
1669855.png,https://derpicdn.net/img/view/2018/3/2/1669855.png,0,0.998533547,69,4,605,540,536,536,applejack
1673634.png,https://derpicdn.net/img/view/2018/3/7/1673634.png,0,0.904846787,0,0,1779,1824,1779,1824,applejack
1683192.png,https://derpicdn.net/img/view/2018/3/17/1683192.png,0,0.95662272,7,19,279,291,272,272,applejack
1685614.png,https://derpicdn.net/img/view/2018/3/20/1685614.png,0,0.995344341,337,151,823,637,486,486,applejack
1688994.png,https://derpicdn.net/img/view/2018/3/24/1688994.png,0,0.962780535,871,262,1589,980,718,718,applejack
1690160.png,https://derpicdn.net/img/view/2018/3/25/1690160.png,0,0.965652704,301,578,491,768,190,190,applejack
1690160.png,https://derpicdn.net/img/view/2018/3/25/1690160.png,1,0.949802995,717,483,935,701,218,218,applejack
170106.png,https://derpicdn.net/img/view/2012/12/2/170106.png,0,0.982433856,37,98,483,512,446,414,applejack
1704691.png,https://derpicdn.net/img/view/2018/4/11/1704691.png,0,0.997268856,1825,795,3147,2117,1322,1322,applejack
1705178.png,https://derpicdn.net/img/view/2018/4/11/1705178.png,0,0.947927237,378,134,1200,956,822,822,applejack
1706418.png,https://derpicdn.net/img/view/2018/4/13/1706418.png,0,0.918088019,10,3,2790,2783,2780,2780,applejack
1707396.png,https://derpicdn.net/img/view/2018/4/14/1707396.png,0,0.969328403,471,0,1343,706,872,706,applejack
1710976.png,https://derpicdn.net/img/view/2018/4/18/1710976.png,0,0.917650402,566,91,1184,709,618,618,applejack
1711573.png,https://derpicdn.net/img/view/2018/4/19/1711573.png,0,0.957971036,0,0,220,283,220,283,applejack
1718935.png,https://derpicdn.net/img/view/2018/4/28/1718935.png,0,0.997934997,45,0,569,511,524,511,applejack
1720012.png,https://derpicdn.net/img/view/2018/4/29/1720012.png,0,0.992658377,2236,0,3508,1203,1272,1203,applejack
1721435.png,https://derpicdn.net/img/view/2018/5/1/1721435.png,0,0.994363964,157,39,473,355,316,316,applejack
1730398.png,https://derpicdn.net/img/view/2018/5/11/1730398.png,0,0.98882103,20,0,784,750,764,750,applejack
1730469.png,https://derpicdn.net/img/view/2018/5/12/1730469.png,0,0.93779856,503,217,1511,1225,1008,1008,applejack
1732132.png,https://derpicdn.net/img/view/2018/5/13/1732132.png,0,0.992778242,99,0,949,842,850,842,applejack
1749151.png,https://derpicdn.net/img/view/2018/6/3/1749151.png,0,0.993517399,579,209,1495,1125,916,916,applejack
1754180.png,https://derpicdn.net/img/view/2018/6/10/1754180.png,0,0.945821226,0,1,1024,1275,1024,1274,applejack
1758456.png,https://derpicdn.net/img/view/2018/6/15/1758456.png,0,0.987475574,399,0,1539,1131,1140,1131,applejack
1763444.png,https://derpicdn.net/img/view/2018/6/22/1763444.png,0,0.998014271,249,58,1041,850,792,792,applejack
1764823.png,https://derpicdn.net/img/view/2018/6/24/1764823.png,0,0.982586086,962,0,1888,873,926,873,applejack
1770363.png,https://derpicdn.net/img/view/2018/7/1/1770363.png,0,0.98740083,166,0,614,448,448,448,applejack
1781152.png,https://derpicdn.net/img/view/2018/7/15/1781152.png,0,0.981338739,453,0,1645,1171,1192,1171,applejack
1788677.png,https://derpicdn.net/img/view/2018/7/24/1788677.png,0,0.998265028,618,63,1350,825,732,762,applejack
1792361.png,https://derpicdn.net/img/view/2018/7/29/1792361.png,0,0.999195576,2535,229,4683,2377,2148,2148,applejack
1793330.png,https://derpicdn.net/img/view/2018/7/30/1793330.png,0,0.982537866,98,0,714,575,616,575,applejack
1801730.png,https://derpicdn.net/img/view/2018/8/8/1801730.png,0,0.997926414,431,0,851,417,420,417,applejack
1810922.png,https://derpicdn.net/img/view/2018/8/19/1810922.png,0,0.998055935,210,201,1428,1419,1218,1218,applejack
1812585.png,https://derpicdn.net/img/view/2018/8/21/1812585.png,0,0.998016179,125,0,815,660,690,660,applejack
1818773.png,https://derpicdn.net/img/view/2018/8/28/1818773.png,0,0.992962956,761,0,1635,815,874,815,applejack
184110.png,https://derpicdn.net/img/view/2012/12/16/184110.png,0,0.943728268,38,87,330,379,292,292,applejack
1855388.png,https://derpicdn.net/img/view/2018/10/13/1855388.png,0,0.935709357,693,166,1059,532,366,366,applejack
1863275.png,https://derpicdn.net/img/view/2018/10/22/1863275.png,0,0.972872019,763,39,1035,311,272,272,applejack
1864513.png,https://derpicdn.net/img/view/2018/10/24/1864513.png,0,0.980440199,0,0,2539,2576,2539,2576,applejack
1866084.png,https://derpicdn.net/img/view/2018/10/25/1866084.png,0,0.980706573,456,0,1473,1129,1017,1129,applejack
1883825.png,https://derpicdn.net/img/view/2018/11/16/1883825.png,0,0.992190182,222,64,1008,850,786,786,applejack
1888904.png,https://derpicdn.net/img/view/2018/11/23/1888904.png,0,0.978311837,202,0,620,341,418,341,applejack
1890582.png,https://derpicdn.net/img/view/2018/11/25/1890582.png,0,0.979573727,0,182,1216,1666,1216,1484,applejack
1894739.png,https://derpicdn.net/img/view/2018/11/30/1894739.png,0,0.965624928,256,0,870,594,614,594,applejack
1903621.png,https://derpicdn.net/img/view/2018/12/9/1903621.png,0,0.92593348,0,0,656,624,656,624,applejack
1903633.png,https://derpicdn.net/img/view/2018/12/9/1903633.png,0,0.986491323,107,0,1027,850,920,850,applejack
1916567.png,https://derpicdn.net/img/view/2018/12/23/1916567.png,0,0.997752011,964,91,1772,899,808,808,applejack
1917872.png,https://derpicdn.net/img/view/2018/12/24/1917872.png,0,0.972531021,160,660,1680,2180,1520,1520,applejack
1921172.png,https://derpicdn.net/img/view/2018/12/29/1921172.png,0,0.914923489,304,0,2724,2392,2420,2392,applejack
1923184.png,https://derpicdn.net/img/view/2018/12/31/1923184.png,0,0.990853488,0,0,997,1006,997,1006,applejack
1924687.png,https://derpicdn.net/img/view/2019/1/2/1924687.png,0,0.986570001,403,170,1197,964,794,794,applejack
1927789.png,https://derpicdn.net/img/view/2019/1/6/1927789.png,0,0.943616629,214,165,530,481,316,316,applejack
1930492.png,https://derpicdn.net/img/view/2019/1/9/1930492.png,0,0.993247926,204,299,454,549,250,250,applejack
1939839.png,https://derpicdn.net/img/view/2019/1/20/1939839.png,0,0.994631588,16,42,370,396,354,354,applejack
1940347.png,https://derpicdn.net/img/view/2019/1/20/1940347.png,0,0.992956817,2,0,570,540,568,540,applejack
1946609.png,https://derpicdn.net/img/view/2019/1/28/1946609.png,0,0.900418401,49,82,603,636,554,554,applejack
1947.jpg,https://derpicdn.net/img/view/2012/1/24/1947.jpg,0,0.947858095,0,177,1577,1600,1577,1423,applejack
1952514.png,https://derpicdn.net/img/view/2019/2/3/1952514.png,0,0.990529656,459,881,709,1131,250,250,applejack
1955355.png,https://derpicdn.net/img/view/2019/2/6/1955355.png,0,0.960950911,49,25,665,641,616,616,applejack
1961574.png,https://derpicdn.net/img/view/2019/2/14/1961574.png,0,0.934069037,953,864,3777,3688,2824,2824,applejack
1964965.png,https://derpicdn.net/img/view/2019/2/18/1964965.png,0,0.909067154,48,0,338,277,290,277,applejack
1967521.png,https://derpicdn.net/img/view/2019/2/21/1967521.png,0,0.988441467,986,153,1706,873,720,720,applejack
1967521.png,https://derpicdn.net/img/view/2019/2/21/1967521.png,1,0.958297789,507,421,1093,1007,586,586,applejack
1971073.png,https://derpicdn.net/img/view/2019/2/25/1971073.png,0,0.997964442,817,35,1181,399,364,364,applejack
1971073.png,https://derpicdn.net/img/view/2019/2/25/1971073.png,1,0.997672975,604,575,1004,975,400,400,applejack
1971073.png,https://derpicdn.net/img/view/2019/2/25/1971073.png,2,0.992425859,178,685,484,991,306,306,applejack
1971073.png,https://derpicdn.net/img/view/2019/2/25/1971073.png,3,0.991314948,118,25,478,385,360,360,applejack
1978857.png,https://derpicdn.net/img/view/2019/3/6/1978857.png,0,0.996771812,420,33,990,603,570,570,applejack
1985182.png,https://derpicdn.net/img/view/2019/3/14/1985182.png,0,0.980866969,69,4,1105,1040,1036,1036,applejack
2001979.png,https://derpicdn.net/img/view/2019/4/3/2001979.png,0,0.998783231,89,78,501,490,412,412,applejack
2013671.png,https://derpicdn.net/img/view/2019/4/15/2013671.png,0,0.925111592,69,24,483,438,414,414,applejack
2014060.png,https://derpicdn.net/img/view/2019/4/16/2014060.png,0,0.99330461,333,504,2041,2160,1708,1656,applejack
2017840.png,https://derpicdn.net/img/view/2019/4/20/2017840.png,0,0.935407102,0,0,335,442,335,442,applejack
2020192.png,https://derpicdn.net/img/view/2019/4/22/2020192.png,0,0.998737514,154,444,1804,2094,1650,1650,applejack
2021654.png,https://derpicdn.net/img/view/2019/4/24/2021654.png,0,0.965619802,434,0,1988,1410,1554,1410,applejack
2023691.png,https://derpicdn.net/img/view/2019/4/26/2023691.png,0,0.99930954,306,26,1860,1580,1554,1554,applejack
2027077.png,https://derpicdn.net/img/view/2019/4/30/2027077.png,0,0.954899132,400,13,894,507,494,494,applejack
2034448.png,https://derpicdn.net/img/view/2019/5/9/2034448.png,0,0.99841404,216,0,796,511,580,511,applejack
2035964.png,https://derpicdn.net/img/view/2019/5/11/2035964.png,0,0.991120994,214,37,1274,1097,1060,1060,applejack
2038379.png,https://derpicdn.net/img/view/2019/5/13/2038379.png,0,0.981362581,587,208,1681,1302,1094,1094,applejack
2042202.png,https://derpicdn.net/img/view/2019/5/18/2042202.png,0,0.902977347,312,41,1394,1123,1082,1082,applejack
2044018.png,https://derpicdn.net/img/view/2019/5/20/2044018.png,0,0.952972174,96,0,632,490,536,490,applejack
2044210.png,https://derpicdn.net/img/view/2019/5/20/2044210.png,0,0.945711434,50,0,570,444,520,444,applejack
2058363.png,https://derpicdn.net/img/view/2019/6/5/2058363.png,0,0.936205447,44,798,958,1712,914,914,applejack
2064232.png,https://derpicdn.net/img/view/2019/6/13/2064232.png,0,0.903755546,26,0,420,377,394,377,applejack
2067535.png,https://derpicdn.net/img/view/2019/6/17/2067535.png,0,0.999231875,0,24,557,598,557,574,applejack
206899.png,https://derpicdn.net/img/view/2013/1/9/206899.png,0,0.98162061,97,19,311,233,214,214,applejack
2074626.png,https://derpicdn.net/img/view/2019/6/25/2074626.png,0,0.995320857,81,0,715,614,634,614,applejack
2076465.png,https://derpicdn.net/img/view/2019/6/27/2076465.png,0,0.995437384,0,0,1528,1528,1528,1528,applejack
207708.jpg,https://derpicdn.net/img/view/2013/1/9/207708.jpg,0,0.99325192,349,260,933,844,584,584,applejack
2078672.png,https://derpicdn.net/img/view/2019/6/29/2078672.png,0,0.997994363,11,0,1155,1050,1144,1050,applejack
2078672.png,https://derpicdn.net/img/view/2019/6/29/2078672.png,1,0.970455945,1632,604,2530,1502,898,898,applejack
2090075.png,https://derpicdn.net/img/view/2019/7/12/2090075.png,0,0.995405197,0,0,560,549,560,549,applejack
209231.png,https://derpicdn.net/img/view/2013/1/11/209231.png,0,0.993497312,406,15,1302,911,896,896,applejack
2100661.png,https://derpicdn.net/img/view/2019/7/25/2100661.png,0,0.996861279,111,5,401,295,290,290,applejack
2103926.png,https://derpicdn.net/img/view/2019/7/29/2103926.png,0,0.992776215,0,67,740,815,740,748,applejack
2110701.png,https://derpicdn.net/img/view/2019/8/6/2110701.png,0,0.998880506,873,112,1995,1234,1122,1122,applejack
2119425.png,https://derpicdn.net/img/view/2019/8/16/2119425.png,0,0.921022654,443,56,729,342,286,286,applejack
2122770.png,https://derpicdn.net/img/view/2019/8/20/2122770.png,0,0.996989965,691,585,1159,1053,468,468,applejack
2125418.png,https://derpicdn.net/img/view/2019/8/23/2125418.png,0,0.963914156,197,74,617,494,420,420,applejack
2140586.png,https://derpicdn.net/img/view/2019/9/10/2140586.png,0,0.904173791,970,669,2436,2135,1466,1466,applejack
2144113.png,https://derpicdn.net/img/view/2019/9/14/2144113.png,0,0.964259267,361,731,1001,1371,640,640,applejack
2148220.png,https://derpicdn.net/img/view/2019/9/20/2148220.png,0,0.997985542,263,64,609,410,346,346,applejack
2149838.png,https://derpicdn.net/img/view/2019/9/22/2149838.png,0,0.927824736,208,353,572,717,364,364,applejack
215064.png,https://derpicdn.net/img/view/2013/1/17/215064.png,0,0.991148293,123,0,395,263,272,263,applejack
2152204.png,https://derpicdn.net/img/view/2019/9/24/2152204.png,1,0.970064342,3406,3162,4336,4000,930,838,applejack
2157609.png,https://derpicdn.net/img/view/2019/10/1/2157609.png,0,0.986199498,121,45,1827,1751,1706,1706,applejack
2166484.png,https://derpicdn.net/img/view/2019/10/12/2166484.png,0,0.942382038,0,0,1531,2248,1531,2248,applejack
2171382.png,https://derpicdn.net/img/view/2019/10/17/2171382.png,0,0.996573985,7,0,357,314,350,314,applejack
2173187.png,https://derpicdn.net/img/view/2019/10/19/2173187.png,0,0.969186425,478,63,824,409,346,346,applejack
2174275.png,https://derpicdn.net/img/view/2019/10/20/2174275.png,0,0.910965145,942,0,1266,324,324,324,applejack
2174839.png,https://derpicdn.net/img/view/2019/10/20/2174839.png,0,0.993518174,0,28,476,526,476,498,applejack
2175655.png,https://derpicdn.net/img/view/2019/10/21/2175655.png,0,0.981911659,718,237,1532,1051,814,814,applejack
2176481.png,https://derpicdn.net/img/view/2019/10/22/2176481.png,0,0.988740742,574,22,1134,582,560,560,applejack
2176481.png,https://derpicdn.net/img/view/2019/10/22/2176481.png,1,0.982503891,246,327,654,735,408,408,applejack
2176481.png,https://derpicdn.net/img/view/2019/10/22/2176481.png,2,0.962727547,80,743,428,1091,348,348,applejack
2176683.png,https://derpicdn.net/img/view/2019/10/23/2176683.png,0,0.966502368,131,0,1217,987,1086,987,applejack
2192628.png,https://derpicdn.net/img/view/2019/11/10/2192628.png,0,0.99207449,0,0,370,368,370,368,applejack
2203227.png,https://derpicdn.net/img/view/2019/11/23/2203227.png,0,0.976297855,19,34,419,434,400,400,applejack
2203228.png,https://derpicdn.net/img/view/2019/11/23/2203228.png,0,0.974324107,0,0,436,408,436,408,applejack
2204399.png,https://derpicdn.net/img/view/2019/11/24/2204399.png,0,0.97968477,461,0,1398,859,937,859,applejack
2210400.png,https://derpicdn.net/img/view/2019/12/1/2210400.png,0,0.976449609,221,98,1043,920,822,822,applejack
2210400.png,https://derpicdn.net/img/view/2019/12/1/2210400.png,1,0.93167007,625,40,1401,816,776,776,applejack
2217079.png,https://derpicdn.net/img/view/2019/12/10/2217079.png,0,0.995611072,336,243,1114,1021,778,778,applejack
2217826.png,https://derpicdn.net/img/view/2019/12/11/2217826.png,0,0.981462777,20,0,2412,2206,2392,2206,applejack
2228432.png,https://derpicdn.net/img/view/2019/12/24/2228432.png,0,0.929454267,71,69,765,763,694,694,applejack
2230648.png,https://derpicdn.net/img/view/2019/12/26/2230648.png,0,0.995094836,31,89,385,443,354,354,applejack
223384.png,https://derpicdn.net/img/view/2013/1/25/223384.png,0,0.988676727,119,35,383,299,264,264,applejack
2237782.jpg,https://derpicdn.net/img/view/2020/1/3/2237782.jpg,0,0.995393395,0,0,1087,1038,1087,1038,applejack
2238980.png,https://derpicdn.net/img/view/2020/1/4/2238980.png,0,0.979741037,1089,155,1957,1023,868,868,applejack
2247133.jpg,https://derpicdn.net/img/view/2020/1/14/2247133.jpg,0,0.996813893,507,0,1823,1231,1316,1231,applejack
2249380.png,https://derpicdn.net/img/view/2020/1/17/2249380.png,0,0.944218874,117,0,1151,1013,1034,1013,applejack
2250454.png,https://derpicdn.net/img/view/2020/1/18/2250454.png,0,0.980920196,57,0,1537,1468,1480,1468,applejack
2255581.jpg,https://derpicdn.net/img/view/2020/1/24/2255581.jpg,0,0.989201009,595,2001,1115,2521,520,520,applejack
2255581.jpg,https://derpicdn.net/img/view/2020/1/24/2255581.jpg,1,0.97665149,189,1886,669,2366,480,480,applejack
2255581.jpg,https://derpicdn.net/img/view/2020/1/24/2255581.jpg,2,0.960038126,983,1451,1777,2245,794,794,applejack
2261588.png,https://derpicdn.net/img/view/2020/1/31/2261588.png,0,0.99874109,23,10,433,420,410,410,applejack
2265968.png,https://derpicdn.net/img/view/2020/2/5/2265968.png,0,0.979666471,1516,0,3330,1582,1814,1582,applejack
2267815.jpg,https://derpicdn.net/img/view/2020/2/7/2267815.jpg,0,0.905313015,17,0,999,1006,982,1006,applejack
2268070.jpg,https://derpicdn.net/img/view/2020/2/7/2268070.jpg,0,0.974452794,0,0,1418,1360,1418,1360,applejack
2269033.png,https://derpicdn.net/img/view/2020/2/8/2269033.png,0,0.990033865,0,89,2035,2131,2035,2042,applejack
2271922.png,https://derpicdn.net/img/view/2020/2/12/2271922.png,0,0.973482847,0,0,806,870,806,870,applejack
2275688.png,https://derpicdn.net/img/view/2020/2/16/2275688.png,0,0.983679414,0,3,561,581,561,578,applejack
2280021.jpg,https://derpicdn.net/img/view/2020/2/21/2280021.jpg,0,0.998413444,323,299,549,525,226,226,applejack
2282462.png,https://derpicdn.net/img/view/2020/2/24/2282462.png,0,0.975242913,40,0,646,585,606,585,applejack
2286258.png,https://derpicdn.net/img/view/2020/2/29/2286258.png,0,0.938128114,46,0,554,458,508,458,applejack
2301359.jpg,https://derpicdn.net/img/view/2020/3/19/2301359.jpg,0,0.998267889,171,0,1121,871,950,871,applejack
2305284.png,https://derpicdn.net/img/view/2020/3/25/2305284.png,0,0.979383707,0,0,2988,2638,2988,2638,applejack
2308487.jpg,https://derpicdn.net/img/view/2020/3/28/2308487.jpg,0,0.978998542,135,16,1920,1890,1785,1874,applejack
2314321.jpg,https://derpicdn.net/img/view/2020/4/5/2314321.jpg,0,0.959070504,46,70,576,600,530,530,applejack
2323033.png,https://derpicdn.net/img/view/2020/4/15/2323033.png,0,0.941316605,0,162,1208,1372,1208,1210,applejack
2324051.jpg,https://derpicdn.net/img/view/2020/4/16/2324051.jpg,0,0.996192634,94,0,580,459,486,459,applejack
2325783.png,https://derpicdn.net/img/view/2020/4/18/2325783.png,0,0.992675722,233,0,709,443,476,443,applejack
2327263.png,https://derpicdn.net/img/view/2020/4/20/2327263.png,0,0.994083226,131,208,1759,1836,1628,1628,applejack
2334661.png,https://derpicdn.net/img/view/2020/4/29/2334661.png,0,0.999064624,1419,21,2879,1481,1460,1460,applejack
2342026.jpg,https://derpicdn.net/img/view/2020/5/7/2342026.jpg,0,0.985210359,139,212,1935,2000,1796,1788,applejack
2342822.jpg,https://derpicdn.net/img/view/2020/5/8/2342822.jpg,0,0.95109725,517,161,1481,1125,964,964,applejack
2347452.jpg,https://derpicdn.net/img/view/2020/5/13/2347452.jpg,0,0.956494868,0,7,779,923,779,916,applejack
2351552.jpg,https://derpicdn.net/img/view/2020/5/18/2351552.jpg,0,0.911645591,57,0,475,399,418,399,applejack
2353106.png,https://derpicdn.net/img/view/2020/5/20/2353106.png,0,0.986580014,242,36,574,368,332,332,applejack
246595.png,https://derpicdn.net/img/view/2013/2/17/246595.png,0,0.951213121,47,33,559,545,512,512,applejack
275305.jpg,https://derpicdn.net/img/view/2013/3/20/275305.jpg,0,0.997728169,0,10,460,488,460,478,applejack
281831.png,https://derpicdn.net/img/view/2013/3/28/281831.png,0,0.98074621,160,0,462,260,302,260,applejack
287146.png,https://derpicdn.net/img/view/2013/4/3/287146.png,0,0.971033037,109,4,323,218,214,214,applejack
288772.png,https://derpicdn.net/img/view/2013/4/5/288772.png,0,0.99877131,238,10,1124,896,886,886,applejack
299029.png,https://derpicdn.net/img/view/2013/4/15/299029.png,0,0.98327899,421,42,1455,1076,1034,1034,applejack
305804.png,https://derpicdn.net/img/view/2013/4/23/305804.png,0,0.91809839,866,267,2370,1771,1504,1504,applejack
306228.png,https://derpicdn.net/img/view/2013/4/23/306228.png,0,0.964167416,194,0,734,526,540,526,applejack
307402.png,https://derpicdn.net/img/view/2013/4/24/307402.png,0,0.973051012,58,15,346,303,288,288,applejack
311004.png,https://derpicdn.net/img/view/2013/4/29/311004.png,0,0.975946009,156,58,936,838,780,780,applejack
327117.png,https://derpicdn.net/img/view/2013/5/17/327117.png,0,0.996276915,666,199,1218,751,552,552,applejack
384080.png,https://derpicdn.net/img/view/2013/7/29/384080.png,0,0.968194544,1074,0,3158,1951,2084,1951,applejack
397031.png,https://derpicdn.net/img/view/2013/8/11/397031.png,0,0.99941057,178,27,462,311,284,284,applejack
402475.png,https://derpicdn.net/img/view/2013/8/17/402475.png,0,0.99325335,151,0,543,354,392,354,applejack
40962.jpg,https://derpicdn.net/img/view/2012/7/11/40962.jpg,0,0.991705298,388,23,764,399,376,376,applejack
414107.png,https://derpicdn.net/img/view/2013/8/29/414107.png,0,0.989808619,2001,0,3184,1116,1183,1116,applejack
421419.png,https://derpicdn.net/img/view/2013/9/7/421419.png,0,0.982644618,0,5,411,435,411,430,applejack
426005.png,https://derpicdn.net/img/view/2013/9/12/426005.png,0,0.979619265,1082,0,1966,856,884,856,applejack
428974.png,https://derpicdn.net/img/view/2013/9/16/428974.png,0,0.995868146,93,0,339,215,246,215,applejack
431848.png,https://derpicdn.net/img/view/2013/9/21/431848.png,0,0.902846813,102,0,554,440,452,440,applejack
436480.png,https://derpicdn.net/img/view/2013/9/27/436480.png,0,0.994433641,38,17,308,287,270,270,applejack
437365.jpg,https://derpicdn.net/img/view/2013/9/29/437365.jpg,0,0.997490525,261,0,551,267,290,267,applejack
440762.png,https://derpicdn.net/img/view/2013/10/3/440762.png,0,0.999549568,98,28,714,644,616,616,applejack
460286.png,https://derpicdn.net/img/view/2013/10/30/460286.png,0,0.97576952,1,12,577,588,576,576,applejack
462166.png,https://derpicdn.net/img/view/2013/11/1/462166.png,0,0.951403856,26,0,316,287,290,287,applejack
488876.png,https://derpicdn.net/img/view/2013/12/3/488876.png,0,0.982895255,0,55,1280,1589,1280,1534,applejack
48945.jpg,https://derpicdn.net/img/view/2012/7/19/48945.jpg,0,0.986317396,374,22,928,576,554,554,applejack
510704.png,https://derpicdn.net/img/view/2013/12/31/510704.png,0,0.991910875,123,50,399,326,276,276,applejack
511.png,https://derpicdn.net/img/view/2012/1/16/511.png,0,0.970229208,1550,78,3143,1752,1593,1674,applejack
518099.png,https://derpicdn.net/img/view/2014/1/7/518099.png,0,0.998800814,142,6,380,244,238,238,applejack
524864.png,https://derpicdn.net/img/view/2014/1/15/524864.png,0,0.998744071,140,0,394,246,254,246,applejack
565688.png,https://derpicdn.net/img/view/2014/3/3/565688.png,0,0.994236469,273,0,571,277,298,277,applejack
566573.png,https://derpicdn.net/img/view/2014/3/4/566573.png,0,0.996850491,0,0,4583,4829,4583,4829,applejack
573229.png,https://derpicdn.net/img/view/2014/3/12/573229.png,0,0.993607402,0,0,923,970,923,970,applejack
631910.jpg,https://derpicdn.net/img/view/2014/5/20/631910.jpg,0,0.992125213,208,470,628,890,420,420,applejack
631982.png,https://derpicdn.net/img/view/2014/5/20/631982.png,0,0.995806038,915,0,2535,1578,1620,1578,applejack
634717.png,https://derpicdn.net/img/view/2014/5/23/634717.png,0,0.993776083,381,0,743,359,362,359,applejack
63631.png,https://derpicdn.net/img/view/2012/8/1/63631.png,0,0.999262154,567,0,1109,492,542,492,applejack
656960.png,https://derpicdn.net/img/view/2014/6/19/656960.png,0,0.966840267,6,0,450,424,444,424,applejack
659843.png,https://derpicdn.net/img/view/2014/6/23/659843.png,0,0.997875571,52,0,708,619,656,619,applejack
674596.png,https://derpicdn.net/img/view/2014/7/14/674596.png,0,0.995114982,88,0,430,337,342,337,applejack
674892.png,https://derpicdn.net/img/view/2014/7/14/674892.png,0,0.983552039,142,235,1112,1205,970,970,applejack
675267.png,https://derpicdn.net/img/view/2014/7/15/675267.png,0,0.943261385,362,25,674,337,312,312,applejack
675523.png,https://derpicdn.net/img/view/2014/7/15/675523.png,0,0.995030522,0,19,309,335,309,316,applejack
675523.png,https://derpicdn.net/img/view/2014/7/15/675523.png,1,0.978895903,292,0,658,361,366,361,applejack
680401.png,https://derpicdn.net/img/view/2014/7/21/680401.png,0,0.937022865,64,30,338,304,274,274,applejack
689563.png,https://derpicdn.net/img/view/2014/8/2/689563.png,0,0.992412865,576,100,954,478,378,378,applejack
690071.png,https://derpicdn.net/img/view/2014/8/3/690071.png,0,0.996981621,550,19,774,243,224,224,applejack
692309.png,https://derpicdn.net/img/view/2014/8/5/692309.png,0,0.944024682,275,0,600,314,325,314,applejack
692310.png,https://derpicdn.net/img/view/2014/8/5/692310.png,0,0.97102809,72,0,428,325,356,325,applejack
692734.png,https://derpicdn.net/img/view/2014/8/6/692734.png,0,0.925838649,195,42,711,558,516,516,applejack
709288.png,https://derpicdn.net/img/view/2014/8/27/709288.png,0,0.921580911,367,68,1021,722,654,654,applejack
716371.jpg,https://derpicdn.net/img/view/2014/9/6/716371.jpg,0,0.999402642,158,0,556,393,398,393,applejack
741540.png,https://derpicdn.net/img/view/2014/10/12/741540.png,0,0.945066094,423,340,1123,1040,700,700,applejack
747662.jpg,https://derpicdn.net/img/view/2014/10/21/747662.jpg,0,0.911446571,87,0,421,319,334,319,applejack
764362.png,https://derpicdn.net/img/view/2014/11/14/764362.png,0,0.932850242,21,0,1079,959,1058,959,applejack
772965.png,https://derpicdn.net/img/view/2014/11/27/772965.png,0,0.987844467,0,0,757,772,757,772,applejack
773182.png,https://derpicdn.net/img/view/2014/11/27/773182.png,0,0.926656783,274,11,850,587,576,576,applejack
773183.png,https://derpicdn.net/img/view/2014/11/27/773183.png,0,0.926476598,274,11,850,587,576,576,applejack
774590.png,https://derpicdn.net/img/view/2014/11/29/774590.png,0,0.937721908,328,0,790,438,462,438,applejack
782929.png,https://derpicdn.net/img/view/2014/12/11/782929.png,0,0.921404183,1653,617,2289,1253,636,636,applejack
784803.png,https://derpicdn.net/img/view/2014/12/14/784803.png,0,0.964674652,111,0,775,662,664,662,applejack
794198.jpg,https://derpicdn.net/img/view/2014/12/28/794198.jpg,0,0.998944342,288,62,724,498,436,436,applejack
794446.jpg,https://derpicdn.net/img/view/2014/12/28/794446.jpg,0,0.993317187,1397,210,1797,610,400,400,applejack
807719.png,https://derpicdn.net/img/view/2015/1/16/807719.png,0,0.97446537,85,49,235,199,150,150,applejack
807719.png,https://derpicdn.net/img/view/2015/1/16/807719.png,1,0.911330819,265,42,429,206,164,164,applejack
808047.png,https://derpicdn.net/img/view/2015/1/16/808047.png,0,0.950294614,102,0,1042,940,940,940,applejack
811078.png,https://derpicdn.net/img/view/2015/1/20/811078.png,0,0.99848485,141,0,385,238,244,238,applejack
827633.jpg,https://derpicdn.net/img/view/2015/2/13/827633.jpg,0,0.994446695,149,22,395,268,246,246,applejack
836344.png,https://derpicdn.net/img/view/2015/2/24/836344.png,0,0.972861409,0,177,1187,1401,1187,1224,applejack
851590.png,https://derpicdn.net/img/view/2015/3/17/851590.png,0,0.905900598,8,0,778,716,770,716,applejack
862135.png,https://derpicdn.net/img/view/2015/4/1/862135.png,0,0.97890687,95,0,500,360,405,360,applejack
864681.png,https://derpicdn.net/img/view/2015/4/4/864681.png,0,0.980266035,310,0,800,467,490,467,applejack
872255.png,https://derpicdn.net/img/view/2015/4/12/872255.png,0,0.959763944,0,0,790,798,790,798,applejack
872863.png,https://derpicdn.net/img/view/2015/4/13/872863.png,0,0.966709733,0,13,407,475,407,462,applejack
875737.png,https://derpicdn.net/img/view/2015/4/17/875737.png,0,0.991735816,538,68,1066,596,528,528,applejack
880537.png,https://derpicdn.net/img/view/2015/4/22/880537.png,0,0.980039656,432,0,844,385,412,385,applejack
880707.png,https://derpicdn.net/img/view/2015/4/23/880707.png,0,0.989974856,190,20,1244,1074,1054,1054,applejack
884853.png,https://derpicdn.net/img/view/2015/4/28/884853.png,0,0.978301167,360,41,794,475,434,434,applejack
885.jpg,https://derpicdn.net/img/view/2012/1/20/885.jpg,0,0.982311428,612,292,1030,710,418,418,applejack
888132.png,https://derpicdn.net/img/view/2015/5/3/888132.png,0,0.999430358,162,0,456,282,294,282,applejack
896704.png,https://derpicdn.net/img/view/2015/5/15/896704.png,0,0.975487411,192,73,616,497,424,424,applejack
909384.png,https://derpicdn.net/img/view/2015/6/3/909384.png,0,0.986153841,143,548,371,776,228,228,applejack
909384.png,https://derpicdn.net/img/view/2015/6/3/909384.png,1,0.942884028,132,11,382,261,250,250,applejack
909588.png,https://derpicdn.net/img/view/2015/6/3/909588.png,0,0.998675227,60,0,548,434,488,434,applejack
909903.png,https://derpicdn.net/img/view/2015/6/4/909903.png,0,0.960914016,152,0,576,414,424,414,applejack
912362.png,https://derpicdn.net/img/view/2015/6/7/912362.png,0,0.998777986,164,0,710,538,546,538,applejack
915550.png,https://derpicdn.net/img/view/2015/6/12/915550.png,0,0.960205019,98,0,656,501,558,501,applejack
927016.png,https://derpicdn.net/img/view/2015/6/30/927016.png,0,0.991785109,124,0,542,399,418,399,applejack
950638.png,https://derpicdn.net/img/view/2015/8/4/950638.png,0,0.967121542,247,7,709,469,462,462,applejack
954007.jpg,https://derpicdn.net/img/view/2015/8/9/954007.jpg,0,0.938244045,0,0,613,548,613,548,applejack
965222.png,https://derpicdn.net/img/view/2015/8/25/965222.png,0,0.993482351,459,0,1313,821,854,821,applejack
976549.png,https://derpicdn.net/img/view/2015/9/10/976549.png,0,0.999821007,357,61,687,391,330,330,applejack
991790.png,https://derpicdn.net/img/view/2015/10/1/991790.png,0,0.99380827,458,39,806,387,348,348,applejack
996433.jpg,https://derpicdn.net/img/view/2015/10/7/996433.jpg,0,0.988511205,294,35,824,565,530,530,applejack
1010539.png,https://derpicdn.net/img/view/2015/10/28/1010539.png,0,0.930601954,166,160,430,424,264,264,applejack
1029569.png,https://derpicdn.net/img/view/2015/11/24/1029569.png,0,0.945132971,338,120,682,464,344,344,applejack
1033572.png,https://derpicdn.net/img/view/2015/11/30/1033572.png,0,0.945337772,736,22,1316,602,580,580,applejack
1059391.png,https://derpicdn.net/img/view/2016/1/4/1059391.png,0,0.996564865,198,25,728,555,530,530,applejack
1074540.png,https://derpicdn.net/img/view/2016/1/27/1074540.png,0,0.930506289,550,0,1136,516,586,516,applejack
107635.png,https://derpicdn.net/img/view/2012/9/27/107635.png,0,0.993353367,45,0,311,251,266,251,applejack
1082556.png,https://derpicdn.net/img/view/2016/2/7/1082556.png,0,0.991839945,829,14,1499,684,670,670,applejack
1085523.png,https://derpicdn.net/img/view/2016/2/11/1085523.png,0,0.926301777,0,0,3333,3490,3333,3490,applejack
1086171.png,https://derpicdn.net/img/view/2016/2/12/1086171.png,0,0.994937479,162,48,908,794,746,746,applejack
1112702.png,https://derpicdn.net/img/view/2016/3/20/1112702.png,0,0.966961205,70,53,1208,1191,1138,1138,applejack
1122332.jpg,https://derpicdn.net/img/view/2016/4/2/1122332.jpg,0,0.998717785,591,71,1457,937,866,866,applejack
1130462.jpg,https://derpicdn.net/img/view/2016/4/12/1130462.jpg,0,0.984657347,147,0,1358,1162,1211,1162,applejack
1147018.png,https://derpicdn.net/img/view/2016/5/5/1147018.png,0,0.989635587,75,50,399,374,324,324,applejack
115414.jpg,https://derpicdn.net/img/view/2012/10/6/115414.jpg,0,0.967673063,71,102,309,340,238,238,applejack
1161321.png,https://derpicdn.net/img/view/2016/5/23/1161321.png,0,0.961461544,0,205,2964,3713,2964,3508,applejack
1166208.png,https://derpicdn.net/img/view/2016/5/30/1166208.png,0,0.999167621,509,0,1183,658,674,658,applejack
1181891.png,https://derpicdn.net/img/view/2016/6/19/1181891.png,0,0.975980997,404,0,1020,604,616,604,applejack
1194215.png,https://derpicdn.net/img/view/2016/7/5/1194215.png,0,0.953855336,1249,0,2501,1170,1252,1170,applejack
119595.jpg,https://derpicdn.net/img/view/2012/10/11/119595.jpg,0,0.951973617,378,213,686,521,308,308,applejack
1196322.png,https://derpicdn.net/img/view/2016/7/8/1196322.png,0,0.990190268,582,139,1024,609,442,470,applejack
1209592.png,https://derpicdn.net/img/view/2016/7/26/1209592.png,0,0.995988071,170,0,732,541,562,541,applejack
1214220.png,https://derpicdn.net/img/view/2016/8/1/1214220.png,0,0.938190997,0,0,634,570,634,570,applejack
1231956.png,https://derpicdn.net/img/view/2016/8/23/1231956.png,0,0.99871695,278,0,694,384,416,384,applejack
1249940.png,https://derpicdn.net/img/view/2016/9/15/1249940.png,0,0.986025989,203,69,489,355,286,286,applejack
1251662.png,https://derpicdn.net/img/view/2016/9/17/1251662.png,0,0.959029973,0,35,368,455,368,420,applejack
1264087.png,https://derpicdn.net/img/view/2016/10/3/1264087.png,0,0.987384319,120,0,816,671,696,671,applejack
1265562.png,https://derpicdn.net/img/view/2016/10/5/1265562.png,0,0.987319708,0,0,722,664,722,664,applejack
1268076.png,https://derpicdn.net/img/view/2016/10/8/1268076.png,0,0.969697714,0,29,366,411,366,382,applejack
1269076.png,https://derpicdn.net/img/view/2016/10/9/1269076.png,0,0.949338555,81,0,428,367,347,367,applejack
1270803.png,https://derpicdn.net/img/view/2016/10/11/1270803.png,0,0.989561975,48,0,2658,2492,2610,2492,applejack
1272876.png,https://derpicdn.net/img/view/2016/10/14/1272876.png,0,0.964418411,81,0,410,314,329,314,applejack
1275636.png,https://derpicdn.net/img/view/2016/10/17/1275636.png,0,0.950748026,0,0,4033,3676,4033,3676,applejack
1288477.png,https://derpicdn.net/img/view/2016/11/4/1288477.png,0,0.924097121,466,256,4250,4330,3784,4074,applejack
1293046.png,https://derpicdn.net/img/view/2016/11/11/1293046.png,0,0.970358193,0,0,317,341,317,341,applejack
1299822.png,https://derpicdn.net/img/view/2016/11/20/1299822.png,0,0.960172594,0,0,1708,1906,1708,1906,applejack
1303841.png,https://derpicdn.net/img/view/2016/11/26/1303841.png,0,0.992355883,0,92,671,800,671,708,applejack
130545.jpg,https://derpicdn.net/img/view/2012/10/24/130545.jpg,0,0.978895247,36,14,272,250,236,236,applejack
1307116.png,https://derpicdn.net/img/view/2016/11/30/1307116.png,0,0.976037979,0,964,10339,12137,10339,11173,applejack
1322434.png,https://derpicdn.net/img/view/2016/12/21/1322434.png,0,0.96608305,1764,0,5335,3527,3571,3527,applejack
1330563.png,https://derpicdn.net/img/view/2017/1/2/1330563.png,0,0.997270763,180,74,376,270,196,196,applejack
1347123.png,https://derpicdn.net/img/view/2017/1/24/1347123.png,0,0.979845524,40,69,420,411,380,342,applejack
1353856.png,https://derpicdn.net/img/view/2017/2/3/1353856.png,0,0.998822987,400,110,802,512,402,402,applejack
1357160.png,https://derpicdn.net/img/view/2017/2/7/1357160.png,0,0.991426408,82,152,636,706,554,554,applejack
1366777.png,https://derpicdn.net/img/view/2017/2/18/1366777.png,0,0.932146192,417,159,931,673,514,514,applejack
1384256.png,https://derpicdn.net/img/view/2017/3/11/1384256.png,0,0.998335361,482,110,858,486,376,376,applejack
1390620.png,https://derpicdn.net/img/view/2017/3/18/1390620.png,0,0.953092396,402,0,836,432,434,432,applejack
1401789.png,https://derpicdn.net/img/view/2017/4/2/1401789.png,0,0.973730505,214,187,718,691,504,504,applejack
1409802.png,https://derpicdn.net/img/view/2017/4/12/1409802.png,0,0.949925125,287,0,911,581,624,581,applejack
1414517.png,https://derpicdn.net/img/view/2017/4/17/1414517.png,0,0.939571381,466,1350,1638,2522,1172,1172,applejack
1420949.png,https://derpicdn.net/img/view/2017/4/24/1420949.png,0,0.999361932,359,6,597,244,238,238,applejack
1422349.png,https://derpicdn.net/img/view/2017/4/26/1422349.png,0,0.910276771,302,41,900,675,598,634,applejack
1430242.png,https://derpicdn.net/img/view/2017/5/6/1430242.png,0,0.913622618,2913,701,6001,3897,3088,3196,applejack
1432221.png,https://derpicdn.net/img/view/2017/5/9/1432221.png,0,0.968967378,288,157,680,549,392,392,applejack
1432253.png,https://derpicdn.net/img/view/2017/5/9/1432253.png,0,0.985783994,0,111,875,987,875,876,applejack
1435631.png,https://derpicdn.net/img/view/2017/5/13/1435631.png,0,0.960323334,96,0,578,397,482,397,applejack
1443161.png,https://derpicdn.net/img/view/2017/5/22/1443161.png,0,0.998102129,197,96,619,518,422,422,applejack
1451431.png,https://derpicdn.net/img/view/2017/6/1/1451431.png,0,0.964013398,1181,655,1989,1463,808,808,applejack
1451613.png,https://derpicdn.net/img/view/2017/6/1/1451613.png,0,0.91549927,116,13,612,509,496,496,applejack
1455038.png,https://derpicdn.net/img/view/2017/6/6/1455038.png,0,0.997273803,1153,39,1799,685,646,646,applejack
1461536.png,https://derpicdn.net/img/view/2017/6/14/1461536.png,0,0.990675449,375,102,768,502,393,400,applejack
1473426.png,https://derpicdn.net/img/view/2017/6/28/1473426.png,0,0.914960206,4852,0,8208,3269,3356,3269,applejack
1475815.png,https://derpicdn.net/img/view/2017/7/1/1475815.png,0,0.995414019,39,14,909,884,870,870,applejack
1475818.png,https://derpicdn.net/img/view/2017/7/1/1475818.png,0,0.999506354,20,0,814,783,794,783,applejack
1477004.png,https://derpicdn.net/img/view/2017/7/2/1477004.png,0,0.915814936,0,247,2266,2605,2266,2358,applejack
1485352.png,https://derpicdn.net/img/view/2017/7/13/1485352.png,0,0.956260681,505,1543,7000,8744,6495,7201,applejack
1486825.png,https://derpicdn.net/img/view/2017/7/15/1486825.png,0,0.935939491,0,54,670,860,670,806,applejack
1492118.png,https://derpicdn.net/img/view/2017/7/22/1492118.png,0,0.999786317,190,17,880,707,690,690,applejack
1500143.png,https://derpicdn.net/img/view/2017/8/1/1500143.png,0,0.968635857,0,0,4713,5195,4713,5195,applejack
1504906.png,https://derpicdn.net/img/view/2017/8/7/1504906.png,0,0.923236907,8,0,960,890,952,890,applejack
151725.jpg,https://derpicdn.net/img/view/2012/11/14/151725.jpg,0,0.990604639,76,0,832,674,756,674,applejack
1519726.png,https://derpicdn.net/img/view/2017/8/26/1519726.png,0,0.965985477,0,0,828,827,828,827,applejack
1520694.png,https://derpicdn.net/img/view/2017/8/27/1520694.png,0,0.992626727,295,165,853,723,558,558,applejack
1522996.png,https://derpicdn.net/img/view/2017/8/29/1522996.png,0,0.956223845,186,50,550,414,364,364,applejack
1530040.png,https://derpicdn.net/img/view/2017/9/7/1530040.png,0,0.938918769,288,20,662,422,374,402,applejack
1535893.png,https://derpicdn.net/img/view/2017/9/15/1535893.png,0,0.991687298,0,0,3007,3134,3007,3134,applejack
153815.jpg,https://derpicdn.net/img/view/2012/11/16/153815.jpg,0,0.984936774,231,0,543,298,312,298,applejack
1558276.png,https://derpicdn.net/img/view/2017/10/11/1558276.png,0,0.97853446,8,0,412,387,404,387,applejack
1565151.png,https://derpicdn.net/img/view/2017/10/19/1565151.png,0,0.998355865,1296,0,2778,1283,1482,1283,applejack
156572.png,https://derpicdn.net/img/view/2012/11/18/156572.png,0,0.950447381,389,52,1721,1384,1332,1332,applejack
1592635.png,https://derpicdn.net/img/view/2017/11/23/1592635.png,0,0.983090281,154,150,1790,1786,1636,1636,applejack
1597430.png,https://derpicdn.net/img/view/2017/11/30/1597430.png,0,0.994065106,110,0,668,530,558,530,applejack
1602257.png,https://derpicdn.net/img/view/2017/12/7/1602257.png,0,0.909289777,252,0,794,457,542,457,applejack
1602342.png,https://derpicdn.net/img/view/2017/12/7/1602342.png,0,0.972665489,91,126,771,806,680,680,applejack
1620234.png,https://derpicdn.net/img/view/2017/12/31/1620234.png,1,0.932913601,0,1922,736,2686,736,764,applejack
1625434.png,https://derpicdn.net/img/view/2018/1/6/1625434.png,0,0.98773104,198,0,762,553,564,553,applejack
1633640.png,https://derpicdn.net/img/view/2018/1/16/1633640.png,0,0.999129176,37,0,357,317,320,317,applejack
1639136.png,https://derpicdn.net/img/view/2018/1/23/1639136.png,0,0.921482563,484,0,2274,1586,1790,1586,applejack
16444.png,https://derpicdn.net/img/view/2012/6/23/16444.png,1,0.931703866,566,21,980,435,414,414,applejack
1649285.png,https://derpicdn.net/img/view/2018/2/5/1649285.png,0,0.943085313,435,0,855,374,420,374,applejack
1649714.png,https://derpicdn.net/img/view/2018/2/6/1649714.png,0,0.989121616,35,85,651,670,616,585,applejack
1649714.png,https://derpicdn.net/img/view/2018/2/6/1649714.png,1,0.910066843,144,0,670,537,526,537,applejack
1655306.png,https://derpicdn.net/img/view/2018/2/13/1655306.png,0,0.994667768,174,0,576,396,402,396,applejack
1663121.png,https://derpicdn.net/img/view/2018/2/22/1663121.png,0,0.992794693,0,44,1737,1812,1737,1768,applejack
1665582.png,https://derpicdn.net/img/view/2018/2/25/1665582.png,0,0.988895774,97,0,479,368,382,368,applejack
1673967.png,https://derpicdn.net/img/view/2018/3/7/1673967.png,0,0.977740645,391,0,1000,577,609,577,applejack
1674440.png,https://derpicdn.net/img/view/2018/3/8/1674440.png,0,0.983595908,1143,62,1847,766,704,704,applejack
1685265.png,https://derpicdn.net/img/view/2018/3/19/1685265.png,0,0.922811747,164,0,860,664,696,664,applejack
1688157.png,https://derpicdn.net/img/view/2018/3/23/1688157.png,0,0.972524464,143,110,453,420,310,310,applejack
1697708.png,https://derpicdn.net/img/view/2018/4/3/1697708.png,0,0.99055326,10,1,456,447,446,446,applejack
1699874.png,https://derpicdn.net/img/view/2018/4/5/1699874.png,0,0.975399673,101,543,525,967,424,424,applejack
1706679.png,https://derpicdn.net/img/view/2018/4/13/1706679.png,0,0.998922527,78,285,616,823,538,538,applejack
1707091.png,https://derpicdn.net/img/view/2018/4/14/1707091.png,0,0.99860388,568,62,1302,796,734,734,applejack
1709241.png,https://derpicdn.net/img/view/2018/4/16/1709241.png,0,0.985728323,25,19,1415,1300,1390,1281,applejack
1716432.png,https://derpicdn.net/img/view/2018/4/24/1716432.png,0,0.999145031,171,47,1217,1093,1046,1046,applejack
1719966.png,https://derpicdn.net/img/view/2018/4/29/1719966.png,0,0.942421675,172,0,668,494,496,494,applejack
1721345.png,https://derpicdn.net/img/view/2018/5/1/1721345.png,0,0.944645345,0,423,3233,3705,3233,3282,applejack
1729488.png,https://derpicdn.net/img/view/2018/5/10/1729488.png,0,0.988357306,117,125,441,449,324,324,applejack
1732383.png,https://derpicdn.net/img/view/2018/5/14/1732383.png,0,0.954688728,0,27,250,347,250,320,applejack
1734425.png,https://derpicdn.net/img/view/2018/5/16/1734425.png,0,0.984313011,64,26,1080,1042,1016,1016,applejack
1737286.png,https://derpicdn.net/img/view/2018/5/20/1737286.png,0,0.958941817,13,45,941,973,928,928,applejack
173871.jpg,https://derpicdn.net/img/view/2012/12/6/173871.jpg,0,0.985758185,0,0,681,646,681,646,applejack
1747930.png,https://derpicdn.net/img/view/2018/6/2/1747930.png,0,0.984749615,139,0,913,762,774,762,applejack
1748134.png,https://derpicdn.net/img/view/2018/6/2/1748134.png,0,0.92714256,664,23,1216,575,552,552,applejack
1753243.png,https://derpicdn.net/img/view/2018/6/9/1753243.png,0,0.976566911,50,0,300,237,250,237,applejack
1765436.png,https://derpicdn.net/img/view/2018/6/25/1765436.png,0,0.998443961,828,423,1408,1003,580,580,applejack
17670.png,https://derpicdn.net/img/view/2012/6/23/17670.png,0,0.972545326,399,105,773,479,374,374,applejack
1773710.png,https://derpicdn.net/img/view/2018/7/5/1773710.png,0,0.976054311,35,154,1705,1800,1670,1646,applejack
1776602.png,https://derpicdn.net/img/view/2018/7/9/1776602.png,0,0.993527353,715,105,1891,1281,1176,1176,applejack
1785387.png,https://derpicdn.net/img/view/2018/7/20/1785387.png,0,0.990695238,0,58,712,792,712,734,applejack
1787567.png,https://derpicdn.net/img/view/2018/7/23/1787567.png,0,0.983757913,241,0,905,620,664,620,applejack
1788236.png,https://derpicdn.net/img/view/2018/7/24/1788236.png,0,0.998784721,186,22,728,564,542,542,applejack
1788753.png,https://derpicdn.net/img/view/2018/7/24/1788753.png,0,0.99017936,143,352,641,850,498,498,applejack
1794541.png,https://derpicdn.net/img/view/2018/7/31/1794541.png,0,0.997273922,22,0,554,499,532,499,applejack
1795411.png,https://derpicdn.net/img/view/2018/8/1/1795411.png,0,0.989184618,0,0,559,596,559,596,applejack
1800108.png,https://derpicdn.net/img/view/2018/8/6/1800108.png,0,0.938530803,273,96,733,556,460,460,applejack
1800875.png,https://derpicdn.net/img/view/2018/8/7/1800875.png,0,0.981948495,368,0,1630,1226,1262,1226,applejack
1803084.png,https://derpicdn.net/img/view/2018/8/10/1803084.png,0,0.953240871,305,50,819,564,514,514,applejack
1805405.png,https://derpicdn.net/img/view/2018/8/13/1805405.png,0,0.956657112,87,30,1315,1258,1228,1228,applejack
1817643.png,https://derpicdn.net/img/view/2018/8/27/1817643.png,0,0.982637584,130,0,972,819,842,819,applejack
18240.png,https://derpicdn.net/img/view/2012/6/24/18240.png,0,0.997310638,390,19,718,347,328,328,applejack
1824392.png,https://derpicdn.net/img/view/2018/9/4/1824392.png,0,0.975148201,982,147,1600,765,618,618,applejack
1834889.png,https://derpicdn.net/img/view/2018/9/17/1834889.png,0,0.980970204,149,0,1331,750,1182,750,applejack
1836092.png,https://derpicdn.net/img/view/2018/9/19/1836092.png,0,0.994609058,126,43,594,511,468,468,applejack
1853694.png,https://derpicdn.net/img/view/2018/10/11/1853694.png,0,0.938038707,233,34,839,640,606,606,applejack
1858194.png,https://derpicdn.net/img/view/2018/10/16/1858194.png,0,0.934206247,434,26,780,372,346,346,applejack
1859887.png,https://derpicdn.net/img/view/2018/10/18/1859887.png,1,0.978123128,764,163,1140,539,376,376,applejack
1864045.png,https://derpicdn.net/img/view/2018/10/23/1864045.png,0,0.98559767,65,184,709,828,644,644,applejack
1864832.png,https://derpicdn.net/img/view/2018/10/24/1864832.png,0,0.997193396,319,0,869,471,550,471,applejack
1864904.png,https://derpicdn.net/img/view/2018/10/24/1864904.png,0,0.98104161,1457,346,2231,1120,774,774,applejack
1869159.png,https://derpicdn.net/img/view/2018/10/29/1869159.png,0,0.975640714,205,394,423,612,218,218,applejack
1872981.png,https://derpicdn.net/img/view/2018/11/2/1872981.png,0,0.924668014,28,0,478,443,450,443,applejack
1877068.png,https://derpicdn.net/img/view/2018/11/7/1877068.png,0,0.9856776,1146,0,2050,821,904,821,applejack
1878565.png,https://derpicdn.net/img/view/2018/11/9/1878565.png,0,0.934700787,0,0,1156,1197,1156,1197,applejack
1879987.png,https://derpicdn.net/img/view/2018/11/11/1879987.png,0,0.974991322,0,29,880,909,880,880,applejack
1880015.png,https://derpicdn.net/img/view/2018/11/11/1880015.png,0,0.996878743,307,121,689,503,382,382,applejack
1896762.png,https://derpicdn.net/img/view/2018/12/3/1896762.png,0,0.994723678,307,0,895,582,588,582,applejack
1900107.png,https://derpicdn.net/img/view/2018/12/6/1900107.png,0,0.906805754,82,15,824,771,742,756,applejack
1900108.png,https://derpicdn.net/img/view/2018/12/6/1900108.png,0,0.959409237,178,0,898,723,720,723,applejack
1908663.png,https://derpicdn.net/img/view/2018/12/15/1908663.png,0,0.998461068,23,21,279,277,256,256,applejack
1916573.png,https://derpicdn.net/img/view/2018/12/23/1916573.png,0,0.952597558,371,95,899,623,528,528,applejack
1921902.png,https://derpicdn.net/img/view/2018/12/30/1921902.png,0,0.977409363,180,0,830,578,650,578,applejack
1928495.png,https://derpicdn.net/img/view/2019/1/6/1928495.png,0,0.960162759,172,0,816,626,644,626,applejack
1929399.png,https://derpicdn.net/img/view/2019/1/7/1929399.png,0,0.99190563,157,42,889,774,732,732,applejack
1936858.png,https://derpicdn.net/img/view/2019/1/16/1936858.png,0,0.96937412,1773,701,2347,1275,574,574,applejack
1942765.png,https://derpicdn.net/img/view/2019/1/23/1942765.png,0,0.99789834,41,1,463,423,422,422,applejack
1942903.png,https://derpicdn.net/img/view/2019/1/24/1942903.png,0,0.951161921,971,394,1831,1254,860,860,applejack
1944428.png,https://derpicdn.net/img/view/2019/1/25/1944428.png,0,0.995718956,139,27,889,777,750,750,applejack
1948707.png,https://derpicdn.net/img/view/2019/1/30/1948707.png,0,0.974761605,290,101,736,547,446,446,applejack
1949946.png,https://derpicdn.net/img/view/2019/2/1/1949946.png,0,0.950395405,373,24,931,582,558,558,applejack
1951505.png,https://derpicdn.net/img/view/2019/2/2/1951505.png,0,0.999079823,1629,265,2811,1447,1182,1182,applejack
1955832.png,https://derpicdn.net/img/view/2019/2/7/1955832.png,0,0.94896853,785,420,1085,720,300,300,applejack
1957893.png,https://derpicdn.net/img/view/2019/2/9/1957893.png,0,0.961351991,384,0,1594,1176,1210,1176,applejack
1958520.png,https://derpicdn.net/img/view/2019/2/10/1958520.png,0,0.958711267,292,78,991,850,699,772,applejack
1961369.png,https://derpicdn.net/img/view/2019/2/14/1961369.png,0,0.995407283,399,144,1217,962,818,818,applejack
1961683.png,https://derpicdn.net/img/view/2019/2/14/1961683.png,0,0.981719315,107,887,3483,4263,3376,3376,applejack
1963095.png,https://derpicdn.net/img/view/2019/2/15/1963095.png,0,0.981067836,387,0,1279,776,892,776,applejack
1966767.png,https://derpicdn.net/img/view/2019/2/20/1966767.png,0,0.990393519,159,0,900,728,741,728,applejack
1971315.png,https://derpicdn.net/img/view/2019/2/25/1971315.png,0,0.997423351,1563,13,3177,1663,1614,1650,applejack
1980902.png,https://derpicdn.net/img/view/2019/3/9/1980902.png,0,0.993034422,64,0,350,254,286,254,applejack
1989257.png,https://derpicdn.net/img/view/2019/3/18/1989257.png,0,0.966142595,35,0,779,742,744,742,applejack
1989258.png,https://derpicdn.net/img/view/2019/3/18/1989258.png,0,0.985200822,14,0,762,747,748,747,applejack
1989336.png,https://derpicdn.net/img/view/2019/3/18/1989336.png,0,0.982634246,4,84,856,940,852,856,applejack
1995169.png,https://derpicdn.net/img/view/2019/3/26/1995169.png,0,0.929275692,704,49,1552,897,848,848,applejack
1996332.png,https://derpicdn.net/img/view/2019/3/27/1996332.png,0,0.978450119,254,0,4184,3786,3930,3786,applejack
2000824.png,https://derpicdn.net/img/view/2019/4/2/2000824.png,0,0.926366389,12,0,366,338,354,338,applejack
2002275.png,https://derpicdn.net/img/view/2019/4/3/2002275.png,0,0.983113468,0,0,371,402,371,402,applejack
2006099.png,https://derpicdn.net/img/view/2019/4/8/2006099.png,0,0.959281325,0,9,331,361,331,352,applejack
2008628.png,https://derpicdn.net/img/view/2019/4/11/2008628.png,0,0.994699538,0,0,277,278,277,278,applejack
2009074.png,https://derpicdn.net/img/view/2019/4/11/2009074.png,0,0.979502738,539,0,1695,1005,1156,1005,applejack
2009700.png,https://derpicdn.net/img/view/2019/4/12/2009700.png,0,0.938662231,28,267,938,1091,910,824,applejack
201298.png,https://derpicdn.net/img/view/2013/1/3/201298.png,0,0.996793926,616,0,1280,619,664,619,applejack
2017756.png,https://derpicdn.net/img/view/2019/4/20/2017756.png,0,0.92193383,0,159,538,720,538,561,applejack
2019329.png,https://derpicdn.net/img/view/2019/4/21/2019329.png,0,0.986525893,84,235,1572,1723,1488,1488,applejack
2021058.png,https://derpicdn.net/img/view/2019/4/23/2021058.png,0,0.940417707,130,0,578,485,448,485,applejack
2024432.png,https://derpicdn.net/img/view/2019/4/27/2024432.png,0,0.937512517,287,48,905,666,618,618,applejack
2027223.png,https://derpicdn.net/img/view/2019/4/30/2027223.png,0,0.926524818,223,0,1063,775,840,775,applejack
2030143.png,https://derpicdn.net/img/view/2019/5/3/2030143.png,0,0.993758738,223,45,653,475,430,430,applejack
2031874.png,https://derpicdn.net/img/view/2019/5/5/2031874.png,0,0.980314016,322,0,896,499,574,499,applejack
2034480.png,https://derpicdn.net/img/view/2019/5/9/2034480.png,0,0.99499464,393,0,843,444,450,444,applejack
2045937.png,https://derpicdn.net/img/view/2019/5/22/2045937.png,0,0.901087403,0,0,670,665,670,665,applejack
2047503.png,https://derpicdn.net/img/view/2019/5/24/2047503.png,0,0.95030582,0,7,505,605,505,598,applejack
2047503.png,https://derpicdn.net/img/view/2019/5/24/2047503.png,1,0.900551975,62,0,550,576,488,576,applejack
20529.png,https://derpicdn.net/img/view/2012/6/25/20529.png,0,0.902963519,641,186,1803,1348,1162,1162,applejack
2055255.png,https://derpicdn.net/img/view/2019/6/1/2055255.png,0,0.95735991,446,122,804,480,358,358,applejack
2055932.png,https://derpicdn.net/img/view/2019/6/2/2055932.png,0,0.967535615,271,37,767,533,496,496,applejack
206051.png,https://derpicdn.net/img/view/2013/1/8/206051.png,0,0.97690773,709,73,1437,899,728,826,applejack
206051.png,https://derpicdn.net/img/view/2013/1/8/206051.png,1,0.965770125,194,24,972,802,778,778,applejack
2060889.png,https://derpicdn.net/img/view/2019/6/8/2060889.png,0,0.942001641,0,29,1085,1147,1085,1118,applejack
2061784.png,https://derpicdn.net/img/view/2019/6/9/2061784.png,0,0.901215315,265,5,2773,2513,2508,2508,applejack
2074819.png,https://derpicdn.net/img/view/2019/6/25/2074819.png,0,0.983613193,0,220,2039,2318,2039,2098,applejack
2076203.png,https://derpicdn.net/img/view/2019/6/27/2076203.png,0,0.940196931,431,214,773,556,342,342,applejack
2077648.png,https://derpicdn.net/img/view/2019/6/28/2077648.png,0,0.984719157,375,0,2448,2197,2073,2197,applejack
2080149.png,https://derpicdn.net/img/view/2019/7/1/2080149.png,0,0.982047439,27,18,1280,1290,1253,1272,applejack
2082.png,https://derpicdn.net/img/view/2012/1/24/2082.png,0,0.914726257,314,0,1430,905,1116,905,applejack
2083859.png,https://derpicdn.net/img/view/2019/7/5/2083859.png,0,0.92633462,85,0,727,628,642,628,applejack
2086425.png,https://derpicdn.net/img/view/2019/7/8/2086425.png,0,0.967840195,104,52,591,584,487,532,applejack
2099663.png,https://derpicdn.net/img/view/2019/7/23/2099663.png,0,0.990840256,125,0,331,197,206,197,applejack
2104381.png,https://derpicdn.net/img/view/2019/7/29/2104381.png,0,0.98838681,61,0,2319,2236,2258,2236,applejack
21109.png,https://derpicdn.net/img/view/2012/6/26/21109.png,0,0.904726148,113,0,813,667,700,667,applejack
2111129.png,https://derpicdn.net/img/view/2019/8/7/2111129.png,0,0.983204424,1937,1345,3555,2963,1618,1618,applejack
2115344.png,https://derpicdn.net/img/view/2019/8/11/2115344.png,0,0.960224986,485,64,1044,660,559,596,applejack
2115346.png,https://derpicdn.net/img/view/2019/8/11/2115346.png,0,0.996167362,117,54,535,472,418,418,applejack
2121527.png,https://derpicdn.net/img/view/2019/8/18/2121527.png,0,0.957985699,17,93,744,881,727,788,applejack
2122742.png,https://derpicdn.net/img/view/2019/8/20/2122742.png,0,0.993419945,1398,0,2491,1023,1093,1023,applejack
2134111.png,https://derpicdn.net/img/view/2019/9/2/2134111.png,1,0.983669102,4858,1319,8122,4583,3264,3264,applejack
2151495.png,https://derpicdn.net/img/view/2019/9/23/2151495.png,0,0.950940371,720,54,1394,728,674,674,applejack
2153795.png,https://derpicdn.net/img/view/2019/9/26/2153795.png,0,0.996698618,6,0,336,325,330,325,applejack
2158335.png,https://derpicdn.net/img/view/2019/10/2/2158335.png,0,0.993322134,2399,2543,4021,4165,1622,1622,applejack
2174777.png,https://derpicdn.net/img/view/2019/10/20/2174777.png,0,0.986768067,0,191,1004,1435,1004,1244,applejack
2175367.png,https://derpicdn.net/img/view/2019/10/21/2175367.png,0,0.98877722,293,0,1037,722,744,722,applejack
2181615.png,https://derpicdn.net/img/view/2019/10/29/2181615.png,0,0.910963356,658,141,950,433,292,292,applejack
2182912.png,https://derpicdn.net/img/view/2019/10/30/2182912.png,0,0.932271957,119,0,482,343,363,343,applejack
2189005.png,https://derpicdn.net/img/view/2019/11/6/2189005.png,0,0.969534039,252,0,1236,852,984,852,applejack
2191646.png,https://derpicdn.net/img/view/2019/11/9/2191646.png,0,0.966838598,0,0,597,603,597,603,applejack
2194959.png,https://derpicdn.net/img/view/2019/11/13/2194959.png,0,0.999597609,786,395,1426,1035,640,640,applejack
2198077.png,https://derpicdn.net/img/view/2019/11/17/2198077.png,0,0.999773562,158,0,1204,1008,1046,1008,applejack
2226539.png,https://derpicdn.net/img/view/2019/12/21/2226539.png,0,0.991346419,459,5,1461,1007,1002,1002,applejack
2232500.png,https://derpicdn.net/img/view/2019/12/28/2232500.png,0,0.997022986,1104,194,1734,824,630,630,applejack
2239226.png,https://derpicdn.net/img/view/2020/1/5/2239226.png,0,0.991230726,92,0,1024,1069,932,1069,applejack
2241485.jpg,https://derpicdn.net/img/view/2020/1/7/2241485.jpg,0,0.970112801,208,0,1030,785,822,785,applejack
2241971.jpg,https://derpicdn.net/img/view/2020/1/8/2241971.jpg,0,0.939012825,686,682,1332,1328,646,646,applejack
2248837.png,https://derpicdn.net/img/view/2020/1/16/2248837.png,0,0.993156791,0,6,1096,1120,1096,1114,applejack
2249560.png,https://derpicdn.net/img/view/2020/1/17/2249560.png,0,0.984273851,0,0,2712,3131,2712,3131,applejack
2252346.png,https://derpicdn.net/img/view/2020/1/20/2252346.png,0,0.990547836,177,0,1240,1071,1063,1071,applejack
2252554.png,https://derpicdn.net/img/view/2020/1/20/2252554.png,0,0.99475795,773,203,1387,817,614,614,applejack
2254782.jpg,https://derpicdn.net/img/view/2020/1/23/2254782.jpg,0,0.975157797,228,0,1110,830,882,830,applejack
2255822.jpg,https://derpicdn.net/img/view/2020/1/24/2255822.jpg,0,0.930829227,257,0,1024,640,767,640,applejack
2262167.png,https://derpicdn.net/img/view/2020/1/31/2262167.png,0,0.981283545,0,0,691,897,691,897,applejack
2269146.jpg,https://derpicdn.net/img/view/2020/2/9/2269146.jpg,0,0.980616391,122,31,646,555,524,524,applejack
2269322.png,https://derpicdn.net/img/view/2020/2/9/2269322.png,0,0.929217279,252,136,674,558,422,422,applejack
2269552.png,https://derpicdn.net/img/view/2020/2/9/2269552.png,0,0.98121655,154,177,562,585,408,408,applejack
2275174.png,https://derpicdn.net/img/view/2020/2/15/2275174.png,0,0.996625721,318,0,1008,683,690,683,applejack
2280068.png,https://derpicdn.net/img/view/2020/2/21/2280068.png,0,0.994526744,1633,341,1971,679,338,338,applejack
2293484.png,https://derpicdn.net/img/view/2020/3/9/2293484.png,0,0.986512482,0,4,583,678,583,674,applejack
2304531.png,https://derpicdn.net/img/view/2020/3/23/2304531.png,0,0.904468596,23,0,515,475,492,475,applejack
2305059.jpg,https://derpicdn.net/img/view/2020/3/24/2305059.jpg,0,0.995441377,555,1,1014,477,459,476,applejack
2315002.png,https://derpicdn.net/img/view/2020/4/5/2315002.png,0,0.947926998,0,63,2180,2329,2180,2266,applejack
2323246.png,https://derpicdn.net/img/view/2020/4/15/2323246.png,0,0.922032654,249,21,1011,807,762,786,applejack
2326770.png,https://derpicdn.net/img/view/2020/4/20/2326770.png,0,0.971750498,100,25,480,405,380,380,applejack
2327367.png,https://derpicdn.net/img/view/2020/4/20/2327367.png,0,0.936987221,1470,41,2939,1515,1469,1474,applejack
2327824.png,https://derpicdn.net/img/view/2020/4/21/2327824.png,0,0.977477968,46,135,958,1047,912,912,applejack
2334229.png,https://derpicdn.net/img/view/2020/4/28/2334229.png,0,0.972169936,36,52,658,674,622,622,applejack
2338494.png,https://derpicdn.net/img/view/2020/5/3/2338494.png,0,0.965761721,504,419,1506,1421,1002,1002,applejack
2338598.png,https://derpicdn.net/img/view/2020/5/3/2338598.png,0,0.99988842,973,1429,1427,1883,454,454,applejack
2340708.png,https://derpicdn.net/img/view/2020/5/6/2340708.png,0,0.905572593,261,0,1291,1004,1030,1004,applejack
235021.png,https://derpicdn.net/img/view/2013/2/6/235021.png,0,0.924865365,1157,93,1459,395,302,302,applejack
2351036.jpg,https://derpicdn.net/img/view/2020/5/17/2351036.jpg,0,0.998885989,389,710,659,980,270,270,applejack
235194.png,https://derpicdn.net/img/view/2013/2/6/235194.png,0,0.987563789,51,52,447,448,396,396,applejack
244580.png,https://derpicdn.net/img/view/2013/2/15/244580.png,0,0.991876185,198,9,700,599,502,590,applejack
260384.png,https://derpicdn.net/img/view/2013/3/2/260384.png,0,0.925162494,677,402,1319,1044,642,642,applejack
267047.png,https://derpicdn.net/img/view/2013/3/10/267047.png,0,0.983447671,39,1,419,381,380,380,applejack
270467.png,https://derpicdn.net/img/view/2013/3/14/270467.png,0,0.997456491,0,0,466,497,466,497,applejack
277211.png,https://derpicdn.net/img/view/2013/3/23/277211.png,0,0.995235503,333,0,781,418,448,418,applejack
298246.png,https://derpicdn.net/img/view/2013/4/14/298246.png,0,0.97653532,84,0,652,497,568,497,applejack
308433.png,https://derpicdn.net/img/view/2013/4/26/308433.png,0,0.985157788,22,36,1136,1150,1114,1114,applejack
322842.jpg,https://derpicdn.net/img/view/2013/5/12/322842.jpg,0,0.911973178,212,4,496,288,284,284,applejack
329255.jpg,https://derpicdn.net/img/view/2013/5/20/329255.jpg,0,0.999356389,201,16,505,320,304,304,applejack
338718.png,https://derpicdn.net/img/view/2013/6/1/338718.png,0,0.993129909,50,47,478,475,428,428,applejack
357589.png,https://derpicdn.net/img/view/2013/6/26/357589.png,0,0.93909663,291,0,547,220,256,220,applejack
357811.jpg,https://derpicdn.net/img/view/2013/6/26/357811.jpg,0,0.999202788,213,17,539,343,326,326,applejack
372767.png,https://derpicdn.net/img/view/2013/7/13/372767.png,0,0.994459093,317,0,735,391,418,391,applejack
374246.png,https://derpicdn.net/img/view/2013/7/14/374246.png,0,0.978110611,0,0,306,304,306,304,applejack
399477.png,https://derpicdn.net/img/view/2013/8/13/399477.png,0,0.974684596,74,0,786,648,712,648,applejack
409038.png,https://derpicdn.net/img/view/2013/8/24/409038.png,0,0.994944811,88,0,440,321,352,321,applejack
41758.png,https://derpicdn.net/img/view/2012/7/12/41758.png,0,0.999042928,379,0,745,359,366,359,applejack
418356.png,https://derpicdn.net/img/view/2013/9/3/418356.png,0,0.99927479,122,0,466,336,344,336,applejack
42206.png,https://derpicdn.net/img/view/2012/7/13/42206.png,0,0.960751355,54,0,250,211,196,211,applejack
424887.png,https://derpicdn.net/img/view/2013/9/11/424887.png,0,0.959858418,273,0,943,571,670,571,applejack
439476.jpg,https://derpicdn.net/img/view/2013/10/1/439476.jpg,0,0.966750383,221,1,521,301,300,300,applejack
49002.jpg,https://derpicdn.net/img/view/2012/7/19/49002.jpg,0,0.999217689,132,7,434,309,302,302,applejack
492481.jpg,https://derpicdn.net/img/view/2013/12/7/492481.jpg,0,0.978684127,481,31,901,451,420,420,applejack
503295.png,https://derpicdn.net/img/view/2013/12/21/503295.png,0,0.906459391,87,0,291,198,204,198,applejack
525081.png,https://derpicdn.net/img/view/2014/1/15/525081.png,0,0.9031443,166,22,3000,3292,2834,3270,applejack
536559.png,https://derpicdn.net/img/view/2014/1/28/536559.png,0,0.973847628,192,0,1026,809,834,809,applejack
541368.png,https://derpicdn.net/img/view/2014/2/2/541368.png,0,0.990662992,19,247,371,599,352,352,applejack
545754.png,https://derpicdn.net/img/view/2014/2/7/545754.png,0,0.926549613,28,0,424,334,396,334,applejack
55815.jpg,https://derpicdn.net/img/view/2012/7/25/55815.jpg,0,0.939392984,75,0,625,547,550,547,applejack
567135.png,https://derpicdn.net/img/view/2014/3/5/567135.png,3,0.988918006,164,481,434,751,270,270,applejack
578661.png,https://derpicdn.net/img/view/2014/3/18/578661.png,0,0.987761617,384,1,658,275,274,274,applejack
580298.png,https://derpicdn.net/img/view/2014/3/20/580298.png,0,0.981666446,126,69,490,433,364,364,applejack
584769.jpg,https://derpicdn.net/img/view/2014/3/25/584769.jpg,0,0.983958304,15,2,635,718,620,716,applejack
587799.png,https://derpicdn.net/img/view/2014/3/29/587799.png,0,0.955224752,118,0,826,565,708,565,applejack
596877.png,https://derpicdn.net/img/view/2014/4/10/596877.png,0,0.998515666,416,165,1616,1365,1200,1200,applejack
613013.png,https://derpicdn.net/img/view/2014/4/29/613013.png,0,0.961029112,0,0,674,650,674,650,applejack
61548.png,https://derpicdn.net/img/view/2012/7/30/61548.png,0,0.991368055,383,399,719,735,336,336,applejack
671286.png,https://derpicdn.net/img/view/2014/7/9/671286.png,0,0.996785879,344,6,624,286,280,280,applejack
674060.png,https://derpicdn.net/img/view/2014/7/13/674060.png,0,0.998856127,510,474,1442,1406,932,932,applejack
675969.png,https://derpicdn.net/img/view/2014/7/16/675969.png,0,0.990098119,0,0,496,537,496,537,applejack
675970.png,https://derpicdn.net/img/view/2014/7/16/675970.png,0,0.968548119,154,0,628,444,474,444,applejack
677711.png,https://derpicdn.net/img/view/2014/7/18/677711.png,0,0.983930826,37,16,209,188,172,172,applejack
678438.png,https://derpicdn.net/img/view/2014/7/19/678438.png,0,0.99546361,206,5,522,321,316,316,applejack
68888.jpg,https://derpicdn.net/img/view/2012/8/7/68888.jpg,0,0.915080249,245,96,577,428,332,332,applejack
714198.png,https://derpicdn.net/img/view/2014/9/3/714198.png,0,0.981095135,162,15,620,473,458,458,applejack
739072.png,https://derpicdn.net/img/view/2014/10/9/739072.png,0,0.998467028,600,51,1336,787,736,736,applejack
742143.png,https://derpicdn.net/img/view/2014/10/13/742143.png,0,0.964054704,170,0,934,670,764,670,applejack
763197.png,https://derpicdn.net/img/view/2014/11/12/763197.png,1,0.990804493,0,243,242,497,242,254,applejack
763197.png,https://derpicdn.net/img/view/2014/11/12/763197.png,2,0.92996347,249,0,453,193,204,193,applejack
763759.png,https://derpicdn.net/img/view/2014/11/13/763759.png,0,0.968307853,280,0,740,429,460,429,applejack
766351.png,https://derpicdn.net/img/view/2014/11/17/766351.png,0,0.997044146,331,0,1295,938,964,938,applejack
773184.png,https://derpicdn.net/img/view/2014/11/27/773184.png,0,0.913937449,158,1,666,509,508,508,applejack
775075.png,https://derpicdn.net/img/view/2014/11/30/775075.png,0,0.958853841,45,0,481,422,436,422,applejack
784536.jpg,https://derpicdn.net/img/view/2014/12/14/784536.jpg,0,0.984205484,2255,241,3409,1395,1154,1154,applejack
787279.png,https://derpicdn.net/img/view/2014/12/18/787279.png,0,0.95043546,230,252,468,490,238,238,applejack
806038.png,https://derpicdn.net/img/view/2015/1/14/806038.png,0,0.970871866,47,0,345,291,298,291,applejack
806038.png,https://derpicdn.net/img/view/2015/1/14/806038.png,1,0.965141237,509,0,775,264,266,264,applejack
807877.png,https://derpicdn.net/img/view/2015/1/16/807877.png,0,0.974445403,583,44,903,364,320,320,applejack
809499.png,https://derpicdn.net/img/view/2015/1/18/809499.png,0,0.995434582,195,180,581,566,386,386,applejack
810460.png,https://derpicdn.net/img/view/2015/1/20/810460.png,0,0.997447371,258,135,1166,1043,908,908,applejack
823726.png,https://derpicdn.net/img/view/2015/2/7/823726.png,0,0.984003127,46,1,406,361,360,360,applejack
848700.png,https://derpicdn.net/img/view/2015/3/13/848700.png,0,0.991832078,573,0,1767,957,1194,957,applejack
859363.png,https://derpicdn.net/img/view/2015/3/29/859363.png,0,0.997654438,0,0,232,182,232,182,applejack
859363.png,https://derpicdn.net/img/view/2015/3/29/859363.png,1,0.99331975,377,14,507,144,130,130,applejack
861875.png,https://derpicdn.net/img/view/2015/4/1/861875.png,0,0.967043519,1041,0,2497,1435,1456,1435,applejack
864649.png,https://derpicdn.net/img/view/2015/4/4/864649.png,0,0.982519627,304,0,814,478,510,478,applejack
880265.png,https://derpicdn.net/img/view/2015/4/22/880265.png,0,0.980233431,70,0,484,354,414,354,applejack
881647.jpg,https://derpicdn.net/img/view/2015/4/24/881647.jpg,0,0.998875856,102,11,408,317,306,306,applejack
884262.png,https://derpicdn.net/img/view/2015/4/27/884262.png,0,0.998472214,688,403,2012,1727,1324,1324,applejack
88548.png,https://derpicdn.net/img/view/2012/9/2/88548.png,0,0.995049417,779,139,1651,1011,872,872,applejack
8871.png,https://derpicdn.net/img/view/2012/6/19/8871.png,0,0.954896688,205,4,471,270,266,266,applejack
888042.png,https://derpicdn.net/img/view/2015/5/3/888042.png,0,0.986524284,45,0,385,325,340,325,applejack
888529.png,https://derpicdn.net/img/view/2015/5/4/888529.png,0,0.98569262,145,200,533,588,388,388,applejack
897070.png,https://derpicdn.net/img/view/2015/5/16/897070.png,0,0.987539113,1597,1045,2283,1731,686,686,applejack
897957.png,https://derpicdn.net/img/view/2015/5/17/897957.png,0,0.989282846,1172,92,2102,1022,930,930,applejack
902263.png,https://derpicdn.net/img/view/2015/5/23/902263.png,0,0.998795629,60,20,570,530,510,510,applejack
907673.png,https://derpicdn.net/img/view/2015/5/31/907673.png,0,0.981554568,516,20,2266,1770,1750,1750,applejack
91232.png,https://derpicdn.net/img/view/2012/9/6/91232.png,0,0.964745045,180,100,1560,1480,1380,1380,applejack
915620.png,https://derpicdn.net/img/view/2015/6/13/915620.png,0,0.99408114,100,23,572,495,472,472,applejack
930538.png,https://derpicdn.net/img/view/2015/7/5/930538.png,0,0.982784152,25,64,455,494,430,430,applejack
962927.png,https://derpicdn.net/img/view/2015/8/21/962927.png,0,0.984234989,86,0,548,442,462,442,applejack
983946.png,https://derpicdn.net/img/view/2015/9/20/983946.png,0,0.998665631,270,19,692,441,422,422,applejack
992992.png,https://derpicdn.net/img/view/2015/10/2/992992.png,0,0.997762442,124,21,594,491,470,470,applejack
1016441.png,https://derpicdn.net/img/view/2015/11/5/1016441.png,1,0.941272855,457,0,921,389,464,389,applejack
1033565.png,https://derpicdn.net/img/view/2015/11/30/1033565.png,0,0.984748602,680,0,1358,654,678,654,applejack
1041105.png,https://derpicdn.net/img/view/2015/12/10/1041105.png,0,0.993693531,229,42,777,590,548,548,applejack
1056039.png,https://derpicdn.net/img/view/2015/12/30/1056039.png,0,0.989483953,155,24,597,466,442,442,applejack
1061021.png,https://derpicdn.net/img/view/2016/1/6/1061021.png,0,0.983994961,239,0,2386,2387,2147,2387,applejack
1083345.png,https://derpicdn.net/img/view/2016/2/8/1083345.png,0,0.998595655,619,89,1139,609,520,520,applejack
1090501.png,https://derpicdn.net/img/view/2016/2/17/1090501.png,0,0.947117031,333,240,537,444,204,204,applejack
1091390.png,https://derpicdn.net/img/view/2016/2/18/1091390.png,0,0.997049809,33,183,253,403,220,220,applejack
1103282.jpg,https://derpicdn.net/img/view/2016/3/6/1103282.jpg,0,0.998307467,205,0,695,473,490,473,applejack
1103994.png,https://derpicdn.net/img/view/2016/3/7/1103994.png,1,0.985934794,413,606,755,948,342,342,applejack
1104862.jpg,https://derpicdn.net/img/view/2016/3/8/1104862.jpg,0,0.983108282,198,51,668,521,470,470,applejack
1108382.png,https://derpicdn.net/img/view/2016/3/14/1108382.png,0,0.987082601,403,75,1047,719,644,644,applejack
1137736.png,https://derpicdn.net/img/view/2016/4/22/1137736.png,0,0.961868346,181,50,2000,1878,1819,1828,applejack
1140750.png,https://derpicdn.net/img/view/2016/4/27/1140750.png,0,0.992339015,194,4,950,760,756,756,applejack
115382.png,https://derpicdn.net/img/view/2012/10/6/115382.png,0,0.998606861,47,0,979,899,932,899,applejack
1158653.png,https://derpicdn.net/img/view/2016/5/20/1158653.png,0,0.994704783,404,39,770,405,366,366,applejack
1170492.png,https://derpicdn.net/img/view/2016/6/4/1170492.png,0,0.960839391,194,0,732,524,538,524,applejack
1219818.png,https://derpicdn.net/img/view/2016/8/7/1219818.png,0,0.911738276,110,36,392,318,282,282,applejack
1231074.png,https://derpicdn.net/img/view/2016/8/22/1231074.png,0,0.950761914,1802,0,2828,1020,1026,1020,applejack
1238850.png,https://derpicdn.net/img/view/2016/9/1/1238850.png,0,0.939471722,0,13,113,169,113,156,applejack
1240937.png,https://derpicdn.net/img/view/2016/9/3/1240937.png,0,0.999198675,306,83,978,755,672,672,applejack
1243617.png,https://derpicdn.net/img/view/2016/9/7/1243617.png,0,0.974623024,0,702,4051,4832,4051,4130,applejack
1251390.png,https://derpicdn.net/img/view/2016/9/17/1251390.png,1,0.925456524,112,73,515,449,403,376,applejack
1262348.png,https://derpicdn.net/img/view/2016/10/1/1262348.png,0,0.951142132,698,0,2153,1211,1455,1211,applejack
1288129.png,https://derpicdn.net/img/view/2016/11/3/1288129.png,0,0.90813148,502,0,900,351,398,351,applejack
1327665.png,https://derpicdn.net/img/view/2016/12/29/1327665.png,0,0.958622992,0,576,3572,4280,3572,3704,applejack
1327763.png,https://derpicdn.net/img/view/2016/12/29/1327763.png,0,0.997985423,30,85,474,529,444,444,applejack
1327763.png,https://derpicdn.net/img/view/2016/12/29/1327763.png,1,0.995295882,566,128,1066,628,500,500,applejack
1327862.png,https://derpicdn.net/img/view/2016/12/29/1327862.png,0,0.996556759,88,0,1526,1337,1438,1337,applejack
133055.jpg,https://derpicdn.net/img/view/2012/10/26/133055.jpg,0,0.999008894,498,916,856,1274,358,358,applejack
133055.jpg,https://derpicdn.net/img/view/2012/10/26/133055.jpg,2,0.97423321,212,139,638,565,426,426,applejack
1338262.png,https://derpicdn.net/img/view/2017/1/13/1338262.png,0,0.99406898,592,0,2974,1906,2382,1906,applejack
1350134.png,https://derpicdn.net/img/view/2017/1/29/1350134.png,0,0.993185401,260,0,1000,778,740,778,applejack
1354262.png,https://derpicdn.net/img/view/2017/2/3/1354262.png,0,0.977134824,578,22,1074,518,496,496,applejack
1358047.png,https://derpicdn.net/img/view/2017/2/8/1358047.png,0,0.967741668,428,182,3118,2872,2690,2690,applejack
136886.png,https://derpicdn.net/img/view/2012/10/30/136886.png,0,0.911783636,177,0,585,464,408,464,applejack
1384073.png,https://derpicdn.net/img/view/2017/3/11/1384073.png,0,0.993791401,0,0,1002,1001,1002,1001,applejack
1386046.png,https://derpicdn.net/img/view/2017/3/13/1386046.png,0,0.998811781,374,0,1136,730,762,730,applejack
1387643.png,https://derpicdn.net/img/view/2017/3/15/1387643.png,0,0.985840261,66,93,864,891,798,798,applejack
1400456.png,https://derpicdn.net/img/view/2017/3/31/1400456.png,0,0.996679306,144,46,588,490,444,444,applejack
1400753.png,https://derpicdn.net/img/view/2017/3/31/1400753.png,0,0.976701856,19,0,805,804,786,804,applejack
1402201.png,https://derpicdn.net/img/view/2017/4/2/1402201.png,0,0.941991687,73,0,1007,922,934,922,applejack
1409879.png,https://derpicdn.net/img/view/2017/4/12/1409879.png,0,0.908020437,744,29,1827,1123,1083,1094,applejack
1413267.png,https://derpicdn.net/img/view/2017/4/16/1413267.png,0,0.984858513,0,11,809,881,809,870,applejack
1415417.png,https://derpicdn.net/img/view/2017/4/18/1415417.png,0,0.903920889,151,4,575,428,424,424,applejack
1418593.png,https://derpicdn.net/img/view/2017/4/22/1418593.png,0,0.983738184,821,0,1515,676,694,676,applejack
1418708.png,https://derpicdn.net/img/view/2017/4/22/1418708.png,0,0.973456562,108,67,538,497,430,430,applejack
1422233.png,https://derpicdn.net/img/view/2017/4/26/1422233.png,0,0.996736467,1,19,453,471,452,452,applejack
1431902.png,https://derpicdn.net/img/view/2017/5/8/1431902.png,0,0.990000367,61,0,1027,947,966,947,applejack
1439572.png,https://derpicdn.net/img/view/2017/5/18/1439572.png,0,0.992305875,67,0,525,439,458,439,applejack
1445711.png,https://derpicdn.net/img/view/2017/5/25/1445711.png,0,0.974442899,122,203,322,403,200,200,applejack
1454258.png,https://derpicdn.net/img/view/2017/6/5/1454258.png,0,0.968759894,227,0,2169,1729,1942,1729,applejack
1456353.png,https://derpicdn.net/img/view/2017/6/7/1456353.png,0,0.954639554,50,1468,1220,2638,1170,1170,applejack
1475809.png,https://derpicdn.net/img/view/2017/7/1/1475809.png,0,0.99974066,0,0,787,852,787,852,applejack
1490626.png,https://derpicdn.net/img/view/2017/7/20/1490626.png,0,0.998631418,342,0,682,323,340,323,applejack
1490626.png,https://derpicdn.net/img/view/2017/7/20/1490626.png,1,0.966219664,90,88,438,436,348,348,applejack
1503791.png,https://derpicdn.net/img/view/2017/8/6/1503791.png,0,0.979000449,105,0,705,580,600,580,applejack
1509133.png,https://derpicdn.net/img/view/2017/8/12/1509133.png,0,0.99741447,79,478,1371,1770,1292,1292,applejack
1510899.png,https://derpicdn.net/img/view/2017/8/14/1510899.png,0,0.929807663,55,0,1611,1518,1556,1518,applejack
151146.png,https://derpicdn.net/img/view/2012/11/13/151146.png,0,0.995840907,3209,0,6281,3043,3072,3043,applejack
1512912.png,https://derpicdn.net/img/view/2017/8/17/1512912.png,0,0.985610604,245,0,1061,764,816,764,applejack
1519467.png,https://derpicdn.net/img/view/2017/8/25/1519467.png,0,0.974106908,551,17,1683,1149,1132,1132,applejack
15240.png,https://derpicdn.net/img/view/2012/6/22/15240.png,0,0.999044001,539,0,1383,837,844,837,applejack
1526320.png,https://derpicdn.net/img/view/2017/9/2/1526320.png,0,0.998265684,851,0,1935,944,1084,944,applejack
1526608.png,https://derpicdn.net/img/view/2017/9/3/1526608.png,1,0.969123662,403,315,749,661,346,346,applejack
1541348.png,https://derpicdn.net/img/view/2017/9/22/1541348.png,0,0.974741578,21,0,877,818,856,818,applejack
1563126.png,https://derpicdn.net/img/view/2017/10/16/1563126.png,0,0.992457151,964,261,2180,1477,1216,1216,applejack
1565829.png,https://derpicdn.net/img/view/2017/10/20/1565829.png,0,0.993693531,9,58,1279,1328,1270,1270,applejack
1570210.png,https://derpicdn.net/img/view/2017/10/25/1570210.png,0,0.952229083,4,68,518,582,514,514,applejack
158714.png,https://derpicdn.net/img/view/2012/11/21/158714.png,0,0.92680788,10,114,528,632,518,518,applejack
1597446.png,https://derpicdn.net/img/view/2017/11/30/1597446.png,0,0.998966634,488,36,910,458,422,422,applejack
1603253.png,https://derpicdn.net/img/view/2017/12/8/1603253.png,0,0.973455667,83,0,1600,1507,1517,1507,applejack
1608099.png,https://derpicdn.net/img/view/2017/12/15/1608099.png,0,0.978094161,960,0,3690,2607,2730,2607,applejack
1616166.png,https://derpicdn.net/img/view/2017/12/25/1616166.png,0,0.919263959,462,69,1248,855,786,786,applejack
1625976.png,https://derpicdn.net/img/view/2018/1/7/1625976.png,0,0.995963037,120,625,462,967,342,342,applejack
1627103.png,https://derpicdn.net/img/view/2018/1/8/1627103.png,0,0.996705055,441,0,1607,1125,1166,1125,applejack
1629881.png,https://derpicdn.net/img/view/2018/1/11/1629881.png,0,0.961608171,1167,78,1729,640,562,562,applejack
1630127.png,https://derpicdn.net/img/view/2018/1/12/1630127.png,0,0.978418469,190,0,1352,1075,1162,1075,applejack
1638773.png,https://derpicdn.net/img/view/2018/1/23/1638773.png,0,0.994827747,1712,0,4226,2754,2514,2754,applejack
1643887.png,https://derpicdn.net/img/view/2018/1/29/1643887.png,0,0.941432059,759,25,1239,505,480,480,applejack
1645211.png,https://derpicdn.net/img/view/2018/1/31/1645211.png,0,0.938064754,324,77,610,363,286,286,applejack
1647419.png,https://derpicdn.net/img/view/2018/2/3/1647419.png,0,0.997336507,291,53,1063,825,772,772,applejack
1648753.png,https://derpicdn.net/img/view/2018/2/5/1648753.png,0,0.903188646,198,160,518,480,320,320,applejack
1650177.png,https://derpicdn.net/img/view/2018/2/7/1650177.png,0,0.989143789,359,235,989,865,630,630,applejack
1652954.png,https://derpicdn.net/img/view/2018/2/11/1652954.png,0,0.960712969,551,115,859,423,308,308,applejack
1658045.png,https://derpicdn.net/img/view/2018/2/17/1658045.png,0,0.990335763,32,5,500,491,468,486,applejack
1659913.png,https://derpicdn.net/img/view/2018/2/18/1659913.png,0,0.962795496,294,393,462,561,168,168,applejack
1659913.png,https://derpicdn.net/img/view/2018/2/18/1659913.png,1,0.934164524,663,161,945,443,282,282,applejack
1663066.png,https://derpicdn.net/img/view/2018/2/22/1663066.png,0,0.94220525,0,34,501,576,501,542,applejack
1674531.png,https://derpicdn.net/img/view/2018/3/8/1674531.png,0,0.99793452,412,246,592,426,180,180,applejack
1680373.png,https://derpicdn.net/img/view/2018/3/14/1680373.png,0,0.948048055,82,0,2150,1978,2068,1978,applejack
1697472.png,https://derpicdn.net/img/view/2018/4/2/1697472.png,0,0.982875109,841,0,1767,885,926,885,applejack
1699570.png,https://derpicdn.net/img/view/2018/4/5/1699570.png,0,0.992591083,5,23,333,351,328,328,applejack
1705952.png,https://derpicdn.net/img/view/2018/4/12/1705952.png,0,0.91535604,0,38,313,402,313,364,applejack
1706080.png,https://derpicdn.net/img/view/2018/4/12/1706080.png,0,0.996060431,111,0,905,750,794,750,applejack
1706680.png,https://derpicdn.net/img/view/2018/4/13/1706680.png,0,0.934978247,89,0,717,569,628,569,applejack
1707335.png,https://derpicdn.net/img/view/2018/4/14/1707335.png,0,0.992901742,132,23,662,553,530,530,applejack
1711621.png,https://derpicdn.net/img/view/2018/4/19/1711621.png,0,0.995715439,603,0,1155,523,552,523,applejack
1711621.png,https://derpicdn.net/img/view/2018/4/19/1711621.png,1,0.987554908,33,0,535,499,502,499,applejack
1719316.png,https://derpicdn.net/img/view/2018/4/28/1719316.png,0,0.998982012,563,567,949,953,386,386,applejack
1722645.png,https://derpicdn.net/img/view/2018/5/2/1722645.png,0,0.944774926,685,0,1995,1281,1310,1281,applejack
1728944.png,https://derpicdn.net/img/view/2018/5/10/1728944.png,0,0.988129199,5,10,695,700,690,690,applejack
1734427.png,https://derpicdn.net/img/view/2018/5/16/1734427.png,0,0.963051915,787,10,2516,1852,1729,1842,applejack
1751041.png,https://derpicdn.net/img/view/2018/6/6/1751041.png,0,0.978071213,0,0,489,484,489,484,applejack
1761035.png,https://derpicdn.net/img/view/2018/6/19/1761035.png,0,0.995220006,783,667,1217,1101,434,434,applejack
1764887.png,https://derpicdn.net/img/view/2018/6/24/1764887.png,0,0.984771132,186,27,550,391,364,364,applejack
1767593.png,https://derpicdn.net/img/view/2018/6/27/1767593.png,0,0.966834843,551,150,1173,772,622,622,applejack
1783478.png,https://derpicdn.net/img/view/2018/7/17/1783478.png,0,0.971551538,345,1,779,435,434,434,applejack
1790707.png,https://derpicdn.net/img/view/2018/7/27/1790707.png,0,0.998230755,85,0,591,493,506,493,applejack
1793031.png,https://derpicdn.net/img/view/2018/7/29/1793031.png,0,0.998707831,245,0,671,379,426,379,applejack
1795243.png,https://derpicdn.net/img/view/2018/8/1/1795243.png,0,0.944240868,276,345,734,803,458,458,applejack
1795873.png,https://derpicdn.net/img/view/2018/8/2/1795873.png,0,0.964931965,2022,9,4756,2985,2734,2976,applejack
1797447.png,https://derpicdn.net/img/view/2018/8/4/1797447.png,0,0.976442337,193,25,571,403,378,378,applejack
1800666.png,https://derpicdn.net/img/view/2018/8/7/1800666.png,0,0.979831517,518,106,2432,2020,1914,1914,applejack
1800961.png,https://derpicdn.net/img/view/2018/8/7/1800961.png,0,0.970373273,495,0,1198,677,703,677,applejack
1809416.png,https://derpicdn.net/img/view/2018/8/17/1809416.png,0,0.98243773,613,0,2221,1560,1608,1560,applejack
1809430.png,https://derpicdn.net/img/view/2018/8/17/1809430.png,0,0.976449549,92,0,794,619,702,619,applejack
182557.jpg,https://derpicdn.net/img/view/2012/12/14/182557.jpg,0,0.997015655,288,81,792,585,504,504,applejack
1826292.png,https://derpicdn.net/img/view/2018/9/6/1826292.png,0,0.969340563,2162,470,3104,1412,942,942,applejack
1830887.png,https://derpicdn.net/img/view/2018/9/12/1830887.png,0,0.961438596,183,0,767,581,584,581,applejack
1832386.png,https://derpicdn.net/img/view/2018/9/14/1832386.png,0,0.940594792,1412,276,4604,3936,3192,3660,applejack
1837952.png,https://derpicdn.net/img/view/2018/9/21/1837952.png,0,0.904440403,260,0,1968,1647,1708,1647,applejack
1844036.png,https://derpicdn.net/img/view/2018/9/29/1844036.png,0,0.923438311,450,49,1058,657,608,608,applejack
1846451.png,https://derpicdn.net/img/view/2018/10/2/1846451.png,0,0.961177409,8400,1665,11752,5017,3352,3352,applejack
1864097.png,https://derpicdn.net/img/view/2018/10/23/1864097.png,0,0.97307843,7,0,1089,1052,1082,1052,applejack
1869068.png,https://derpicdn.net/img/view/2018/10/29/1869068.png,0,0.99895519,1293,0,4521,3201,3228,3201,applejack
1880431.png,https://derpicdn.net/img/view/2018/11/12/1880431.png,0,0.998454571,431,3,1011,583,580,580,applejack
1890379.png,https://derpicdn.net/img/view/2018/11/25/1890379.png,0,0.904749393,0,0,258,258,258,258,applejack
1891461.png,https://derpicdn.net/img/view/2018/11/26/1891461.png,0,0.977409065,103,82,381,360,278,278,applejack
1895748.png,https://derpicdn.net/img/view/2018/12/1/1895748.png,0,0.993318617,441,221,1199,979,758,758,applejack
190720.png,https://derpicdn.net/img/view/2012/12/22/190720.png,0,0.927751184,126,0,452,287,326,287,applejack
1908321.png,https://derpicdn.net/img/view/2018/12/14/1908321.png,0,0.996902764,248,0,754,495,506,495,applejack
1920031.png,https://derpicdn.net/img/view/2018/12/27/1920031.png,0,0.93740195,51,21,693,663,642,642,applejack
1925132.png,https://derpicdn.net/img/view/2019/1/2/1925132.png,0,0.966924667,0,0,575,538,575,538,applejack
1935895.png,https://derpicdn.net/img/view/2019/1/15/1935895.png,0,0.995317698,31,48,829,846,798,798,applejack
1936856.png,https://derpicdn.net/img/view/2019/1/16/1936856.png,0,0.900969028,141,0,817,657,676,657,applejack
1946685.png,https://derpicdn.net/img/view/2019/1/28/1946685.png,0,0.904731095,139,0,1081,939,942,939,applejack
1952586.png,https://derpicdn.net/img/view/2019/2/3/1952586.png,0,0.992049277,124,0,564,431,440,431,applejack
1952594.png,https://derpicdn.net/img/view/2019/2/3/1952594.png,0,0.988548875,0,0,444,434,444,434,applejack
1953604.png,https://derpicdn.net/img/view/2019/2/4/1953604.png,0,0.998471737,363,72,581,290,218,218,applejack
1953775.png,https://derpicdn.net/img/view/2019/2/5/1953775.png,0,0.968915284,78,4,550,476,472,472,applejack
1956885.png,https://derpicdn.net/img/view/2019/2/8/1956885.png,0,0.911668956,47,6,169,128,122,122,applejack
1958492.png,https://derpicdn.net/img/view/2019/2/10/1958492.png,0,0.949202061,420,347,3180,3107,2760,2760,applejack
1960548.png,https://derpicdn.net/img/view/2019/2/13/1960548.png,0,0.97083354,81,0,1033,927,952,927,applejack
1969029.png,https://derpicdn.net/img/view/2019/2/22/1969029.png,0,0.960511327,338,347,3816,3825,3478,3478,applejack
1969126.png,https://derpicdn.net/img/view/2019/2/22/1969126.png,0,0.943980157,97,0,1131,924,1034,924,applejack
1969255.png,https://derpicdn.net/img/view/2019/2/22/1969255.png,0,0.910354018,0,18,634,740,634,722,applejack
1974562.png,https://derpicdn.net/img/view/2019/3/1/1974562.png,0,0.9850142,902,922,3440,3460,2538,2538,applejack
1975037.png,https://derpicdn.net/img/view/2019/3/2/1975037.png,0,0.996249557,137,36,511,410,374,374,applejack
1982214.png,https://derpicdn.net/img/view/2019/3/10/1982214.png,0,0.924188256,2139,0,6729,3978,4590,3978,applejack
1982477.png,https://derpicdn.net/img/view/2019/3/10/1982477.png,0,0.930641949,1332,0,4846,3501,3514,3501,applejack
1982480.png,https://derpicdn.net/img/view/2019/3/10/1982480.png,0,0.97328341,0,692,3751,4478,3751,3786,applejack
1982481.png,https://derpicdn.net/img/view/2019/3/10/1982481.png,0,0.966669142,2779,664,5708,3750,2929,3086,applejack
1982482.png,https://derpicdn.net/img/view/2019/3/10/1982482.png,0,0.981076181,1556,369,4839,4107,3283,3738,applejack
1989210.png,https://derpicdn.net/img/view/2019/3/18/1989210.png,0,0.989349186,17,19,475,477,458,458,applejack
1995609.png,https://derpicdn.net/img/view/2019/3/26/1995609.png,0,0.99367857,504,372,1722,1590,1218,1218,applejack
2004657.png,https://derpicdn.net/img/view/2019/4/6/2004657.png,0,0.912629008,351,495,1495,1639,1144,1144,applejack
2008108.png,https://derpicdn.net/img/view/2019/4/10/2008108.png,0,0.980695069,1014,546,2682,2214,1668,1668,applejack
2009682.png,https://derpicdn.net/img/view/2019/4/12/2009682.png,0,0.93489641,31,269,937,1091,906,822,applejack
2017683.png,https://derpicdn.net/img/view/2019/4/20/2017683.png,0,0.915869951,480,147,962,629,482,482,applejack
2017683.png,https://derpicdn.net/img/view/2019/4/20/2017683.png,1,0.907153487,982,170,1420,608,438,438,applejack
2020158.png,https://derpicdn.net/img/view/2019/4/22/2020158.png,0,0.998701096,520,0,896,369,376,369,applejack
2020158.png,https://derpicdn.net/img/view/2019/4/22/2020158.png,1,0.997953713,373,486,761,874,388,388,applejack
2020158.png,https://derpicdn.net/img/view/2019/4/22/2020158.png,2,0.981232405,0,617,355,977,355,360,applejack
2020158.png,https://derpicdn.net/img/view/2019/4/22/2020158.png,3,0.953946173,73,65,455,447,382,382,applejack
2023389.png,https://derpicdn.net/img/view/2019/4/26/2023389.png,0,0.984678924,114,0,634,516,520,516,applejack
2034562.png,https://derpicdn.net/img/view/2019/5/9/2034562.png,0,0.998292625,32,13,542,523,510,510,applejack
2040910.png,https://derpicdn.net/img/view/2019/5/16/2040910.png,0,0.912529945,39,582,3227,3770,3188,3188,applejack
2060100.png,https://derpicdn.net/img/view/2019/6/7/2060100.png,0,0.964835584,347,46,859,558,512,512,applejack
2060510.png,https://derpicdn.net/img/view/2019/6/8/2060510.png,0,0.937349558,1405,321,4541,3913,3136,3592,applejack
2060511.png,https://derpicdn.net/img/view/2019/6/8/2060511.png,0,0.967485487,1044,185,5154,4295,4110,4110,applejack
2060594.png,https://derpicdn.net/img/view/2019/6/8/2060594.png,0,0.923738658,0,0,461,470,461,470,applejack
2060865.png,https://derpicdn.net/img/view/2019/6/8/2060865.png,0,0.963320315,0,0,433,476,433,476,applejack
2067962.png,https://derpicdn.net/img/view/2019/6/17/2067962.png,0,0.958818436,0,0,3517,4116,3517,4116,applejack
2074870.png,https://derpicdn.net/img/view/2019/6/25/2074870.png,0,0.907555759,0,0,485,481,485,481,applejack
2075060.png,https://derpicdn.net/img/view/2019/6/25/2075060.png,0,0.994808078,302,250,1112,1060,810,810,applejack
2080795.png,https://derpicdn.net/img/view/2019/7/2/2080795.png,0,0.951134324,0,0,256,258,256,258,applejack
2088188.png,https://derpicdn.net/img/view/2019/7/10/2088188.png,0,0.987742841,0,0,1485,1646,1485,1646,applejack
2090407.png,https://derpicdn.net/img/view/2019/7/13/2090407.png,0,0.975112677,0,0,5525,7197,5525,7197,applejack
20965.png,https://derpicdn.net/img/view/2012/6/25/20965.png,0,0.930187762,82,0,852,717,770,717,applejack
2102463.png,https://derpicdn.net/img/view/2019/7/27/2102463.png,0,0.982398391,75,0,1509,1425,1434,1425,applejack
2112645.png,https://derpicdn.net/img/view/2019/8/8/2112645.png,0,0.977526903,313,0,931,571,618,571,applejack
2113696.png,https://derpicdn.net/img/view/2019/8/10/2113696.png,0,0.99444133,327,15,1637,1325,1310,1310,applejack
2117724.png,https://derpicdn.net/img/view/2019/8/14/2117724.png,0,0.964847028,727,377,1279,933,552,556,applejack
2126715.png,https://derpicdn.net/img/view/2019/8/24/2126715.png,0,0.976708651,0,7,616,661,616,654,applejack
2133740.png,https://derpicdn.net/img/view/2019/9/1/2133740.png,0,0.974522054,0,0,1054,1014,1054,1014,applejack
2138735.png,https://derpicdn.net/img/view/2019/9/7/2138735.png,0,0.972385645,26,226,924,1078,898,852,applejack
2143997.png,https://derpicdn.net/img/view/2019/9/14/2143997.png,0,0.997471094,314,99,1442,1227,1128,1128,applejack
2148924.png,https://derpicdn.net/img/view/2019/9/20/2148924.png,0,0.929945111,144,0,605,500,461,500,applejack
2152038.png,https://derpicdn.net/img/view/2019/9/24/2152038.png,0,0.99743861,305,530,1147,1372,842,842,applejack
2153129.png,https://derpicdn.net/img/view/2019/9/26/2153129.png,0,0.97341609,0,469,4411,4921,4411,4452,applejack
2159405.png,https://derpicdn.net/img/view/2019/10/3/2159405.png,0,0.989540756,336,230,1056,950,720,720,applejack
2167652.png,https://derpicdn.net/img/view/2019/10/13/2167652.png,0,0.995170712,100,43,406,349,306,306,applejack
21695.jpg,https://derpicdn.net/img/view/2012/6/26/21695.jpg,0,0.967168987,29,57,503,531,474,474,applejack
2177885.png,https://derpicdn.net/img/view/2019/10/24/2177885.png,0,0.957183421,0,0,614,757,614,757,applejack
2180271.png,https://derpicdn.net/img/view/2019/10/27/2180271.png,0,0.996091664,657,5,991,339,334,334,applejack
2182212.png,https://derpicdn.net/img/view/2019/10/29/2182212.png,0,0.906543076,492,0,832,330,340,330,applejack
2185142.png,https://derpicdn.net/img/view/2019/11/2/2185142.png,0,0.987967372,165,172,1833,1840,1668,1668,applejack
2198948.png,https://derpicdn.net/img/view/2019/11/17/2198948.png,0,0.998217881,277,25,621,369,344,344,applejack
2198948.png,https://derpicdn.net/img/view/2019/11/17/2198948.png,1,0.91449976,848,28,1188,368,340,340,applejack
2200096.png,https://derpicdn.net/img/view/2019/11/19/2200096.png,0,0.99637717,105,0,523,401,418,401,applejack
2217397.png,https://derpicdn.net/img/view/2019/12/10/2217397.png,0,0.935085773,0,0,460,517,460,517,applejack
2218952.png,https://derpicdn.net/img/view/2019/12/12/2218952.png,0,0.989400625,201,24,635,458,434,434,applejack
2220956.png,https://derpicdn.net/img/view/2019/12/15/2220956.png,0,0.982836068,236,28,738,546,502,518,applejack
22223.png,https://derpicdn.net/img/view/2012/6/26/22223.png,0,0.992305577,141,7,511,377,370,370,applejack
2233511.png,https://derpicdn.net/img/view/2019/12/30/2233511.png,0,0.967159986,343,25,725,407,382,382,applejack
2238827.png,https://derpicdn.net/img/view/2020/1/4/2238827.png,0,0.969109833,36,136,1086,1186,1050,1050,applejack
2243385.png,https://derpicdn.net/img/view/2020/1/10/2243385.png,0,0.993919909,0,0,733,731,733,731,applejack
2246469.png,https://derpicdn.net/img/view/2020/1/13/2246469.png,0,0.988295317,561,89,833,361,272,272,applejack
224663.png,https://derpicdn.net/img/view/2013/1/26/224663.png,0,0.96060735,876,241,1636,1001,760,760,applejack
224966.jpg,https://derpicdn.net/img/view/2013/1/27/224966.jpg,0,0.999025583,54,0,418,326,364,326,applejack
2251438.jpg,https://derpicdn.net/img/view/2020/1/19/2251438.jpg,0,0.996824443,74,233,530,689,456,456,applejack
2255654.jpg,https://derpicdn.net/img/view/2020/1/24/2255654.jpg,0,0.957451701,562,611,878,927,316,316,applejack
2259731.png,https://derpicdn.net/img/view/2020/1/28/2259731.png,0,0.968417346,0,0,906,915,906,915,applejack
2259732.png,https://derpicdn.net/img/view/2020/1/28/2259732.png,0,0.980883121,0,86,751,872,751,786,applejack
2260280.jpg,https://derpicdn.net/img/view/2020/1/29/2260280.jpg,0,0.995586514,245,230,483,468,238,238,applejack
2263068.png,https://derpicdn.net/img/view/2020/2/1/2263068.png,0,0.9826594,214,65,4000,4031,3786,3966,applejack
2265227.png,https://derpicdn.net/img/view/2020/2/4/2265227.png,0,0.981054187,0,0,953,909,953,909,applejack
2271076.png,https://derpicdn.net/img/view/2020/2/11/2271076.png,0,0.903829396,59,5,725,749,666,744,applejack
2271080.png,https://derpicdn.net/img/view/2020/2/11/2271080.png,0,0.984191537,149,0,751,571,602,571,applejack
2273628.jpg,https://derpicdn.net/img/view/2020/2/14/2273628.jpg,0,0.939347863,626,985,1960,2319,1334,1334,applejack
227561.png,https://derpicdn.net/img/view/2013/1/29/227561.png,0,0.992161572,190,0,1118,829,928,829,applejack
2279288.jpg,https://derpicdn.net/img/view/2020/2/20/2279288.jpg,0,0.988614798,36,47,638,649,602,602,applejack
2279407.png,https://derpicdn.net/img/view/2020/2/20/2279407.png,0,0.97755146,105,31,855,781,750,750,applejack
2281701.png,https://derpicdn.net/img/view/2020/2/23/2281701.png,0,0.94798708,64,29,684,649,620,620,applejack
2282986.png,https://derpicdn.net/img/view/2020/2/24/2282986.png,0,0.986281633,191,0,1907,1662,1716,1662,applejack
2287032.png,https://derpicdn.net/img/view/2020/3/1/2287032.png,0,0.938177824,33,190,637,794,604,604,applejack
2288630.png,https://derpicdn.net/img/view/2020/3/3/2288630.png,0,0.956345022,0,53,997,1097,997,1044,applejack
2292171.png,https://derpicdn.net/img/view/2020/3/7/2292171.png,0,0.989625633,0,0,1352,1278,1352,1278,applejack
2293266.png,https://derpicdn.net/img/view/2020/3/9/2293266.png,0,0.940060079,99,158,887,937,788,779,applejack
2293266.png,https://derpicdn.net/img/view/2020/3/9/2293266.png,1,0.911557972,0,0,721,720,721,720,applejack
2293742.jpg,https://derpicdn.net/img/view/2020/3/9/2293742.jpg,0,0.990546227,830,1883,1692,2745,862,862,applejack
2303561.png,https://derpicdn.net/img/view/2020/3/22/2303561.png,0,0.977521956,489,0,657,166,168,166,applejack
2303561.png,https://derpicdn.net/img/view/2020/3/22/2303561.png,1,0.971713543,154,0,382,197,228,197,applejack
2308620.png,https://derpicdn.net/img/view/2020/3/29/2308620.png,0,0.963493884,133,94,887,848,754,754,applejack
2314057.png,https://derpicdn.net/img/view/2020/4/4/2314057.png,0,0.999477148,383,0,995,586,612,586,applejack
2318904.png,https://derpicdn.net/img/view/2020/4/10/2318904.png,0,0.914322793,170,81,1262,1173,1092,1092,applejack
2323247.png,https://derpicdn.net/img/view/2020/4/15/2323247.png,0,0.953304172,333,29,1121,855,788,826,applejack
2342289.jpg,https://derpicdn.net/img/view/2020/5/7/2342289.jpg,0,0.96339947,0,1111,1845,3027,1845,1916,applejack
2343166.jpg,https://derpicdn.net/img/view/2020/5/8/2343166.jpg,0,0.980649352,16,0,634,572,618,572,applejack
2347649.png,https://derpicdn.net/img/view/2020/5/13/2347649.png,0,0.998251915,149,0,617,449,468,449,applejack
2353511.png,https://derpicdn.net/img/view/2020/5/20/2353511.png,0,0.989978015,351,175,1611,1435,1260,1260,applejack
2355752.png,https://derpicdn.net/img/view/2020/5/23/2355752.png,0,0.990928352,407,69,871,533,464,464,applejack
246541.png,https://derpicdn.net/img/view/2013/2/17/246541.png,0,0.993916571,0,117,744,993,744,876,applejack
25082.png,https://derpicdn.net/img/view/2012/6/29/25082.png,0,0.984876573,92,79,668,655,576,576,applejack
26472.jpg,https://derpicdn.net/img/view/2012/6/30/26472.jpg,0,0.988271236,157,21,479,343,322,322,applejack
2697.png,https://derpicdn.net/img/view/2012/1/29/2697.png,0,0.997792065,98,0,630,510,532,510,applejack
286472.jpg,https://derpicdn.net/img/view/2013/4/2/286472.jpg,0,0.986125052,0,0,408,370,408,370,applejack
323936.png,https://derpicdn.net/img/view/2013/5/13/323936.png,0,0.997804403,1538,148,2544,1154,1006,1006,applejack
328205.png,https://derpicdn.net/img/view/2013/5/18/328205.png,0,0.971684098,62,0,500,397,438,397,applejack
348271.png,https://derpicdn.net/img/view/2013/6/14/348271.png,0,0.999213636,343,33,779,469,436,436,applejack
350993.jpg,https://derpicdn.net/img/view/2013/6/17/350993.jpg,0,0.986388683,854,11,1136,293,282,282,applejack
350993.jpg,https://derpicdn.net/img/view/2013/6/17/350993.jpg,1,0.957547545,115,16,393,294,278,278,applejack
3708.jpg,https://derpicdn.net/img/view/2012/3/5/3708.jpg,0,0.987643242,0,0,1162,1173,1162,1173,applejack
465148.png,https://derpicdn.net/img/view/2013/11/5/465148.png,0,0.930256784,112,24,560,472,448,448,applejack
47318.png,https://derpicdn.net/img/view/2012/7/17/47318.png,0,0.922456384,24,0,288,246,264,246,applejack
480183.jpg,https://derpicdn.net/img/view/2013/11/24/480183.jpg,0,0.998187304,379,19,1057,697,678,678,applejack
499166.png,https://derpicdn.net/img/view/2013/12/17/499166.png,0,0.955281615,119,0,873,710,754,710,applejack
504776.png,https://derpicdn.net/img/view/2013/12/23/504776.png,0,0.996546149,201,23,569,391,368,368,applejack
516938.png,https://derpicdn.net/img/view/2014/1/6/516938.png,0,0.941333294,48,51,276,279,228,228,applejack
521661.png,https://derpicdn.net/img/view/2014/1/11/521661.png,0,0.992088616,120,41,408,329,288,288,applejack
534118.png,https://derpicdn.net/img/view/2014/1/25/534118.png,0,0.978168786,242,508,818,1084,576,576,applejack
536125.png,https://derpicdn.net/img/view/2014/1/27/536125.png,0,0.949097335,98,6,537,446,439,440,applejack
539205.png,https://derpicdn.net/img/view/2014/1/31/539205.png,0,0.951734662,0,0,356,295,356,295,applejack
549474.png,https://derpicdn.net/img/view/2014/2/11/549474.png,0,0.976883948,48,0,412,314,364,314,applejack
563844.jpg,https://derpicdn.net/img/view/2014/3/1/563844.jpg,0,0.998349071,171,21,443,293,272,272,applejack
566683.png,https://derpicdn.net/img/view/2014/3/4/566683.png,0,0.901391923,46,32,868,854,822,822,applejack
600422.png,https://derpicdn.net/img/view/2014/4/14/600422.png,0,0.98059237,77,0,561,475,484,475,applejack
602344.png,https://derpicdn.net/img/view/2014/4/17/602344.png,0,0.945915282,0,0,738,691,738,691,applejack
607846.jpg,https://derpicdn.net/img/view/2014/4/23/607846.jpg,0,0.997755885,737,83,1695,1041,958,958,applejack
610245.png,https://derpicdn.net/img/view/2014/4/26/610245.png,0,0.993214309,137,23,391,277,254,254,applejack
65211.png,https://derpicdn.net/img/view/2012/8/2/65211.png,0,0.907931864,0,20,474,558,474,538,applejack
664015.png,https://derpicdn.net/img/view/2014/6/29/664015.png,0,0.949269891,690,189,1366,865,676,676,applejack
667416.png,https://derpicdn.net/img/view/2014/7/4/667416.png,0,0.993326902,582,235,1470,1123,888,888,applejack
668668.png,https://derpicdn.net/img/view/2014/7/6/668668.png,0,0.971132159,4,0,370,362,366,362,applejack
679854.png,https://derpicdn.net/img/view/2014/7/21/679854.png,0,0.995403886,633,14,1315,696,682,682,applejack
682447.png,https://derpicdn.net/img/view/2014/7/24/682447.png,0,0.969081342,4,0,500,324,496,324,applejack
688676.png,https://derpicdn.net/img/view/2014/8/1/688676.png,0,0.984240592,402,232,1300,1152,898,920,applejack
719839.png,https://derpicdn.net/img/view/2014/9/11/719839.png,0,0.930343151,61,83,736,736,675,653,applejack
739144.jpg,https://derpicdn.net/img/view/2014/10/9/739144.jpg,0,0.984355748,0,79,548,681,548,602,applejack
755817.png,https://derpicdn.net/img/view/2014/11/2/755817.png,0,0.920317411,709,0,2541,1770,1832,1770,applejack
766324.png,https://derpicdn.net/img/view/2014/11/17/766324.png,0,0.996687353,269,56,651,438,382,382,applejack
770274.png,https://derpicdn.net/img/view/2014/11/23/770274.png,0,0.997832119,308,0,914,566,606,566,applejack
770414.png,https://derpicdn.net/img/view/2014/11/23/770414.png,0,0.990620494,110,37,436,363,326,326,applejack
84577.png,https://derpicdn.net/img/view/2012/8/28/84577.png,0,0.9871068,131,0,1669,1523,1538,1523,applejack
84691.jpg,https://derpicdn.net/img/view/2012/8/28/84691.jpg,0,0.998975337,533,112,909,488,376,376,applejack
850545.jpg,https://derpicdn.net/img/view/2015/3/16/850545.jpg,0,0.971970856,122,0,1856,1433,1734,1433,applejack
852845.png,https://derpicdn.net/img/view/2015/3/19/852845.png,0,0.99058795,83,0,1709,1504,1626,1504,applejack
878417.png,https://derpicdn.net/img/view/2015/4/20/878417.png,0,0.934644699,152,827,4400,5200,4248,4373,applejack
885396.png,https://derpicdn.net/img/view/2015/4/29/885396.png,0,0.985837102,126,0,790,600,664,600,applejack
943840.png,https://derpicdn.net/img/view/2015/7/25/943840.png,0,0.995337069,262,126,740,604,478,478,applejack
950446.png,https://derpicdn.net/img/view/2015/8/4/950446.png,0,0.99021858,149,0,651,480,502,480,applejack
960.jpg,https://derpicdn.net/img/view/2012/1/20/960.jpg,0,0.931288123,458,114,674,330,216,216,applejack
963539.png,https://derpicdn.net/img/view/2015/8/22/963539.png,0,0.942948163,1168,651,1770,1253,602,602,applejack
973400.png,https://derpicdn.net/img/view/2015/9/5/973400.png,0,0.997802377,696,0,1414,584,718,584,applejack
976105.png,https://derpicdn.net/img/view/2015/9/9/976105.png,0,0.951597452,203,0,917,704,714,704,applejack
1000103.jpeg,https://derpicdn.net/img/view/2015/10/11/1000103.jpeg,0,0.999489903,299,149,647,497,348,348,applejack
1005600.jpeg,https://derpicdn.net/img/view/2015/10/19/1005600.jpeg,0,0.994232655,638,138,2660,2160,2022,2022,applejack
1006804.jpeg,https://derpicdn.net/img/view/2015/10/21/1006804.jpeg,0,0.973742306,114,0,1000,926,886,926,applejack
1009689.jpeg,https://derpicdn.net/img/view/2015/10/25/1009689.jpeg,0,0.900056422,222,0,762,451,540,451,applejack
1011011.jpeg,https://derpicdn.net/img/view/2015/10/28/1011011.jpeg,0,0.97592485,1137,26,2411,1300,1274,1274,applejack
1011104.jpeg,https://derpicdn.net/img/view/2015/10/28/1011104.jpeg,0,0.994559288,63,0,607,490,544,490,applejack
1015289.jpeg,https://derpicdn.net/img/view/2015/11/3/1015289.jpeg,0,0.995516539,204,10,380,186,176,176,applejack
1017315.jpeg,https://derpicdn.net/img/view/2015/11/6/1017315.jpeg,0,0.994588971,702,0,1032,283,330,283,applejack
1021404.jpeg,https://derpicdn.net/img/view/2015/11/12/1021404.jpeg,0,0.999056518,516,0,1114,579,598,579,applejack
1023889.jpeg,https://derpicdn.net/img/view/2015/11/16/1023889.jpeg,0,0.980980277,988,0,1280,275,292,275,applejack
1023889.jpeg,https://derpicdn.net/img/view/2015/11/16/1023889.jpeg,1,0.968461871,689,0,955,240,266,240,applejack
1023889.jpeg,https://derpicdn.net/img/view/2015/11/16/1023889.jpeg,2,0.953815758,987,539,1259,811,272,272,applejack
1023889.jpeg,https://derpicdn.net/img/view/2015/11/16/1023889.jpeg,3,0.933642507,346,0,612,252,266,252,applejack
1025229.jpeg,https://derpicdn.net/img/view/2015/11/18/1025229.jpeg,0,0.998408914,102,21,500,419,398,398,applejack
1043344.jpeg,https://derpicdn.net/img/view/2015/12/13/1043344.jpeg,0,0.916447043,322,16,786,480,464,464,applejack
1046984.jpeg,https://derpicdn.net/img/view/2015/12/18/1046984.jpeg,0,0.948300183,739,12,1797,1070,1058,1058,applejack
1047177.jpeg,https://derpicdn.net/img/view/2015/12/18/1047177.jpeg,0,0.976260781,200,3,494,297,294,294,applejack
1049789.jpeg,https://derpicdn.net/img/view/2015/12/21/1049789.jpeg,0,0.999192834,1141,223,3007,2089,1866,1866,applejack
1051666.jpeg,https://derpicdn.net/img/view/2015/12/24/1051666.jpeg,0,0.995129585,553,0,907,328,354,328,applejack
1074859.jpeg,https://derpicdn.net/img/view/2016/1/27/1074859.jpeg,0,0.994217694,746,11,1690,955,944,944,applejack
1074995.jpeg,https://derpicdn.net/img/view/2016/1/27/1074995.jpeg,0,0.993464291,201,111,691,601,490,490,applejack
1082714.jpeg,https://derpicdn.net/img/view/2016/2/7/1082714.jpeg,0,0.972937286,898,445,1818,1365,920,920,applejack
1094451.jpeg,https://derpicdn.net/img/view/2016/2/22/1094451.jpeg,0,0.993020654,359,0,1469,1063,1110,1063,applejack
1098916.jpeg,https://derpicdn.net/img/view/2016/2/28/1098916.jpeg,0,0.904300153,304,532,674,902,370,370,applejack
1112050.jpeg,https://derpicdn.net/img/view/2016/3/19/1112050.jpeg,0,0.978981078,31,0,293,251,262,251,applejack
1113181.jpeg,https://derpicdn.net/img/view/2016/3/20/1113181.jpeg,0,0.965255737,0,208,2618,3068,2618,2860,applejack
1119062.jpeg,https://derpicdn.net/img/view/2016/3/28/1119062.jpeg,0,0.933272779,627,18,1025,416,398,398,applejack
1127004.jpeg,https://derpicdn.net/img/view/2016/4/7/1127004.jpeg,0,0.988283336,259,18,499,258,240,240,applejack
1140126.jpeg,https://derpicdn.net/img/view/2016/4/26/1140126.jpeg,0,0.982088208,364,122,932,690,568,568,applejack
1144706.jpeg,https://derpicdn.net/img/view/2016/5/2/1144706.jpeg,0,0.999243796,877,0,1631,747,754,747,applejack
1155221.jpeg,https://derpicdn.net/img/view/2016/5/16/1155221.jpeg,0,0.984384477,0,0,2300,2343,2300,2343,applejack
1158440.jpeg,https://derpicdn.net/img/view/2016/5/20/1158440.jpeg,0,0.994139254,1008,0,1600,573,592,573,applejack
1158440.jpeg,https://derpicdn.net/img/view/2016/5/20/1158440.jpeg,1,0.97212857,562,496,822,756,260,260,applejack
1174338.jpeg,https://derpicdn.net/img/view/2016/6/9/1174338.jpeg,0,0.91239816,405,0,935,487,530,487,applejack
1184650.jpeg,https://derpicdn.net/img/view/2016/6/22/1184650.jpeg,0,0.997350514,65,1000,377,1312,312,312,applejack
1184883.jpeg,https://derpicdn.net/img/view/2016/6/23/1184883.jpeg,0,0.992087543,214,286,506,578,292,292,applejack
1187314.jpeg,https://derpicdn.net/img/view/2016/6/26/1187314.jpeg,0,0.996733904,91,0,975,837,884,837,applejack
1188283.jpeg,https://derpicdn.net/img/view/2016/6/27/1188283.jpeg,0,0.971786201,467,8,969,510,502,502,applejack
1188714.jpeg,https://derpicdn.net/img/view/2016/6/28/1188714.jpeg,0,0.955919445,445,0,1171,710,726,710,applejack
1192519.jpeg,https://derpicdn.net/img/view/2016/7/3/1192519.jpeg,0,0.969879866,0,510,577,1106,577,596,applejack
1197763.jpeg,https://derpicdn.net/img/view/2016/7/10/1197763.jpeg,0,0.994278193,346,247,728,629,382,382,applejack
1203249.jpeg,https://derpicdn.net/img/view/2016/7/17/1203249.jpeg,0,0.934800088,306,0,1634,1311,1328,1311,applejack
1204988.jpeg,https://derpicdn.net/img/view/2016/7/20/1204988.jpeg,0,0.933226347,490,608,948,1066,458,458,applejack
1204988.jpeg,https://derpicdn.net/img/view/2016/7/20/1204988.jpeg,1,0.928706229,90,469,660,1039,570,570,applejack
1210868.jpeg,https://derpicdn.net/img/view/2016/7/28/1210868.jpeg,0,0.969213903,466,50,1282,866,816,816,applejack
1213693.jpeg,https://derpicdn.net/img/view/2016/7/31/1213693.jpeg,0,0.956413507,0,18,346,490,346,472,applejack
1216012.jpeg,https://derpicdn.net/img/view/2016/8/3/1216012.jpeg,0,0.981069505,76,1,452,377,376,376,applejack
1233866.jpeg,https://derpicdn.net/img/view/2016/8/26/1233866.jpeg,0,0.991071045,213,11,721,519,508,508,applejack
1234711.jpeg,https://derpicdn.net/img/view/2016/8/27/1234711.jpeg,0,0.997955203,2274,45,3594,1365,1320,1320,applejack
1238106.jpeg,https://derpicdn.net/img/view/2016/8/31/1238106.jpeg,0,0.96149826,32,0,1550,1080,1518,1080,applejack
1241455.jpeg,https://derpicdn.net/img/view/2016/9/4/1241455.jpeg,0,0.988866806,214,16,562,364,348,348,applejack
1242220.jpeg,https://derpicdn.net/img/view/2016/9/5/1242220.jpeg,0,0.989857137,195,9,553,367,358,358,applejack
1254372.jpeg,https://derpicdn.net/img/view/2016/9/20/1254372.jpeg,0,0.988737702,31,7,549,525,518,518,applejack
1258259.jpeg,https://derpicdn.net/img/view/2016/9/25/1258259.jpeg,0,0.919778883,369,0,1179,776,810,776,applejack
1262022.jpeg,https://derpicdn.net/img/view/2016/10/1/1262022.jpeg,0,0.983650684,106,0,436,313,330,313,applejack
1262412.jpeg,https://derpicdn.net/img/view/2016/10/1/1262412.jpeg,0,0.99327147,175,0,1051,860,876,860,applejack
1268015.jpeg,https://derpicdn.net/img/view/2016/10/8/1268015.jpeg,0,0.987133086,16,0,876,824,860,824,applejack
1268125.jpeg,https://derpicdn.net/img/view/2016/10/8/1268125.jpeg,0,0.958752036,7,0,577,555,570,555,applejack
1268698.jpeg,https://derpicdn.net/img/view/2016/10/9/1268698.jpeg,0,0.983355463,323,171,1689,1537,1366,1366,applejack
1268737.jpeg,https://derpicdn.net/img/view/2016/10/9/1268737.jpeg,0,0.988135934,146,0,1262,713,1116,713,applejack
1286959.jpeg,https://derpicdn.net/img/view/2016/11/2/1286959.jpeg,0,0.923287451,110,53,998,941,888,888,applejack
1289109.jpeg,https://derpicdn.net/img/view/2016/11/5/1289109.jpeg,0,0.971247256,224,9,452,237,228,228,applejack
1290362.jpeg,https://derpicdn.net/img/view/2016/11/7/1290362.jpeg,0,0.999135137,49,0,605,546,556,546,applejack
1292683.jpeg,https://derpicdn.net/img/view/2016/11/10/1292683.jpeg,0,0.991321325,167,58,2137,2028,1970,1970,applejack
1295468.jpeg,https://derpicdn.net/img/view/2016/11/14/1295468.jpeg,0,0.993312895,1410,399,1846,835,436,436,applejack
1300553.jpeg,https://derpicdn.net/img/view/2016/11/21/1300553.jpeg,0,0.99136728,0,0,429,404,429,404,applejack
1304720.jpeg,https://derpicdn.net/img/view/2016/11/27/1304720.jpeg,0,0.996964335,240,0,750,503,510,503,applejack
1306473.jpeg,https://derpicdn.net/img/view/2016/11/30/1306473.jpeg,0,0.997737348,485,17,945,477,460,460,applejack
1311044.jpeg,https://derpicdn.net/img/view/2016/12/6/1311044.jpeg,0,0.901388347,479,618,1575,1714,1096,1096,applejack
1312671.jpeg,https://derpicdn.net/img/view/2016/12/8/1312671.jpeg,0,0.99796772,356,0,966,607,610,607,applejack
1313238.jpeg,https://derpicdn.net/img/view/2016/12/9/1313238.jpeg,0,0.989026904,87,6,487,406,400,400,applejack
1331456.jpeg,https://derpicdn.net/img/view/2017/1/3/1331456.jpeg,0,0.994409084,440,25,790,375,350,350,applejack
1331852.jpeg,https://derpicdn.net/img/view/2017/1/4/1331852.jpeg,0,0.999344468,632,0,1790,1098,1158,1098,applejack
1340128.jpeg,https://derpicdn.net/img/view/2017/1/15/1340128.jpeg,0,0.997683644,2642,0,3640,962,998,962,applejack
1356398.jpeg,https://derpicdn.net/img/view/2017/2/6/1356398.jpeg,0,0.981139064,0,0,1395,1405,1395,1405,applejack
1359037.jpeg,https://derpicdn.net/img/view/2017/2/9/1359037.jpeg,0,0.982417285,291,0,1000,665,709,665,applejack
1359506.jpeg,https://derpicdn.net/img/view/2017/2/10/1359506.jpeg,0,0.998010933,368,0,1362,944,994,944,applejack
1370604.jpeg,https://derpicdn.net/img/view/2017/2/23/1370604.jpeg,0,0.985514522,494,0,1016,499,522,499,applejack
1380908.jpeg,https://derpicdn.net/img/view/2017/3/6/1380908.jpeg,0,0.961301029,0,0,591,618,591,618,applejack
1382756.jpeg,https://derpicdn.net/img/view/2017/3/9/1382756.jpeg,0,0.967495024,28,0,238,200,210,200,applejack
1396390.jpeg,https://derpicdn.net/img/view/2017/3/25/1396390.jpeg,0,0.993425488,474,0,1364,701,890,701,applejack
1406163.jpeg,https://derpicdn.net/img/view/2017/4/7/1406163.jpeg,0,0.994902074,460,1,800,341,340,340,applejack
1406587.jpeg,https://derpicdn.net/img/view/2017/4/8/1406587.jpeg,0,0.936339021,5464,1199,6700,2435,1236,1236,applejack
1407497.jpeg,https://derpicdn.net/img/view/2017/4/9/1407497.jpeg,0,0.971000075,481,0,1041,471,560,471,applejack
1411522.jpeg,https://derpicdn.net/img/view/2017/4/14/1411522.jpeg,0,0.996257067,276,0,680,401,404,401,applejack
1417938.jpeg,https://derpicdn.net/img/view/2017/4/22/1417938.jpeg,0,0.955516875,73,0,1241,1131,1168,1131,applejack
1422906.jpeg,https://derpicdn.net/img/view/2017/4/27/1422906.jpeg,0,0.956542671,114,0,658,541,544,541,applejack
1423370.jpeg,https://derpicdn.net/img/view/2017/4/28/1423370.jpeg,0,0.970121205,0,0,827,792,827,792,applejack
1424178.jpeg,https://derpicdn.net/img/view/2017/4/29/1424178.jpeg,0,0.997927308,275,332,557,614,282,282,applejack
1424499.jpeg,https://derpicdn.net/img/view/2017/4/29/1424499.jpeg,0,0.977068901,167,0,901,671,734,671,applejack
1427189.jpeg,https://derpicdn.net/img/view/2017/5/2/1427189.jpeg,0,0.944025099,2154,398,2918,1162,764,764,applejack
1427469.jpeg,https://derpicdn.net/img/view/2017/5/3/1427469.jpeg,0,0.927082241,0,0,856,837,856,837,applejack
1431275.jpeg,https://derpicdn.net/img/view/2017/5/7/1431275.jpeg,0,0.943367243,20,0,368,332,348,332,applejack
1433774.jpeg,https://derpicdn.net/img/view/2017/5/11/1433774.jpeg,0,0.984843731,26,14,1130,1118,1104,1104,applejack
1434309.jpeg,https://derpicdn.net/img/view/2017/5/11/1434309.jpeg,0,0.998862624,168,21,524,377,356,356,applejack
1435071.jpeg,https://derpicdn.net/img/view/2017/5/13/1435071.jpeg,0,0.97108078,320,35,664,379,344,344,applejack
1436953.jpeg,https://derpicdn.net/img/view/2017/5/15/1436953.jpeg,0,0.988144577,192,15,372,195,180,180,applejack
1440429.jpeg,https://derpicdn.net/img/view/2017/5/19/1440429.jpeg,0,0.993179977,93,0,2579,2415,2486,2415,applejack
1440519.jpeg,https://derpicdn.net/img/view/2017/5/19/1440519.jpeg,0,0.976298094,160,0,640,450,480,450,applejack
1443261.jpeg,https://derpicdn.net/img/view/2017/5/22/1443261.jpeg,0,0.99396044,192,55,854,717,662,662,applejack
1444479.jpeg,https://derpicdn.net/img/view/2017/5/24/1444479.jpeg,0,0.979885817,0,42,1317,1388,1317,1346,applejack
1454251.jpeg,https://derpicdn.net/img/view/2017/6/5/1454251.jpeg,0,0.9853369,205,0,509,300,304,300,applejack
1454380.jpeg,https://derpicdn.net/img/view/2017/6/5/1454380.jpeg,0,0.962890029,1930,0,3074,1105,1144,1105,applejack
1457659.jpeg,https://derpicdn.net/img/view/2017/6/9/1457659.jpeg,1,0.947585225,551,1574,1491,2514,940,940,applejack
1471048.jpeg,https://derpicdn.net/img/view/2017/6/25/1471048.jpeg,0,0.990138352,339,38,985,684,646,646,applejack
1471048.jpeg,https://derpicdn.net/img/view/2017/6/25/1471048.jpeg,1,0.973442256,0,518,513,1060,513,542,applejack
1472046.jpeg,https://derpicdn.net/img/view/2017/6/26/1472046.jpeg,1,0.947979629,0,0,328,267,328,267,applejack
1478212.jpeg,https://derpicdn.net/img/view/2017/7/4/1478212.jpeg,0,0.983863592,435,0,839,393,404,393,applejack
1482633.jpeg,https://derpicdn.net/img/view/2017/7/10/1482633.jpeg,0,0.9942379,413,98,719,404,306,306,applejack
1485353.jpeg,https://derpicdn.net/img/view/2017/7/13/1485353.jpeg,0,0.995585322,71,0,567,485,496,485,applejack
1485633.jpeg,https://derpicdn.net/img/view/2017/7/13/1485633.jpeg,0,0.935325086,413,0,1599,900,1186,900,applejack
1489259.jpeg,https://derpicdn.net/img/view/2017/7/18/1489259.jpeg,0,0.99463743,1000,0,1690,654,690,654,applejack
1489259.jpeg,https://derpicdn.net/img/view/2017/7/18/1489259.jpeg,1,0.991537213,328,0,1086,711,758,711,applejack
1489648.jpeg,https://derpicdn.net/img/view/2017/7/19/1489648.jpeg,0,0.995005131,694,282,1164,752,470,470,applejack
1495346.jpeg,https://derpicdn.net/img/view/2017/7/26/1495346.jpeg,0,0.947366893,0,2,800,1146,800,1144,applejack
1497762.jpeg,https://derpicdn.net/img/view/2017/7/29/1497762.jpeg,0,0.966829658,14,0,422,395,408,395,applejack
1507990.jpeg,https://derpicdn.net/img/view/2017/8/11/1507990.jpeg,0,0.996083021,63,0,833,719,770,719,applejack
1508117.jpeg,https://derpicdn.net/img/view/2017/8/11/1508117.jpeg,0,0.929951847,79,38,1817,1776,1738,1738,applejack
1516276.jpeg,https://derpicdn.net/img/view/2017/8/21/1516276.jpeg,0,0.99772197,387,111,667,391,280,280,applejack
1521174.jpeg,https://derpicdn.net/img/view/2017/8/27/1521174.jpeg,0,0.991355896,761,27,2921,2187,2160,2160,applejack
1522030.jpeg,https://derpicdn.net/img/view/2017/8/28/1522030.jpeg,0,0.991547942,357,0,3385,2924,3028,2924,applejack
1531006.jpeg,https://derpicdn.net/img/view/2017/9/8/1531006.jpeg,0,0.963718891,812,573,1740,1501,928,928,applejack
1535774.jpeg,https://derpicdn.net/img/view/2017/9/15/1535774.jpeg,0,0.97586751,724,688,992,956,268,268,applejack
1540253.jpeg,https://derpicdn.net/img/view/2017/9/20/1540253.jpeg,0,0.968744218,77,29,445,397,368,368,applejack
1547529.jpeg,https://derpicdn.net/img/view/2017/9/29/1547529.jpeg,0,0.999614716,358,138,1116,896,758,758,applejack
1549640.jpeg,https://derpicdn.net/img/view/2017/10/1/1549640.jpeg,0,0.904857516,126,224,690,788,564,564,applejack
1549967.jpeg,https://derpicdn.net/img/view/2017/10/2/1549967.jpeg,0,0.990315855,0,0,1198,1144,1198,1144,applejack
1550936.jpeg,https://derpicdn.net/img/view/2017/10/3/1550936.jpeg,0,0.911679626,258,52,628,422,370,370,applejack
1565737.jpeg,https://derpicdn.net/img/view/2017/10/20/1565737.jpeg,0,0.996350408,254,100,898,744,644,644,applejack
1566581.jpeg,https://derpicdn.net/img/view/2017/10/21/1566581.jpeg,0,0.995395422,784,1302,1060,1578,276,276,applejack
1568498.jpeg,https://derpicdn.net/img/view/2017/10/23/1568498.jpeg,0,0.992724478,0,139,831,1071,831,932,applejack
1568500.jpeg,https://derpicdn.net/img/view/2017/10/23/1568500.jpeg,0,0.996348083,480,188,932,640,452,452,applejack
1572724.jpeg,https://derpicdn.net/img/view/2017/10/29/1572724.jpeg,0,0.976637006,549,126,717,294,168,168,applejack
1572724.jpeg,https://derpicdn.net/img/view/2017/10/29/1572724.jpeg,1,0.97636342,165,22,357,214,192,192,applejack
1574349.jpeg,https://derpicdn.net/img/view/2017/10/31/1574349.jpeg,0,0.999786794,430,72,1002,644,572,572,applejack
1575025.jpeg,https://derpicdn.net/img/view/2017/11/1/1575025.jpeg,0,0.954786122,10,318,366,674,356,356,applejack
1580687.jpeg,https://derpicdn.net/img/view/2017/11/7/1580687.jpeg,0,0.968467951,61,0,1081,928,1020,928,applejack
1582284.jpeg,https://derpicdn.net/img/view/2017/11/9/1582284.jpeg,0,0.989055276,311,2,1197,888,886,886,applejack
1584086.jpeg,https://derpicdn.net/img/view/2017/11/11/1584086.jpeg,0,0.987544954,0,0,1354,1428,1354,1428,applejack
1590019.jpeg,https://derpicdn.net/img/view/2017/11/19/1590019.jpeg,0,0.989575267,108,517,874,1283,766,766,applejack
1594664.jpeg,https://derpicdn.net/img/view/2017/11/26/1594664.jpeg,0,0.996272624,35,73,487,525,452,452,applejack
1595327.jpeg,https://derpicdn.net/img/view/2017/11/27/1595327.jpeg,0,0.91804564,541,19,1571,1049,1030,1030,applejack
1595421.jpeg,https://derpicdn.net/img/view/2017/11/27/1595421.jpeg,0,0.930148423,47,0,600,553,553,553,applejack
1595898.jpeg,https://derpicdn.net/img/view/2017/11/28/1595898.jpeg,0,0.928796053,430,427,1120,1117,690,690,applejack
1600395.jpeg,https://derpicdn.net/img/view/2017/12/4/1600395.jpeg,0,0.999277234,413,59,1109,755,696,696,applejack
1600581.jpeg,https://derpicdn.net/img/view/2017/12/4/1600581.jpeg,0,0.943711758,158,0,2582,2195,2424,2195,applejack
1601975.jpeg,https://derpicdn.net/img/view/2017/12/6/1601975.jpeg,0,0.984476268,199,0,547,334,348,334,applejack
1603086.jpeg,https://derpicdn.net/img/view/2017/12/8/1603086.jpeg,0,0.989637017,1629,39,2723,1133,1094,1094,applejack
1603251.jpeg,https://derpicdn.net/img/view/2017/12/8/1603251.jpeg,0,0.980830193,0,244,778,1000,778,756,applejack
1603251.jpeg,https://derpicdn.net/img/view/2017/12/8/1603251.jpeg,1,0.917096972,166,131,1000,1000,834,869,applejack
1605099.jpeg,https://derpicdn.net/img/view/2017/12/11/1605099.jpeg,0,0.996875882,165,74,523,432,358,358,applejack
1605708.jpeg,https://derpicdn.net/img/view/2017/12/12/1605708.jpeg,0,0.961508512,169,2,361,194,192,192,applejack
1608562.jpeg,https://derpicdn.net/img/view/2017/12/15/1608562.jpeg,0,0.994533181,62,13,574,525,512,512,applejack
1613660.jpeg,https://derpicdn.net/img/view/2017/12/22/1613660.jpeg,0,0.965014756,0,0,751,670,751,670,applejack
1614825.jpeg,https://derpicdn.net/img/view/2017/12/24/1614825.jpeg,0,0.9697541,29,0,999,948,970,948,applejack
1618287.jpeg,https://derpicdn.net/img/view/2017/12/28/1618287.jpeg,0,0.951030314,356,119,640,403,284,284,applejack
1618751.jpeg,https://derpicdn.net/img/view/2017/12/29/1618751.jpeg,0,0.945498288,1251,573,1793,1115,542,542,applejack
1618751.jpeg,https://derpicdn.net/img/view/2017/12/29/1618751.jpeg,1,0.904337764,761,0,1649,859,888,859,applejack
1620028.jpeg,https://derpicdn.net/img/view/2017/12/30/1620028.jpeg,0,0.985712409,224,294,2544,2614,2320,2320,applejack
1623594.jpeg,https://derpicdn.net/img/view/2018/1/4/1623594.jpeg,0,0.987484932,1909,194,3291,1576,1382,1382,applejack
1626118.jpeg,https://derpicdn.net/img/view/2018/1/7/1626118.jpeg,0,0.970792651,397,656,2157,2416,1760,1760,applejack
1630488.jpeg,https://derpicdn.net/img/view/2018/1/12/1630488.jpeg,0,0.99806869,127,0,2097,1590,1970,1590,applejack
1630915.jpeg,https://derpicdn.net/img/view/2018/1/13/1630915.jpeg,0,0.922679901,896,0,1436,534,540,534,applejack
1634298.jpeg,https://derpicdn.net/img/view/2018/1/17/1634298.jpeg,0,0.985623777,0,0,1260,1305,1260,1305,applejack
1635162.jpeg,https://derpicdn.net/img/view/2018/1/18/1635162.jpeg,0,0.930494428,93,286,911,1104,818,818,applejack
1635528.jpeg,https://derpicdn.net/img/view/2018/1/19/1635528.jpeg,0,0.918347239,330,9,836,515,506,506,applejack
1638997.jpeg,https://derpicdn.net/img/view/2018/1/23/1638997.jpeg,0,0.997481287,239,0,1211,930,972,930,applejack
1640852.jpeg,https://derpicdn.net/img/view/2018/1/25/1640852.jpeg,0,0.981008768,337,208,911,782,574,574,applejack
1642541.jpeg,https://derpicdn.net/img/view/2018/1/28/1642541.jpeg,0,0.998991609,283,294,769,780,486,486,applejack
1642728.jpeg,https://derpicdn.net/img/view/2018/1/28/1642728.jpeg,0,0.996255994,151,30,597,476,446,446,applejack
1643342.jpeg,https://derpicdn.net/img/view/2018/1/29/1643342.jpeg,0,0.986083329,232,251,678,697,446,446,applejack
1644705.jpeg,https://derpicdn.net/img/view/2018/1/30/1644705.jpeg,0,0.914976656,905,0,1903,989,998,989,applejack
1646013.jpeg,https://derpicdn.net/img/view/2018/2/1/1646013.jpeg,0,0.984248102,70,13,548,491,478,478,applejack
1646115.jpeg,https://derpicdn.net/img/view/2018/2/1/1646115.jpeg,0,0.991868198,163,60,461,358,298,298,applejack
1647284.jpeg,https://derpicdn.net/img/view/2018/2/3/1647284.jpeg,0,0.928428948,1016,80,1618,682,602,602,applejack
1647397.jpeg,https://derpicdn.net/img/view/2018/2/3/1647397.jpeg,0,0.96043396,128,0,596,444,468,444,applejack
1647691.jpeg,https://derpicdn.net/img/view/2018/2/3/1647691.jpeg,0,0.989875019,0,32,388,442,388,410,applejack
1649199.jpeg,https://derpicdn.net/img/view/2018/2/5/1649199.jpeg,0,0.995880842,343,0,595,249,252,249,applejack
1653839.jpeg,https://derpicdn.net/img/view/2018/2/12/1653839.jpeg,0,0.998520076,48,0,576,513,528,513,applejack
1657063.jpeg,https://derpicdn.net/img/view/2018/2/15/1657063.jpeg,0,0.989531159,1288,1358,2080,2150,792,792,applejack
1660444.jpeg,https://derpicdn.net/img/view/2018/2/19/1660444.jpeg,0,0.990954876,109,0,1145,916,1036,916,applejack
1662778.jpeg,https://derpicdn.net/img/view/2018/2/22/1662778.jpeg,0,0.960194588,0,78,892,1200,892,1122,applejack
1662822.jpeg,https://derpicdn.net/img/view/2018/2/22/1662822.jpeg,0,0.990194976,0,398,911,1352,911,954,applejack
1664142.jpeg,https://derpicdn.net/img/view/2018/2/24/1664142.jpeg,0,0.949711502,0,96,779,990,779,894,applejack
1667142.jpeg,https://derpicdn.net/img/view/2018/2/27/1667142.jpeg,0,0.996879339,643,122,1809,1288,1166,1166,applejack
1671312.jpeg,https://derpicdn.net/img/view/2018/3/4/1671312.jpeg,0,0.983245134,9,45,577,613,568,568,applejack
1671853.jpeg,https://derpicdn.net/img/view/2018/3/5/1671853.jpeg,0,0.956542671,167,114,479,426,312,312,applejack
1671855.jpeg,https://derpicdn.net/img/view/2018/3/5/1671855.jpeg,0,0.964490652,168,115,476,423,308,308,applejack
1672407.jpeg,https://derpicdn.net/img/view/2018/3/5/1672407.jpeg,0,0.900061011,386,102,676,392,290,290,applejack
1674068.jpeg,https://derpicdn.net/img/view/2018/3/7/1674068.jpeg,0,0.953114629,119,0,543,390,424,390,applejack
1674556.jpeg,https://derpicdn.net/img/view/2018/3/8/1674556.jpeg,0,0.936438501,0,0,796,657,796,657,applejack
1676990.jpeg,https://derpicdn.net/img/view/2018/3/11/1676990.jpeg,0,0.997187376,581,0,1095,501,514,501,applejack
1680418.jpeg,https://derpicdn.net/img/view/2018/3/14/1680418.jpeg,0,0.937637746,612,94,1108,590,496,496,applejack
1688530.jpeg,https://derpicdn.net/img/view/2018/3/23/1688530.jpeg,0,0.944858611,215,0,899,648,684,648,applejack
1688826.jpeg,https://derpicdn.net/img/view/2018/3/24/1688826.jpeg,0,0.973479927,0,0,380,430,380,430,applejack
1689089.jpeg,https://derpicdn.net/img/view/2018/3/24/1689089.jpeg,0,0.982216179,1154,196,1866,908,712,712,applejack
1689089.jpeg,https://derpicdn.net/img/view/2018/3/24/1689089.jpeg,1,0.979866147,0,0,657,650,657,650,applejack
1689180.jpeg,https://derpicdn.net/img/view/2018/3/24/1689180.jpeg,0,0.906364024,334,0,870,482,536,482,applejack
1694373.jpeg,https://derpicdn.net/img/view/2018/3/30/1694373.jpeg,0,0.975359857,332,38,858,564,526,526,applejack
1694946.jpeg,https://derpicdn.net/img/view/2018/3/31/1694946.jpeg,0,0.973394334,701,0,1407,679,706,679,applejack
1700578.jpeg,https://derpicdn.net/img/view/2018/4/6/1700578.jpeg,0,0.994040549,352,0,1236,831,884,831,applejack
1705137.jpeg,https://derpicdn.net/img/view/2018/4/11/1705137.jpeg,0,0.973907471,0,81,768,873,768,792,applejack
1705217.jpeg,https://derpicdn.net/img/view/2018/4/11/1705217.jpeg,0,0.960169554,182,0,536,329,354,329,applejack
1707090.jpeg,https://derpicdn.net/img/view/2018/4/14/1707090.jpeg,0,0.945377171,23,157,453,587,430,430,applejack
1707936.jpeg,https://derpicdn.net/img/view/2018/4/14/1707936.jpeg,0,0.986412704,0,0,2028,2024,2028,2024,applejack
1722293.jpeg,https://derpicdn.net/img/view/2018/5/2/1722293.jpeg,0,0.986664832,635,467,1499,1331,864,864,applejack
1725622.jpeg,https://derpicdn.net/img/view/2018/5/6/1725622.jpeg,0,0.994830966,25,64,479,518,454,454,applejack
1725622.jpeg,https://derpicdn.net/img/view/2018/5/6/1725622.jpeg,1,0.975346088,682,6,932,256,250,250,applejack
1726739.jpeg,https://derpicdn.net/img/view/2018/5/7/1726739.jpeg,0,0.976302743,30,39,228,237,198,198,applejack
1726741.jpeg,https://derpicdn.net/img/view/2018/5/7/1726741.jpeg,0,0.913088083,185,0,1241,1035,1056,1035,applejack
1726912.jpeg,https://derpicdn.net/img/view/2018/5/7/1726912.jpeg,0,0.993411541,229,0,1001,760,772,760,applejack
1728346.jpeg,https://derpicdn.net/img/view/2018/5/9/1728346.jpeg,0,0.997752249,15,11,1133,1129,1118,1118,applejack
1730603.jpeg,https://derpicdn.net/img/view/2018/5/12/1730603.jpeg,0,0.938880742,759,405,1375,1021,616,616,applejack
1730957.jpeg,https://derpicdn.net/img/view/2018/5/12/1730957.jpeg,0,0.99315536,0,0,1012,999,1012,999,applejack
1731833.jpeg,https://derpicdn.net/img/view/2018/5/13/1731833.jpeg,0,0.94493103,392,123,678,409,286,286,applejack
1734578.jpeg,https://derpicdn.net/img/view/2018/5/17/1734578.jpeg,0,0.95360285,94,0,464,367,370,367,applejack
1742333.jpeg,https://derpicdn.net/img/view/2018/5/27/1742333.jpeg,0,0.993615627,131,0,545,397,414,397,applejack
1747658.jpeg,https://derpicdn.net/img/view/2018/6/2/1747658.jpeg,0,0.93760103,763,59,1155,451,392,392,applejack
1754806.jpeg,https://derpicdn.net/img/view/2018/6/10/1754806.jpeg,0,0.971826971,1560,11,2434,885,874,874,applejack
1759578.jpeg,https://derpicdn.net/img/view/2018/6/17/1759578.jpeg,0,0.998880386,209,25,639,455,430,430,applejack
1760604.jpeg,https://derpicdn.net/img/view/2018/6/18/1760604.jpeg,0,0.979024827,261,31,1035,805,774,774,applejack
1760605.jpeg,https://derpicdn.net/img/view/2018/6/18/1760605.jpeg,0,0.935957134,0,0,1140,1106,1140,1106,applejack
1762012.jpeg,https://derpicdn.net/img/view/2018/6/20/1762012.jpeg,0,0.940388858,248,207,2198,2157,1950,1950,applejack
1766450.jpeg,https://derpicdn.net/img/view/2018/6/26/1766450.jpeg,0,0.959107935,100,74,600,574,500,500,applejack
1769542.jpeg,https://derpicdn.net/img/view/2018/6/30/1769542.jpeg,0,0.999493659,549,137,1591,1179,1042,1042,applejack
1769612.jpeg,https://derpicdn.net/img/view/2018/6/30/1769612.jpeg,0,0.998032689,276,0,648,367,372,367,applejack
1771472.jpeg,https://derpicdn.net/img/view/2018/7/2/1771472.jpeg,0,0.966327488,618,177,932,491,314,314,applejack
1773416.jpeg,https://derpicdn.net/img/view/2018/7/5/1773416.jpeg,0,0.979734719,0,0,683,705,683,705,applejack
1777266.jpeg,https://derpicdn.net/img/view/2018/7/10/1777266.jpeg,0,0.960296988,0,8,1398,1618,1398,1610,applejack
1777277.jpeg,https://derpicdn.net/img/view/2018/7/10/1777277.jpeg,0,0.991997302,0,0,1272,1219,1272,1219,applejack
1778326.jpeg,https://derpicdn.net/img/view/2018/7/11/1778326.jpeg,0,0.978399396,28,91,733,843,705,752,applejack
1779073.jpeg,https://derpicdn.net/img/view/2018/7/12/1779073.jpeg,0,0.985601783,23,0,753,712,730,712,applejack
1779251.jpeg,https://derpicdn.net/img/view/2018/7/12/1779251.jpeg,0,0.981978238,214,205,336,327,122,122,applejack
1784711.jpeg,https://derpicdn.net/img/view/2018/7/19/1784711.jpeg,0,0.992720366,9,22,787,800,778,778,applejack
1784711.jpeg,https://derpicdn.net/img/view/2018/7/19/1784711.jpeg,1,0.97653991,760,18,1452,710,692,692,applejack
1784712.jpeg,https://derpicdn.net/img/view/2018/7/19/1784712.jpeg,0,0.986851037,0,0,786,776,786,776,applejack
1784712.jpeg,https://derpicdn.net/img/view/2018/7/19/1784712.jpeg,1,0.974104702,713,0,1536,842,823,842,applejack
1785489.jpeg,https://derpicdn.net/img/view/2018/7/20/1785489.jpeg,0,0.918591619,12,0,672,560,660,560,applejack
1785513.jpeg,https://derpicdn.net/img/view/2018/7/20/1785513.jpeg,0,0.995554447,330,0,858,504,528,504,applejack
1786150.jpeg,https://derpicdn.net/img/view/2018/7/21/1786150.jpeg,0,0.989634871,533,356,1305,1128,772,772,applejack
1787054.jpeg,https://derpicdn.net/img/view/2018/7/22/1787054.jpeg,0,0.986151218,272,1,712,441,440,440,applejack
1787513.jpeg,https://derpicdn.net/img/view/2018/7/23/1787513.jpeg,0,0.992099285,289,0,1000,838,711,838,applejack
1796783.jpeg,https://derpicdn.net/img/view/2018/8/3/1796783.jpeg,0,0.98779279,232,8,556,332,324,324,applejack
1797546.jpeg,https://derpicdn.net/img/view/2018/8/4/1797546.jpeg,0,0.986023307,183,98,530,486,347,388,applejack
1797751.jpeg,https://derpicdn.net/img/view/2018/8/4/1797751.jpeg,0,0.989818454,499,0,1155,623,656,623,applejack
1800445.jpeg,https://derpicdn.net/img/view/2018/8/7/1800445.jpeg,0,0.98358506,249,0,719,429,470,429,applejack
1807841.jpeg,https://derpicdn.net/img/view/2018/8/16/1807841.jpeg,0,0.991168439,282,111,628,457,346,346,applejack
1807997.jpeg,https://derpicdn.net/img/view/2018/8/16/1807997.jpeg,0,0.952816069,413,193,793,573,380,380,applejack
1808877.jpeg,https://derpicdn.net/img/view/2018/8/17/1808877.jpeg,0,0.998972356,135,7,781,653,646,646,applejack
1820684.jpeg,https://derpicdn.net/img/view/2018/8/30/1820684.jpeg,0,0.981824636,133,7,691,565,558,558,applejack
1822415.jpeg,https://derpicdn.net/img/view/2018/9/1/1822415.jpeg,0,0.999785841,1321,137,1855,671,534,534,applejack
1822415.jpeg,https://derpicdn.net/img/view/2018/9/1/1822415.jpeg,1,0.986473799,906,266,1396,756,490,490,applejack
1824457.jpeg,https://derpicdn.net/img/view/2018/9/4/1824457.jpeg,0,0.991328895,166,0,706,510,540,510,applejack
182477.jpeg,https://derpicdn.net/img/view/2012/12/14/182477.jpeg,0,0.999376535,294,130,1574,1410,1280,1280,applejack
1825481.jpeg,https://derpicdn.net/img/view/2018/9/5/1825481.jpeg,0,0.968192279,0,81,666,799,666,718,applejack
1825481.jpeg,https://derpicdn.net/img/view/2018/9/5/1825481.jpeg,1,0.900713801,71,0,813,685,742,685,applejack
1825675.jpeg,https://derpicdn.net/img/view/2018/9/5/1825675.jpeg,0,0.988795817,870,566,1942,1638,1072,1072,applejack
1829944.jpeg,https://derpicdn.net/img/view/2018/9/11/1829944.jpeg,0,0.991473317,309,12,1039,742,730,730,applejack
1834885.jpeg,https://derpicdn.net/img/view/2018/9/17/1834885.jpeg,0,0.999495149,1521,166,2117,762,596,596,applejack
1835726.jpeg,https://derpicdn.net/img/view/2018/9/18/1835726.jpeg,0,0.988790393,478,40,972,534,494,494,applejack
1839415.jpeg,https://derpicdn.net/img/view/2018/9/23/1839415.jpeg,0,0.986991823,0,0,996,984,996,984,applejack
1841522.jpeg,https://derpicdn.net/img/view/2018/9/26/1841522.jpeg,0,0.996308267,182,0,758,551,576,551,applejack
1842684.jpeg,https://derpicdn.net/img/view/2018/9/27/1842684.jpeg,0,0.99287653,698,0,1518,820,820,820,applejack
1844668.jpeg,https://derpicdn.net/img/view/2018/9/30/1844668.jpeg,0,0.936854005,165,0,788,637,623,637,applejack
1847708.jpeg,https://derpicdn.net/img/view/2018/10/4/1847708.jpeg,0,0.986841679,0,0,1368,1080,1368,1080,applejack
1847710.jpeg,https://derpicdn.net/img/view/2018/10/4/1847710.jpeg,0,0.934576273,690,0,1910,1080,1220,1080,applejack
1848570.jpeg,https://derpicdn.net/img/view/2018/10/5/1848570.jpeg,0,0.992540658,1146,0,1888,674,742,674,applejack
1850379.jpeg,https://derpicdn.net/img/view/2018/10/7/1850379.jpeg,0,0.991633832,1447,146,2685,1384,1238,1238,applejack
1851058.jpeg,https://derpicdn.net/img/view/2018/10/8/1851058.jpeg,0,0.989789069,121,111,1327,1317,1206,1206,applejack
1851363.jpeg,https://derpicdn.net/img/view/2018/10/8/1851363.jpeg,0,0.996801257,54,0,796,720,742,720,applejack
1852381.jpeg,https://derpicdn.net/img/view/2018/10/9/1852381.jpeg,0,0.982997,729,10,1445,726,716,716,applejack
1853084.jpeg,https://derpicdn.net/img/view/2018/10/10/1853084.jpeg,0,0.989110231,872,611,1708,1447,836,836,applejack
1854320.jpeg,https://derpicdn.net/img/view/2018/10/12/1854320.jpeg,0,0.994084597,526,137,1164,775,638,638,applejack
1855107.jpeg,https://derpicdn.net/img/view/2018/10/13/1855107.jpeg,0,0.976276815,85,0,1775,1080,1690,1080,applejack
1862135.jpeg,https://derpicdn.net/img/view/2018/10/21/1862135.jpeg,0,0.968369305,76,19,534,477,458,458,applejack
1865578.jpeg,https://derpicdn.net/img/view/2018/10/25/1865578.jpeg,0,0.972657919,41,0,735,646,694,646,applejack
1866164.jpeg,https://derpicdn.net/img/view/2018/10/26/1866164.jpeg,0,0.997875988,723,126,1197,600,474,474,applejack
1873807.jpeg,https://derpicdn.net/img/view/2018/11/3/1873807.jpeg,0,0.969225705,54,0,1544,1434,1490,1434,applejack
1875838.jpeg,https://derpicdn.net/img/view/2018/11/5/1875838.jpeg,0,0.987670183,153,154,893,894,740,740,applejack
1876816.jpeg,https://derpicdn.net/img/view/2018/11/7/1876816.jpeg,0,0.989406228,152,77,1050,975,898,898,applejack
1877317.jpeg,https://derpicdn.net/img/view/2018/11/7/1877317.jpeg,0,0.97492975,337,0,1431,1064,1094,1064,applejack
1878256.jpeg,https://derpicdn.net/img/view/2018/11/9/1878256.jpeg,0,0.970295906,640,0,1290,622,650,622,applejack
1878422.jpeg,https://derpicdn.net/img/view/2018/11/9/1878422.jpeg,0,0.919705153,74,0,644,534,570,534,applejack
1878786.jpeg,https://derpicdn.net/img/view/2018/11/10/1878786.jpeg,0,0.986491263,113,0,927,686,814,686,applejack
1879328.jpeg,https://derpicdn.net/img/view/2018/11/10/1879328.jpeg,0,0.997830272,1558,25,2473,981,915,956,applejack
1880195.jpeg,https://derpicdn.net/img/view/2018/11/11/1880195.jpeg,0,0.992736876,369,61,897,589,528,528,applejack
1880461.jpeg,https://derpicdn.net/img/view/2018/11/12/1880461.jpeg,0,0.993525505,202,0,942,740,740,740,applejack
1882065.jpeg,https://derpicdn.net/img/view/2018/11/14/1882065.jpeg,0,0.970831811,60,2,380,322,320,320,applejack
1884480.jpeg,https://derpicdn.net/img/view/2018/11/17/1884480.jpeg,0,0.992832303,343,31,557,245,214,214,applejack
1886353.jpeg,https://derpicdn.net/img/view/2018/11/19/1886353.jpeg,0,0.985457122,48,124,820,896,772,772,applejack
1888385.jpeg,https://derpicdn.net/img/view/2018/11/22/1888385.jpeg,0,0.976382256,100,0,668,523,568,523,applejack
1889212.jpeg,https://derpicdn.net/img/view/2018/11/23/1889212.jpeg,0,0.991967738,69,54,1117,1102,1048,1048,applejack
1896405.jpeg,https://derpicdn.net/img/view/2018/12/2/1896405.jpeg,0,0.995665073,339,213,1063,937,724,724,applejack
1896459.jpeg,https://derpicdn.net/img/view/2018/12/2/1896459.jpeg,0,0.993158519,24,82,1368,1426,1344,1344,applejack
1896937.jpeg,https://derpicdn.net/img/view/2018/12/3/1896937.jpeg,0,0.906857491,0,68,1082,1256,1082,1188,applejack
1896951.jpeg,https://derpicdn.net/img/view/2018/12/3/1896951.jpeg,0,0.999521971,472,204,962,694,490,490,applejack
1899199.jpeg,https://derpicdn.net/img/view/2018/12/5/1899199.jpeg,0,0.990203619,12,0,508,486,496,486,applejack
1899378.jpeg,https://derpicdn.net/img/view/2018/12/5/1899378.jpeg,0,0.955732644,0,0,1339,1366,1339,1366,applejack
1902017.jpeg,https://derpicdn.net/img/view/2018/12/8/1902017.jpeg,0,0.921947181,0,37,663,723,663,686,applejack
1902019.jpeg,https://derpicdn.net/img/view/2018/12/8/1902019.jpeg,0,0.919419646,163,28,477,342,314,314,applejack
1905830.jpeg,https://derpicdn.net/img/view/2018/12/11/1905830.jpeg,0,0.978916705,155,0,1273,1063,1118,1063,applejack
1905830.jpeg,https://derpicdn.net/img/view/2018/12/11/1905830.jpeg,1,0.919455945,0,117,1024,1063,1024,946,applejack
1906906.jpeg,https://derpicdn.net/img/view/2018/12/13/1906906.jpeg,0,0.979568899,384,28,1434,1078,1050,1050,applejack
1908401.jpeg,https://derpicdn.net/img/view/2018/12/14/1908401.jpeg,0,0.9659127,32,0,324,268,292,268,applejack
1910039.jpeg,https://derpicdn.net/img/view/2018/12/16/1910039.jpeg,0,0.992681861,117,1,527,411,410,410,applejack
1914288.jpeg,https://derpicdn.net/img/view/2018/12/21/1914288.jpeg,0,0.971781194,5,72,1695,1762,1690,1690,applejack
1915463.jpeg,https://derpicdn.net/img/view/2018/12/22/1915463.jpeg,0,0.998865962,196,0,822,576,626,576,applejack
1918334.jpeg,https://derpicdn.net/img/view/2018/12/25/1918334.jpeg,0,0.985626876,597,79,1317,799,720,720,applejack
1919550.jpeg,https://derpicdn.net/img/view/2018/12/26/1919550.jpeg,0,0.973666728,0,0,549,562,549,562,applejack
1919639.jpeg,https://derpicdn.net/img/view/2018/12/27/1919639.jpeg,0,0.933375597,118,0,1196,928,1078,928,applejack
1925815.jpeg,https://derpicdn.net/img/view/2019/1/3/1925815.jpeg,0,0.984107554,348,61,2570,2283,2222,2222,applejack
1928829.jpeg,https://derpicdn.net/img/view/2019/1/7/1928829.jpeg,0,0.998011291,97,0,401,277,304,277,applejack
1928910.jpeg,https://derpicdn.net/img/view/2019/1/7/1928910.jpeg,0,0.917556405,155,0,1217,1026,1062,1026,applejack
1929931.jpeg,https://derpicdn.net/img/view/2019/1/8/1929931.jpeg,0,0.94131273,0,0,700,696,700,696,applejack
1930826.jpeg,https://derpicdn.net/img/view/2019/1/9/1930826.jpeg,0,0.986310363,181,164,1637,1620,1456,1456,applejack
1933298.jpeg,https://derpicdn.net/img/view/2019/1/12/1933298.jpeg,0,0.995238125,458,0,790,266,332,266,applejack
1939274.jpeg,https://derpicdn.net/img/view/2019/1/19/1939274.jpeg,0,0.980249822,207,34,769,596,562,562,applejack
1940646.jpeg,https://derpicdn.net/img/view/2019/1/21/1940646.jpeg,0,0.991194963,50,0,1668,1523,1618,1523,applejack
1942436.jpeg,https://derpicdn.net/img/view/2019/1/23/1942436.jpeg,0,0.979774117,678,0,1016,325,338,325,applejack
1942744.jpeg,https://derpicdn.net/img/view/2019/1/23/1942744.jpeg,0,0.9799546,0,0,615,586,615,586,applejack
1943426.jpeg,https://derpicdn.net/img/view/2019/1/24/1943426.jpeg,0,0.998060226,667,657,1247,1237,580,580,applejack
1946862.jpeg,https://derpicdn.net/img/view/2019/1/28/1946862.jpeg,0,0.971903563,45,0,731,641,686,641,applejack
1948650.jpeg,https://derpicdn.net/img/view/2019/1/30/1948650.jpeg,0,0.982641339,0,255,1013,1341,1013,1086,applejack
1950544.jpeg,https://derpicdn.net/img/view/2019/2/1/1950544.jpeg,0,0.986350358,157,0,1253,971,1096,971,applejack
1951664.jpeg,https://derpicdn.net/img/view/2019/2/3/1951664.jpeg,0,0.999519408,201,0,567,338,366,338,applejack
1953247.jpeg,https://derpicdn.net/img/view/2019/2/4/1953247.jpeg,0,0.969871461,570,32,872,334,302,302,applejack
1953612.jpeg,https://derpicdn.net/img/view/2019/2/4/1953612.jpeg,0,0.993153453,446,293,1410,1257,964,964,applejack
1957733.jpeg,https://derpicdn.net/img/view/2019/2/9/1957733.jpeg,0,0.981140435,166,0,754,558,588,558,applejack
1958136.jpeg,https://derpicdn.net/img/view/2019/2/10/1958136.jpeg,0,0.965534985,308,0,914,457,606,457,applejack
1958476.jpeg,https://derpicdn.net/img/view/2019/2/10/1958476.jpeg,0,0.996472895,270,141,460,331,190,190,applejack
1959451.jpeg,https://derpicdn.net/img/view/2019/2/11/1959451.jpeg,0,0.99803561,443,87,853,497,410,410,applejack
1961680.jpeg,https://derpicdn.net/img/view/2019/2/14/1961680.jpeg,0,0.949385405,299,116,1385,1202,1086,1086,applejack
1962989.jpeg,https://derpicdn.net/img/view/2019/2/15/1962989.jpeg,0,0.918435633,1229,364,2769,1904,1540,1540,applejack
1967043.jpeg,https://derpicdn.net/img/view/2019/2/20/1967043.jpeg,0,0.984413087,0,0,749,743,749,743,applejack
1970558.jpeg,https://derpicdn.net/img/view/2019/2/24/1970558.jpeg,0,0.997365594,156,54,342,240,186,186,applejack
1970558.jpeg,https://derpicdn.net/img/view/2019/2/24/1970558.jpeg,1,0.952362478,474,99,640,265,166,166,applejack
1971017.jpeg,https://derpicdn.net/img/view/2019/2/25/1971017.jpeg,0,0.989113986,167,11,593,437,426,426,applejack
1971889.jpeg,https://derpicdn.net/img/view/2019/2/26/1971889.jpeg,0,0.997317612,388,57,1310,979,922,922,applejack
1977500.jpeg,https://derpicdn.net/img/view/2019/3/4/1977500.jpeg,0,0.990469217,133,0,835,697,702,697,applejack
1977735.jpeg,https://derpicdn.net/img/view/2019/3/5/1977735.jpeg,0,0.998924851,2474,200,3954,1680,1480,1480,applejack
1978714.jpeg,https://derpicdn.net/img/view/2019/3/6/1978714.jpeg,0,0.996918142,203,18,547,362,344,344,applejack
1979311.jpeg,https://derpicdn.net/img/view/2019/3/7/1979311.jpeg,0,0.927796066,26,0,562,498,536,498,applejack
1987513.jpeg,https://derpicdn.net/img/view/2019/3/16/1987513.jpeg,0,0.901856959,540,39,987,495,447,456,applejack
1989081.jpeg,https://derpicdn.net/img/view/2019/3/18/1989081.jpeg,0,0.987645864,3,0,843,771,840,771,applejack
1989979.jpeg,https://derpicdn.net/img/view/2019/3/19/1989979.jpeg,0,0.908041298,414,74,784,444,370,370,applejack
1993124.jpeg,https://derpicdn.net/img/view/2019/3/23/1993124.jpeg,0,0.999433696,359,0,861,490,502,490,applejack
199332.jpeg,https://derpicdn.net/img/view/2013/1/1/199332.jpeg,0,0.995025992,138,0,424,283,286,283,applejack
1993796.jpeg,https://derpicdn.net/img/view/2019/3/24/1993796.jpeg,0,0.997782111,594,0,958,361,364,361,applejack
1994277.jpeg,https://derpicdn.net/img/view/2019/3/25/1994277.jpeg,1,0.900603116,1388,510,2978,2100,1590,1590,applejack
1998124.jpeg,https://derpicdn.net/img/view/2019/3/30/1998124.jpeg,0,0.998148143,350,0,1212,848,862,848,applejack
1998211.jpeg,https://derpicdn.net/img/view/2019/3/30/1998211.jpeg,0,0.999819398,507,0,1017,490,510,490,applejack
1998211.jpeg,https://derpicdn.net/img/view/2019/3/30/1998211.jpeg,1,0.991055012,0,57,576,707,576,650,applejack
2001574.jpeg,https://derpicdn.net/img/view/2019/4/3/2001574.jpeg,0,0.996737361,420,1666,1506,2752,1086,1086,applejack
2001574.jpeg,https://derpicdn.net/img/view/2019/4/3/2001574.jpeg,1,0.996333778,641,2,1323,684,682,682,applejack
2001574.jpeg,https://derpicdn.net/img/view/2019/4/3/2001574.jpeg,2,0.984709322,434,693,1490,1749,1056,1056,applejack
2001804.jpeg,https://derpicdn.net/img/view/2019/4/3/2001804.jpeg,0,0.997079551,254,181,560,487,306,306,applejack
2002751.jpeg,https://derpicdn.net/img/view/2019/4/4/2002751.jpeg,0,0.995906889,59,0,761,676,702,676,applejack
2006193.jpeg,https://derpicdn.net/img/view/2019/4/8/2006193.jpeg,0,0.962851882,798,121,1280,621,482,500,applejack
2006879.jpeg,https://derpicdn.net/img/view/2019/4/8/2006879.jpeg,0,0.954291999,21,202,1079,1260,1058,1058,applejack
200794.jpeg,https://derpicdn.net/img/view/2013/1/3/200794.jpeg,0,0.981026947,0,0,701,681,701,681,applejack
2008322.jpeg,https://derpicdn.net/img/view/2019/4/10/2008322.jpeg,0,0.988230228,834,149,1678,993,844,844,applejack
2009651.jpeg,https://derpicdn.net/img/view/2019/4/12/2009651.jpeg,0,0.991709888,57,0,1967,1572,1910,1572,applejack
2019775.jpeg,https://derpicdn.net/img/view/2019/4/22/2019775.jpeg,0,0.976499319,0,8,465,598,465,590,applejack
2019809.jpeg,https://derpicdn.net/img/view/2019/4/22/2019809.jpeg,0,0.928206682,203,424,1277,1498,1074,1074,applejack
2021376.jpeg,https://derpicdn.net/img/view/2019/4/23/2021376.jpeg,0,0.933063924,235,0,1567,1190,1332,1190,applejack
2026621.jpeg,https://derpicdn.net/img/view/2019/4/29/2026621.jpeg,0,0.994858325,1575,210,3011,1646,1436,1436,applejack
2027762.jpeg,https://derpicdn.net/img/view/2019/5/1/2027762.jpeg,0,0.988488436,479,1,1899,1421,1420,1420,applejack
2027923.jpeg,https://derpicdn.net/img/view/2019/5/1/2027923.jpeg,0,0.992519021,205,0,787,580,582,580,applejack
2032546.jpeg,https://derpicdn.net/img/view/2019/5/6/2032546.jpeg,0,0.998232841,436,0,1164,697,728,697,applejack
2032719.jpeg,https://derpicdn.net/img/view/2019/5/6/2032719.jpeg,0,0.997700453,54,27,1058,1031,1004,1004,applejack
2034050.jpeg,https://derpicdn.net/img/view/2019/5/8/2034050.jpeg,0,0.983686209,0,289,1558,1921,1558,1632,applejack
2034602.jpeg,https://derpicdn.net/img/view/2019/5/9/2034602.jpeg,0,0.963775098,0,0,1410,1412,1410,1412,applejack
2036239.jpeg,https://derpicdn.net/img/view/2019/5/11/2036239.jpeg,0,0.976017833,543,142,1005,604,462,462,applejack
2037245.jpeg,https://derpicdn.net/img/view/2019/5/12/2037245.jpeg,0,0.975423336,0,77,994,1197,994,1120,applejack
2037461.jpeg,https://derpicdn.net/img/view/2019/5/12/2037461.jpeg,0,0.997904003,337,0,1395,1046,1058,1046,applejack
2041575.jpeg,https://derpicdn.net/img/view/2019/5/17/2041575.jpeg,0,0.99422431,172,0,484,310,312,310,applejack
2047697.jpeg,https://derpicdn.net/img/view/2019/5/24/2047697.jpeg,0,0.917494357,376,292,736,652,360,360,applejack
2047697.jpeg,https://derpicdn.net/img/view/2019/5/24/2047697.jpeg,1,0.915866911,11,6,223,218,212,212,applejack
2048413.jpeg,https://derpicdn.net/img/view/2019/5/25/2048413.jpeg,0,0.993904352,285,0,887,540,602,540,applejack
2048868.jpeg,https://derpicdn.net/img/view/2019/5/25/2048868.jpeg,0,0.951052308,205,0,970,808,765,808,applejack
2050283.jpeg,https://derpicdn.net/img/view/2019/5/27/2050283.jpeg,0,0.947859645,0,22,865,950,865,928,applejack
2054655.jpeg,https://derpicdn.net/img/view/2019/5/31/2054655.jpeg,0,0.990377784,141,27,523,409,382,382,applejack
2055358.jpeg,https://derpicdn.net/img/view/2019/6/1/2055358.jpeg,0,0.952882469,270,0,1121,864,851,864,applejack
2057105.jpeg,https://derpicdn.net/img/view/2019/6/3/2057105.jpeg,0,0.935838044,0,0,608,599,608,599,applejack
2059563.jpeg,https://derpicdn.net/img/view/2019/6/7/2059563.jpeg,0,0.949163795,1130,0,1718,527,588,527,applejack
2059699.jpeg,https://derpicdn.net/img/view/2019/6/7/2059699.jpeg,0,0.949614525,336,62,1500,1262,1164,1200,applejack
2063293.jpeg,https://derpicdn.net/img/view/2019/6/12/2063293.jpeg,0,0.989936352,372,0,1812,1399,1440,1399,applejack
2064904.jpeg,https://derpicdn.net/img/view/2019/6/14/2064904.jpeg,0,0.963123024,498,176,1414,1106,916,930,applejack
2064958.jpeg,https://derpicdn.net/img/view/2019/6/14/2064958.jpeg,0,0.981644928,152,177,688,713,536,536,applejack
2065037.jpeg,https://derpicdn.net/img/view/2019/6/14/2065037.jpeg,0,0.993367374,0,0,741,688,741,688,applejack
2066652.jpeg,https://derpicdn.net/img/view/2019/6/16/2066652.jpeg,0,0.988711357,88,62,1982,1956,1894,1894,applejack
2068781.jpeg,https://derpicdn.net/img/view/2019/6/18/2068781.jpeg,0,0.98387295,202,0,1206,880,1004,880,applejack
2069017.jpeg,https://derpicdn.net/img/view/2019/6/18/2069017.jpeg,0,0.998097241,131,108,1567,1544,1436,1436,applejack
2070982.jpeg,https://derpicdn.net/img/view/2019/6/21/2070982.jpeg,0,0.924076736,284,718,1222,1656,938,938,applejack
2071913.jpeg,https://derpicdn.net/img/view/2019/6/22/2071913.jpeg,0,0.940016985,404,920,1108,1624,704,704,applejack
2073108.jpeg,https://derpicdn.net/img/view/2019/6/23/2073108.jpeg,0,0.98327899,0,130,811,988,811,858,applejack
2074311.jpeg,https://derpicdn.net/img/view/2019/6/24/2074311.jpeg,0,0.987125397,142,0,378,226,236,226,applejack
2074313.jpeg,https://derpicdn.net/img/view/2019/6/24/2074313.jpeg,0,0.961459517,137,0,871,727,734,727,applejack
2074850.jpeg,https://derpicdn.net/img/view/2019/6/25/2074850.jpeg,0,0.987662792,419,32,763,376,344,344,applejack
2075263.jpeg,https://derpicdn.net/img/view/2019/6/25/2075263.jpeg,0,0.99898392,533,26,1175,668,642,642,applejack
2079369.jpeg,https://derpicdn.net/img/view/2019/6/30/2079369.jpeg,0,0.997303367,84,0,726,588,642,588,applejack
2082437.jpeg,https://derpicdn.net/img/view/2019/7/4/2082437.jpeg,0,0.931208849,467,0,1151,664,684,664,applejack
2084035.jpeg,https://derpicdn.net/img/view/2019/7/6/2084035.jpeg,1,0.973811805,654,0,2200,1567,1546,1567,applejack
2088668.jpeg,https://derpicdn.net/img/view/2019/7/11/2088668.jpeg,0,0.996351063,0,6,608,658,608,652,applejack
2092038.jpeg,https://derpicdn.net/img/view/2019/7/15/2092038.jpeg,0,0.998522341,131,0,803,592,672,592,applejack
2093586.jpeg,https://derpicdn.net/img/view/2019/7/16/2093586.jpeg,0,0.993061244,198,91,640,533,442,442,applejack
2093743.jpeg,https://derpicdn.net/img/view/2019/7/16/2093743.jpeg,0,0.976079047,0,0,499,509,499,509,applejack
2094659.jpeg,https://derpicdn.net/img/view/2019/7/18/2094659.jpeg,0,0.984703243,0,0,1373,1504,1373,1504,applejack
2096446.jpeg,https://derpicdn.net/img/view/2019/7/20/2096446.jpeg,0,0.932366908,284,0,892,597,608,597,applejack
2098480.jpeg,https://derpicdn.net/img/view/2019/7/22/2098480.jpeg,0,0.988566995,597,202,1401,1006,804,804,applejack
2102070.jpeg,https://derpicdn.net/img/view/2019/7/27/2102070.jpeg,0,0.990399957,342,482,734,874,392,392,applejack
2106590.jpeg,https://derpicdn.net/img/view/2019/8/1/2106590.jpeg,0,0.977973044,0,26,386,418,386,392,applejack
2108161.jpeg,https://derpicdn.net/img/view/2019/8/3/2108161.jpeg,1,0.937064648,45,0,711,662,666,662,applejack
2108419.jpeg,https://derpicdn.net/img/view/2019/8/4/2108419.jpeg,0,0.999109566,365,0,1017,629,652,629,applejack
2109288.jpeg,https://derpicdn.net/img/view/2019/8/5/2109288.jpeg,0,0.979337931,344,53,1114,869,770,816,applejack
2110128.jpeg,https://derpicdn.net/img/view/2019/8/5/2110128.jpeg,0,0.983228385,0,16,682,764,682,748,applejack
2113587.jpeg,https://derpicdn.net/img/view/2019/8/10/2113587.jpeg,0,0.999884963,230,0,784,537,554,537,applejack
2114400.jpeg,https://derpicdn.net/img/view/2019/8/10/2114400.jpeg,0,0.998691201,246,0,622,369,376,369,applejack
2120074.jpeg,https://derpicdn.net/img/view/2019/8/17/2120074.jpeg,0,0.948458672,35,19,929,913,894,894,applejack
2123238.jpeg,https://derpicdn.net/img/view/2019/8/20/2123238.jpeg,0,0.924510002,171,327,589,745,418,418,applejack
2125006.jpeg,https://derpicdn.net/img/view/2019/8/22/2125006.jpeg,0,0.910039127,0,0,1149,1023,1149,1023,applejack
2126899.jpeg,https://derpicdn.net/img/view/2019/8/25/2126899.jpeg,0,0.98973161,0,0,888,898,888,898,applejack
2128235.jpeg,https://derpicdn.net/img/view/2019/8/26/2128235.jpeg,0,0.986454606,124,88,862,826,738,738,applejack
2128819.jpeg,https://derpicdn.net/img/view/2019/8/27/2128819.jpeg,0,0.996974885,86,0,522,432,436,432,applejack
2129186.jpeg,https://derpicdn.net/img/view/2019/8/27/2129186.jpeg,0,0.992708862,256,39,1184,967,928,928,applejack
2129198.jpeg,https://derpicdn.net/img/view/2019/8/27/2129198.jpeg,0,0.94178015,854,249,1714,1109,860,860,applejack
2132324.jpeg,https://derpicdn.net/img/view/2019/8/31/2132324.jpeg,0,0.982744515,1018,473,2572,2027,1554,1554,applejack
2134436.jpeg,https://derpicdn.net/img/view/2019/9/2/2134436.jpeg,0,0.939278841,4,4,1395,1438,1391,1434,applejack
2136009.jpeg,https://derpicdn.net/img/view/2019/9/4/2136009.jpeg,0,0.994171262,341,479,737,875,396,396,applejack
213601.jpeg,https://derpicdn.net/img/view/2013/1/15/213601.jpeg,0,0.99246341,333,17,923,607,590,590,applejack
2142757.jpeg,https://derpicdn.net/img/view/2019/9/13/2142757.jpeg,0,0.913085103,0,0,1104,1050,1104,1050,applejack
2143982.jpeg,https://derpicdn.net/img/view/2019/9/14/2143982.jpeg,0,0.969805062,271,8,1355,1092,1084,1084,applejack
2146426.jpeg,https://derpicdn.net/img/view/2019/9/17/2146426.jpeg,0,0.959460497,65,0,783,701,718,701,applejack
2149413.jpeg,https://derpicdn.net/img/view/2019/9/21/2149413.jpeg,0,0.965360165,573,77,1395,899,822,822,applejack
2157107.jpeg,https://derpicdn.net/img/view/2019/9/30/2157107.jpeg,0,0.933612227,179,216,1255,1292,1076,1076,applejack
2157877.jpeg,https://derpicdn.net/img/view/2019/10/1/2157877.jpeg,0,0.9571594,0,1085,1242,2688,1242,1603,applejack
2158815.jpeg,https://derpicdn.net/img/view/2019/10/3/2158815.jpeg,0,0.99881798,210,0,706,457,496,457,applejack
2159341.jpeg,https://derpicdn.net/img/view/2019/10/3/2159341.jpeg,0,0.938539743,505,136,695,326,190,190,applejack
2160928.jpeg,https://derpicdn.net/img/view/2019/10/5/2160928.jpeg,0,0.990455747,0,0,506,527,506,527,applejack
2161212.jpeg,https://derpicdn.net/img/view/2019/10/6/2161212.jpeg,0,0.947177708,0,0,835,876,835,876,applejack
2164512.jpeg,https://derpicdn.net/img/view/2019/10/10/2164512.jpeg,0,0.999546111,202,62,522,382,320,320,applejack
2168273.jpeg,https://derpicdn.net/img/view/2019/10/14/2168273.jpeg,0,0.99789232,89,0,621,532,532,532,applejack
2168277.jpeg,https://derpicdn.net/img/view/2019/10/14/2168277.jpeg,0,0.998482883,202,31,814,643,612,612,applejack
2168591.jpeg,https://derpicdn.net/img/view/2019/10/14/2168591.jpeg,0,0.964395761,56,0,438,336,382,336,applejack
2172267.jpeg,https://derpicdn.net/img/view/2019/10/18/2172267.jpeg,0,0.911439002,0,0,1188,1375,1188,1375,applejack
2172618.jpeg,https://derpicdn.net/img/view/2019/10/18/2172618.jpeg,0,0.964559615,584,114,1560,1090,976,976,applejack
2175752.jpeg,https://derpicdn.net/img/view/2019/10/22/2175752.jpeg,0,0.997419119,464,80,1060,676,596,596,applejack
2176254.jpeg,https://derpicdn.net/img/view/2019/10/22/2176254.jpeg,0,0.90401113,177,86,1379,1288,1202,1202,applejack
2176969.jpeg,https://derpicdn.net/img/view/2019/10/23/2176969.jpeg,0,0.941591859,492,139,1092,739,600,600,applejack
2177648.jpeg,https://derpicdn.net/img/view/2019/10/24/2177648.jpeg,0,0.99649924,494,28,848,382,354,354,applejack
2179056.jpeg,https://derpicdn.net/img/view/2019/10/25/2179056.jpeg,0,0.932229996,73,68,263,258,190,190,applejack
2182612.jpeg,https://derpicdn.net/img/view/2019/10/30/2182612.jpeg,0,0.986941755,210,52,1228,1070,1018,1018,applejack
2182614.jpeg,https://derpicdn.net/img/view/2019/10/30/2182614.jpeg,0,0.973837912,389,14,1400,1118,1011,1104,applejack
2182615.jpeg,https://derpicdn.net/img/view/2019/10/30/2182615.jpeg,0,0.955545664,138,0,1308,1141,1170,1141,applejack
2184702.jpeg,https://derpicdn.net/img/view/2019/11/1/2184702.jpeg,0,0.973511338,0,4,700,800,700,796,applejack
2185864.jpeg,https://derpicdn.net/img/view/2019/11/2/2185864.jpeg,0,0.991265714,1539,370,3105,1936,1566,1566,applejack
2185864.jpeg,https://derpicdn.net/img/view/2019/11/2/2185864.jpeg,1,0.980424285,1283,2115,1901,2733,618,618,applejack
2191607.jpeg,https://derpicdn.net/img/view/2019/11/9/2191607.jpeg,0,0.978095293,1109,247,1879,1017,770,770,applejack
2192005.jpeg,https://derpicdn.net/img/view/2019/11/10/2192005.jpeg,0,0.997907937,285,32,887,634,602,602,applejack
2192854.jpeg,https://derpicdn.net/img/view/2019/11/11/2192854.jpeg,0,0.989041388,0,29,1280,1419,1280,1390,applejack
2192981.jpeg,https://derpicdn.net/img/view/2019/11/11/2192981.jpeg,0,0.978382289,362,361,718,715,356,354,applejack
2192981.jpeg,https://derpicdn.net/img/view/2019/11/11/2192981.jpeg,1,0.946002603,26,9,326,309,300,300,applejack
2195542.jpeg,https://derpicdn.net/img/view/2019/11/14/2195542.jpeg,0,0.968120277,159,106,963,910,804,804,applejack
2197446.jpeg,https://derpicdn.net/img/view/2019/11/16/2197446.jpeg,0,0.977223873,0,197,1661,1981,1661,1784,applejack
2199105.jpeg,https://derpicdn.net/img/view/2019/11/18/2199105.jpeg,0,0.911044538,155,0,1285,1000,1130,1000,applejack
2201813.jpeg,https://derpicdn.net/img/view/2019/11/21/2201813.jpeg,0,0.98370564,131,0,1053,890,922,890,applejack
2202746.jpeg,https://derpicdn.net/img/view/2019/11/22/2202746.jpeg,1,0.978977144,475,724,759,1008,284,284,applejack
220555.jpeg,https://derpicdn.net/img/view/2013/1/22/220555.jpeg,0,0.950452209,72,0,468,412,396,412,applejack
2205646.jpeg,https://derpicdn.net/img/view/2019/11/25/2205646.jpeg,0,0.998745501,342,0,964,619,622,619,applejack
2211318.jpeg,https://derpicdn.net/img/view/2019/12/3/2211318.jpeg,0,0.9969877,12,0,460,413,448,413,applejack
2212299.jpeg,https://derpicdn.net/img/view/2019/12/4/2212299.jpeg,0,0.998380661,312,55,680,423,368,368,applejack
2212299.jpeg,https://derpicdn.net/img/view/2019/12/4/2212299.jpeg,1,0.990009189,419,783,801,1165,382,382,applejack
221353.jpeg,https://derpicdn.net/img/view/2013/1/23/221353.jpeg,0,0.999659777,562,192,984,614,422,422,applejack
2215268.jpeg,https://derpicdn.net/img/view/2019/12/7/2215268.jpeg,0,0.994379401,58,0,612,539,554,539,applejack
2217959.jpeg,https://derpicdn.net/img/view/2019/12/11/2217959.jpeg,0,0.985674977,573,0,1229,542,656,542,applejack
2220602.jpeg,https://derpicdn.net/img/view/2019/12/14/2220602.jpeg,0,0.965901136,151,20,836,758,685,738,applejack
2222889.jpeg,https://derpicdn.net/img/view/2019/12/17/2222889.jpeg,0,0.967875898,36,14,434,412,398,398,applejack
2224864.jpeg,https://derpicdn.net/img/view/2019/12/20/2224864.jpeg,0,0.944564342,151,26,1707,1620,1556,1594,applejack
223295.jpeg,https://derpicdn.net/img/view/2013/1/25/223295.jpeg,0,0.90964514,186,2,436,252,250,250,applejack
226187.jpeg,https://derpicdn.net/img/view/2013/1/28/226187.jpeg,0,0.945515454,0,11,410,433,410,422,applejack
237764.jpeg,https://derpicdn.net/img/view/2013/2/9/237764.jpeg,1,0.987562835,532,52,1210,730,678,678,applejack
246339.jpeg,https://derpicdn.net/img/view/2013/2/17/246339.jpeg,0,0.979194999,49,243,307,501,258,258,applejack
251539.jpeg,https://derpicdn.net/img/view/2013/2/22/251539.jpeg,0,0.907385945,277,0,701,401,424,401,applejack
258278.jpeg,https://derpicdn.net/img/view/2013/2/28/258278.jpeg,0,0.970725894,43,60,987,1004,944,944,applejack
272731.jpeg,https://derpicdn.net/img/view/2013/3/17/272731.jpeg,0,0.993714333,327,81,569,323,242,242,applejack
281824.jpeg,https://derpicdn.net/img/view/2013/3/28/281824.jpeg,0,0.935482621,36,92,480,536,444,444,applejack
286206.jpeg,https://derpicdn.net/img/view/2013/4/2/286206.jpeg,0,0.99856925,441,184,899,642,458,458,applejack
294237.jpeg,https://derpicdn.net/img/view/2013/4/11/294237.jpeg,0,0.995117366,1514,0,1912,398,398,398,applejack
296291.jpeg,https://derpicdn.net/img/view/2013/4/13/296291.jpeg,0,0.993941963,71,0,423,338,352,338,applejack
299389.jpeg,https://derpicdn.net/img/view/2013/4/15/299389.jpeg,0,0.985439241,545,133,1019,607,474,474,applejack
300665.jpeg,https://derpicdn.net/img/view/2013/4/17/300665.jpeg,0,0.914538562,411,0,907,473,496,473,applejack
307890.jpeg,https://derpicdn.net/img/view/2013/4/25/307890.jpeg,0,0.996475697,594,70,804,280,210,210,applejack
307890.jpeg,https://derpicdn.net/img/view/2013/4/25/307890.jpeg,1,0.988987505,145,293,459,607,314,314,applejack
333910.jpeg,https://derpicdn.net/img/view/2013/5/26/333910.jpeg,0,0.954637051,855,32,1659,836,804,804,applejack
341257.jpeg,https://derpicdn.net/img/view/2013/6/5/341257.jpeg,0,0.995281279,287,0,723,417,436,417,applejack
377569.jpeg,https://derpicdn.net/img/view/2013/7/18/377569.jpeg,0,0.990645647,195,215,539,559,344,344,applejack
377570.jpeg,https://derpicdn.net/img/view/2013/7/18/377570.jpeg,0,0.990083635,428,179,688,439,260,260,applejack
379744.jpeg,https://derpicdn.net/img/view/2013/7/20/379744.jpeg,0,0.975064456,60,60,710,710,650,650,applejack
381603.jpeg,https://derpicdn.net/img/view/2013/7/22/381603.jpeg,0,0.97933656,195,120,407,332,212,212,applejack
381603.jpeg,https://derpicdn.net/img/view/2013/7/22/381603.jpeg,1,0.929834485,423,94,631,302,208,208,applejack
385445.jpeg,https://derpicdn.net/img/view/2013/7/29/385445.jpeg,0,0.980217874,132,23,414,305,282,282,applejack
394882.jpeg,https://derpicdn.net/img/view/2013/8/8/394882.jpeg,0,0.994036138,680,113,2080,1513,1400,1400,applejack
400841.jpeg,https://derpicdn.net/img/view/2013/8/15/400841.jpeg,0,0.98505497,287,0,603,316,316,316,applejack
414601.jpeg,https://derpicdn.net/img/view/2013/8/30/414601.jpeg,0,0.989800751,126,0,392,247,266,247,applejack
429504.jpeg,https://derpicdn.net/img/view/2013/9/17/429504.jpeg,0,0.924560905,1704,460,2402,1158,698,698,applejack
430132.jpeg,https://derpicdn.net/img/view/2013/9/18/430132.jpeg,0,0.977228284,99,70,487,458,388,388,applejack
447325.jpeg,https://derpicdn.net/img/view/2013/10/12/447325.jpeg,0,0.966205537,152,15,574,437,422,422,applejack
448471.jpeg,https://derpicdn.net/img/view/2013/10/14/448471.jpeg,0,0.996326447,474,0,1138,572,664,572,applejack
449988.jpeg,https://derpicdn.net/img/view/2013/10/16/449988.jpeg,0,0.984339774,132,0,900,636,768,636,applejack
470790.jpeg,https://derpicdn.net/img/view/2013/11/12/470790.jpeg,0,0.997548223,255,0,731,470,476,470,applejack
512705.jpeg,https://derpicdn.net/img/view/2014/1/2/512705.jpeg,0,0.999114573,210,0,572,353,362,353,applejack
539394.jpeg,https://derpicdn.net/img/view/2014/1/31/539394.jpeg,0,0.991584659,242,0,954,680,712,680,applejack
550242.jpeg,https://derpicdn.net/img/view/2014/2/12/550242.jpeg,0,0.97839576,88,0,448,329,360,329,applejack
569928.jpeg,https://derpicdn.net/img/view/2014/3/9/569928.jpeg,0,0.992394567,179,0,459,261,280,261,applejack
572633.jpeg,https://derpicdn.net/img/view/2014/3/11/572633.jpeg,0,0.969537258,64,0,408,310,344,310,applejack
574370.jpeg,https://derpicdn.net/img/view/2014/3/13/574370.jpeg,0,0.984499335,17,0,501,467,484,467,applejack
578696.jpeg,https://derpicdn.net/img/view/2014/3/18/578696.jpeg,0,0.975220561,1123,197,3291,2365,2168,2168,applejack
590747.jpeg,https://derpicdn.net/img/view/2014/4/2/590747.jpeg,0,0.991092861,174,0,848,539,674,539,applejack
594074.jpeg,https://derpicdn.net/img/view/2014/4/6/594074.jpeg,0,0.991777241,7,53,467,513,460,460,applejack
594638.jpeg,https://derpicdn.net/img/view/2014/4/6/594638.jpeg,0,0.994860351,125,12,661,548,536,536,applejack
596653.jpeg,https://derpicdn.net/img/view/2014/4/9/596653.jpeg,0,0.998099327,29,112,279,362,250,250,applejack
626364.jpeg,https://derpicdn.net/img/view/2014/5/14/626364.jpeg,0,0.972173452,648,0,988,317,340,317,applejack
630814.jpeg,https://derpicdn.net/img/view/2014/5/19/630814.jpeg,0,0.97154969,296,322,456,482,160,160,applejack
641319.jpeg,https://derpicdn.net/img/view/2014/5/31/641319.jpeg,0,0.991056085,314,124,926,736,612,612,applejack
643272.jpeg,https://derpicdn.net/img/view/2014/6/2/643272.jpeg,0,0.956069112,31,0,379,348,348,348,applejack
645639.jpeg,https://derpicdn.net/img/view/2014/6/5/645639.jpeg,0,0.937114358,1251,473,1529,751,278,278,applejack
650040.jpeg,https://derpicdn.net/img/view/2014/6/10/650040.jpeg,0,0.99061805,193,0,561,320,368,320,applejack
650040.jpeg,https://derpicdn.net/img/view/2014/6/10/650040.jpeg,1,0.95704478,444,0,832,353,388,353,applejack
667475.jpeg,https://derpicdn.net/img/view/2014/7/4/667475.jpeg,0,0.980509698,783,71,1323,611,540,540,applejack
668639.jpeg,https://derpicdn.net/img/view/2014/7/6/668639.jpeg,0,0.999443829,85,92,761,768,676,676,applejack
670447.jpeg,https://derpicdn.net/img/view/2014/7/8/670447.jpeg,0,0.949322879,1092,898,1640,1446,548,548,applejack
685040.jpeg,https://derpicdn.net/img/view/2014/7/28/685040.jpeg,0,0.940370381,191,0,667,462,476,462,applejack
687671.jpeg,https://derpicdn.net/img/view/2014/7/31/687671.jpeg,0,0.980133653,85,0,499,412,414,412,applejack
690065.jpeg,https://derpicdn.net/img/view/2014/8/3/690065.jpeg,0,0.98086977,57,1,329,273,272,272,applejack
690068.jpeg,https://derpicdn.net/img/view/2014/8/3/690068.jpeg,0,0.982958555,343,103,513,273,170,170,applejack
705033.jpeg,https://derpicdn.net/img/view/2014/8/21/705033.jpeg,0,0.996673465,213,41,605,433,392,392,applejack
706332.jpeg,https://derpicdn.net/img/view/2014/8/23/706332.jpeg,0,0.990470707,4,0,726,666,722,666,applejack
713680.jpeg,https://derpicdn.net/img/view/2014/9/2/713680.jpeg,0,0.985978782,312,80,770,538,458,458,applejack
738343.jpeg,https://derpicdn.net/img/view/2014/10/8/738343.jpeg,0,0.992409885,0,0,604,576,604,576,applejack
738711.jpeg,https://derpicdn.net/img/view/2014/10/8/738711.jpeg,0,0.990997374,292,52,756,516,464,464,applejack
750718.jpeg,https://derpicdn.net/img/view/2014/10/26/750718.jpeg,0,0.971476853,261,174,563,476,302,302,applejack
772013.jpeg,https://derpicdn.net/img/view/2014/11/26/772013.jpeg,0,0.96241653,119,63,1804,1795,1685,1732,applejack
772578.jpeg,https://derpicdn.net/img/view/2014/11/27/772578.jpeg,0,0.998763025,554,0,1060,494,506,494,applejack
778873.jpeg,https://derpicdn.net/img/view/2014/12/6/778873.jpeg,0,0.971865177,558,95,974,511,416,416,applejack
786614.jpeg,https://derpicdn.net/img/view/2014/12/17/786614.jpeg,0,0.998734295,328,0,1104,698,776,698,applejack
788607.jpeg,https://derpicdn.net/img/view/2014/12/20/788607.jpeg,0,0.999395967,95,0,661,552,566,552,applejack
789571.jpeg,https://derpicdn.net/img/view/2014/12/21/789571.jpeg,0,0.999525428,1905,14,2605,714,700,700,applejack
791050.jpeg,https://derpicdn.net/img/view/2014/12/23/791050.jpeg,0,0.940490127,0,42,310,366,310,324,applejack
791504.jpeg,https://derpicdn.net/img/view/2014/12/24/791504.jpeg,0,0.917749941,336,0,1074,720,738,720,applejack
801367.jpeg,https://derpicdn.net/img/view/2015/1/7/801367.jpeg,0,0.994275212,565,0,1650,1013,1085,1013,applejack
803357.jpeg,https://derpicdn.net/img/view/2015/1/10/803357.jpeg,0,0.976424217,19,0,805,805,786,805,applejack
804407.jpeg,https://derpicdn.net/img/view/2015/1/11/804407.jpeg,0,0.971874654,803,0,1479,605,676,605,applejack
805167.jpeg,https://derpicdn.net/img/view/2015/1/13/805167.jpeg,0,0.939315617,284,505,1296,1517,1012,1012,applejack
814231.jpeg,https://derpicdn.net/img/view/2015/1/25/814231.jpeg,0,0.992576003,206,0,422,216,216,216,applejack
818185.jpeg,https://derpicdn.net/img/view/2015/1/31/818185.jpeg,0,0.920680821,221,92,601,472,380,380,applejack
822323.jpeg,https://derpicdn.net/img/view/2015/2/6/822323.jpeg,0,0.922371447,0,0,891,1034,891,1034,applejack
826890.jpeg,https://derpicdn.net/img/view/2015/2/12/826890.jpeg,0,0.936781824,944,267,2480,2089,1536,1822,applejack
831698.jpeg,https://derpicdn.net/img/view/2015/2/18/831698.jpeg,0,0.994066656,114,0,438,322,324,322,applejack
835643.jpeg,https://derpicdn.net/img/view/2015/2/23/835643.jpeg,0,0.98573035,223,231,495,503,272,272,applejack
855052.jpeg,https://derpicdn.net/img/view/2015/3/22/855052.jpeg,0,0.989189267,0,13,449,467,449,454,applejack
855768.jpeg,https://derpicdn.net/img/view/2015/3/23/855768.jpeg,0,0.972721696,22,340,506,824,484,484,applejack
863735.jpeg,https://derpicdn.net/img/view/2015/4/3/863735.jpeg,0,0.943191171,94,0,884,682,790,682,applejack
86698.jpeg,https://derpicdn.net/img/view/2012/8/30/86698.jpeg,0,0.989558816,0,0,533,422,533,422,applejack
867570.jpeg,https://derpicdn.net/img/view/2015/4/7/867570.jpeg,0,0.981308341,63,17,451,405,388,388,applejack
869272.jpeg,https://derpicdn.net/img/view/2015/4/9/869272.jpeg,0,0.996780455,412,0,1584,1110,1172,1110,applejack
869695.jpeg,https://derpicdn.net/img/view/2015/4/9/869695.jpeg,0,0.999023318,237,13,631,407,394,394,applejack
873096.jpeg,https://derpicdn.net/img/view/2015/4/13/873096.jpeg,0,0.962850749,331,54,605,328,274,274,applejack
891425.jpeg,https://derpicdn.net/img/view/2015/5/8/891425.jpeg,0,0.981519759,160,9,306,155,146,146,applejack
924422.jpeg,https://derpicdn.net/img/view/2015/6/27/924422.jpeg,0,0.999820709,364,0,962,592,598,592,applejack
939865.jpeg,https://derpicdn.net/img/view/2015/7/19/939865.jpeg,0,0.987031579,119,0,771,635,652,635,applejack
940550.jpeg,https://derpicdn.net/img/view/2015/7/20/940550.jpeg,0,0.997136891,1181,0,2569,1248,1388,1248,applejack
940693.jpeg,https://derpicdn.net/img/view/2015/7/20/940693.jpeg,0,0.996945381,252,0,850,580,598,580,applejack
942501.jpeg,https://derpicdn.net/img/view/2015/7/23/942501.jpeg,0,0.968565285,876,0,1468,566,592,566,applejack
947933.jpeg,https://derpicdn.net/img/view/2015/7/31/947933.jpeg,0,0.944620013,106,10,666,570,560,560,applejack
952084.jpeg,https://derpicdn.net/img/view/2015/8/6/952084.jpeg,0,0.934976578,0,0,2238,1942,2238,1942,applejack
958355.jpeg,https://derpicdn.net/img/view/2015/8/15/958355.jpeg,0,0.960106552,76,5,552,481,476,476,applejack
958904.jpeg,https://derpicdn.net/img/view/2015/8/16/958904.jpeg,0,0.985059798,343,49,959,665,616,616,applejack
960165.jpeg,https://derpicdn.net/img/view/2015/8/18/960165.jpeg,0,0.912026525,469,0,1335,830,866,830,applejack
962565.jpeg,https://derpicdn.net/img/view/2015/8/21/962565.jpeg,0,0.985297501,0,0,2149,1883,2149,1883,applejack
962747.jpeg,https://derpicdn.net/img/view/2015/8/21/962747.jpeg,0,0.999398828,283,0,1215,905,932,905,applejack
982400.jpeg,https://derpicdn.net/img/view/2015/9/18/982400.jpeg,0,0.954220355,398,0,1086,630,688,630,applejack
994516.jpeg,https://derpicdn.net/img/view/2015/10/4/994516.jpeg,0,0.995295465,1126,204,2838,1916,1712,1712,applejack
994932.jpeg,https://derpicdn.net/img/view/2015/10/5/994932.jpeg,0,0.997776687,37,0,725,639,688,639,applejack
998499.jpeg,https://derpicdn.net/img/view/2015/10/10/998499.jpeg,0,0.950651288,259,251,579,571,320,320,applejack
1001513.png,https://derpicdn.net/img/view/2015/10/13/1001513.png,0,0.944202662,0,0,1156,1246,1156,1246,fluttershy
1001513.png,https://derpicdn.net/img/view/2015/10/13/1001513.png,0,0.944202662,0,41,1099,1189,1099,1148,fluttershy
1001513.png,https://derpicdn.net/img/view/2015/10/13/1001513.png,0,0.944202662,0,41,1099,1189,1099,1148,fluttershy
1006525.png,https://derpicdn.net/img/view/2015/10/20/1006525.png,0,0.986039877,102,246,1576,1720,1474,1474,fluttershy
1006525.png,https://derpicdn.net/img/view/2015/10/20/1006525.png,0,0.986039877,170,313,1512,1655,1342,1342,fluttershy
1006525.png,https://derpicdn.net/img/view/2015/10/20/1006525.png,0,0.986039877,170,313,1512,1655,1342,1342,fluttershy
1009963.png,https://derpicdn.net/img/view/2015/10/25/1009963.png,0,0.917863905,0,0,1700,2231,1700,2231,fluttershy
1009963.png,https://derpicdn.net/img/view/2015/10/25/1009963.png,0,0.917863905,0,0,1700,2123,1700,2123,fluttershy
1009963.png,https://derpicdn.net/img/view/2015/10/25/1009963.png,0,0.917863905,0,0,1700,2123,1700,2123,fluttershy
1010013.png,https://derpicdn.net/img/view/2015/10/25/1010013.png,0,0.995275438,271,0,840,546,569,546,fluttershy
1010013.png,https://derpicdn.net/img/view/2015/10/25/1010013.png,0,0.995275438,299,0,840,522,541,522,fluttershy
1010013.png,https://derpicdn.net/img/view/2015/10/25/1010013.png,0,0.995275438,299,0,840,522,541,522,fluttershy
1010811.png,https://derpicdn.net/img/view/2015/10/28/1010811.png,0,0.911064863,883,209,1731,1057,848,848,fluttershy
1010811.png,https://derpicdn.net/img/view/2015/10/28/1010811.png,0,0.911064863,924,248,1694,1018,770,770,fluttershy
1010811.png,https://derpicdn.net/img/view/2015/10/28/1010811.png,0,0.911064863,924,248,1694,1018,770,770,fluttershy
1010909.png,https://derpicdn.net/img/view/2015/10/28/1010909.png,0,0.998274267,1154,0,2870,1395,1716,1395,fluttershy
1010909.png,https://derpicdn.net/img/view/2015/10/28/1010909.png,0,0.998274267,1231,0,2789,1316,1558,1316,fluttershy
1010909.png,https://derpicdn.net/img/view/2015/10/28/1010909.png,0,0.998274267,1231,0,2789,1316,1558,1316,fluttershy
1012039.png,https://derpicdn.net/img/view/2015/10/29/1012039.png,0,0.993483007,583,238,1079,734,496,496,fluttershy
1012039.png,https://derpicdn.net/img/view/2015/10/29/1012039.png,0,0.993483007,604,260,1058,714,454,454,fluttershy
1012039.png,https://derpicdn.net/img/view/2015/10/29/1012039.png,0,0.993483007,604,260,1058,714,454,454,fluttershy
1012584.png,https://derpicdn.net/img/view/2015/10/30/1012584.png,0,0.953028858,104,0,1330,1129,1226,1129,fluttershy
1012584.png,https://derpicdn.net/img/view/2015/10/30/1012584.png,0,0.953028858,160,0,1276,1065,1116,1065,fluttershy
1012584.png,https://derpicdn.net/img/view/2015/10/30/1012584.png,0,0.953028858,160,0,1276,1065,1116,1065,fluttershy
1013007.png,https://derpicdn.net/img/view/2015/10/31/1013007.png,0,0.957360148,1448,0,3200,2273,1752,2273,fluttershy
1013007.png,https://derpicdn.net/img/view/2015/10/31/1013007.png,0,0.957360148,1557,47,3200,2163,1643,2116,fluttershy
1013007.png,https://derpicdn.net/img/view/2015/10/31/1013007.png,0,0.957360148,1557,47,3200,2163,1643,2116,fluttershy
1013272.png,https://derpicdn.net/img/view/2015/10/31/1013272.png,0,0.986677408,1398,732,2238,1572,840,840,fluttershy
1013272.png,https://derpicdn.net/img/view/2015/10/31/1013272.png,1,0.977019727,178,0,1464,994,1286,994,fluttershy
1013272.png,https://derpicdn.net/img/view/2015/10/31/1013272.png,0,0.986677408,1439,772,2201,1534,762,762,fluttershy
1013272.png,https://derpicdn.net/img/view/2015/10/31/1013272.png,1,0.977019727,237,0,1403,920,1166,920,fluttershy
1013272.png,https://derpicdn.net/img/view/2015/10/31/1013272.png,0,0.986677408,1439,772,2201,1534,762,762,fluttershy
1013272.png,https://derpicdn.net/img/view/2015/10/31/1013272.png,1,0.977019727,237,0,1403,920,1166,920,fluttershy
1013810.png,https://derpicdn.net/img/view/2015/11/1/1013810.png,0,0.970066428,323,0,593,258,270,258,fluttershy
1013810.png,https://derpicdn.net/img/view/2015/11/1/1013810.png,0,0.970066428,335,1,581,247,246,246,fluttershy
1013810.png,https://derpicdn.net/img/view/2015/11/1/1013810.png,0,0.970066428,335,1,581,247,246,246,fluttershy
1015500.png,https://derpicdn.net/img/view/2015/11/3/1015500.png,0,0.995976925,503,0,1439,893,936,893,fluttershy
1015500.png,https://derpicdn.net/img/view/2015/11/3/1015500.png,0,0.995976925,526,0,1416,850,890,850,fluttershy
1015500.png,https://derpicdn.net/img/view/2015/11/3/1015500.png,0,0.995976925,526,0,1416,850,890,850,fluttershy
1016240.png,https://derpicdn.net/img/view/2015/11/4/1016240.png,0,0.978223979,89,0,750,727,661,727,fluttershy
1016240.png,https://derpicdn.net/img/view/2015/11/4/1016240.png,0,0.978223979,136,15,750,693,614,678,fluttershy
1016240.png,https://derpicdn.net/img/view/2015/11/4/1016240.png,0,0.978223979,136,15,750,693,614,678,fluttershy
1016321.png,https://derpicdn.net/img/view/2015/11/5/1016321.png,0,0.997029006,1063,135,1657,729,594,594,fluttershy
1016321.png,https://derpicdn.net/img/view/2015/11/5/1016321.png,0,0.997029006,1089,161,1631,703,542,542,fluttershy
1016321.png,https://derpicdn.net/img/view/2015/11/5/1016321.png,0,0.997029006,1089,161,1631,703,542,542,fluttershy
1017781.png,https://derpicdn.net/img/view/2015/11/7/1017781.png,0,0.992847502,61,0,615,424,554,424,fluttershy
1017781.png,https://derpicdn.net/img/view/2015/11/7/1017781.png,0,0.992847502,86,0,590,398,504,398,fluttershy
1017781.png,https://derpicdn.net/img/view/2015/11/7/1017781.png,0,0.992847502,86,0,590,398,504,398,fluttershy
1017782.png,https://derpicdn.net/img/view/2015/11/7/1017782.png,0,0.961884439,35,0,599,478,564,478,fluttershy
1017782.png,https://derpicdn.net/img/view/2015/11/7/1017782.png,0,0.961884439,62,0,598,443,536,443,fluttershy
1017782.png,https://derpicdn.net/img/view/2015/11/7/1017782.png,0,0.961884439,62,0,598,443,536,443,fluttershy
1020017.png,https://derpicdn.net/img/view/2015/11/10/1020017.png,0,0.972684085,12,0,520,413,508,413,fluttershy
1020017.png,https://derpicdn.net/img/view/2015/11/10/1020017.png,0,0.972684085,34,0,496,388,462,388,fluttershy
1020017.png,https://derpicdn.net/img/view/2015/11/10/1020017.png,0,0.972684085,34,0,496,388,462,388,fluttershy
1021073.png,https://derpicdn.net/img/view/2015/11/11/1021073.png,0,0.987860978,250,17,880,647,630,630,fluttershy
1021073.png,https://derpicdn.net/img/view/2015/11/11/1021073.png,0,0.987860978,278,47,852,621,574,574,fluttershy
1021073.png,https://derpicdn.net/img/view/2015/11/11/1021073.png,0,0.987860978,278,47,852,621,574,574,fluttershy
1021082.png,https://derpicdn.net/img/view/2015/11/11/1021082.png,0,0.9875741,196,66,872,742,676,676,fluttershy
1021082.png,https://derpicdn.net/img/view/2015/11/11/1021082.png,0,0.9875741,226,97,842,713,616,616,fluttershy
1021082.png,https://derpicdn.net/img/view/2015/11/11/1021082.png,0,0.9875741,226,97,842,713,616,616,fluttershy
1021565.png,https://derpicdn.net/img/view/2015/11/12/1021565.png,0,0.975882947,0,0,550,533,550,533,fluttershy
1021565.png,https://derpicdn.net/img/view/2015/11/12/1021565.png,0,0.975882947,0,0,523,504,523,504,fluttershy
1021565.png,https://derpicdn.net/img/view/2015/11/12/1021565.png,0,0.975882947,0,0,523,504,523,504,fluttershy
1023148.png,https://derpicdn.net/img/view/2015/11/15/1023148.png,0,0.96332562,0,0,4772,6665,4772,6665,fluttershy
1023148.png,https://derpicdn.net/img/view/2015/11/15/1023148.png,0,0.96332562,0,206,4772,6586,4772,6380,fluttershy
1023148.png,https://derpicdn.net/img/view/2015/11/15/1023148.png,0,0.96332562,0,206,4772,6586,4772,6380,fluttershy
1024027.png,https://derpicdn.net/img/view/2015/11/16/1024027.png,0,0.998520792,139,0,825,550,686,550,fluttershy
1024027.png,https://derpicdn.net/img/view/2015/11/16/1024027.png,0,0.998520792,170,0,794,516,624,516,fluttershy
1024027.png,https://derpicdn.net/img/view/2015/11/16/1024027.png,0,0.998520792,170,0,794,516,624,516,fluttershy
1027706.png,https://derpicdn.net/img/view/2015/11/22/1027706.png,0,0.991031229,455,0,759,284,304,284,fluttershy
1027706.png,https://derpicdn.net/img/view/2015/11/22/1027706.png,0,0.991031229,469,0,747,265,278,265,fluttershy
1027706.png,https://derpicdn.net/img/view/2015/11/22/1027706.png,0,0.991031229,469,0,747,265,278,265,fluttershy
1028436.png,https://derpicdn.net/img/view/2015/11/23/1028436.png,0,0.961572766,0,0,1842,1981,1842,1981,fluttershy
1028436.png,https://derpicdn.net/img/view/2015/11/23/1028436.png,0,0.961572766,0,0,1842,1887,1842,1887,fluttershy
1028436.png,https://derpicdn.net/img/view/2015/11/23/1028436.png,0,0.961572766,0,0,1842,1887,1842,1887,fluttershy
1029857.png,https://derpicdn.net/img/view/2015/11/25/1029857.png,0,0.983783901,90,0,646,450,556,450,fluttershy
1030197.png,https://derpicdn.net/img/view/2015/11/25/1030197.png,0,0.98333627,31,6,465,440,434,434,fluttershy
1030983.png,https://derpicdn.net/img/view/2015/11/27/1030983.png,0,0.947345078,181,0,705,513,524,513,fluttershy
1032523.png,https://derpicdn.net/img/view/2015/11/29/1032523.png,0,0.987583041,62,0,1178,975,1116,975,fluttershy
1033818.png,https://derpicdn.net/img/view/2015/11/30/1033818.png,0,0.994290411,747,962,1773,1988,1026,1026,fluttershy
1035689.png,https://derpicdn.net/img/view/2015/12/3/1035689.png,0,0.998313606,54,0,786,703,732,703,fluttershy
1042981.png,https://derpicdn.net/img/view/2015/12/12/1042981.png,0,0.996280551,125,0,549,383,424,383,fluttershy
1043065.png,https://derpicdn.net/img/view/2015/12/13/1043065.png,0,0.931008577,25,0,1163,1063,1138,1063,fluttershy
1044589.jpg,https://derpicdn.net/img/view/2015/12/14/1044589.jpg,0,0.995006979,316,4,1336,1024,1020,1020,fluttershy
1044603.png,https://derpicdn.net/img/view/2015/12/14/1044603.png,0,0.954145312,89,0,453,329,364,329,fluttershy
1045596.png,https://derpicdn.net/img/view/2015/12/16/1045596.png,0,0.986164033,263,198,623,558,360,360,fluttershy
1045657.png,https://derpicdn.net/img/view/2015/12/16/1045657.png,0,0.988843679,45,0,679,626,634,626,fluttershy
1047152.png,https://derpicdn.net/img/view/2015/12/18/1047152.png,0,0.957102239,249,473,1109,1333,860,860,fluttershy
1051258.png,https://derpicdn.net/img/view/2015/12/23/1051258.png,0,0.993964076,240,81,838,679,598,598,fluttershy
1053537.png,https://derpicdn.net/img/view/2015/12/27/1053537.png,0,0.935801923,67,19,1819,1771,1752,1752,fluttershy
1063090.png,https://derpicdn.net/img/view/2016/1/9/1063090.png,0,0.962330341,170,13,714,557,544,544,fluttershy
1063091.png,https://derpicdn.net/img/view/2016/1/9/1063091.png,0,0.9759444,157,5,723,571,566,566,fluttershy
1064643.png,https://derpicdn.net/img/view/2016/1/11/1064643.png,0,0.999485612,1105,0,3803,2595,2698,2595,fluttershy
1065348.png,https://derpicdn.net/img/view/2016/1/12/1065348.png,0,0.994617105,428,81,1910,1563,1482,1482,fluttershy
1066465.png,https://derpicdn.net/img/view/2016/1/14/1066465.png,0,0.9820472,94,0,994,895,900,895,fluttershy
1068473.png,https://derpicdn.net/img/view/2016/1/17/1068473.png,0,0.996646941,515,0,1863,1240,1348,1240,fluttershy
1070369.png,https://derpicdn.net/img/view/2016/1/20/1070369.png,0,0.988042533,282,63,1286,1067,1004,1004,fluttershy
1070390.png,https://derpicdn.net/img/view/2016/1/20/1070390.png,0,0.988834321,282,63,1290,1071,1008,1008,fluttershy
1071183.png,https://derpicdn.net/img/view/2016/1/22/1071183.png,0,0.982689738,146,27,330,211,184,184,fluttershy
1071346.png,https://derpicdn.net/img/view/2016/1/22/1071346.png,0,0.993982494,1416,0,2938,1479,1522,1479,fluttershy
1075051.png,https://derpicdn.net/img/view/2016/1/28/1075051.png,0,0.982865274,221,20,587,386,366,366,fluttershy
1075628.png,https://derpicdn.net/img/view/2016/1/28/1075628.png,0,0.960290313,125,31,737,643,612,612,fluttershy
1076078.png,https://derpicdn.net/img/view/2016/1/29/1076078.png,0,0.958624065,51,5,759,713,708,708,fluttershy
1077140.png,https://derpicdn.net/img/view/2016/1/31/1077140.png,0,0.998028874,279,0,1173,818,894,818,fluttershy
1080688.jpg,https://derpicdn.net/img/view/2016/2/5/1080688.jpg,0,0.914676905,0,117,1229,1439,1229,1322,fluttershy
1083544.png,https://derpicdn.net/img/view/2016/2/8/1083544.png,0,0.926151693,37,0,419,379,382,379,fluttershy
1083907.png,https://derpicdn.net/img/view/2016/2/9/1083907.png,0,0.9694134,765,0,2067,1125,1302,1125,fluttershy
1084264.png,https://derpicdn.net/img/view/2016/2/10/1084264.png,0,0.999001026,745,231,1175,661,430,430,fluttershy
1084264.png,https://derpicdn.net/img/view/2016/2/10/1084264.png,1,0.985376835,8,739,822,1553,814,814,fluttershy
1085692.png,https://derpicdn.net/img/view/2016/2/11/1085692.png,0,0.980714023,0,13,429,515,429,502,fluttershy
1092611.png,https://derpicdn.net/img/view/2016/2/20/1092611.png,0,0.985551417,227,0,2397,2088,2170,2088,fluttershy
1093519.jpg,https://derpicdn.net/img/view/2016/2/21/1093519.jpg,0,0.944629192,0,89,325,533,325,444,fluttershy
1098221.png,https://derpicdn.net/img/view/2016/2/28/1098221.png,0,0.989106774,343,0,981,611,638,611,fluttershy
1099241.png,https://derpicdn.net/img/view/2016/2/29/1099241.png,0,0.993574619,824,44,1370,590,546,546,fluttershy
1102711.png,https://derpicdn.net/img/view/2016/3/5/1102711.png,0,0.990891457,498,0,1380,870,882,870,fluttershy
1103508.png,https://derpicdn.net/img/view/2016/3/6/1103508.png,0,0.998304129,310,6,644,340,334,334,fluttershy
1103602.png,https://derpicdn.net/img/view/2016/3/7/1103602.png,0,0.990752578,542,11,1386,855,844,844,fluttershy
1104025.png,https://derpicdn.net/img/view/2016/3/7/1104025.png,0,0.982002735,278,394,3634,4088,3356,3694,fluttershy
1108427.jpg,https://derpicdn.net/img/view/2016/3/14/1108427.jpg,0,0.950419307,60,18,626,584,566,566,fluttershy
1110094.png,https://derpicdn.net/img/view/2016/3/16/1110094.png,0,0.993182302,1956,488,2700,1232,744,744,fluttershy
1110899.png,https://derpicdn.net/img/view/2016/3/17/1110899.png,0,0.982860029,56,7,922,873,866,866,fluttershy
1110927.png,https://derpicdn.net/img/view/2016/3/17/1110927.png,0,0.947776735,288,0,1394,1092,1106,1092,fluttershy
1112503.png,https://derpicdn.net/img/view/2016/3/19/1112503.png,0,0.988787174,557,29,907,379,350,350,fluttershy
1112833.png,https://derpicdn.net/img/view/2016/3/20/1112833.png,0,0.993786991,196,0,684,471,488,471,fluttershy
1112889.png,https://derpicdn.net/img/view/2016/3/20/1112889.png,0,0.949638307,118,0,380,247,262,247,fluttershy
1114926.png,https://derpicdn.net/img/view/2016/3/23/1114926.png,0,0.997141659,275,36,683,444,408,408,fluttershy
1114927.png,https://derpicdn.net/img/view/2016/3/23/1114927.png,0,0.99374342,269,29,687,447,418,418,fluttershy
1119195.png,https://derpicdn.net/img/view/2016/3/28/1119195.png,0,0.998525918,109,55,1041,987,932,932,fluttershy
1120414.png,https://derpicdn.net/img/view/2016/3/30/1120414.png,0,0.987896085,121,0,497,371,376,371,fluttershy
1121591.jpg,https://derpicdn.net/img/view/2016/4/1/1121591.jpg,0,0.964810133,108,0,406,295,298,295,fluttershy
1122355.jpg,https://derpicdn.net/img/view/2016/4/2/1122355.jpg,0,0.989468455,57,0,457,369,400,369,fluttershy
1122980.png,https://derpicdn.net/img/view/2016/4/2/1122980.png,0,0.992681444,124,0,948,800,824,800,fluttershy
1123622.png,https://derpicdn.net/img/view/2016/4/3/1123622.png,0,0.991729319,587,154,875,442,288,288,fluttershy
1127322.png,https://derpicdn.net/img/view/2016/4/8/1127322.png,0,0.973258018,530,1003,1552,2025,1022,1022,fluttershy
1129103.png,https://derpicdn.net/img/view/2016/4/10/1129103.png,0,0.996913552,440,0,816,376,376,376,fluttershy
1129615.jpg,https://derpicdn.net/img/view/2016/4/11/1129615.jpg,0,0.994234085,164,10,640,486,476,476,fluttershy
1133574.png,https://derpicdn.net/img/view/2016/4/16/1133574.png,0,0.997219443,510,0,1846,1294,1336,1294,fluttershy
1135426.png,https://derpicdn.net/img/view/2016/4/19/1135426.png,0,0.927306056,32,4,528,500,496,496,fluttershy
1138675.jpg,https://derpicdn.net/img/view/2016/4/23/1138675.jpg,0,0.996902168,672,116,1430,874,758,758,fluttershy
1139245.jpg,https://derpicdn.net/img/view/2016/4/24/1139245.jpg,0,0.952915549,439,749,1017,1327,578,578,fluttershy
1148134.png,https://derpicdn.net/img/view/2016/5/7/1148134.png,0,0.97023803,840,301,1194,655,354,354,fluttershy
1150065.png,https://derpicdn.net/img/view/2016/5/9/1150065.png,0,0.91322279,196,0,618,404,422,404,fluttershy
1153393.jpg,https://derpicdn.net/img/view/2016/5/14/1153393.jpg,0,0.984574199,0,0,503,493,503,493,fluttershy
1155765.png,https://derpicdn.net/img/view/2016/5/16/1155765.png,0,0.980458856,875,121,1593,839,718,718,fluttershy
1155767.png,https://derpicdn.net/img/view/2016/5/16/1155767.png,0,0.980532229,880,125,1590,835,710,710,fluttershy
1157911.png,https://derpicdn.net/img/view/2016/5/19/1157911.png,0,0.958910882,440,348,806,714,366,366,fluttershy
1158973.jpg,https://derpicdn.net/img/view/2016/5/21/1158973.jpg,0,0.98746556,119,0,729,606,610,606,fluttershy
1167375.png,https://derpicdn.net/img/view/2016/5/31/1167375.png,0,0.943394899,81,8,463,390,382,382,fluttershy
1167524.jpg,https://derpicdn.net/img/view/2016/6/1/1167524.jpg,0,0.992832243,186,0,1110,818,924,818,fluttershy
1167574.jpg,https://derpicdn.net/img/view/2016/6/1/1167574.jpg,1,0.971683443,66,1259,842,2035,776,776,fluttershy
1167574.jpg,https://derpicdn.net/img/view/2016/6/1/1167574.jpg,2,0.925132334,152,40,816,704,664,664,fluttershy
1167700.png,https://derpicdn.net/img/view/2016/6/1/1167700.png,0,0.991985559,39,66,627,654,588,588,fluttershy
1167881.png,https://derpicdn.net/img/view/2016/6/1/1167881.png,0,0.968678355,814,667,1372,1225,558,558,fluttershy
1168641.png,https://derpicdn.net/img/view/2016/6/2/1168641.png,0,0.935887039,72,0,1024,906,952,906,fluttershy
1169929.png,https://derpicdn.net/img/view/2016/6/4/1169929.png,0,0.984324813,162,17,796,651,634,634,fluttershy
1170296.png,https://derpicdn.net/img/view/2016/6/4/1170296.png,0,0.981577396,339,0,1879,1487,1540,1487,fluttershy
1170956.png,https://derpicdn.net/img/view/2016/6/5/1170956.png,0,0.983880043,18,0,1052,1005,1034,1005,fluttershy
1172481.png,https://derpicdn.net/img/view/2016/6/7/1172481.png,0,0.946621358,1031,0,3909,2653,2878,2653,fluttershy
1173063.png,https://derpicdn.net/img/view/2016/6/8/1173063.png,0,0.971214354,811,49,1229,467,418,418,fluttershy
1173969.jpg,https://derpicdn.net/img/view/2016/6/9/1173969.jpg,0,0.99389571,541,164,1029,652,488,488,fluttershy
1174522.jpg,https://derpicdn.net/img/view/2016/6/9/1174522.jpg,0,0.994036734,800,280,1112,592,312,312,fluttershy
1174568.png,https://derpicdn.net/img/view/2016/6/9/1174568.png,0,0.997097731,669,83,1047,461,378,378,fluttershy
1174578.png,https://derpicdn.net/img/view/2016/6/9/1174578.png,0,0.996812403,666,79,1048,461,382,382,fluttershy
1177558.png,https://derpicdn.net/img/view/2016/6/13/1177558.png,0,0.919720232,902,82,2432,1612,1530,1530,fluttershy
1177617.png,https://derpicdn.net/img/view/2016/6/13/1177617.png,0,0.971521735,1265,204,2343,1282,1078,1078,fluttershy
1179873.jpg,https://derpicdn.net/img/view/2016/6/16/1179873.jpg,0,0.985429347,16,0,852,819,836,819,fluttershy
1181288.png,https://derpicdn.net/img/view/2016/6/18/1181288.png,0,0.983634412,530,134,994,598,464,464,fluttershy
1190582.png,https://derpicdn.net/img/view/2016/7/1/1190582.png,0,0.987275124,267,0,795,447,528,447,fluttershy
1201006.png,https://derpicdn.net/img/view/2016/7/15/1201006.png,0,0.963351369,191,16,579,404,388,388,fluttershy
1201715.png,https://derpicdn.net/img/view/2016/7/15/1201715.png,0,0.983830988,0,64,383,445,383,381,fluttershy
1203374.png,https://derpicdn.net/img/view/2016/7/18/1203374.png,0,0.991206229,382,0,768,372,386,372,fluttershy
12049.png,https://derpicdn.net/img/view/2012/6/20/12049.png,0,0.988286197,164,18,422,276,258,258,fluttershy
1209962.png,https://derpicdn.net/img/view/2016/7/26/1209962.png,0,0.997436583,67,32,1379,1344,1312,1312,fluttershy
1227135.png,https://derpicdn.net/img/view/2016/8/17/1227135.png,0,0.988440156,516,203,1136,823,620,620,fluttershy
1227596.png,https://derpicdn.net/img/view/2016/8/18/1227596.png,0,0.998273671,510,0,1012,469,502,469,fluttershy
1231321.png,https://derpicdn.net/img/view/2016/8/22/1231321.png,0,0.993910313,144,30,790,676,646,646,fluttershy
1234100.png,https://derpicdn.net/img/view/2016/8/26/1234100.png,0,0.997096658,21,46,1037,1062,1016,1016,fluttershy
1236224.png,https://derpicdn.net/img/view/2016/8/28/1236224.png,0,0.932718456,253,0,2679,2076,2426,2076,fluttershy
1237894.png,https://derpicdn.net/img/view/2016/8/30/1237894.png,0,0.988586843,1129,107,2479,1457,1350,1350,fluttershy
124024.png,https://derpicdn.net/img/view/2012/10/16/124024.png,0,0.99709487,142,0,724,542,582,542,fluttershy
1240711.png,https://derpicdn.net/img/view/2016/9/3/1240711.png,0,0.924245894,504,0,1396,850,892,850,fluttershy
1245297.png,https://derpicdn.net/img/view/2016/9/9/1245297.png,0,0.989424646,147,71,799,723,652,652,fluttershy
1245850.png,https://derpicdn.net/img/view/2016/9/10/1245850.png,0,0.986564517,76,0,564,467,488,467,fluttershy
1250223.png,https://derpicdn.net/img/view/2016/9/16/1250223.png,0,0.996795595,326,65,1274,1013,948,948,fluttershy
1255042.png,https://derpicdn.net/img/view/2016/9/21/1255042.png,0,0.962447047,123,37,1161,1075,1038,1038,fluttershy
1257944.png,https://derpicdn.net/img/view/2016/9/25/1257944.png,0,0.937379301,447,327,1147,1027,700,700,fluttershy
1260804.png,https://derpicdn.net/img/view/2016/9/29/1260804.png,0,0.99487412,433,37,1197,801,764,764,fluttershy
1261495.png,https://derpicdn.net/img/view/2016/9/30/1261495.png,0,0.996665657,672,0,1860,1135,1188,1135,fluttershy
1263714.png,https://derpicdn.net/img/view/2016/10/2/1263714.png,0,0.978605628,18,0,540,517,522,517,fluttershy
1267461.png,https://derpicdn.net/img/view/2016/10/8/1267461.png,0,0.986331224,939,0,1847,845,908,845,fluttershy
1269438.png,https://derpicdn.net/img/view/2016/10/10/1269438.png,0,0.998233676,408,9,936,537,528,528,fluttershy
1273263.png,https://derpicdn.net/img/view/2016/10/15/1273263.png,0,0.999009013,300,103,1096,899,796,796,fluttershy
1273352.png,https://derpicdn.net/img/view/2016/10/15/1273352.png,0,0.992789507,106,0,612,463,506,463,fluttershy
1276151.png,https://derpicdn.net/img/view/2016/10/18/1276151.png,0,0.988017678,223,91,645,513,422,422,fluttershy
1276305.png,https://derpicdn.net/img/view/2016/10/18/1276305.png,0,0.923494101,272,46,1556,1330,1284,1284,fluttershy
1276985.png,https://derpicdn.net/img/view/2016/10/19/1276985.png,0,0.946199834,24,24,1200,1224,1176,1200,fluttershy
1283904.png,https://derpicdn.net/img/view/2016/10/29/1283904.png,0,0.988850296,23,67,447,491,424,424,fluttershy
1284340.png,https://derpicdn.net/img/view/2016/10/29/1284340.png,0,0.997518957,1008,0,2048,946,1040,946,fluttershy
1284341.png,https://derpicdn.net/img/view/2016/10/29/1284341.png,0,0.995448291,1004,0,2052,970,1048,970,fluttershy
1284437.png,https://derpicdn.net/img/view/2016/10/29/1284437.png,0,0.936699271,684,313,1412,1041,728,728,fluttershy
1288987.png,https://derpicdn.net/img/view/2016/11/5/1288987.png,0,0.982892096,312,1,1004,693,692,692,fluttershy
1289318.png,https://derpicdn.net/img/view/2016/11/5/1289318.png,0,0.984560132,84,51,278,245,194,194,fluttershy
1290307.png,https://derpicdn.net/img/view/2016/11/6/1290307.png,0,0.917884886,1613,198,3255,1840,1642,1642,fluttershy
1290473.png,https://derpicdn.net/img/view/2016/11/7/1290473.png,0,0.994428039,312,0,998,658,686,658,fluttershy
1292288.png,https://derpicdn.net/img/view/2016/11/9/1292288.png,0,0.997763038,269,10,617,358,348,348,fluttershy
1293528.png,https://derpicdn.net/img/view/2016/11/11/1293528.png,0,0.996162891,819,9,2049,1239,1230,1230,fluttershy
1295160.png,https://derpicdn.net/img/view/2016/11/13/1295160.png,0,0.999010086,401,39,849,487,448,448,fluttershy
1295713.png,https://derpicdn.net/img/view/2016/11/14/1295713.png,0,0.999522746,669,33,1491,855,822,822,fluttershy
1298432.png,https://derpicdn.net/img/view/2016/11/18/1298432.png,0,0.95809418,75,49,885,859,810,810,fluttershy
1298729.png,https://derpicdn.net/img/view/2016/11/19/1298729.png,0,0.997956693,942,0,2092,1030,1150,1030,fluttershy
1300545.png,https://derpicdn.net/img/view/2016/11/21/1300545.png,0,0.960780263,191,14,807,630,616,616,fluttershy
1303264.png,https://derpicdn.net/img/view/2016/11/25/1303264.png,0,0.990268707,140,131,914,905,774,774,fluttershy
1303833.png,https://derpicdn.net/img/view/2016/11/26/1303833.png,0,0.960154593,1090,653,2028,1591,938,938,fluttershy
1305224.png,https://derpicdn.net/img/view/2016/11/28/1305224.png,0,0.949930012,350,1,542,193,192,192,fluttershy
1305553.png,https://derpicdn.net/img/view/2016/11/28/1305553.png,0,0.991467237,547,0,947,377,400,377,fluttershy
1305553.png,https://derpicdn.net/img/view/2016/11/28/1305553.png,1,0.98355037,306,0,698,369,392,369,fluttershy
1305554.png,https://derpicdn.net/img/view/2016/11/28/1305554.png,0,0.994510591,549,0,945,374,396,374,fluttershy
1305554.png,https://derpicdn.net/img/view/2016/11/28/1305554.png,1,0.984746695,305,0,701,371,396,371,fluttershy
1306600.png,https://derpicdn.net/img/view/2016/11/30/1306600.png,0,0.985839307,90,86,1280,1280,1190,1194,fluttershy
1306766.png,https://derpicdn.net/img/view/2016/11/30/1306766.png,0,0.97522229,680,0,1826,1118,1146,1118,fluttershy
1310093.png,https://derpicdn.net/img/view/2016/12/4/1310093.png,0,0.972118795,1135,0,2177,1009,1042,1009,fluttershy
1314685.png,https://derpicdn.net/img/view/2016/12/11/1314685.png,0,0.963268399,195,0,800,582,605,582,fluttershy
1317306.png,https://derpicdn.net/img/view/2016/12/14/1317306.png,0,0.986920238,343,42,905,604,562,562,fluttershy
1319083.png,https://derpicdn.net/img/view/2016/12/16/1319083.png,0,0.965197325,540,0,1080,527,540,527,fluttershy
1322778.png,https://derpicdn.net/img/view/2016/12/22/1322778.png,0,0.974912286,206,0,588,378,382,378,fluttershy
1323198.png,https://derpicdn.net/img/view/2016/12/23/1323198.png,0,0.96919924,185,0,1277,1061,1092,1061,fluttershy
132358.png,https://derpicdn.net/img/view/2012/10/25/132358.png,0,0.998850346,378,0,802,407,424,407,fluttershy
1327220.png,https://derpicdn.net/img/view/2016/12/28/1327220.png,0,0.990632653,24,0,1696,1668,1672,1668,fluttershy
1329077.png,https://derpicdn.net/img/view/2016/12/31/1329077.png,0,0.970229149,3527,0,8000,4007,4473,4007,fluttershy
1332170.png,https://derpicdn.net/img/view/2017/1/4/1332170.png,0,0.987416625,272,32,692,452,420,420,fluttershy
1333076.png,https://derpicdn.net/img/view/2017/1/6/1333076.png,0,0.929996312,260,54,1364,1158,1104,1104,fluttershy
1336695.png,https://derpicdn.net/img/view/2017/1/10/1336695.png,0,0.987502277,67,124,1229,1200,1162,1076,fluttershy
1338106.png,https://derpicdn.net/img/view/2017/1/12/1338106.png,0,0.97690016,1,0,799,707,798,707,fluttershy
1338389.png,https://derpicdn.net/img/view/2017/1/13/1338389.png,0,0.99318409,750,93,1300,643,550,550,fluttershy
1339506.png,https://derpicdn.net/img/view/2017/1/14/1339506.png,0,0.991649747,277,0,1011,720,734,720,fluttershy
1339880.png,https://derpicdn.net/img/view/2017/1/15/1339880.png,0,0.9970029,314,2,750,438,436,436,fluttershy
1341730.png,https://derpicdn.net/img/view/2017/1/17/1341730.png,0,0.997477889,1236,0,1900,648,664,648,fluttershy
1341747.png,https://derpicdn.net/img/view/2017/1/17/1341747.png,0,0.972315073,263,11,1497,1245,1234,1234,fluttershy
1342431.png,https://derpicdn.net/img/view/2017/1/18/1342431.png,0,0.995326459,966,0,1736,732,770,732,fluttershy
1344168.png,https://derpicdn.net/img/view/2017/1/21/1344168.png,0,0.971808076,189,0,1033,814,844,814,fluttershy
1344404.png,https://derpicdn.net/img/view/2017/1/21/1344404.png,0,0.997340202,750,100,1292,642,542,542,fluttershy
1348684.png,https://derpicdn.net/img/view/2017/1/26/1348684.png,0,0.999541938,516,26,1056,566,540,540,fluttershy
1349060.png,https://derpicdn.net/img/view/2017/1/27/1349060.png,0,0.979843199,673,401,1733,1461,1060,1060,fluttershy
1349939.png,https://derpicdn.net/img/view/2017/1/28/1349939.png,0,0.987640321,250,0,882,539,632,539,fluttershy
1351243.png,https://derpicdn.net/img/view/2017/1/30/1351243.png,0,0.991707504,450,289,1074,913,624,624,fluttershy
1352102.png,https://derpicdn.net/img/view/2017/1/31/1352102.png,0,0.999204457,244,334,720,810,476,476,fluttershy
1352102.png,https://derpicdn.net/img/view/2017/1/31/1352102.png,1,0.982076585,627,337,1031,741,404,404,fluttershy
1353477.png,https://derpicdn.net/img/view/2017/2/2/1353477.png,0,0.995801866,128,0,594,446,466,446,fluttershy
1354409.png,https://derpicdn.net/img/view/2017/2/3/1354409.png,0,0.917002738,291,0,1601,1249,1310,1249,fluttershy
1355146.png,https://derpicdn.net/img/view/2017/2/4/1355146.png,0,0.992351413,56,0,618,552,562,552,fluttershy
1357519.png,https://derpicdn.net/img/view/2017/2/7/1357519.png,0,0.981523991,609,660,1265,1316,656,656,fluttershy
1357787.png,https://derpicdn.net/img/view/2017/2/8/1357787.png,0,0.971854448,1239,161,2653,1575,1414,1414,fluttershy
1358779.png,https://derpicdn.net/img/view/2017/2/9/1358779.png,0,0.914873481,359,55,939,635,580,580,fluttershy
1364560.png,https://derpicdn.net/img/view/2017/2/16/1364560.png,0,0.94830817,164,93,946,875,782,782,fluttershy
1365915.png,https://derpicdn.net/img/view/2017/2/18/1365915.png,0,0.905597806,1334,139,3074,1879,1740,1740,fluttershy
1368985.png,https://derpicdn.net/img/view/2017/2/21/1368985.png,0,0.995594025,132,0,3142,2806,3010,2806,fluttershy
1370201.png,https://derpicdn.net/img/view/2017/2/22/1370201.png,0,0.985246062,48,0,968,827,920,827,fluttershy
1372690.png,https://derpicdn.net/img/view/2017/2/25/1372690.png,0,0.996919692,1004,0,2096,1020,1092,1020,fluttershy
1372691.png,https://derpicdn.net/img/view/2017/2/25/1372691.png,0,0.99228096,998,0,2106,1037,1108,1037,fluttershy
1377091.png,https://derpicdn.net/img/view/2017/3/2/1377091.png,0,0.954665124,146,20,964,838,818,818,fluttershy
1379312.png,https://derpicdn.net/img/view/2017/3/4/1379312.png,0,0.954707086,229,158,697,626,468,468,fluttershy
1379711.png,https://derpicdn.net/img/view/2017/3/5/1379711.png,0,0.915588021,231,9,585,363,354,354,fluttershy
1383300.png,https://derpicdn.net/img/view/2017/3/10/1383300.png,0,0.969677329,93,68,867,842,774,774,fluttershy
1385461.png,https://derpicdn.net/img/view/2017/3/12/1385461.png,0,0.995434582,75,219,1055,1199,980,980,fluttershy
1387656.png,https://derpicdn.net/img/view/2017/3/15/1387656.png,0,0.999033213,361,0,1385,1022,1024,1022,fluttershy
1393047.png,https://derpicdn.net/img/view/2017/3/21/1393047.png,0,0.998082042,322,0,1270,781,948,781,fluttershy
1394514.png,https://derpicdn.net/img/view/2017/3/23/1394514.png,0,0.992753923,43,0,473,364,430,364,fluttershy
1395769.png,https://derpicdn.net/img/view/2017/3/25/1395769.png,0,0.999156177,503,182,1073,752,570,570,fluttershy
1396203.png,https://derpicdn.net/img/view/2017/3/25/1396203.png,0,0.994099438,230,0,718,469,488,469,fluttershy
1396204.png,https://derpicdn.net/img/view/2017/3/25/1396204.png,0,0.994068086,227,0,723,475,496,475,fluttershy
1396987.png,https://derpicdn.net/img/view/2017/3/26/1396987.png,0,0.967626393,894,267,2455,1921,1561,1654,fluttershy
1400350.png,https://derpicdn.net/img/view/2017/3/31/1400350.png,0,0.989102244,158,0,736,573,578,573,fluttershy
1401398.png,https://derpicdn.net/img/view/2017/4/1/1401398.png,0,0.915835559,306,28,1202,924,896,896,fluttershy
1402308.png,https://derpicdn.net/img/view/2017/4/2/1402308.png,0,0.964680135,362,353,838,829,476,476,fluttershy
1402664.png,https://derpicdn.net/img/view/2017/4/2/1402664.png,0,0.998948276,305,0,941,579,636,579,fluttershy
1404931.png,https://derpicdn.net/img/view/2017/4/5/1404931.png,0,0.951815963,362,380,1048,1066,686,686,fluttershy
1405259.png,https://derpicdn.net/img/view/2017/4/6/1405259.png,0,0.905578136,699,29,1993,1323,1294,1294,fluttershy
1407345.png,https://derpicdn.net/img/view/2017/4/9/1407345.png,0,0.999187469,149,7,569,427,420,420,fluttershy
1407750.png,https://derpicdn.net/img/view/2017/4/9/1407750.png,0,0.967306495,0,94,795,938,795,844,fluttershy
1407750.png,https://derpicdn.net/img/view/2017/4/9/1407750.png,1,0.901208639,160,0,1000,828,840,828,fluttershy
1409528.png,https://derpicdn.net/img/view/2017/4/12/1409528.png,0,0.990032673,121,0,639,415,518,415,fluttershy
1416299.png,https://derpicdn.net/img/view/2017/4/19/1416299.png,0,0.993320346,77,72,573,568,496,496,fluttershy
1416313.png,https://derpicdn.net/img/view/2017/4/19/1416313.png,0,0.979482055,237,24,1371,1158,1134,1134,fluttershy
1424813.png,https://derpicdn.net/img/view/2017/4/29/1424813.png,0,0.942841351,563,0,1393,802,830,802,fluttershy
1427431.png,https://derpicdn.net/img/view/2017/5/3/1427431.png,0,0.967447519,0,0,732,725,732,725,fluttershy
1429554.png,https://derpicdn.net/img/view/2017/5/6/1429554.png,0,0.998558342,128,0,828,671,700,671,fluttershy
1429769.png,https://derpicdn.net/img/view/2017/5/6/1429769.png,0,0.99921453,297,0,1585,1242,1288,1242,fluttershy
1432908.png,https://derpicdn.net/img/view/2017/5/9/1432908.png,0,0.994608641,157,33,483,359,326,326,fluttershy
1432908.png,https://derpicdn.net/img/view/2017/5/9/1432908.png,1,0.975697935,370,428,604,662,234,234,fluttershy
1438364.png,https://derpicdn.net/img/view/2017/5/16/1438364.png,0,0.998781085,293,20,931,658,638,638,fluttershy
1445933.png,https://derpicdn.net/img/view/2017/5/25/1445933.png,0,0.948317289,248,0,1536,1216,1288,1216,fluttershy
1447099.png,https://derpicdn.net/img/view/2017/5/27/1447099.png,0,0.998492956,571,26,957,412,386,386,fluttershy
1449129.png,https://derpicdn.net/img/view/2017/5/29/1449129.png,0,0.94911474,767,0,2405,1524,1638,1524,fluttershy
1450260.png,https://derpicdn.net/img/view/2017/5/30/1450260.png,0,0.995525539,334,0,968,587,634,587,fluttershy
1450262.png,https://derpicdn.net/img/view/2017/5/30/1450262.png,0,0.999842882,14,0,758,697,744,697,fluttershy
1450263.png,https://derpicdn.net/img/view/2017/5/30/1450263.png,0,0.999649525,421,0,1077,587,656,587,fluttershy
1450265.png,https://derpicdn.net/img/view/2017/5/30/1450265.png,0,0.997053683,129,0,825,600,696,600,fluttershy
1450267.png,https://derpicdn.net/img/view/2017/5/30/1450267.png,0,0.98970139,0,0,318,339,318,339,fluttershy
1450951.png,https://derpicdn.net/img/view/2017/5/31/1450951.png,0,0.905138016,597,377,4199,3979,3602,3602,fluttershy
1452486.png,https://derpicdn.net/img/view/2017/6/2/1452486.png,0,0.994944632,1187,0,1993,789,806,789,fluttershy
145306.png,https://derpicdn.net/img/view/2012/11/7/145306.png,0,0.951888144,0,0,1267,1434,1267,1434,fluttershy
1453222.png,https://derpicdn.net/img/view/2017/6/3/1453222.png,0,0.968147874,169,0,731,538,562,538,fluttershy
1455850.png,https://derpicdn.net/img/view/2017/6/7/1455850.png,0,0.993316233,377,26,1111,760,734,734,fluttershy
1456120.png,https://derpicdn.net/img/view/2017/6/7/1456120.png,0,0.981677413,84,13,1024,967,940,954,fluttershy
1458013.png,https://derpicdn.net/img/view/2017/6/10/1458013.png,0,0.934116542,215,185,493,463,278,278,fluttershy
1459337.png,https://derpicdn.net/img/view/2017/6/11/1459337.png,0,0.918725491,465,83,1385,1003,920,920,fluttershy
1461661.png,https://derpicdn.net/img/view/2017/6/14/1461661.png,0,0.999060571,849,0,2367,1515,1518,1515,fluttershy
1462631.png,https://derpicdn.net/img/view/2017/6/15/1462631.png,0,0.99318254,480,0,990,487,510,487,fluttershy
1462695.png,https://derpicdn.net/img/view/2017/6/15/1462695.png,0,0.992860973,462,45,810,393,348,348,fluttershy
1463703.png,https://derpicdn.net/img/view/2017/6/17/1463703.png,0,0.993890941,203,0,777,528,574,528,fluttershy
1468129.png,https://derpicdn.net/img/view/2017/6/21/1468129.png,0,0.99658066,241,0,1279,992,1038,992,fluttershy
1469393.png,https://derpicdn.net/img/view/2017/6/23/1469393.png,0,0.930065036,329,146,979,796,650,650,fluttershy
1470179.png,https://derpicdn.net/img/view/2017/6/24/1470179.png,0,0.995039225,34,46,640,652,606,606,fluttershy
1475250.png,https://derpicdn.net/img/view/2017/6/30/1475250.png,0,0.996244371,294,134,668,508,374,374,fluttershy
1479150.png,https://derpicdn.net/img/view/2017/7/5/1479150.png,0,0.971141815,982,122,1786,926,804,804,fluttershy
1479839.png,https://derpicdn.net/img/view/2017/7/6/1479839.png,0,0.99270153,50,0,420,354,370,354,fluttershy
1481278.png,https://derpicdn.net/img/view/2017/7/8/1481278.png,0,0.979851782,92,0,990,770,898,770,fluttershy
1481377.png,https://derpicdn.net/img/view/2017/7/8/1481377.png,0,0.923976123,352,87,746,481,394,394,fluttershy
1482320.png,https://derpicdn.net/img/view/2017/7/9/1482320.png,0,0.96516794,237,18,989,770,752,752,fluttershy
1482465.png,https://derpicdn.net/img/view/2017/7/9/1482465.png,0,0.984842002,150,0,846,680,696,680,fluttershy
1483850.png,https://derpicdn.net/img/view/2017/7/11/1483850.png,0,0.984625936,27,0,891,768,864,768,fluttershy
1485603.png,https://derpicdn.net/img/view/2017/7/13/1485603.png,0,0.982042491,101,0,777,632,676,632,fluttershy
1486359.png,https://derpicdn.net/img/view/2017/7/14/1486359.png,0,0.995580614,443,0,1203,658,760,658,fluttershy
1488325.png,https://derpicdn.net/img/view/2017/7/17/1488325.png,0,0.98199445,410,0,932,508,522,508,fluttershy
1490041.png,https://derpicdn.net/img/view/2017/7/19/1490041.png,0,0.979339421,46,0,536,468,490,468,fluttershy
1490503.png,https://derpicdn.net/img/view/2017/7/20/1490503.png,0,0.995294631,316,0,626,297,310,297,fluttershy
1490510.png,https://derpicdn.net/img/view/2017/7/20/1490510.png,0,0.969565153,916,0,1616,647,700,647,fluttershy
1491122.png,https://derpicdn.net/img/view/2017/7/21/1491122.png,0,0.965024173,360,1,870,511,510,510,fluttershy
1493459.png,https://derpicdn.net/img/view/2017/7/24/1493459.png,0,0.964738905,502,148,1370,1016,868,868,fluttershy
1493705.png,https://derpicdn.net/img/view/2017/7/24/1493705.png,0,0.979115844,266,0,1048,730,782,730,fluttershy
1493708.png,https://derpicdn.net/img/view/2017/7/24/1493708.png,0,0.913311303,201,50,829,678,628,628,fluttershy
1494509.png,https://derpicdn.net/img/view/2017/7/25/1494509.png,0,0.997188807,42,107,700,700,658,593,fluttershy
1498308.png,https://derpicdn.net/img/view/2017/7/30/1498308.png,0,0.999405384,728,217,1172,661,444,444,fluttershy
1499411.png,https://derpicdn.net/img/view/2017/7/31/1499411.png,0,0.922822893,266,34,864,632,598,598,fluttershy
1501078.png,https://derpicdn.net/img/view/2017/8/2/1501078.png,0,0.952346325,919,456,1711,1248,792,792,fluttershy
1501910.png,https://derpicdn.net/img/view/2017/8/3/1501910.png,0,0.962777197,324,50,680,406,356,356,fluttershy
1506161.png,https://derpicdn.net/img/view/2017/8/8/1506161.png,0,0.98683095,368,0,2066,1503,1698,1503,fluttershy
1507546.png,https://derpicdn.net/img/view/2017/8/10/1507546.png,0,0.905555487,728,65,1956,1293,1228,1228,fluttershy
1509676.png,https://derpicdn.net/img/view/2017/8/13/1509676.png,0,0.943123221,662,12,1404,754,742,742,fluttershy
1510009.png,https://derpicdn.net/img/view/2017/8/13/1510009.png,0,0.957314491,207,367,881,1041,674,674,fluttershy
1518334.png,https://derpicdn.net/img/view/2017/8/23/1518334.png,0,0.937983394,0,129,948,1253,948,1124,fluttershy
1518846.png,https://derpicdn.net/img/view/2017/8/24/1518846.png,0,0.985295594,63,0,1923,1536,1860,1536,fluttershy
1521176.png,https://derpicdn.net/img/view/2017/8/27/1521176.png,0,0.98182857,368,143,2732,2507,2364,2364,fluttershy
1521907.png,https://derpicdn.net/img/view/2017/8/28/1521907.png,0,0.959830225,104,190,654,740,550,550,fluttershy
1522082.png,https://derpicdn.net/img/view/2017/8/28/1522082.png,0,0.955496967,715,0,1685,927,970,927,fluttershy
1522498.png,https://derpicdn.net/img/view/2017/8/29/1522498.png,0,0.935206413,142,36,1194,1088,1052,1052,fluttershy
1523020.png,https://derpicdn.net/img/view/2017/8/29/1523020.png,0,0.977026761,275,0,767,456,492,456,fluttershy
1524083.png,https://derpicdn.net/img/view/2017/8/31/1524083.png,0,0.97230196,79,0,973,854,894,854,fluttershy
1524562.png,https://derpicdn.net/img/view/2017/8/31/1524562.png,0,0.993901968,1405,0,2643,1088,1238,1088,fluttershy
1524788.png,https://derpicdn.net/img/view/2017/9/1/1524788.png,0,0.97411859,1132,694,1572,1134,440,440,fluttershy
1524943.png,https://derpicdn.net/img/view/2017/9/1/1524943.png,0,0.967083514,2380,58,3956,1634,1576,1576,fluttershy
1525361.png,https://derpicdn.net/img/view/2017/9/1/1525361.png,0,0.981604099,600,0,848,225,248,225,fluttershy
1526668.png,https://derpicdn.net/img/view/2017/9/3/1526668.png,0,0.98857224,0,0,1742,1536,1742,1536,fluttershy
1528027.png,https://derpicdn.net/img/view/2017/9/4/1528027.png,0,0.981446922,352,0,970,566,618,566,fluttershy
1529060.png,https://derpicdn.net/img/view/2017/9/6/1529060.png,0,0.994729638,894,436,2570,2112,1676,1676,fluttershy
1529177.png,https://derpicdn.net/img/view/2017/9/6/1529177.png,0,0.972192287,0,0,540,573,540,573,fluttershy
1529475.png,https://derpicdn.net/img/view/2017/9/6/1529475.png,0,0.925906301,897,341,2573,2017,1676,1676,fluttershy
1529489.png,https://derpicdn.net/img/view/2017/9/6/1529489.png,0,0.995535016,254,0,1024,736,770,736,fluttershy
1530662.png,https://derpicdn.net/img/view/2017/9/8/1530662.png,0,0.992395878,173,0,1013,817,840,817,fluttershy
1530662.png,https://derpicdn.net/img/view/2017/9/8/1530662.png,1,0.990505397,1073,0,1969,866,896,866,fluttershy
1538772.png,https://derpicdn.net/img/view/2017/9/18/1538772.png,0,0.985360324,194,0,2910,2577,2716,2577,fluttershy
1539524.png,https://derpicdn.net/img/view/2017/9/19/1539524.png,0,0.995502174,242,0,622,368,380,368,fluttershy
1541664.png,https://derpicdn.net/img/view/2017/9/22/1541664.png,0,0.99395901,1447,0,2429,899,982,899,fluttershy
1542488.png,https://derpicdn.net/img/view/2017/9/23/1542488.png,0,0.981414855,462,47,1482,1067,1020,1020,fluttershy
1545140.png,https://derpicdn.net/img/view/2017/9/26/1545140.png,0,0.964453816,241,0,917,649,676,649,fluttershy
1547259.png,https://derpicdn.net/img/view/2017/9/29/1547259.png,0,0.986046135,334,0,806,438,472,438,fluttershy
1548281.png,https://derpicdn.net/img/view/2017/9/30/1548281.png,0,0.9848333,933,46,1831,944,898,898,fluttershy
1549477.png,https://derpicdn.net/img/view/2017/10/1/1549477.png,0,0.992842376,276,0,4518,3775,4242,3775,fluttershy
1549914.png,https://derpicdn.net/img/view/2017/10/1/1549914.png,0,0.993835926,75,0,905,826,830,826,fluttershy
1549997.png,https://derpicdn.net/img/view/2017/10/2/1549997.png,0,0.980852902,175,139,457,421,282,282,fluttershy
1550881.png,https://derpicdn.net/img/view/2017/10/3/1550881.png,0,0.986435115,829,101,1823,1095,994,994,fluttershy
1555347.png,https://derpicdn.net/img/view/2017/10/8/1555347.png,0,0.997267842,0,0,2629,2682,2629,2682,fluttershy
1555616.png,https://derpicdn.net/img/view/2017/10/8/1555616.png,0,0.985661685,285,82,849,646,564,564,fluttershy
1558166.png,https://derpicdn.net/img/view/2017/10/11/1558166.png,0,0.994954288,571,388,857,674,286,286,fluttershy
1558166.png,https://derpicdn.net/img/view/2017/10/11/1558166.png,1,0.991731822,1168,413,1440,685,272,272,fluttershy
1559758.png,https://derpicdn.net/img/view/2017/10/13/1559758.png,0,0.982734203,289,32,1543,1286,1254,1254,fluttershy
1560298.png,https://derpicdn.net/img/view/2017/10/13/1560298.png,0,0.991135299,287,0,1037,682,750,682,fluttershy
1560801.png,https://derpicdn.net/img/view/2017/10/14/1560801.png,0,0.993883133,75,0,823,694,748,694,fluttershy
1561882.png,https://derpicdn.net/img/view/2017/10/15/1561882.png,0,0.972672641,821,591,1537,1307,716,716,fluttershy
1562587.png,https://derpicdn.net/img/view/2017/10/16/1562587.png,0,0.99633956,213,0,1385,1151,1172,1151,fluttershy
1563962.png,https://derpicdn.net/img/view/2017/10/17/1563962.png,0,0.998241246,380,23,688,331,308,308,fluttershy
1569109.png,https://derpicdn.net/img/view/2017/10/24/1569109.png,0,0.999801636,0,0,746,854,746,854,fluttershy
1569825.png,https://derpicdn.net/img/view/2017/10/25/1569825.png,0,0.997776687,422,4,790,372,368,368,fluttershy
1570071.png,https://derpicdn.net/img/view/2017/10/25/1570071.png,0,0.960097492,881,59,1405,583,524,524,fluttershy
1570633.png,https://derpicdn.net/img/view/2017/10/26/1570633.png,0,0.959353328,222,22,706,506,484,484,fluttershy
1573946.png,https://derpicdn.net/img/view/2017/10/30/1573946.png,0,0.98854661,779,199,1693,1113,914,914,fluttershy
1575124.png,https://derpicdn.net/img/view/2017/11/1/1575124.png,0,0.993718266,200,0,586,351,386,351,fluttershy
1575317.png,https://derpicdn.net/img/view/2017/11/1/1575317.png,0,0.982564449,81,0,1387,1248,1306,1248,fluttershy
1576684.png,https://derpicdn.net/img/view/2017/11/3/1576684.png,0,0.950823069,90,0,900,838,810,838,fluttershy
1579337.png,https://derpicdn.net/img/view/2017/11/6/1579337.png,0,0.993321359,0,256,1700,2022,1700,1766,fluttershy
1580366.png,https://derpicdn.net/img/view/2017/11/7/1580366.png,0,0.996390104,774,0,2886,2111,2112,2111,fluttershy
15831.png,https://derpicdn.net/img/view/2012/6/22/15831.png,0,0.994600415,317,35,953,671,636,636,fluttershy
1584180.png,https://derpicdn.net/img/view/2017/11/12/1584180.png,0,0.995200396,117,0,871,681,754,681,fluttershy
1584852.png,https://derpicdn.net/img/view/2017/11/12/1584852.png,0,0.990397036,177,610,3923,4356,3746,3746,fluttershy
1584930.png,https://derpicdn.net/img/view/2017/11/12/1584930.png,0,0.979056954,0,0,978,792,978,792,fluttershy
1587754.png,https://derpicdn.net/img/view/2017/11/16/1587754.png,0,0.980013013,76,0,1190,973,1114,973,fluttershy
1588646.png,https://derpicdn.net/img/view/2017/11/17/1588646.png,0,0.910097122,40,152,360,472,320,320,fluttershy
1588910.png,https://derpicdn.net/img/view/2017/11/18/1588910.png,0,0.911966026,93,2,633,542,540,540,fluttershy
1590476.png,https://derpicdn.net/img/view/2017/11/20/1590476.png,0,0.999799788,484,0,1534,936,1050,936,fluttershy
1591088.png,https://derpicdn.net/img/view/2017/11/21/1591088.png,0,0.966920614,791,57,1853,1119,1062,1062,fluttershy
1591297.png,https://derpicdn.net/img/view/2017/11/21/1591297.png,0,0.986455083,0,44,878,938,878,894,fluttershy
1592134.png,https://derpicdn.net/img/view/2017/11/22/1592134.png,0,0.995536327,132,0,738,558,606,558,fluttershy
1594902.png,https://derpicdn.net/img/view/2017/11/26/1594902.png,0,0.980783463,517,109,2043,1635,1526,1526,fluttershy
1596775.png,https://derpicdn.net/img/view/2017/11/29/1596775.png,0,0.995793164,138,0,412,250,274,250,fluttershy
1597556.png,https://derpicdn.net/img/view/2017/11/30/1597556.png,0,0.993584692,367,33,881,547,514,514,fluttershy
1597556.png,https://derpicdn.net/img/view/2017/11/30/1597556.png,1,0.98588258,737,75,1161,499,424,424,fluttershy
1598507.png,https://derpicdn.net/img/view/2017/12/1/1598507.png,0,0.987725854,635,348,1367,1080,732,732,fluttershy
1599181.png,https://derpicdn.net/img/view/2017/12/3/1599181.png,0,0.940079689,1270,34,2500,1282,1230,1248,fluttershy
1601404.png,https://derpicdn.net/img/view/2017/12/6/1601404.png,0,0.988236248,827,115,1745,1033,918,918,fluttershy
1602920.png,https://derpicdn.net/img/view/2017/12/8/1602920.png,0,0.957943678,484,40,1036,592,552,552,fluttershy
1604628.png,https://derpicdn.net/img/view/2017/12/10/1604628.png,0,0.966291964,710,0,2028,1213,1318,1213,fluttershy
1605173.png,https://derpicdn.net/img/view/2017/12/11/1605173.png,0,0.994979024,566,35,1672,1141,1106,1106,fluttershy
1607134.png,https://derpicdn.net/img/view/2017/12/13/1607134.png,0,0.954568565,152,0,1062,873,910,873,fluttershy
1607698.png,https://derpicdn.net/img/view/2017/12/14/1607698.png,0,0.991149902,125,0,1200,953,1075,953,fluttershy
1608038.png,https://derpicdn.net/img/view/2017/12/15/1608038.png,0,0.980650127,770,182,1886,1298,1116,1116,fluttershy
1610528.png,https://derpicdn.net/img/view/2017/12/18/1610528.png,0,0.912324727,106,0,712,593,606,593,fluttershy
1611304.png,https://derpicdn.net/img/view/2017/12/19/1611304.png,0,0.997699738,453,0,909,433,456,433,fluttershy
1613530.png,https://derpicdn.net/img/view/2017/12/22/1613530.png,0,0.984217167,0,0,898,789,898,789,fluttershy
1615604.png,https://derpicdn.net/img/view/2017/12/25/1615604.png,0,0.916543961,540,299,1206,965,666,666,fluttershy
1621585.png,https://derpicdn.net/img/view/2018/1/1/1621585.png,0,0.99895668,467,0,875,391,408,391,fluttershy
1622210.png,https://derpicdn.net/img/view/2018/1/2/1622210.png,0,0.996783495,740,93,1304,657,564,564,fluttershy
1624379.png,https://derpicdn.net/img/view/2018/1/5/1624379.png,0,0.988822103,262,10,894,642,632,632,fluttershy
1625293.png,https://derpicdn.net/img/view/2018/1/6/1625293.png,0,0.994842887,309,0,1707,1293,1398,1293,fluttershy
1627129.png,https://derpicdn.net/img/view/2018/1/8/1627129.png,0,0.968708634,68,0,896,770,828,770,fluttershy
1627727.png,https://derpicdn.net/img/view/2018/1/9/1627727.png,0,0.998405457,275,0,517,235,242,235,fluttershy
1628310.png,https://derpicdn.net/img/view/2018/1/9/1628310.png,0,0.99685806,855,103,1693,941,838,838,fluttershy
1631027.png,https://derpicdn.net/img/view/2018/1/13/1631027.png,0,0.981013954,439,0,1741,1299,1302,1299,fluttershy
1632329.png,https://derpicdn.net/img/view/2018/1/14/1632329.png,0,0.969615638,596,123,1426,953,830,830,fluttershy
1632341.png,https://derpicdn.net/img/view/2018/1/14/1632341.png,0,0.996863723,209,0,1059,809,850,809,fluttershy
1632396.png,https://derpicdn.net/img/view/2018/1/14/1632396.png,0,0.995937228,466,43,732,309,266,266,fluttershy
1632399.png,https://derpicdn.net/img/view/2018/1/14/1632399.png,0,0.999247074,474,40,730,296,256,256,fluttershy
1632443.png,https://derpicdn.net/img/view/2018/1/14/1632443.png,0,0.981388092,193,40,1869,1716,1676,1676,fluttershy
1632555.png,https://derpicdn.net/img/view/2018/1/15/1632555.png,0,0.974427283,225,0,2233,1948,2008,1948,fluttershy
1634240.png,https://derpicdn.net/img/view/2018/1/17/1634240.png,0,0.982662678,555,126,1655,1226,1100,1100,fluttershy
1636000.png,https://derpicdn.net/img/view/2018/1/19/1636000.png,0,0.988309264,72,43,2526,2497,2454,2454,fluttershy
1637877.png,https://derpicdn.net/img/view/2018/1/21/1637877.png,0,0.997456789,461,31,1015,585,554,554,fluttershy
1639552.png,https://derpicdn.net/img/view/2018/1/24/1639552.png,0,0.993901968,1405,0,2643,1088,1238,1088,fluttershy
1640359.png,https://derpicdn.net/img/view/2018/1/25/1640359.png,0,0.995725751,97,0,543,442,446,442,fluttershy
1640900.png,https://derpicdn.net/img/view/2018/1/25/1640900.png,0,0.987231016,28,3,376,351,348,348,fluttershy
1644360.png,https://derpicdn.net/img/view/2018/1/30/1644360.png,0,0.998305321,168,0,564,338,396,338,fluttershy
1644675.png,https://derpicdn.net/img/view/2018/1/30/1644675.png,0,0.908480704,643,305,1457,1119,814,814,fluttershy
1645092.png,https://derpicdn.net/img/view/2018/1/31/1645092.png,0,0.944764256,382,0,1640,1191,1258,1191,fluttershy
1647074.png,https://derpicdn.net/img/view/2018/2/2/1647074.png,0,0.994344771,699,38,1251,590,552,552,fluttershy
1647716.png,https://derpicdn.net/img/view/2018/2/3/1647716.png,0,0.996109068,229,0,779,510,550,510,fluttershy
1648721.png,https://derpicdn.net/img/view/2018/2/5/1648721.png,0,0.98791939,891,62,2185,1356,1294,1294,fluttershy
1653635.png,https://derpicdn.net/img/view/2018/2/11/1653635.png,0,0.982759416,1613,246,2417,1050,804,804,fluttershy
1655468.png,https://derpicdn.net/img/view/2018/2/14/1655468.png,0,0.988473058,323,86,2193,1956,1870,1870,fluttershy
1656666.png,https://derpicdn.net/img/view/2018/2/15/1656666.png,0,0.987323284,528,44,1436,952,908,908,fluttershy
1658081.png,https://derpicdn.net/img/view/2018/2/17/1658081.png,0,0.998287082,398,0,900,489,502,489,fluttershy
1658089.png,https://derpicdn.net/img/view/2018/2/17/1658089.png,0,0.972961068,1317,0,2311,975,994,975,fluttershy
1658090.png,https://derpicdn.net/img/view/2018/2/17/1658090.png,0,0.965080082,1325,0,2307,970,982,970,fluttershy
1659984.png,https://derpicdn.net/img/view/2018/2/19/1659984.png,0,0.980680168,329,0,1583,1192,1254,1192,fluttershy
1661458.png,https://derpicdn.net/img/view/2018/2/20/1661458.png,0,0.98993963,164,13,768,617,604,604,fluttershy
1661664.png,https://derpicdn.net/img/view/2018/2/21/1661664.png,0,0.98901099,425,0,1561,1076,1136,1076,fluttershy
1662115.png,https://derpicdn.net/img/view/2018/2/21/1662115.png,0,0.989693403,215,0,849,616,634,616,fluttershy
1662118.png,https://derpicdn.net/img/view/2018/2/21/1662118.png,0,0.989726365,215,0,849,616,634,616,fluttershy
1664733.png,https://derpicdn.net/img/view/2018/2/24/1664733.png,0,0.975339651,263,0,2531,2175,2268,2175,fluttershy
1666079.png,https://derpicdn.net/img/view/2018/2/26/1666079.png,0,0.951566935,140,0,1016,846,876,846,fluttershy
1666255.png,https://derpicdn.net/img/view/2018/2/26/1666255.png,0,0.97528559,215,0,963,718,748,718,fluttershy
1669688.png,https://derpicdn.net/img/view/2018/3/2/1669688.png,0,0.991890967,701,165,1483,947,782,782,fluttershy
1671563.png,https://derpicdn.net/img/view/2018/3/4/1671563.png,0,0.972718358,0,0,616,664,616,664,fluttershy
1673027.png,https://derpicdn.net/img/view/2018/3/6/1673027.png,0,0.974947393,425,754,1163,1492,738,738,fluttershy
1675214.png,https://derpicdn.net/img/view/2018/3/9/1675214.png,1,0.976773262,169,167,495,493,326,326,fluttershy
1675719.png,https://derpicdn.net/img/view/2018/3/10/1675719.png,0,0.98155427,473,0,1567,1045,1094,1045,fluttershy
1676404.png,https://derpicdn.net/img/view/2018/3/10/1676404.png,0,0.999403358,1187,0,1995,716,808,716,fluttershy
1681160.png,https://derpicdn.net/img/view/2018/3/15/1681160.png,0,0.999298632,610,0,1684,968,1074,968,fluttershy
1681703.png,https://derpicdn.net/img/view/2018/3/16/1681703.png,0,0.966445148,945,0,3555,2581,2610,2581,fluttershy
1684772.png,https://derpicdn.net/img/view/2018/3/19/1684772.png,0,0.998437881,1038,217,2986,2165,1948,1948,fluttershy
1685451.png,https://derpicdn.net/img/view/2018/3/20/1685451.png,0,0.996142149,505,104,821,420,316,316,fluttershy
1686977.png,https://derpicdn.net/img/view/2018/3/21/1686977.png,0,0.99536562,312,0,710,375,398,375,fluttershy
1689580.png,https://derpicdn.net/img/view/2018/3/24/1689580.png,0,0.972602069,1929,0,3395,1304,1466,1304,fluttershy
1692043.png,https://derpicdn.net/img/view/2018/3/27/1692043.png,0,0.987815857,607,37,1491,921,884,884,fluttershy
1692184.png,https://derpicdn.net/img/view/2018/3/27/1692184.png,0,0.985035777,203,0,1033,765,830,765,fluttershy
1696408.png,https://derpicdn.net/img/view/2018/4/1/1696408.png,0,0.994183123,666,177,1994,1505,1328,1328,fluttershy
1698173.png,https://derpicdn.net/img/view/2018/4/3/1698173.png,0,0.982362092,144,0,2208,1755,2064,1755,fluttershy
1699844.png,https://derpicdn.net/img/view/2018/4/5/1699844.png,0,0.993589878,146,0,873,676,727,676,fluttershy
1701918.png,https://derpicdn.net/img/view/2018/4/7/1701918.png,0,0.989684045,829,0,1637,755,808,755,fluttershy
1702306.png,https://derpicdn.net/img/view/2018/4/8/1702306.png,0,0.998755038,174,0,576,384,402,384,fluttershy
1702350.png,https://derpicdn.net/img/view/2018/4/8/1702350.png,0,0.982290268,94,176,524,606,430,430,fluttershy
1702441.png,https://derpicdn.net/img/view/2018/4/8/1702441.png,0,0.993500531,66,0,348,280,282,280,fluttershy
1702480.png,https://derpicdn.net/img/view/2018/4/8/1702480.png,0,0.997177899,3175,0,6713,3386,3538,3386,fluttershy
1702628.png,https://derpicdn.net/img/view/2018/4/8/1702628.png,0,0.993121207,105,0,1985,1869,1880,1869,fluttershy
1703357.png,https://derpicdn.net/img/view/2018/4/9/1703357.png,0,0.99890399,616,0,1108,467,492,467,fluttershy
1703357.png,https://derpicdn.net/img/view/2018/4/9/1703357.png,1,0.996854424,68,219,388,539,320,320,fluttershy
1703499.png,https://derpicdn.net/img/view/2018/4/9/1703499.png,0,0.99502027,341,0,789,441,448,441,fluttershy
1703592.png,https://derpicdn.net/img/view/2018/4/9/1703592.png,0,0.991510808,139,0,903,730,764,730,fluttershy
1704023.png,https://derpicdn.net/img/view/2018/4/10/1704023.png,0,0.969511688,388,0,1518,1029,1130,1029,fluttershy
1704147.png,https://derpicdn.net/img/view/2018/4/10/1704147.png,0,0.934532344,0,114,925,1172,925,1058,fluttershy
1704152.png,https://derpicdn.net/img/view/2018/4/10/1704152.png,0,0.992991269,74,3,852,781,778,778,fluttershy
1704460.png,https://derpicdn.net/img/view/2018/4/10/1704460.png,0,0.998846829,302,0,3640,2890,3338,2890,fluttershy
170476.jpg,https://derpicdn.net/img/view/2012/12/2/170476.jpg,0,0.900290549,674,58,1164,548,490,490,fluttershy
1704857.png,https://derpicdn.net/img/view/2018/4/11/1704857.png,0,0.962980509,0,0,658,678,658,678,fluttershy
1705230.png,https://derpicdn.net/img/view/2018/4/11/1705230.png,1,0.987759948,434,232,1632,1430,1198,1198,fluttershy
1705260.png,https://derpicdn.net/img/view/2018/4/11/1705260.png,0,0.971592367,652,414,1472,1234,820,820,fluttershy
1706973.png,https://derpicdn.net/img/view/2018/4/13/1706973.png,0,0.972258031,121,65,409,353,288,288,fluttershy
1707202.png,https://derpicdn.net/img/view/2018/4/14/1707202.png,0,0.998621702,158,0,988,814,830,814,fluttershy
1707443.png,https://derpicdn.net/img/view/2018/4/14/1707443.png,0,0.979306996,216,39,758,581,542,542,fluttershy
1709116.png,https://derpicdn.net/img/view/2018/4/16/1709116.png,0,0.980289102,10,0,1320,1252,1310,1252,fluttershy
1709616.png,https://derpicdn.net/img/view/2018/4/16/1709616.png,0,0.926219344,398,65,972,639,574,574,fluttershy
1710438.png,https://derpicdn.net/img/view/2018/4/17/1710438.png,0,0.945747018,197,0,791,579,594,579,fluttershy
1710457.png,https://derpicdn.net/img/view/2018/4/17/1710457.png,0,0.985423207,346,0,800,441,454,441,fluttershy
1711297.png,https://derpicdn.net/img/view/2018/4/18/1711297.png,0,0.994230866,151,0,873,671,722,671,fluttershy
1712420.png,https://derpicdn.net/img/view/2018/4/20/1712420.png,0,0.920790255,17,94,849,924,832,830,fluttershy
1714069.png,https://derpicdn.net/img/view/2018/4/22/1714069.png,0,0.987569749,157,35,1351,1229,1194,1194,fluttershy
1714218.png,https://derpicdn.net/img/view/2018/4/22/1714218.png,0,0.996451139,511,416,1029,934,518,518,fluttershy
1715687.png,https://derpicdn.net/img/view/2018/4/24/1715687.png,0,0.995369256,258,12,650,404,392,392,fluttershy
1716446.png,https://derpicdn.net/img/view/2018/4/25/1716446.png,0,0.989662051,238,0,1946,1578,1708,1578,fluttershy
1717029.png,https://derpicdn.net/img/view/2018/4/25/1717029.png,0,0.998486042,167,0,749,544,582,544,fluttershy
1717156.png,https://derpicdn.net/img/view/2018/4/26/1717156.png,0,0.967052519,415,8,795,388,380,380,fluttershy
1717461.png,https://derpicdn.net/img/view/2018/4/26/1717461.png,0,0.950925052,429,20,775,366,346,346,fluttershy
1717893.png,https://derpicdn.net/img/view/2018/4/26/1717893.png,0,0.989203334,45,0,1200,1138,1155,1138,fluttershy
1718067.png,https://derpicdn.net/img/view/2018/4/27/1718067.png,0,0.958677948,135,175,843,883,708,708,fluttershy
1718400.png,https://derpicdn.net/img/view/2018/4/27/1718400.png,0,0.93848139,907,48,1881,1022,974,974,fluttershy
1718402.png,https://derpicdn.net/img/view/2018/4/27/1718402.png,0,0.990264177,438,91,1262,915,824,824,fluttershy
1720461.png,https://derpicdn.net/img/view/2018/4/29/1720461.png,0,0.952091455,2202,382,2836,1016,634,634,fluttershy
1720486.png,https://derpicdn.net/img/view/2018/4/29/1720486.png,0,0.985396624,411,0,875,412,464,412,fluttershy
1721199.png,https://derpicdn.net/img/view/2018/4/30/1721199.png,0,0.997308314,284,0,1490,1162,1206,1162,fluttershy
1724509.png,https://derpicdn.net/img/view/2018/5/5/1724509.png,0,0.913840711,415,402,1861,1848,1446,1446,fluttershy
1724932.png,https://derpicdn.net/img/view/2018/5/5/1724932.png,0,0.998648822,623,1351,1605,2333,982,982,fluttershy
1725000.png,https://derpicdn.net/img/view/2018/5/5/1725000.png,0,0.96354866,229,0,2425,2066,2196,2066,fluttershy
1725030.png,https://derpicdn.net/img/view/2018/5/5/1725030.png,0,0.945098042,563,0,1495,924,932,924,fluttershy
1725039.png,https://derpicdn.net/img/view/2018/5/5/1725039.png,0,0.970397115,1153,432,1785,1064,632,632,fluttershy
1725071.png,https://derpicdn.net/img/view/2018/5/5/1725071.png,0,0.946735203,748,516,2594,2362,1846,1846,fluttershy
1725357.png,https://derpicdn.net/img/view/2018/5/5/1725357.png,0,0.99243319,339,341,1209,1211,870,870,fluttershy
1725856.png,https://derpicdn.net/img/view/2018/5/6/1725856.png,0,0.992862344,371,23,1427,1079,1056,1056,fluttershy
1726300.png,https://derpicdn.net/img/view/2018/5/6/1726300.png,0,0.989764571,462,485,2604,2627,2142,2142,fluttershy
1726329.png,https://derpicdn.net/img/view/2018/5/6/1726329.png,0,0.999146461,515,936,1491,1912,976,976,fluttershy
1727243.png,https://derpicdn.net/img/view/2018/5/8/1727243.png,0,0.96853137,137,39,2729,2631,2592,2592,fluttershy
1727315.png,https://derpicdn.net/img/view/2018/5/8/1727315.png,0,0.995471001,153,0,773,617,620,617,fluttershy
1728211.png,https://derpicdn.net/img/view/2018/5/9/1728211.png,0,0.981054723,33,0,611,564,578,564,fluttershy
1728753.png,https://derpicdn.net/img/view/2018/5/10/1728753.png,0,0.994244933,1617,719,2447,1549,830,830,fluttershy
1728774.png,https://derpicdn.net/img/view/2018/5/10/1728774.png,0,0.996769845,607,243,2017,1653,1410,1410,fluttershy
1729546.png,https://derpicdn.net/img/view/2018/5/10/1729546.png,0,0.997564971,399,49,1687,1337,1288,1288,fluttershy
1734600.png,https://derpicdn.net/img/view/2018/5/17/1734600.png,1,0.987789571,1059,0,1500,382,441,382,fluttershy
1735683.png,https://derpicdn.net/img/view/2018/5/18/1735683.png,0,0.987099349,43,507,395,859,352,352,fluttershy
1735683.png,https://derpicdn.net/img/view/2018/5/18/1735683.png,1,0.980193377,383,52,1043,712,660,660,fluttershy
1736642.png,https://derpicdn.net/img/view/2018/5/19/1736642.png,0,0.988203466,742,0,2788,1866,2046,1866,fluttershy
1737408.png,https://derpicdn.net/img/view/2018/5/20/1737408.png,0,0.994405389,386,15,1360,989,974,974,fluttershy
1737718.png,https://derpicdn.net/img/view/2018/5/20/1737718.png,0,0.963984251,246,86,1044,884,798,798,fluttershy
1737994.png,https://derpicdn.net/img/view/2018/5/21/1737994.png,0,0.989345789,107,0,355,243,248,243,fluttershy
1738.jpg,https://derpicdn.net/img/view/2012/1/23/1738.jpg,0,0.983360529,486,17,938,469,452,452,fluttershy
1738655.png,https://derpicdn.net/img/view/2018/5/22/1738655.png,0,0.958648145,725,38,1147,460,422,422,fluttershy
1738687.png,https://derpicdn.net/img/view/2018/5/22/1738687.png,0,0.985909283,718,117,1516,915,798,798,fluttershy
1738736.png,https://derpicdn.net/img/view/2018/5/22/1738736.png,0,0.987545073,11,10,431,430,420,420,fluttershy
1739424.png,https://derpicdn.net/img/view/2018/5/23/1739424.png,0,0.90692246,401,1,749,349,348,348,fluttershy
1739468.png,https://derpicdn.net/img/view/2018/5/23/1739468.png,0,0.992655873,0,0,1304,1307,1304,1307,fluttershy
1739480.png,https://derpicdn.net/img/view/2018/5/23/1739480.png,0,0.993142664,81,0,1751,1637,1670,1637,fluttershy
1740588.png,https://derpicdn.net/img/view/2018/5/24/1740588.png,0,0.925547779,267,0,2115,1740,1848,1740,fluttershy
1740818.png,https://derpicdn.net/img/view/2018/5/25/1740818.png,0,0.992085636,84,78,964,958,880,880,fluttershy
1744170.png,https://derpicdn.net/img/view/2018/5/29/1744170.png,0,0.973952711,422,191,1362,1131,940,940,fluttershy
1745.jpg,https://derpicdn.net/img/view/2012/1/23/1745.jpg,0,0.958487511,830,18,1676,864,846,846,fluttershy
1750508.png,https://derpicdn.net/img/view/2018/6/5/1750508.png,0,0.984827936,208,104,892,788,684,684,fluttershy
1752504.png,https://derpicdn.net/img/view/2018/6/8/1752504.png,0,0.996347189,36,8,704,676,668,668,fluttershy
1752931.png,https://derpicdn.net/img/view/2018/6/8/1752931.png,0,0.99639523,0,0,1264,1172,1264,1172,fluttershy
1753736.png,https://derpicdn.net/img/view/2018/6/9/1753736.png,2,0.973514259,1160,60,1522,422,362,362,fluttershy
1754635.png,https://derpicdn.net/img/view/2018/6/10/1754635.png,0,0.99566853,451,0,865,414,414,414,fluttershy
1755518.png,https://derpicdn.net/img/view/2018/6/11/1755518.png,0,0.986907482,197,0,635,419,438,419,fluttershy
1755829.png,https://derpicdn.net/img/view/2018/6/12/1755829.png,0,0.924282551,566,1074,1780,2288,1214,1214,fluttershy
1755942.png,https://derpicdn.net/img/view/2018/6/12/1755942.png,0,0.98170352,1154,321,1810,977,656,656,fluttershy
1755952.png,https://derpicdn.net/img/view/2018/6/12/1755952.png,0,0.997620404,687,191,1605,1109,918,918,fluttershy
1756835.png,https://derpicdn.net/img/view/2018/6/13/1756835.png,0,0.947490811,590,0,1796,1107,1206,1107,fluttershy
1757433.png,https://derpicdn.net/img/view/2018/6/14/1757433.png,0,0.968298018,270,136,812,678,542,542,fluttershy
1758010.png,https://derpicdn.net/img/view/2018/6/15/1758010.png,0,0.977978289,288,0,2094,1602,1806,1602,fluttershy
1758491.png,https://derpicdn.net/img/view/2018/6/15/1758491.png,0,0.98637259,820,197,1838,1215,1018,1018,fluttershy
1758812.png,https://derpicdn.net/img/view/2018/6/16/1758812.png,0,0.998733222,421,0,1317,882,896,882,fluttershy
1760025.png,https://derpicdn.net/img/view/2018/6/17/1760025.png,0,0.987439215,378,128,622,372,244,244,fluttershy
176121.png,https://derpicdn.net/img/view/2012/12/8/176121.png,0,0.982401431,96,0,704,606,608,606,fluttershy
1763514.png,https://derpicdn.net/img/view/2018/6/22/1763514.png,0,0.982274771,253,0,731,457,478,457,fluttershy
1767740.png,https://derpicdn.net/img/view/2018/6/28/1767740.png,0,0.998680174,257,90,673,506,416,416,fluttershy
1767770.png,https://derpicdn.net/img/view/2018/6/28/1767770.png,0,0.982315361,791,0,3401,2566,2610,2566,fluttershy
1768799.png,https://derpicdn.net/img/view/2018/6/29/1768799.png,0,0.998279393,29,0,1129,1002,1100,1002,fluttershy
1769331.png,https://derpicdn.net/img/view/2018/6/30/1769331.png,0,0.962774158,1350,0,2642,1231,1292,1231,fluttershy
1769331.png,https://derpicdn.net/img/view/2018/6/30/1769331.png,1,0.926136553,878,552,1976,1650,1098,1098,fluttershy
1769584.png,https://derpicdn.net/img/view/2018/6/30/1769584.png,0,0.998633087,25,0,451,408,426,408,fluttershy
1770069.png,https://derpicdn.net/img/view/2018/7/1/1770069.png,0,0.998767793,48,0,756,655,708,655,fluttershy
1772212.png,https://derpicdn.net/img/view/2018/7/3/1772212.png,0,0.987134099,304,211,1404,1311,1100,1100,fluttershy
1772212.png,https://derpicdn.net/img/view/2018/7/3/1772212.png,1,0.911715508,1947,32,2973,1058,1026,1026,fluttershy
1772795.png,https://derpicdn.net/img/view/2018/7/4/1772795.png,0,0.975408018,136,0,1200,991,1064,991,fluttershy
1776468.png,https://derpicdn.net/img/view/2018/7/9/1776468.png,0,0.999127686,1663,290,2753,1380,1090,1090,fluttershy
1779912.png,https://derpicdn.net/img/view/2018/7/13/1779912.png,0,0.947982907,0,0,576,583,576,583,fluttershy
1780110.png,https://derpicdn.net/img/view/2018/7/13/1780110.png,0,0.997971654,390,0,1668,1123,1278,1123,fluttershy
1780332.png,https://derpicdn.net/img/view/2018/7/13/1780332.png,0,0.976501167,220,0,620,382,400,382,fluttershy
1780657.png,https://derpicdn.net/img/view/2018/7/14/1780657.png,0,0.961588383,0,0,359,369,359,369,fluttershy
1780951.png,https://derpicdn.net/img/view/2018/7/14/1780951.png,0,0.985827208,688,32,1322,666,634,634,fluttershy
1781437.png,https://derpicdn.net/img/view/2018/7/15/1781437.png,0,0.990778387,12,0,1774,1635,1762,1635,fluttershy
1781732.png,https://derpicdn.net/img/view/2018/7/15/1781732.png,0,0.94754535,151,181,571,601,420,420,fluttershy
1782125.png,https://derpicdn.net/img/view/2018/7/16/1782125.png,0,0.982492447,974,1706,2346,3078,1372,1372,fluttershy
1784384.png,https://derpicdn.net/img/view/2018/7/19/1784384.png,0,0.90516597,838,236,2638,2036,1800,1800,fluttershy
1786917.png,https://derpicdn.net/img/view/2018/7/22/1786917.png,0,0.997457325,334,0,1462,995,1128,995,fluttershy
1789995.png,https://derpicdn.net/img/view/2018/7/26/1789995.png,0,0.917962253,1007,0,1821,757,814,757,fluttershy
1790150.png,https://derpicdn.net/img/view/2018/7/26/1790150.png,0,0.99448508,243,0,917,639,674,639,fluttershy
1790760.png,https://derpicdn.net/img/view/2018/7/27/1790760.png,0,0.995979428,440,67,728,355,288,288,fluttershy
1790907.png,https://derpicdn.net/img/view/2018/7/27/1790907.png,0,0.99389565,612,0,1498,842,886,842,fluttershy
1795610.png,https://derpicdn.net/img/view/2018/8/2/1795610.png,0,0.984448612,1544,0,3376,1582,1832,1582,fluttershy
1798611.png,https://derpicdn.net/img/view/2018/8/5/1798611.png,0,0.99455303,710,471,1510,1271,800,800,fluttershy
1799534.png,https://derpicdn.net/img/view/2018/8/6/1799534.png,0,0.943264127,660,65,1592,997,932,932,fluttershy
1801607.png,https://derpicdn.net/img/view/2018/8/8/1801607.png,0,0.987340868,41,11,579,549,538,538,fluttershy
1801992.png,https://derpicdn.net/img/view/2018/8/9/1801992.png,0,0.996124923,288,10,686,408,398,398,fluttershy
1802486.png,https://derpicdn.net/img/view/2018/8/9/1802486.png,0,0.999248445,1178,0,2004,726,826,726,fluttershy
1803898.png,https://derpicdn.net/img/view/2018/8/11/1803898.png,0,0.971459389,261,0,593,317,332,317,fluttershy
1804179.png,https://derpicdn.net/img/view/2018/8/11/1804179.png,0,0.993061721,66,0,536,457,470,457,fluttershy
1805255.png,https://derpicdn.net/img/view/2018/8/12/1805255.png,0,0.917197168,62,0,924,836,862,836,fluttershy
1806853.png,https://derpicdn.net/img/view/2018/8/14/1806853.png,0,0.973191142,587,28,1895,1336,1308,1308,fluttershy
1808803.png,https://derpicdn.net/img/view/2018/8/16/1808803.png,0,0.993571222,143,28,585,470,442,442,fluttershy
181157.jpg,https://derpicdn.net/img/view/2012/12/13/181157.jpg,0,0.998596728,130,0,680,533,550,533,fluttershy
1812573.png,https://derpicdn.net/img/view/2018/8/21/1812573.png,0,0.999439657,1041,38,1419,416,378,378,fluttershy
1813735.png,https://derpicdn.net/img/view/2018/8/22/1813735.png,0,0.934251845,762,142,1756,1136,994,994,fluttershy
1814214.png,https://derpicdn.net/img/view/2018/8/23/1814214.png,0,0.978341579,362,115,1452,1205,1090,1090,fluttershy
1814330.png,https://derpicdn.net/img/view/2018/8/23/1814330.png,0,0.997541308,980,70,1902,992,922,922,fluttershy
1814913.png,https://derpicdn.net/img/view/2018/8/24/1814913.png,0,0.994624436,1137,150,2573,1586,1436,1436,fluttershy
1817678.png,https://derpicdn.net/img/view/2018/8/27/1817678.png,0,0.997709274,952,10,1986,1044,1034,1034,fluttershy
1819491.png,https://derpicdn.net/img/view/2018/8/29/1819491.png,0,0.99866879,935,0,1931,984,996,984,fluttershy
1820730.png,https://derpicdn.net/img/view/2018/8/30/1820730.png,0,0.994523227,234,0,912,661,678,661,fluttershy
1821140.png,https://derpicdn.net/img/view/2018/8/31/1821140.png,0,0.994911373,1299,53,2603,1357,1304,1304,fluttershy
1821167.png,https://derpicdn.net/img/view/2018/8/31/1821167.png,0,0.999649882,29,0,631,534,602,534,fluttershy
1823103.png,https://derpicdn.net/img/view/2018/9/2/1823103.png,0,0.993799031,766,488,1778,1500,1012,1012,fluttershy
1824118.png,https://derpicdn.net/img/view/2018/9/3/1824118.png,0,0.996667445,771,177,1373,779,602,602,fluttershy
1831473.png,https://derpicdn.net/img/view/2018/9/13/1831473.png,0,0.997981727,886,0,2196,1284,1310,1284,fluttershy
1832052.png,https://derpicdn.net/img/view/2018/9/13/1832052.png,0,0.988873005,65,0,343,272,278,272,fluttershy
1833007.png,https://derpicdn.net/img/view/2018/9/15/1833007.png,0,0.992624521,378,23,1142,787,764,764,fluttershy
1833215.png,https://derpicdn.net/img/view/2018/9/15/1833215.png,0,0.997617304,2070,109,3274,1313,1204,1204,fluttershy
1833215.png,https://derpicdn.net/img/view/2018/9/15/1833215.png,1,0.945899069,883,1054,1961,2132,1078,1078,fluttershy
1837108.png,https://derpicdn.net/img/view/2018/9/20/1837108.png,0,0.98894304,583,2,1137,556,554,554,fluttershy
1837329.png,https://derpicdn.net/img/view/2018/9/20/1837329.png,0,0.999502182,332,0,536,186,204,186,fluttershy
1838504.png,https://derpicdn.net/img/view/2018/9/22/1838504.png,0,0.998580873,811,0,3289,2349,2478,2349,fluttershy
1843169.png,https://derpicdn.net/img/view/2018/9/28/1843169.png,0,0.991415024,151,0,1319,1158,1168,1158,fluttershy
1843371.png,https://derpicdn.net/img/view/2018/9/28/1843371.png,0,0.918405473,387,0,941,541,554,541,fluttershy
1843797.png,https://derpicdn.net/img/view/2018/9/29/1843797.png,0,0.99267602,806,0,2766,1821,1960,1821,fluttershy
1844086.png,https://derpicdn.net/img/view/2018/9/29/1844086.png,0,0.948295116,338,0,1522,1144,1184,1144,fluttershy
1845727.png,https://derpicdn.net/img/view/2018/10/1/1845727.png,0,0.9950158,0,0,1065,790,1065,790,fluttershy
1846703.png,https://derpicdn.net/img/view/2018/10/3/1846703.png,0,0.9957394,376,15,1904,1543,1528,1528,fluttershy
1847859.png,https://derpicdn.net/img/view/2018/10/4/1847859.png,0,0.997948408,966,278,2728,2040,1762,1762,fluttershy
1847894.png,https://derpicdn.net/img/view/2018/10/4/1847894.png,0,0.99414891,983,0,2157,1039,1174,1039,fluttershy
1849336.png,https://derpicdn.net/img/view/2018/10/6/1849336.png,0,0.997645438,132,0,696,530,564,530,fluttershy
1850555.png,https://derpicdn.net/img/view/2018/10/7/1850555.png,0,0.994924486,837,97,2481,1741,1644,1644,fluttershy
1851104.png,https://derpicdn.net/img/view/2018/10/8/1851104.png,0,0.993019879,600,16,1600,1068,1000,1052,fluttershy
1851121.png,https://derpicdn.net/img/view/2018/10/8/1851121.png,0,0.994367242,148,48,494,394,346,346,fluttershy
1852978.png,https://derpicdn.net/img/view/2018/10/10/1852978.png,0,0.989230633,519,0,1729,1076,1210,1076,fluttershy
1854323.png,https://derpicdn.net/img/view/2018/10/12/1854323.png,0,0.983544886,899,927,1173,1201,274,274,fluttershy
1854678.png,https://derpicdn.net/img/view/2018/10/12/1854678.png,0,0.956273794,354,0,1337,1011,983,1011,fluttershy
1855595.png,https://derpicdn.net/img/view/2018/10/13/1855595.png,0,0.996826768,397,0,629,209,232,209,fluttershy
1857056.png,https://derpicdn.net/img/view/2018/10/15/1857056.png,0,0.921216607,264,1,1930,1667,1666,1666,fluttershy
1857897.png,https://derpicdn.net/img/view/2018/10/16/1857897.png,0,0.990578234,0,0,477,482,477,482,fluttershy
1858755.png,https://derpicdn.net/img/view/2018/10/17/1858755.png,0,0.99198705,392,80,1194,882,802,802,fluttershy
1859915.png,https://derpicdn.net/img/view/2018/10/18/1859915.png,1,0.905529201,761,241,1315,795,554,554,fluttershy
1860891.png,https://derpicdn.net/img/view/2018/10/19/1860891.png,0,0.966408372,232,0,1122,877,890,877,fluttershy
1863538.png,https://derpicdn.net/img/view/2018/10/23/1863538.png,0,0.974038124,436,274,706,544,270,270,fluttershy
1867016.png,https://derpicdn.net/img/view/2018/10/27/1867016.png,0,0.90771699,103,0,481,343,378,343,fluttershy
1868224.png,https://derpicdn.net/img/view/2018/10/28/1868224.png,0,0.991577029,39,196,977,1078,938,882,fluttershy
1868834.png,https://derpicdn.net/img/view/2018/10/28/1868834.png,0,0.99242425,592,69,2324,1801,1732,1732,fluttershy
1869760.png,https://derpicdn.net/img/view/2018/10/29/1869760.png,0,0.998300672,131,138,561,568,430,430,fluttershy
1870045.png,https://derpicdn.net/img/view/2018/10/30/1870045.png,0,0.989772737,75,0,317,233,242,233,fluttershy
1870308.png,https://derpicdn.net/img/view/2018/10/30/1870308.png,0,0.993543744,843,0,2363,1240,1520,1240,fluttershy
1870691.png,https://derpicdn.net/img/view/2018/10/30/1870691.png,0,0.944525719,630,0,1622,975,992,975,fluttershy
1873687.png,https://derpicdn.net/img/view/2018/11/3/1873687.png,0,0.991107464,124,61,498,435,374,374,fluttershy
1873705.png,https://derpicdn.net/img/view/2018/11/3/1873705.png,0,0.997332633,260,0,964,665,704,665,fluttershy
1876832.png,https://derpicdn.net/img/view/2018/11/7/1876832.png,0,0.986363351,122,0,646,489,524,489,fluttershy
1878943.png,https://derpicdn.net/img/view/2018/11/10/1878943.png,0,0.986002803,840,205,1612,977,772,772,fluttershy
1882410.png,https://derpicdn.net/img/view/2018/11/14/1882410.png,0,0.925402403,219,0,495,268,276,268,fluttershy
1883462.png,https://derpicdn.net/img/view/2018/11/16/1883462.png,0,0.944984198,463,52,3571,3160,3108,3108,fluttershy
1884210.png,https://derpicdn.net/img/view/2018/11/17/1884210.png,0,0.998522282,1737,61,2657,981,920,920,fluttershy
1884360.png,https://derpicdn.net/img/view/2018/11/17/1884360.png,0,0.998599231,401,69,2155,1823,1754,1754,fluttershy
1884372.png,https://derpicdn.net/img/view/2018/11/17/1884372.png,0,0.984882414,157,141,753,737,596,596,fluttershy
1889821.png,https://derpicdn.net/img/view/2018/11/24/1889821.png,0,0.963352144,91,0,1377,1246,1286,1246,fluttershy
1891148.png,https://derpicdn.net/img/view/2018/11/26/1891148.png,0,0.996920288,624,279,1206,861,582,582,fluttershy
189375.png,https://derpicdn.net/img/view/2012/12/21/189375.png,0,0.974187195,55,0,584,455,529,455,fluttershy
1894026.png,https://derpicdn.net/img/view/2018/11/29/1894026.png,0,0.989760578,572,211,916,555,344,344,fluttershy
1894026.png,https://derpicdn.net/img/view/2018/11/29/1894026.png,1,0.944528103,331,212,543,424,212,212,fluttershy
1895881.png,https://derpicdn.net/img/view/2018/12/2/1895881.png,0,0.999031067,759,0,1555,771,796,771,fluttershy
1897930.png,https://derpicdn.net/img/view/2018/12/4/1897930.png,0,0.98174572,92,0,1468,1339,1376,1339,fluttershy
189822.jpg,https://derpicdn.net/img/view/2012/12/22/189822.jpg,0,0.995340943,390,20,790,420,400,400,fluttershy
1903134.png,https://derpicdn.net/img/view/2018/12/9/1903134.png,0,0.971859157,0,0,780,866,780,866,fluttershy
1905474.png,https://derpicdn.net/img/view/2018/12/11/1905474.png,0,0.984574795,0,15,955,1045,955,1030,fluttershy
1912436.png,https://derpicdn.net/img/view/2018/12/19/1912436.png,0,0.989924669,252,2,736,486,484,484,fluttershy
1918629.png,https://derpicdn.net/img/view/2018/12/25/1918629.png,0,0.987909198,350,0,782,394,432,394,fluttershy
1920224.png,https://derpicdn.net/img/view/2018/12/27/1920224.png,0,0.996851206,493,45,1351,903,858,858,fluttershy
1920917.png,https://derpicdn.net/img/view/2018/12/28/1920917.png,0,0.996703565,126,0,688,531,562,531,fluttershy
1921656.png,https://derpicdn.net/img/view/2018/12/29/1921656.png,0,0.991580307,217,7,563,353,346,346,fluttershy
1923561.png,https://derpicdn.net/img/view/2019/1/1/1923561.png,0,0.980458856,0,118,1125,1294,1125,1176,fluttershy
1923561.png,https://derpicdn.net/img/view/2019/1/1/1923561.png,1,0.919991076,95,0,1404,1186,1309,1186,fluttershy
1925994.png,https://derpicdn.net/img/view/2019/1/3/1925994.png,0,0.986214399,1565,0,5047,3486,3482,3486,fluttershy
1930696.png,https://derpicdn.net/img/view/2019/1/9/1930696.png,0,0.999353349,657,0,1135,396,478,396,fluttershy
1931045.png,https://derpicdn.net/img/view/2019/1/9/1931045.png,0,0.991215467,237,0,771,533,534,533,fluttershy
1935169.png,https://derpicdn.net/img/view/2019/1/14/1935169.png,0,0.938263237,1006,995,2350,2339,1344,1344,fluttershy
1935630.png,https://derpicdn.net/img/view/2019/1/14/1935630.png,0,0.966236234,25,0,1459,1379,1434,1379,fluttershy
1936093.png,https://derpicdn.net/img/view/2019/1/15/1936093.png,0,0.98899436,813,86,1591,864,778,778,fluttershy
1936876.png,https://derpicdn.net/img/view/2019/1/16/1936876.png,0,0.980191946,3172,0,6290,2905,3118,2905,fluttershy
1937130.png,https://derpicdn.net/img/view/2019/1/16/1937130.png,0,0.996177316,372,0,800,406,428,406,fluttershy
1938551.png,https://derpicdn.net/img/view/2019/1/18/1938551.png,0,0.97200197,136,0,1200,1061,1064,1061,fluttershy
1939377.png,https://derpicdn.net/img/view/2019/1/19/1939377.png,0,0.991349161,214,0,1008,789,794,789,fluttershy
1939842.png,https://derpicdn.net/img/view/2019/1/20/1939842.png,0,0.99586004,231,53,569,391,338,338,fluttershy
1940998.png,https://derpicdn.net/img/view/2019/1/21/1940998.png,0,0.956636369,67,67,1000,1000,933,933,fluttershy
1941416.png,https://derpicdn.net/img/view/2019/1/22/1941416.png,0,0.950854778,351,209,1695,1553,1344,1344,fluttershy
1941766.png,https://derpicdn.net/img/view/2019/1/22/1941766.png,0,0.994101942,296,0,1256,941,960,941,fluttershy
1947421.png,https://derpicdn.net/img/view/2019/1/29/1947421.png,0,0.975612819,211,0,1383,1192,1172,1192,fluttershy
1948267.png,https://derpicdn.net/img/view/2019/1/30/1948267.png,0,0.983900785,0,0,1339,1486,1339,1486,fluttershy
1950525.png,https://derpicdn.net/img/view/2019/2/1/1950525.png,0,0.970241129,516,88,1458,1030,942,942,fluttershy
1951464.png,https://derpicdn.net/img/view/2019/2/2/1951464.png,0,0.996770799,488,0,1602,1064,1114,1064,fluttershy
1954789.png,https://derpicdn.net/img/view/2019/2/6/1954789.png,0,0.986914456,31,26,1285,1280,1254,1254,fluttershy
1955248.png,https://derpicdn.net/img/view/2019/2/6/1955248.png,0,0.981027484,360,38,2000,1860,1640,1822,fluttershy
1956115.png,https://derpicdn.net/img/view/2019/2/7/1956115.png,0,0.967351317,1899,265,2507,873,608,608,fluttershy
1956730.png,https://derpicdn.net/img/view/2019/2/8/1956730.png,0,0.976398945,407,415,787,795,380,380,fluttershy
1956730.png,https://derpicdn.net/img/view/2019/2/8/1956730.png,1,0.920293748,74,80,568,574,494,494,fluttershy
1957687.png,https://derpicdn.net/img/view/2019/2/9/1957687.png,0,0.951104283,373,0,1267,882,894,882,fluttershy
1958686.png,https://derpicdn.net/img/view/2019/2/10/1958686.png,0,0.999706209,1057,70,1833,846,776,776,fluttershy
1959350.png,https://derpicdn.net/img/view/2019/2/11/1959350.png,0,0.993522584,96,0,634,533,538,533,fluttershy
1959409.png,https://derpicdn.net/img/view/2019/2/11/1959409.png,0,0.989750981,79,0,725,605,646,605,fluttershy
1960146.png,https://derpicdn.net/img/view/2019/2/12/1960146.png,0,0.955755055,39,0,1387,1328,1348,1328,fluttershy
1960535.png,https://derpicdn.net/img/view/2019/2/13/1960535.png,0,0.997324824,310,0,1198,837,888,837,fluttershy
1960901.png,https://derpicdn.net/img/view/2019/2/13/1960901.png,0,0.986367226,459,28,1399,968,940,940,fluttershy
1961419.png,https://derpicdn.net/img/view/2019/2/14/1961419.png,0,0.988137186,378,17,1216,855,838,838,fluttershy
1963361.png,https://derpicdn.net/img/view/2019/2/16/1963361.png,0,0.987750113,980,293,1624,937,644,644,fluttershy
1964754.png,https://derpicdn.net/img/view/2019/2/17/1964754.png,0,0.997321308,562,76,1006,520,444,444,fluttershy
1964875.png,https://derpicdn.net/img/view/2019/2/17/1964875.png,0,0.991134286,535,20,2279,1764,1744,1744,fluttershy
1965602.png,https://derpicdn.net/img/view/2019/2/18/1965602.png,0,0.93173039,390,11,888,509,498,498,fluttershy
1966902.png,https://derpicdn.net/img/view/2019/2/20/1966902.png,0,0.996253073,201,0,2765,2392,2564,2392,fluttershy
1967078.png,https://derpicdn.net/img/view/2019/2/20/1967078.png,0,0.991134286,535,20,2279,1764,1744,1744,fluttershy
1967417.png,https://derpicdn.net/img/view/2019/2/20/1967417.png,0,0.97781074,391,177,1179,965,788,788,fluttershy
1967985.png,https://derpicdn.net/img/view/2019/2/21/1967985.png,0,0.995868921,461,216,1341,1096,880,880,fluttershy
1967985.png,https://derpicdn.net/img/view/2019/2/21/1967985.png,1,0.986398876,1420,0,1768,347,348,347,fluttershy
1967985.png,https://derpicdn.net/img/view/2019/2/21/1967985.png,2,0.917707145,1634,282,2000,662,366,380,fluttershy
1968846.png,https://derpicdn.net/img/view/2019/2/22/1968846.png,0,0.989723444,143,0,595,434,452,434,fluttershy
1968953.png,https://derpicdn.net/img/view/2019/2/22/1968953.png,0,0.968326807,83,0,667,569,584,569,fluttershy
1970317.png,https://derpicdn.net/img/view/2019/2/24/1970317.png,0,0.912156403,179,256,2964,3196,2785,2940,fluttershy
1972755.png,https://derpicdn.net/img/view/2019/2/27/1972755.png,0,0.941813946,30,66,760,796,730,730,fluttershy
1973433.png,https://derpicdn.net/img/view/2019/2/28/1973433.png,0,0.99286592,250,8,634,392,384,384,fluttershy
1973656.png,https://derpicdn.net/img/view/2019/2/28/1973656.png,0,0.939066947,0,0,4256,4123,4256,4123,fluttershy
1973746.png,https://derpicdn.net/img/view/2019/2/28/1973746.png,0,0.974893928,363,124,2261,2022,1898,1898,fluttershy
1976188.png,https://derpicdn.net/img/view/2019/3/3/1976188.png,0,0.961890996,0,87,386,483,386,396,fluttershy
1976537.png,https://derpicdn.net/img/view/2019/3/3/1976537.png,0,0.995381832,1465,0,3977,2418,2512,2418,fluttershy
1976764.png,https://derpicdn.net/img/view/2019/3/3/1976764.png,0,0.996527314,338,11,1034,707,696,696,fluttershy
1982167.png,https://derpicdn.net/img/view/2019/3/10/1982167.png,0,0.959471941,275,159,671,555,396,396,fluttershy
1984171.png,https://derpicdn.net/img/view/2019/3/13/1984171.png,0,0.994591117,1197,122,1895,820,698,698,fluttershy
1987233.png,https://derpicdn.net/img/view/2019/3/16/1987233.png,0,0.999480009,1453,226,2689,1462,1236,1236,fluttershy
1989376.png,https://derpicdn.net/img/view/2019/3/18/1989376.png,0,0.957025051,734,231,1988,1485,1254,1254,fluttershy
1990961.png,https://derpicdn.net/img/view/2019/3/20/1990961.png,0,0.976633549,491,309,2479,2297,1988,1988,fluttershy
1991470.png,https://derpicdn.net/img/view/2019/3/21/1991470.png,0,0.988189995,432,0,1168,655,736,655,fluttershy
1992162.png,https://derpicdn.net/img/view/2019/3/22/1992162.png,0,0.968609333,804,0,1428,597,624,597,fluttershy
1992251.png,https://derpicdn.net/img/view/2019/3/22/1992251.png,0,0.900106907,2019,0,2627,562,608,562,fluttershy
199410.jpg,https://derpicdn.net/img/view/2013/1/1/199410.jpg,0,0.953153789,0,0,412,407,412,407,fluttershy
1994996.png,https://derpicdn.net/img/view/2019/3/25/1994996.png,0,0.976131916,1463,0,4813,3223,3350,3223,fluttershy
1995848.png,https://derpicdn.net/img/view/2019/3/27/1995848.png,0,0.996450365,615,0,2319,1537,1704,1537,fluttershy
1997692.png,https://derpicdn.net/img/view/2019/3/29/1997692.png,0,0.994884968,99,122,1649,1672,1550,1550,fluttershy
1998001.png,https://derpicdn.net/img/view/2019/3/30/1998001.png,0,0.93099153,242,221,806,785,564,564,fluttershy
1998898.png,https://derpicdn.net/img/view/2019/3/31/1998898.png,0,0.939663827,156,0,2640,2372,2484,2372,fluttershy
1999400.png,https://derpicdn.net/img/view/2019/3/31/1999400.png,0,0.975744128,343,59,1220,944,877,885,fluttershy
1999569.png,https://derpicdn.net/img/view/2019/3/31/1999569.png,0,0.932258725,1503,225,1909,631,406,406,fluttershy
2000376.png,https://derpicdn.net/img/view/2019/4/1/2000376.png,0,0.996462286,334,0,1406,960,1072,960,fluttershy
2000906.png,https://derpicdn.net/img/view/2019/4/2/2000906.png,0,0.956902444,227,0,1005,643,778,643,fluttershy
2002174.png,https://derpicdn.net/img/view/2019/4/3/2002174.png,0,0.985952318,544,131,1418,1005,874,874,fluttershy
2003026.png,https://derpicdn.net/img/view/2019/4/4/2003026.png,0,0.999298751,599,52,1243,696,644,644,fluttershy
2003466.png,https://derpicdn.net/img/view/2019/4/5/2003466.png,0,0.948095441,0,0,3000,3282,3000,3282,fluttershy
2005860.png,https://derpicdn.net/img/view/2019/4/7/2005860.png,0,0.994653165,311,0,1379,1033,1068,1033,fluttershy
2007772.png,https://derpicdn.net/img/view/2019/4/9/2007772.png,0,0.997227907,178,0,2358,1993,2180,1993,fluttershy
200824.png,https://derpicdn.net/img/view/2013/1/3/200824.png,0,0.924832344,241,0,725,445,484,445,fluttershy
2009752.png,https://derpicdn.net/img/view/2019/4/12/2009752.png,0,0.981314063,306,0,1906,1540,1600,1540,fluttershy
2010053.png,https://derpicdn.net/img/view/2019/4/12/2010053.png,0,0.960048258,922,89,1430,597,508,508,fluttershy
2010337.png,https://derpicdn.net/img/view/2019/4/13/2010337.png,0,0.997207522,390,68,1550,1228,1160,1160,fluttershy
2010508.png,https://derpicdn.net/img/view/2019/4/13/2010508.png,0,0.990169287,81,53,1031,1003,950,950,fluttershy
2011124.png,https://derpicdn.net/img/view/2019/4/13/2011124.png,0,0.970480621,188,154,828,794,640,640,fluttershy
2012045.png,https://derpicdn.net/img/view/2019/4/14/2012045.png,0,0.9600631,258,40,1130,912,872,872,fluttershy
2015281.png,https://derpicdn.net/img/view/2019/4/17/2015281.png,0,0.987046599,192,0,604,404,412,404,fluttershy
2015442.png,https://derpicdn.net/img/view/2019/4/17/2015442.png,0,0.928756654,1365,178,2663,1476,1298,1298,fluttershy
2015501.png,https://derpicdn.net/img/view/2019/4/18/2015501.png,0,0.983167827,64,0,718,584,654,584,fluttershy
2017037.png,https://derpicdn.net/img/view/2019/4/19/2017037.png,0,0.92929852,190,2,678,490,488,488,fluttershy
2018392.png,https://derpicdn.net/img/view/2019/4/21/2018392.png,0,0.991541505,0,0,3644,3928,3644,3928,fluttershy
2019930.png,https://derpicdn.net/img/view/2019/4/22/2019930.png,0,0.943024099,255,0,950,605,695,605,fluttershy
2021964.png,https://derpicdn.net/img/view/2019/4/24/2021964.png,0,0.989853859,2368,54,3890,1576,1522,1522,fluttershy
2022158.png,https://derpicdn.net/img/view/2019/4/24/2022158.png,0,0.997968793,177,0,463,277,286,277,fluttershy
2023461.png,https://derpicdn.net/img/view/2019/4/26/2023461.png,0,0.904823303,793,285,1939,1431,1146,1146,fluttershy
2023686.png,https://derpicdn.net/img/view/2019/4/26/2023686.png,0,0.929484725,1032,0,1446,319,414,319,fluttershy
2024012.png,https://derpicdn.net/img/view/2019/4/27/2024012.png,0,0.957742035,760,0,1412,641,652,641,fluttershy
2024704.png,https://derpicdn.net/img/view/2019/4/27/2024704.png,0,0.998171747,358,58,1294,994,936,936,fluttershy
2024755.png,https://derpicdn.net/img/view/2019/4/27/2024755.png,0,0.986693382,587,172,1415,1000,828,828,fluttershy
2025772.png,https://derpicdn.net/img/view/2019/4/28/2025772.png,0,0.96037215,228,142,1200,1174,972,1032,fluttershy
2025772.png,https://derpicdn.net/img/view/2019/4/28/2025772.png,1,0.908015072,0,220,891,1122,891,902,fluttershy
2027061.png,https://derpicdn.net/img/view/2019/4/30/2027061.png,0,0.989336252,8,24,1306,1322,1298,1298,fluttershy
2028749.png,https://derpicdn.net/img/view/2019/5/2/2028749.png,0,0.996358573,751,663,1725,1637,974,974,fluttershy
2030722.png,https://derpicdn.net/img/view/2019/5/4/2030722.png,0,0.974471986,472,0,3394,2817,2922,2817,fluttershy
2031441.png,https://derpicdn.net/img/view/2019/5/5/2031441.png,0,0.997769415,644,0,934,284,290,284,fluttershy
2032769.png,https://derpicdn.net/img/view/2019/5/6/2032769.png,0,0.922631383,161,0,1231,1006,1070,1006,fluttershy
2033434.png,https://derpicdn.net/img/view/2019/5/7/2033434.png,0,0.966183364,0,300,1034,1496,1034,1196,fluttershy
2034163.png,https://derpicdn.net/img/view/2019/5/8/2034163.png,0,0.976249218,469,509,919,959,450,450,fluttershy
2035189.png,https://derpicdn.net/img/view/2019/5/10/2035189.png,0,0.941694379,809,0,5481,4461,4672,4461,fluttershy
2035750.png,https://derpicdn.net/img/view/2019/5/10/2035750.png,0,0.974725723,569,90,2189,1710,1620,1620,fluttershy
2037082.png,https://derpicdn.net/img/view/2019/5/12/2037082.png,0,0.964474142,398,0,2523,2037,2125,2037,fluttershy
2037099.png,https://derpicdn.net/img/view/2019/5/12/2037099.png,0,0.950460374,0,158,1731,2092,1731,1934,fluttershy
2037100.png,https://derpicdn.net/img/view/2019/5/12/2037100.png,0,0.982093155,862,0,2300,1370,1438,1370,fluttershy
2038887.png,https://derpicdn.net/img/view/2019/5/14/2038887.png,0,0.991777897,355,177,765,587,410,410,fluttershy
2039056.png,https://derpicdn.net/img/view/2019/5/14/2039056.png,0,0.993612468,340,36,1008,704,668,668,fluttershy
2043199.png,https://derpicdn.net/img/view/2019/5/19/2043199.png,0,0.992702425,253,79,923,749,670,670,fluttershy
2043360.png,https://derpicdn.net/img/view/2019/5/19/2043360.png,0,0.998492658,402,16,780,394,378,378,fluttershy
2045168.png,https://derpicdn.net/img/view/2019/5/21/2045168.png,0,0.979136229,417,22,753,358,336,336,fluttershy
2046527.png,https://derpicdn.net/img/view/2019/5/23/2046527.png,0,0.998558044,547,335,953,741,406,406,fluttershy
2046966.png,https://derpicdn.net/img/view/2019/5/23/2046966.png,0,0.976098001,493,0,2341,1799,1848,1799,fluttershy
2047261.png,https://derpicdn.net/img/view/2019/5/23/2047261.png,0,0.964890659,893,0,1977,1073,1084,1073,fluttershy
2053129.png,https://derpicdn.net/img/view/2019/5/30/2053129.png,0,0.930667639,3083,105,7038,4115,3955,4010,fluttershy
2053867.png,https://derpicdn.net/img/view/2019/5/31/2053867.png,0,0.997318208,276,77,1278,1079,1002,1002,fluttershy
2055710.png,https://derpicdn.net/img/view/2019/6/2/2055710.png,0,0.993955374,134,0,476,337,342,337,fluttershy
2061514.png,https://derpicdn.net/img/view/2019/6/9/2061514.png,0,0.958038926,116,0,2472,2274,2356,2274,fluttershy
2063223.png,https://derpicdn.net/img/view/2019/6/11/2063223.png,0,0.999118268,724,0,1299,560,575,560,fluttershy
2063872.png,https://derpicdn.net/img/view/2019/6/12/2063872.png,0,0.997175455,277,30,635,388,358,358,fluttershy
2064744.png,https://derpicdn.net/img/view/2019/6/13/2064744.png,0,0.983897924,380,0,3000,2573,2620,2573,fluttershy
2065367.png,https://derpicdn.net/img/view/2019/6/14/2065367.png,0,0.999423802,591,0,2545,1899,1954,1899,fluttershy
2065982.png,https://derpicdn.net/img/view/2019/6/15/2065982.png,0,0.94455117,226,37,1450,1261,1224,1224,fluttershy
2068917.png,https://derpicdn.net/img/view/2019/6/18/2068917.png,0,0.928305447,253,54,1353,1154,1100,1100,fluttershy
2074542.png,https://derpicdn.net/img/view/2019/6/24/2074542.png,0,0.9767313,215,118,2123,2026,1908,1908,fluttershy
2075523.png,https://derpicdn.net/img/view/2019/6/26/2075523.png,0,0.987586617,97,0,697,592,600,592,fluttershy
2076702.png,https://derpicdn.net/img/view/2019/6/27/2076702.png,0,0.997898698,0,0,600,590,600,590,fluttershy
207855.png,https://derpicdn.net/img/view/2013/1/9/207855.png,0,0.997666657,87,0,465,362,378,362,fluttershy
2078723.png,https://derpicdn.net/img/view/2019/6/29/2078723.png,0,0.963450909,0,0,260,346,260,346,fluttershy
2079528.png,https://derpicdn.net/img/view/2019/6/30/2079528.png,0,0.999879837,578,88,1474,984,896,896,fluttershy
2079742.png,https://derpicdn.net/img/view/2019/6/30/2079742.png,1,0.968865931,3396,169,4138,911,742,742,fluttershy
208127.jpg,https://derpicdn.net/img/view/2013/1/10/208127.jpg,0,0.991756022,249,0,953,679,704,679,fluttershy
2082908.png,https://derpicdn.net/img/view/2019/7/4/2082908.png,0,0.942101181,54,130,904,980,850,850,fluttershy
2083259.png,https://derpicdn.net/img/view/2019/7/5/2083259.png,0,0.980944872,827,0,2757,1880,1930,1880,fluttershy
2084711.png,https://derpicdn.net/img/view/2019/7/6/2084711.png,0,0.974603534,263,19,2017,1773,1754,1754,fluttershy
2092209.png,https://derpicdn.net/img/view/2019/7/15/2092209.png,0,0.973568082,69,118,1009,1058,940,940,fluttershy
2096213.png,https://derpicdn.net/img/view/2019/7/19/2096213.png,0,0.966924906,223,0,657,408,434,408,fluttershy
2096296.png,https://derpicdn.net/img/view/2019/7/20/2096296.png,0,0.963043451,331,458,1613,1740,1282,1282,fluttershy
2096894.png,https://derpicdn.net/img/view/2019/7/20/2096894.png,0,0.993716538,344,0,1132,762,788,762,fluttershy
2098484.png,https://derpicdn.net/img/view/2019/7/22/2098484.png,0,0.996807516,254,0,990,660,736,660,fluttershy
2098999.png,https://derpicdn.net/img/view/2019/7/23/2098999.png,0,0.99385488,628,0,1889,1099,1261,1099,fluttershy
209932.png,https://derpicdn.net/img/view/2013/1/12/209932.png,0,0.982314408,204,0,1100,760,896,760,fluttershy
209933.png,https://derpicdn.net/img/view/2013/1/12/209933.png,0,0.976393342,212,0,691,461,479,461,fluttershy
2099701.png,https://derpicdn.net/img/view/2019/7/23/2099701.png,0,0.953641474,0,0,2160,2841,2160,2841,fluttershy
2100076.png,https://derpicdn.net/img/view/2019/7/24/2100076.png,0,0.916757524,1849,301,3669,2121,1820,1820,fluttershy
2100626.png,https://derpicdn.net/img/view/2019/7/25/2100626.png,0,0.999377131,412,0,4214,3423,3802,3423,fluttershy
2100626.png,https://derpicdn.net/img/view/2019/7/25/2100626.png,1,0.995348394,3880,0,8594,4044,4714,4044,fluttershy
2102931.png,https://derpicdn.net/img/view/2019/7/28/2102931.png,0,0.978139758,344,0,3716,3343,3372,3343,fluttershy
2104497.png,https://derpicdn.net/img/view/2019/7/30/2104497.png,0,0.976226628,3714,0,7532,3389,3818,3389,fluttershy
2110692.png,https://derpicdn.net/img/view/2019/8/6/2110692.png,0,0.989897847,234,0,1196,910,962,910,fluttershy
2116504.png,https://derpicdn.net/img/view/2019/8/12/2116504.png,0,0.995464146,51,6,703,658,652,652,fluttershy
2116504.png,https://derpicdn.net/img/view/2019/8/12/2116504.png,1,0.985379338,728,0,1504,761,776,761,fluttershy
2117940.png,https://derpicdn.net/img/view/2019/8/14/2117940.png,0,0.990009725,508,0,2400,1881,1892,1881,fluttershy
2118245.png,https://derpicdn.net/img/view/2019/8/14/2118245.png,0,0.985341489,0,0,3601,3530,3601,3530,fluttershy
2120063.png,https://derpicdn.net/img/view/2019/8/17/2120063.png,0,0.975413501,1519,82,2127,690,608,608,fluttershy
2121509.png,https://derpicdn.net/img/view/2019/8/18/2121509.png,0,0.979371071,635,0,4493,3494,3858,3494,fluttershy
2122369.png,https://derpicdn.net/img/view/2019/8/19/2122369.png,0,0.985732853,1082,0,1932,839,850,839,fluttershy
2123730.png,https://derpicdn.net/img/view/2019/8/21/2123730.png,0,0.997228205,131,0,433,301,302,301,fluttershy
2125983.png,https://derpicdn.net/img/view/2019/8/24/2125983.png,0,0.997079611,0,708,1804,2868,1804,2160,fluttershy
2127399.png,https://derpicdn.net/img/view/2019/8/25/2127399.png,0,0.965446413,405,5,937,537,532,532,fluttershy
2128883.png,https://derpicdn.net/img/view/2019/8/27/2128883.png,0,0.985312521,627,27,1603,1003,976,976,fluttershy
2130101.png,https://derpicdn.net/img/view/2019/8/28/2130101.png,0,0.997729778,2119,428,3453,1762,1334,1334,fluttershy
2130875.png,https://derpicdn.net/img/view/2019/8/29/2130875.png,0,0.996355295,114,7,1562,1455,1448,1448,fluttershy
2131564.png,https://derpicdn.net/img/view/2019/8/30/2131564.png,0,0.98976773,62,13,896,847,834,834,fluttershy
2131585.png,https://derpicdn.net/img/view/2019/8/30/2131585.png,0,0.995460093,1560,32,2960,1432,1400,1400,fluttershy
2132470.png,https://derpicdn.net/img/view/2019/8/31/2132470.png,0,0.989458263,205,121,775,691,570,570,fluttershy
2133714.png,https://derpicdn.net/img/view/2019/9/1/2133714.png,0,0.908705831,781,356,2123,1698,1342,1342,fluttershy
2134009.png,https://derpicdn.net/img/view/2019/9/2/2134009.png,0,0.985089123,2094,863,2436,1205,342,342,fluttershy
2136416.png,https://derpicdn.net/img/view/2019/9/4/2136416.png,0,0.984710217,80,0,494,389,414,389,fluttershy
2136546.png,https://derpicdn.net/img/view/2019/9/4/2136546.png,0,0.983408689,0,29,1325,1417,1325,1388,fluttershy
2137372.png,https://derpicdn.net/img/view/2019/9/5/2137372.png,0,0.999617577,735,287,1031,583,296,296,fluttershy
2140705.png,https://derpicdn.net/img/view/2019/9/10/2140705.png,0,0.984703004,197,0,491,283,294,283,fluttershy
2145003.png,https://derpicdn.net/img/view/2019/9/15/2145003.png,0,0.996980846,1283,159,1541,417,258,258,fluttershy
215120.png,https://derpicdn.net/img/view/2013/1/17/215120.png,0,0.934750557,362,158,810,606,448,448,fluttershy
2152624.png,https://derpicdn.net/img/view/2019/9/25/2152624.png,0,0.993190408,395,0,1499,1093,1104,1093,fluttershy
2152635.png,https://derpicdn.net/img/view/2019/9/25/2152635.png,0,0.999172151,1321,377,2615,1671,1294,1294,fluttershy
2155776.png,https://derpicdn.net/img/view/2019/9/29/2155776.png,0,0.98578757,79,40,843,804,764,764,fluttershy
2156369.png,https://derpicdn.net/img/view/2019/9/30/2156369.png,0,0.951025903,5,0,771,506,766,506,fluttershy
2156701.png,https://derpicdn.net/img/view/2019/9/30/2156701.png,0,0.99622035,644,427,1240,1023,596,596,fluttershy
2156701.png,https://derpicdn.net/img/view/2019/9/30/2156701.png,1,0.951279283,537,1260,805,1528,268,268,fluttershy
2156802.png,https://derpicdn.net/img/view/2019/9/30/2156802.png,0,0.997379303,0,0,244,234,244,234,fluttershy
2158001.png,https://derpicdn.net/img/view/2019/10/2/2158001.png,0,0.975289583,1617,0,4649,2895,3032,2895,fluttershy
2159086.png,https://derpicdn.net/img/view/2019/10/3/2159086.png,0,0.994487524,24,55,2324,2355,2300,2300,fluttershy
2160206.png,https://derpicdn.net/img/view/2019/10/4/2160206.png,0,0.988216937,396,49,804,457,408,408,fluttershy
2161558.png,https://derpicdn.net/img/view/2019/10/6/2161558.png,0,0.993692338,400,187,856,643,456,456,fluttershy
2163341.png,https://derpicdn.net/img/view/2019/10/8/2163341.png,0,0.997070968,376,67,1380,1071,1004,1004,fluttershy
2163506.png,https://derpicdn.net/img/view/2019/10/8/2163506.png,1,0.963476181,205,40,593,428,388,388,fluttershy
2165099.png,https://derpicdn.net/img/view/2019/10/10/2165099.png,0,0.993995488,379,0,1265,881,886,881,fluttershy
2168153.png,https://derpicdn.net/img/view/2019/10/14/2168153.png,0,0.970892131,0,29,775,845,775,816,fluttershy
2169983.png,https://derpicdn.net/img/view/2019/10/15/2169983.png,0,0.981369436,0,0,197,164,197,164,fluttershy
2171924.png,https://derpicdn.net/img/view/2019/10/17/2171924.png,0,0.995655715,58,233,1754,1937,1696,1704,fluttershy
2175223.png,https://derpicdn.net/img/view/2019/10/21/2175223.png,0,0.994873166,397,57,1405,1065,1008,1008,fluttershy
2175244.png,https://derpicdn.net/img/view/2019/10/21/2175244.png,0,0.994033992,370,29,1428,1087,1058,1058,fluttershy
2180247.png,https://derpicdn.net/img/view/2019/10/27/2180247.png,0,0.999111474,1668,69,2953,1407,1285,1338,fluttershy
2180247.png,https://derpicdn.net/img/view/2019/10/27/2180247.png,1,0.99306947,104,36,1398,1330,1294,1294,fluttershy
2185450.png,https://derpicdn.net/img/view/2019/11/2/2185450.png,0,0.995392025,240,0,1508,1141,1268,1141,fluttershy
2189619.png,https://derpicdn.net/img/view/2019/11/7/2189619.png,0,0.995298862,1266,228,2598,1560,1332,1332,fluttershy
2193244.png,https://derpicdn.net/img/view/2019/11/11/2193244.png,0,0.937736511,423,80,1287,944,864,864,fluttershy
2193921.png,https://derpicdn.net/img/view/2019/11/12/2193921.png,0,0.99084121,39,53,765,779,726,726,fluttershy
2193936.png,https://derpicdn.net/img/view/2019/11/12/2193936.png,1,0.992064416,64,644,654,1234,590,590,fluttershy
2197546.png,https://derpicdn.net/img/view/2019/11/16/2197546.png,0,0.988713145,30,0,400,343,370,343,fluttershy
2200510.png,https://derpicdn.net/img/view/2019/11/20/2200510.png,0,0.939930379,58,0,980,921,922,921,fluttershy
2204944.png,https://derpicdn.net/img/view/2019/11/25/2204944.png,0,0.995350599,1926,115,4900,3089,2974,2974,fluttershy
2206655.png,https://derpicdn.net/img/view/2019/11/27/2206655.png,0,0.946038067,383,0,1729,1221,1346,1221,fluttershy
2207508.png,https://derpicdn.net/img/view/2019/11/28/2207508.png,0,0.998628259,37,0,601,548,564,548,fluttershy
2208078.png,https://derpicdn.net/img/view/2019/11/29/2208078.png,0,0.998808324,495,50,1003,558,508,508,fluttershy
2208080.png,https://derpicdn.net/img/view/2019/11/29/2208080.png,0,0.949205399,441,25,1039,623,598,598,fluttershy
2208080.png,https://derpicdn.net/img/view/2019/11/29/2208080.png,1,0.941489279,1845,28,2435,618,590,590,fluttershy
2210869.png,https://derpicdn.net/img/view/2019/12/2/2210869.png,0,0.976559043,410,0,2056,1484,1646,1484,fluttershy
2215083.png,https://derpicdn.net/img/view/2019/12/7/2215083.png,0,0.998865366,521,0,1263,715,742,715,fluttershy
2217484.png,https://derpicdn.net/img/view/2019/12/10/2217484.png,0,0.973353326,398,18,696,316,298,298,fluttershy
2218918.png,https://derpicdn.net/img/view/2019/12/12/2218918.png,0,0.982834578,721,0,2035,1098,1314,1098,fluttershy
2218978.png,https://derpicdn.net/img/view/2019/12/12/2218978.png,0,0.997407913,547,21,1305,779,758,758,fluttershy
2220262.jpg,https://derpicdn.net/img/view/2019/12/14/2220262.jpg,0,0.994476497,653,58,1661,1066,1008,1008,fluttershy
2220447.png,https://derpicdn.net/img/view/2019/12/14/2220447.png,0,0.999459922,280,0,1558,1259,1278,1259,fluttershy
2221758.png,https://derpicdn.net/img/view/2019/12/16/2221758.png,0,0.997980118,879,139,1851,1111,972,972,fluttershy
2225013.png,https://derpicdn.net/img/view/2019/12/20/2225013.png,0,0.998639584,870,139,1842,1111,972,972,fluttershy
2227997.jpg,https://derpicdn.net/img/view/2019/12/23/2227997.jpg,0,0.988525748,342,0,1402,990,1060,990,fluttershy
2228654.png,https://derpicdn.net/img/view/2019/12/24/2228654.png,0,0.991154194,357,254,2097,1994,1740,1740,fluttershy
2228913.png,https://derpicdn.net/img/view/2019/12/24/2228913.png,0,0.996474385,150,0,1274,1073,1124,1073,fluttershy
2230749.jpg,https://derpicdn.net/img/view/2019/12/26/2230749.jpg,0,0.993142009,615,433,2581,2399,1966,1966,fluttershy
2230989.png,https://derpicdn.net/img/view/2019/12/27/2230989.png,0,0.957970977,736,231,1990,1485,1254,1254,fluttershy
2233280.jpg,https://derpicdn.net/img/view/2019/12/29/2233280.jpg,0,0.925596535,873,336,1913,1376,1040,1040,fluttershy
2234933.jpg,https://derpicdn.net/img/view/2019/12/31/2234933.jpg,0,0.952355146,802,376,1404,978,602,602,fluttershy
2237626.jpg,https://derpicdn.net/img/view/2020/1/3/2237626.jpg,0,0.998292387,205,0,1131,893,926,893,fluttershy
2238508.png,https://derpicdn.net/img/view/2020/1/4/2238508.png,0,0.950185835,0,0,1427,1412,1427,1412,fluttershy
2239109.png,https://derpicdn.net/img/view/2020/1/5/2239109.png,0,0.985736966,473,34,813,374,340,340,fluttershy
2239850.png,https://derpicdn.net/img/view/2020/1/6/2239850.png,0,0.990609825,665,0,1107,410,442,410,fluttershy
2240575.png,https://derpicdn.net/img/view/2020/1/6/2240575.png,2,0.993656039,6,11,734,739,728,728,fluttershy
2240575.png,https://derpicdn.net/img/view/2020/1/6/2240575.png,4,0.97407037,1148,0,1974,768,826,768,fluttershy
2240579.png,https://derpicdn.net/img/view/2020/1/6/2240579.png,0,0.986514688,0,43,830,895,830,852,fluttershy
2240580.png,https://derpicdn.net/img/view/2020/1/6/2240580.png,0,0.986013114,117,0,1000,776,883,776,fluttershy
2240586.png,https://derpicdn.net/img/view/2020/1/6/2240586.png,0,0.922282517,138,0,824,674,686,674,fluttershy
2243478.png,https://derpicdn.net/img/view/2020/1/10/2243478.png,0,0.976925731,296,8,1986,1665,1690,1657,fluttershy
2246048.png,https://derpicdn.net/img/view/2020/1/13/2246048.png,0,0.905970991,773,391,1221,839,448,448,fluttershy
2247357.jpg,https://derpicdn.net/img/view/2020/1/14/2247357.jpg,0,0.995583534,314,33,1036,755,722,722,fluttershy
2249695.jpg,https://derpicdn.net/img/view/2020/1/17/2249695.jpg,0,0.998266518,407,549,1267,1409,860,860,fluttershy
2253422.jpg,https://derpicdn.net/img/view/2020/1/21/2253422.jpg,0,0.987300873,108,185,1326,1403,1218,1218,fluttershy
2254773.jpg,https://derpicdn.net/img/view/2020/1/23/2254773.jpg,0,0.991915345,330,0,1344,950,1014,950,fluttershy
225507.jpg,https://derpicdn.net/img/view/2013/1/27/225507.jpg,0,0.992192864,106,0,614,465,508,465,fluttershy
2256006.jpg,https://derpicdn.net/img/view/2020/1/24/2256006.jpg,0,0.957587242,10,0,3157,3281,3147,3281,fluttershy
2256534.jpg,https://derpicdn.net/img/view/2020/1/25/2256534.jpg,0,0.995270789,281,93,801,613,520,520,fluttershy
2257679.png,https://derpicdn.net/img/view/2020/1/26/2257679.png,0,0.967422903,51,0,2149,2070,2098,2070,fluttershy
2257972.png,https://derpicdn.net/img/view/2020/1/26/2257972.png,0,0.998608351,388,5,1666,1283,1278,1278,fluttershy
2258729.png,https://derpicdn.net/img/view/2020/1/27/2258729.png,0,0.994908035,14,0,1096,987,1082,987,fluttershy
2261621.jpg,https://derpicdn.net/img/view/2020/1/31/2261621.jpg,0,0.991691053,0,0,923,971,923,971,fluttershy
2262510.jpg,https://derpicdn.net/img/view/2020/2/1/2262510.jpg,0,0.972036958,234,57,780,603,546,546,fluttershy
2262564.jpg,https://derpicdn.net/img/view/2020/2/1/2262564.jpg,0,0.986812115,149,16,559,426,410,410,fluttershy
2264856.png,https://derpicdn.net/img/view/2020/2/3/2264856.png,0,0.998362482,753,0,2305,1468,1552,1468,fluttershy
2265181.jpg,https://derpicdn.net/img/view/2020/2/3/2265181.jpg,0,0.958751917,664,0,2482,1591,1818,1591,fluttershy
2265265.png,https://derpicdn.net/img/view/2020/2/4/2265265.png,0,0.903191328,2317,0,7125,4481,4808,4481,fluttershy
2268210.jpg,https://derpicdn.net/img/view/2020/2/7/2268210.jpg,0,0.981669903,137,26,1625,1514,1488,1488,fluttershy
2268390.jpg,https://derpicdn.net/img/view/2020/2/8/2268390.jpg,0,0.991323709,679,0,1201,499,522,499,fluttershy
2268821.png,https://derpicdn.net/img/view/2020/2/8/2268821.png,0,0.956474364,177,0,2011,1750,1834,1750,fluttershy
2269426.png,https://derpicdn.net/img/view/2020/2/9/2269426.png,0,0.984305143,16,0,858,780,842,780,fluttershy
2270905.jpg,https://derpicdn.net/img/view/2020/2/10/2270905.jpg,0,0.985282183,151,0,1600,1436,1449,1436,fluttershy
2271726.jpg,https://derpicdn.net/img/view/2020/2/11/2271726.jpg,0,0.98886162,22,0,2972,2907,2950,2907,fluttershy
22753.png,https://derpicdn.net/img/view/2012/6/27/22753.png,0,0.976811707,33,0,357,321,324,321,fluttershy
2276048.jpg,https://derpicdn.net/img/view/2020/2/16/2276048.jpg,0,0.967601776,182,0,812,536,630,536,fluttershy
2278311.jpg,https://derpicdn.net/img/view/2020/2/19/2278311.jpg,0,0.991156876,47,0,857,771,810,771,fluttershy
2279209.png,https://derpicdn.net/img/view/2020/2/20/2279209.png,0,0.969412386,185,0,637,444,452,444,fluttershy
2280040.png,https://derpicdn.net/img/view/2020/2/21/2280040.png,0,0.990536153,1299,36,2041,778,742,742,fluttershy
2280810.jpg,https://derpicdn.net/img/view/2020/2/22/2280810.jpg,0,0.998911262,2022,728,3132,1838,1110,1110,fluttershy
2280988.jpg,https://derpicdn.net/img/view/2020/2/22/2280988.jpg,0,0.998162687,484,0,1326,728,842,728,fluttershy
2283290.jpg,https://derpicdn.net/img/view/2020/2/25/2283290.jpg,0,0.989238918,811,167,1517,873,706,706,fluttershy
2284586.jpg,https://derpicdn.net/img/view/2020/2/27/2284586.jpg,0,0.993843138,180,0,942,713,762,713,fluttershy
2287577.png,https://derpicdn.net/img/view/2020/3/1/2287577.png,0,0.973589599,187,13,405,231,218,218,fluttershy
2287826.jpg,https://derpicdn.net/img/view/2020/3/2/2287826.jpg,0,0.965203404,203,6,435,238,232,232,fluttershy
2287827.jpg,https://derpicdn.net/img/view/2020/3/2/2287827.jpg,0,0.995185971,243,15,457,229,214,214,fluttershy
2287828.jpg,https://derpicdn.net/img/view/2020/3/2/2287828.jpg,0,0.957466066,416,0,660,236,244,236,fluttershy
2289096.jpg,https://derpicdn.net/img/view/2020/3/3/2289096.jpg,0,0.980511069,2547,281,3543,1277,996,996,fluttershy
2289239.jpg,https://derpicdn.net/img/view/2020/3/3/2289239.jpg,0,0.977466881,162,46,808,692,646,646,fluttershy
2289927.png,https://derpicdn.net/img/view/2020/3/4/2289927.png,0,0.931233644,183,3,807,627,624,624,fluttershy
2292683.png,https://derpicdn.net/img/view/2020/3/8/2292683.png,0,0.97384882,0,0,1092,900,1092,900,fluttershy
2294820.jpg,https://derpicdn.net/img/view/2020/3/11/2294820.jpg,0,0.917968929,933,308,2649,2024,1716,1716,fluttershy
2297392.jpg,https://derpicdn.net/img/view/2020/3/14/2297392.jpg,0,0.99979049,1039,145,2811,1917,1772,1772,fluttershy
2297402.jpg,https://derpicdn.net/img/view/2020/3/14/2297402.jpg,0,0.971966982,954,185,1528,759,574,574,fluttershy
2301194.png,https://derpicdn.net/img/view/2020/3/19/2301194.png,0,0.998904884,441,150,1333,1042,892,892,fluttershy
2301232.png,https://derpicdn.net/img/view/2020/3/19/2301232.png,0,0.919247627,808,0,3894,2889,3086,2889,fluttershy
2303444.png,https://derpicdn.net/img/view/2020/3/22/2303444.png,0,0.998038352,242,0,1066,784,824,784,fluttershy
230498.png,https://derpicdn.net/img/view/2013/2/1/230498.png,0,0.99604255,226,62,816,652,590,590,fluttershy
2304980.png,https://derpicdn.net/img/view/2020/3/24/2304980.png,0,0.982340455,192,26,1440,1362,1248,1336,fluttershy
2304983.png,https://derpicdn.net/img/view/2020/3/24/2304983.png,0,0.982340455,192,26,1440,1362,1248,1336,fluttershy
2304984.png,https://derpicdn.net/img/view/2020/3/24/2304984.png,0,0.981022,198,90,1440,1410,1242,1320,fluttershy
2306645.png,https://derpicdn.net/img/view/2020/3/26/2306645.png,0,0.99831754,362,0,896,520,534,520,fluttershy
2309250.png,https://derpicdn.net/img/view/2020/3/29/2309250.png,0,0.964522481,41,8,1307,1274,1266,1266,fluttershy
2312467.jpg,https://derpicdn.net/img/view/2020/4/2/2312467.jpg,0,0.975280941,532,0,1740,1053,1208,1053,fluttershy
2313751.png,https://derpicdn.net/img/view/2020/4/4/2313751.png,0,0.997739732,361,6,847,492,486,486,fluttershy
2315496.png,https://derpicdn.net/img/view/2020/4/6/2315496.png,0,0.998763502,1080,70,1988,978,908,908,fluttershy
2317678.jpg,https://derpicdn.net/img/view/2020/4/9/2317678.jpg,0,0.996921122,271,0,859,579,588,579,fluttershy
2318688.jpg,https://derpicdn.net/img/view/2020/4/10/2318688.jpg,0,0.999352872,1382,382,2376,1376,994,994,fluttershy
2318844.png,https://derpicdn.net/img/view/2020/4/10/2318844.png,0,0.999045253,1059,17,2049,1007,990,990,fluttershy
2321235.png,https://derpicdn.net/img/view/2020/4/13/2321235.png,0,0.979822457,23,0,337,290,314,290,fluttershy
2321449.jpg,https://derpicdn.net/img/view/2020/4/13/2321449.jpg,0,0.996470988,424,1400,1560,2536,1136,1136,fluttershy
2321719.jpg,https://derpicdn.net/img/view/2020/4/13/2321719.jpg,0,0.975288093,214,319,1816,1921,1602,1602,fluttershy
2321721.jpg,https://derpicdn.net/img/view/2020/4/13/2321721.jpg,0,0.981154203,181,287,1841,1947,1660,1660,fluttershy
2322286.jpg,https://derpicdn.net/img/view/2020/4/14/2322286.jpg,0,0.980604351,326,0,1244,891,918,891,fluttershy
2323251.png,https://derpicdn.net/img/view/2020/4/15/2323251.png,0,0.990300238,563,18,829,284,266,266,fluttershy
2324851.png,https://derpicdn.net/img/view/2020/4/17/2324851.png,0,0.922203541,128,0,924,741,796,741,fluttershy
2325204.jpg,https://derpicdn.net/img/view/2020/4/18/2325204.jpg,0,0.986715317,1054,646,2180,1772,1126,1126,fluttershy
2326573.jpg,https://derpicdn.net/img/view/2020/4/19/2326573.jpg,0,0.974786282,208,260,1352,1404,1144,1144,fluttershy
2326657.jpg,https://derpicdn.net/img/view/2020/4/19/2326657.jpg,0,0.997520626,2286,219,3290,1223,1004,1004,fluttershy
2327262.jpg,https://derpicdn.net/img/view/2020/4/20/2327262.jpg,0,0.994837165,478,0,1564,1045,1086,1045,fluttershy
2327421.png,https://derpicdn.net/img/view/2020/4/20/2327421.png,0,0.97491169,1114,114,2142,1142,1028,1028,fluttershy
2330289.png,https://derpicdn.net/img/view/2020/4/24/2330289.png,0,0.987645507,513,57,1459,1003,946,946,fluttershy
2330732.png,https://derpicdn.net/img/view/2020/4/24/2330732.png,0,0.998897016,882,101,1690,909,808,808,fluttershy
2332934.jpg,https://derpicdn.net/img/view/2020/4/27/2332934.jpg,0,0.989838183,245,85,795,635,550,550,fluttershy
2333156.jpg,https://derpicdn.net/img/view/2020/4/27/2333156.jpg,0,0.939405978,806,0,1444,626,638,626,fluttershy
2333539.jpg,https://derpicdn.net/img/view/2020/4/28/2333539.jpg,1,0.945085168,3,2175,1171,3343,1168,1168,fluttershy
2335692.png,https://derpicdn.net/img/view/2020/4/30/2335692.png,0,0.996766925,304,502,982,1180,678,678,fluttershy
2339232.jpg,https://derpicdn.net/img/view/2020/5/4/2339232.jpg,0,0.993422806,1306,288,2786,1768,1480,1480,fluttershy
2339289.jpg,https://derpicdn.net/img/view/2020/5/4/2339289.jpg,0,0.993741393,1572,0,3158,1514,1586,1514,fluttershy
2340640.png,https://derpicdn.net/img/view/2020/5/6/2340640.png,0,0.991920531,66,56,1300,1290,1234,1234,fluttershy
2345722.jpg,https://derpicdn.net/img/view/2020/5/11/2345722.jpg,0,0.953523695,390,81,2068,1759,1678,1678,fluttershy
2350249.jpg,https://derpicdn.net/img/view/2020/5/16/2350249.jpg,0,0.996914625,702,0,1500,791,798,791,fluttershy
2350309.png,https://derpicdn.net/img/view/2020/5/16/2350309.png,0,0.985269248,303,93,1109,899,806,806,fluttershy
2350402.jpg,https://derpicdn.net/img/view/2020/5/16/2350402.jpg,0,0.983453691,0,0,360,345,360,345,fluttershy
2352987.png,https://derpicdn.net/img/view/2020/5/19/2352987.png,0,0.910598636,329,0,2549,1970,2220,1970,fluttershy
2353403.png,https://derpicdn.net/img/view/2020/5/20/2353403.png,0,0.996400476,1737,446,3065,1774,1328,1328,fluttershy
2353532.png,https://derpicdn.net/img/view/2020/5/20/2353532.png,0,0.998972833,766,12,2718,1964,1952,1952,fluttershy
262816.jpg,https://derpicdn.net/img/view/2013/3/5/262816.jpg,0,0.969616115,569,502,911,844,342,342,fluttershy
269388.png,https://derpicdn.net/img/view/2013/3/13/269388.png,0,0.98499167,35,0,835,638,800,638,fluttershy
269521.png,https://derpicdn.net/img/view/2013/3/13/269521.png,0,0.977567375,483,0,1300,761,817,761,fluttershy
272592.png,https://derpicdn.net/img/view/2013/3/17/272592.png,0,0.944606721,56,130,562,636,506,506,fluttershy
2727.png,https://derpicdn.net/img/view/2012/2/2/2727.png,0,0.985965133,13,0,473,440,460,440,fluttershy
278177.png,https://derpicdn.net/img/view/2013/3/24/278177.png,0,0.948311806,893,0,1655,754,762,754,fluttershy
284593.png,https://derpicdn.net/img/view/2013/3/31/284593.png,0,0.902977586,194,14,430,250,236,236,fluttershy
297986.png,https://derpicdn.net/img/view/2013/4/14/297986.png,0,0.98448205,191,0,461,237,270,237,fluttershy
299282.jpg,https://derpicdn.net/img/view/2013/4/15/299282.jpg,0,0.973201871,248,157,1032,941,784,784,fluttershy
312770.png,https://derpicdn.net/img/view/2013/4/30/312770.png,0,0.989422619,194,11,432,249,238,238,fluttershy
313594.png,https://derpicdn.net/img/view/2013/5/1/313594.png,0,0.991355121,219,19,439,239,220,220,fluttershy
31999.png,https://derpicdn.net/img/view/2012/7/5/31999.png,0,0.994200468,301,90,869,658,568,568,fluttershy
343368.png,https://derpicdn.net/img/view/2013/6/8/343368.png,0,0.988474429,87,126,583,622,496,496,fluttershy
344032.png,https://derpicdn.net/img/view/2013/6/9/344032.png,0,0.988504052,85,123,585,623,500,500,fluttershy
349656.png,https://derpicdn.net/img/view/2013/6/16/349656.png,0,0.997816384,249,8,635,394,386,386,fluttershy
351905.jpg,https://derpicdn.net/img/view/2013/6/18/351905.jpg,0,0.994701862,268,0,806,478,538,478,fluttershy
352086.png,https://derpicdn.net/img/view/2013/6/19/352086.png,0,0.98436439,365,49,841,525,476,476,fluttershy
354279.jpg,https://derpicdn.net/img/view/2013/6/22/354279.jpg,0,0.995957315,173,12,485,324,312,312,fluttershy
360815.png,https://derpicdn.net/img/view/2013/6/30/360815.png,0,0.961440325,328,343,1136,1151,808,808,fluttershy
373.png,https://derpicdn.net/img/view/2012/1/15/373.png,0,0.989409149,242,0,842,558,600,558,fluttershy
383774.jpg,https://derpicdn.net/img/view/2013/7/25/383774.jpg,0,0.934899926,676,293,1118,735,442,442,fluttershy
38473.png,https://derpicdn.net/img/view/2012/7/9/38473.png,0,0.910498679,22,0,976,941,954,941,fluttershy
393728.png,https://derpicdn.net/img/view/2013/8/7/393728.png,0,0.98040688,351,18,703,370,352,352,fluttershy
399002.png,https://derpicdn.net/img/view/2013/8/13/399002.png,0,0.987030625,53,0,867,704,814,704,fluttershy
408259.jpg,https://derpicdn.net/img/view/2013/8/23/408259.jpg,0,0.990973532,244,3,486,245,242,242,fluttershy
41515.png,https://derpicdn.net/img/view/2012/7/12/41515.png,0,0.993920326,412,0,1508,1056,1096,1056,fluttershy
419989.jpg,https://derpicdn.net/img/view/2013/9/5/419989.jpg,0,0.996115088,161,52,323,214,162,162,fluttershy
42454.png,https://derpicdn.net/img/view/2012/7/13/42454.png,0,0.979519904,318,412,1364,1458,1046,1046,fluttershy
424929.png,https://derpicdn.net/img/view/2013/9/11/424929.png,0,0.992172539,146,14,398,266,252,252,fluttershy
426477.png,https://derpicdn.net/img/view/2013/9/13/426477.png,0,0.979640961,0,0,705,692,705,692,fluttershy
428628.png,https://derpicdn.net/img/view/2013/9/16/428628.png,0,0.988058865,39,8,399,368,360,360,fluttershy
430274.png,https://derpicdn.net/img/view/2013/9/18/430274.png,0,0.984278202,0,16,203,240,203,224,fluttershy
430292.png,https://derpicdn.net/img/view/2013/9/18/430292.png,0,0.916817784,53,0,531,460,478,460,fluttershy
437058.png,https://derpicdn.net/img/view/2013/9/28/437058.png,0,0.972541094,176,28,544,396,368,368,fluttershy
437364.png,https://derpicdn.net/img/view/2013/9/29/437364.png,0,0.999717414,209,0,603,378,394,378,fluttershy
437803.png,https://derpicdn.net/img/view/2013/9/29/437803.png,0,0.985598207,0,262,1283,1766,1283,1504,fluttershy
441125.jpg,https://derpicdn.net/img/view/2013/10/4/441125.jpg,0,0.928376138,115,8,491,384,376,376,fluttershy
442064.png,https://derpicdn.net/img/view/2013/10/5/442064.png,0,0.985256016,1252,96,3234,2078,1982,1982,fluttershy
447876.png,https://derpicdn.net/img/view/2013/10/13/447876.png,0,0.977459073,1450,1719,3964,4233,2514,2514,fluttershy
447936.png,https://derpicdn.net/img/view/2013/10/13/447936.png,0,0.916266859,88,0,416,302,328,302,fluttershy
451854.png,https://derpicdn.net/img/view/2013/10/19/451854.png,0,0.983210623,414,187,904,677,490,490,fluttershy
452858.jpg,https://derpicdn.net/img/view/2013/10/20/452858.jpg,0,0.999165535,190,33,664,507,474,474,fluttershy
454536.png,https://derpicdn.net/img/view/2013/10/23/454536.png,0,0.976763964,299,0,603,299,304,299,fluttershy
455433.jpg,https://derpicdn.net/img/view/2013/10/24/455433.jpg,0,0.998073459,983,0,1391,378,408,378,fluttershy
4611.jpg,https://derpicdn.net/img/view/2012/6/17/4611.jpg,0,0.997960567,310,0,1128,768,818,768,fluttershy
461607.png,https://derpicdn.net/img/view/2013/11/1/461607.png,0,0.949969053,192,89,780,677,588,588,fluttershy
462223.png,https://derpicdn.net/img/view/2013/11/2/462223.png,0,0.990985215,218,42,466,290,248,248,fluttershy
4624.png,https://derpicdn.net/img/view/2012/6/17/4624.png,0,0.985189855,119,0,607,431,488,431,fluttershy
463346.png,https://derpicdn.net/img/view/2013/11/3/463346.png,0,0.997716606,203,0,627,413,424,413,fluttershy
469008.png,https://derpicdn.net/img/view/2013/11/10/469008.png,0,0.979121029,388,0,1116,610,728,610,fluttershy
472442.png,https://derpicdn.net/img/view/2013/11/14/472442.png,0,0.955250859,124,17,696,589,572,572,fluttershy
473188.png,https://derpicdn.net/img/view/2013/11/15/473188.png,0,0.996418655,217,121,855,759,638,638,fluttershy
478110.png,https://derpicdn.net/img/view/2013/11/22/478110.png,0,0.981526077,228,0,624,376,396,376,fluttershy
481689.png,https://derpicdn.net/img/view/2013/11/25/481689.png,0,0.987411141,314,375,782,843,468,468,fluttershy
483751.png,https://derpicdn.net/img/view/2013/11/27/483751.png,0,0.962068617,153,0,853,672,700,672,fluttershy
496444.png,https://derpicdn.net/img/view/2013/12/14/496444.png,0,0.956441581,1258,479,2328,1549,1070,1070,fluttershy
508255.png,https://derpicdn.net/img/view/2013/12/28/508255.png,0,0.983172417,96,0,878,747,782,747,fluttershy
508264.png,https://derpicdn.net/img/view/2013/12/28/508264.png,0,0.997246563,14,0,464,418,450,418,fluttershy
508378.png,https://derpicdn.net/img/view/2013/12/28/508378.png,0,0.983048439,98,20,500,422,402,402,fluttershy
508887.png,https://derpicdn.net/img/view/2013/12/29/508887.png,0,0.985872805,125,0,1533,1159,1408,1159,fluttershy
509201.png,https://derpicdn.net/img/view/2013/12/29/509201.png,0,0.990055323,52,0,388,316,336,316,fluttershy
509977.png,https://derpicdn.net/img/view/2013/12/30/509977.png,0,0.993797302,413,0,2023,1371,1610,1371,fluttershy
510108.png,https://derpicdn.net/img/view/2013/12/30/510108.png,0,0.976231396,187,0,713,524,526,524,fluttershy
510156.png,https://derpicdn.net/img/view/2013/12/30/510156.png,0,0.996901274,304,0,816,490,512,490,fluttershy
510239.png,https://derpicdn.net/img/view/2013/12/30/510239.png,0,0.994922221,173,282,541,650,368,368,fluttershy
510939.png,https://derpicdn.net/img/view/2013/12/31/510939.png,0,0.921769619,105,0,977,789,872,789,fluttershy
511760.png,https://derpicdn.net/img/view/2014/1/1/511760.png,0,0.998868346,268,85,724,541,456,456,fluttershy
512078.png,https://derpicdn.net/img/view/2014/1/1/512078.png,0,0.987572849,812,0,3994,2889,3182,2889,fluttershy
515801.png,https://derpicdn.net/img/view/2014/1/5/515801.png,0,0.924498141,0,322,768,1130,768,808,fluttershy
516907.png,https://derpicdn.net/img/view/2014/1/6/516907.png,0,0.930352032,221,90,2055,1811,1834,1721,fluttershy
520133.jpg,https://derpicdn.net/img/view/2014/1/10/520133.jpg,0,0.983928144,120,0,454,324,334,324,fluttershy
521267.png,https://derpicdn.net/img/view/2014/1/11/521267.png,0,0.992482126,140,0,624,472,484,472,fluttershy
522625.png,https://derpicdn.net/img/view/2014/1/12/522625.png,0,0.967435539,75,117,461,441,386,324,fluttershy
530062.png,https://derpicdn.net/img/view/2014/1/20/530062.png,0,0.988490224,461,0,1151,602,690,602,fluttershy
530069.png,https://derpicdn.net/img/view/2014/1/20/530069.png,0,0.999605656,189,0,681,476,492,476,fluttershy
533621.png,https://derpicdn.net/img/view/2014/1/25/533621.png,0,0.996979773,140,0,922,776,782,776,fluttershy
544432.jpg,https://derpicdn.net/img/view/2014/2/5/544432.jpg,0,0.998761356,331,60,667,396,336,336,fluttershy
545702.png,https://derpicdn.net/img/view/2014/2/7/545702.png,0,0.90857321,46,0,326,268,280,268,fluttershy
554741.png,https://derpicdn.net/img/view/2014/2/17/554741.png,0,0.994324803,0,39,500,549,500,510,fluttershy
556067.png,https://derpicdn.net/img/view/2014/2/19/556067.png,0,0.987881899,104,57,2298,2251,2194,2194,fluttershy
561757.png,https://derpicdn.net/img/view/2014/2/26/561757.png,0,0.937768102,232,0,988,719,756,719,fluttershy
563085.png,https://derpicdn.net/img/view/2014/2/28/563085.png,0,0.990968585,162,9,708,555,546,546,fluttershy
564152.jpg,https://derpicdn.net/img/view/2014/3/1/564152.jpg,0,0.970441341,496,205,1146,855,650,650,fluttershy
568802.jpg,https://derpicdn.net/img/view/2014/3/7/568802.jpg,0,0.993078172,88,69,976,957,888,888,fluttershy
57533.jpg,https://derpicdn.net/img/view/2012/7/26/57533.jpg,0,0.927057505,235,162,819,746,584,584,fluttershy
578975.png,https://derpicdn.net/img/view/2014/3/18/578975.png,0,0.954298496,0,0,347,367,347,367,fluttershy
579793.png,https://derpicdn.net/img/view/2014/3/19/579793.png,0,0.996918023,159,8,533,382,374,374,fluttershy
595481.png,https://derpicdn.net/img/view/2014/4/8/595481.png,0,0.947724998,584,0,1170,488,586,488,fluttershy
596708.png,https://derpicdn.net/img/view/2014/4/9/596708.png,0,0.966651797,109,0,766,637,657,637,fluttershy
599698.png,https://derpicdn.net/img/view/2014/4/13/599698.png,0,0.955843806,56,0,568,504,512,504,fluttershy
601071.png,https://derpicdn.net/img/view/2014/4/15/601071.png,0,0.946405649,256,0,688,432,432,432,fluttershy
601835.png,https://derpicdn.net/img/view/2014/4/16/601835.png,0,0.993228078,633,366,1955,1688,1322,1322,fluttershy
60632.png,https://derpicdn.net/img/view/2012/7/29/60632.png,0,0.970927656,227,90,453,316,226,226,fluttershy
608505.png,https://derpicdn.net/img/view/2014/4/24/608505.png,0,0.986296535,137,0,385,236,248,236,fluttershy
619704.png,https://derpicdn.net/img/view/2014/5/7/619704.png,0,0.993858159,213,0,623,401,410,401,fluttershy
619705.png,https://derpicdn.net/img/view/2014/5/7/619705.png,0,0.990874767,225,0,611,384,386,384,fluttershy
623586.png,https://derpicdn.net/img/view/2014/5/11/623586.png,0,0.93193841,296,67,740,511,444,444,fluttershy
634273.png,https://derpicdn.net/img/view/2014/5/23/634273.png,0,0.999349654,752,118,1748,1114,996,996,fluttershy
652040.png,https://derpicdn.net/img/view/2014/6/13/652040.png,0,0.909473479,106,0,364,236,258,236,fluttershy
653120.png,https://derpicdn.net/img/view/2014/6/14/653120.png,0,0.985209107,217,47,1045,875,828,828,fluttershy
653835.png,https://derpicdn.net/img/view/2014/6/15/653835.png,0,0.995175481,0,0,304,306,304,306,fluttershy
657505.png,https://derpicdn.net/img/view/2014/6/20/657505.png,0,0.957198083,214,205,1050,1041,836,836,fluttershy
658407.png,https://derpicdn.net/img/view/2014/6/21/658407.png,0,0.997349858,191,0,653,461,462,461,fluttershy
664052.png,https://derpicdn.net/img/view/2014/6/29/664052.png,0,0.980371714,30,0,1182,1060,1152,1060,fluttershy
673192.png,https://derpicdn.net/img/view/2014/7/12/673192.png,0,0.998535335,612,52,1012,452,400,400,fluttershy
673878.png,https://derpicdn.net/img/view/2014/7/13/673878.png,0,0.934304118,806,44,1302,540,496,496,fluttershy
673949.jpg,https://derpicdn.net/img/view/2014/7/13/673949.jpg,0,0.937497377,190,99,544,453,354,354,fluttershy
676101.png,https://derpicdn.net/img/view/2014/7/16/676101.png,0,0.991001427,1021,1044,1443,1466,422,422,fluttershy
677573.png,https://derpicdn.net/img/view/2014/7/18/677573.png,0,0.99956125,413,229,1119,935,706,706,fluttershy
682734.jpg,https://derpicdn.net/img/view/2014/7/25/682734.jpg,0,0.980225086,286,56,840,610,554,554,fluttershy
683196.png,https://derpicdn.net/img/view/2014/7/25/683196.png,0,0.992615163,0,4,677,690,677,686,fluttershy
685110.png,https://derpicdn.net/img/view/2014/7/28/685110.png,0,0.926593542,2,0,470,450,468,450,fluttershy
692959.png,https://derpicdn.net/img/view/2014/8/6/692959.png,0,0.962162375,23,0,625,560,602,560,fluttershy
694251.png,https://derpicdn.net/img/view/2014/8/8/694251.png,0,0.998198926,452,0,1120,625,668,625,fluttershy
697707.png,https://derpicdn.net/img/view/2014/8/12/697707.png,0,0.980968595,622,435,2740,2553,2118,2118,fluttershy
698613.jpg,https://derpicdn.net/img/view/2014/8/13/698613.jpg,0,0.979736567,0,0,2107,2338,2107,2338,fluttershy
699458.png,https://derpicdn.net/img/view/2014/8/14/699458.png,0,0.98814553,84,0,590,451,506,451,fluttershy
699507.jpg,https://derpicdn.net/img/view/2014/8/14/699507.jpg,0,0.996095777,104,0,472,366,368,366,fluttershy
702649.jpg,https://derpicdn.net/img/view/2014/8/18/702649.jpg,0,0.999376774,122,0,642,493,520,493,fluttershy
705699.png,https://derpicdn.net/img/view/2014/8/22/705699.png,0,0.999284327,363,0,753,339,390,339,fluttershy
705769.png,https://derpicdn.net/img/view/2014/8/22/705769.png,0,0.983552217,26,0,654,562,628,562,fluttershy
707987.png,https://derpicdn.net/img/view/2014/8/25/707987.png,0,0.991071761,127,70,411,354,284,284,fluttershy
710159.png,https://derpicdn.net/img/view/2014/8/29/710159.png,0,0.978669047,398,14,878,494,480,480,fluttershy
714855.png,https://derpicdn.net/img/view/2014/9/4/714855.png,0,0.991809845,500,8,2118,1626,1618,1618,fluttershy
718896.png,https://derpicdn.net/img/view/2014/9/9/718896.png,0,0.95317775,18,0,370,345,352,345,fluttershy
725085.jpg,https://derpicdn.net/img/view/2014/9/19/725085.jpg,0,0.986919165,0,41,959,1045,959,1004,fluttershy
731933.png,https://derpicdn.net/img/view/2014/9/29/731933.png,0,0.999307334,63,0,441,366,378,366,fluttershy
732.png,https://derpicdn.net/img/view/2012/1/17/732.png,0,0.971687078,277,0,787,505,510,505,fluttershy
733399.png,https://derpicdn.net/img/view/2014/10/1/733399.png,0,0.985693276,396,0,1046,626,650,626,fluttershy
733593.png,https://derpicdn.net/img/view/2014/10/1/733593.png,0,0.998910129,69,0,437,362,368,362,fluttershy
734858.png,https://derpicdn.net/img/view/2014/10/3/734858.png,0,0.9950881,0,0,579,606,579,606,fluttershy
735364.png,https://derpicdn.net/img/view/2014/10/4/735364.png,0,0.946417511,675,420,1193,938,518,518,fluttershy
736313.png,https://derpicdn.net/img/view/2014/10/5/736313.png,0,0.991335809,337,0,2145,1721,1808,1721,fluttershy
738345.png,https://derpicdn.net/img/view/2014/10/8/738345.png,0,0.980668485,234,0,2398,2027,2164,2027,fluttershy
739355.jpg,https://derpicdn.net/img/view/2014/10/9/739355.jpg,0,0.985281825,860,0,1892,1028,1032,1028,fluttershy
739368.png,https://derpicdn.net/img/view/2014/10/9/739368.png,0,0.982780397,188,0,430,240,242,240,fluttershy
739570.png,https://derpicdn.net/img/view/2014/10/9/739570.png,0,0.996723473,0,0,588,616,588,616,fluttershy
740288.png,https://derpicdn.net/img/view/2014/10/10/740288.png,0,0.997197092,2851,750,3791,1690,940,940,fluttershy
740289.png,https://derpicdn.net/img/view/2014/10/10/740289.png,0,0.997372508,2804,694,3838,1728,1034,1034,fluttershy
749998.png,https://derpicdn.net/img/view/2014/10/25/749998.png,0,0.995591462,209,41,671,503,462,462,fluttershy
753068.png,https://derpicdn.net/img/view/2014/10/29/753068.png,0,0.984987438,395,0,697,297,302,297,fluttershy
755479.png,https://derpicdn.net/img/view/2014/11/1/755479.png,0,0.993756175,299,0,723,424,424,424,fluttershy
757902.png,https://derpicdn.net/img/view/2014/11/4/757902.png,0,0.921388805,236,290,1200,1200,964,910,fluttershy
758924.png,https://derpicdn.net/img/view/2014/11/6/758924.png,0,0.980446994,126,0,1120,950,994,950,fluttershy
759426.png,https://derpicdn.net/img/view/2014/11/6/759426.png,0,0.96936965,18,0,1158,1115,1140,1115,fluttershy
760775.jpg,https://derpicdn.net/img/view/2014/11/8/760775.jpg,0,0.987012625,972,126,1828,982,856,856,fluttershy
761126.jpg,https://derpicdn.net/img/view/2014/11/9/761126.jpg,0,0.998781264,253,1324,865,1936,612,612,fluttershy
763138.png,https://derpicdn.net/img/view/2014/11/12/763138.png,0,0.94455868,0,25,1168,1199,1168,1174,fluttershy
764169.png,https://derpicdn.net/img/view/2014/11/14/764169.png,0,0.963471711,361,82,965,686,604,604,fluttershy
768127.png,https://derpicdn.net/img/view/2014/11/20/768127.png,0,0.972710967,150,0,592,426,442,426,fluttershy
772904.png,https://derpicdn.net/img/view/2014/11/27/772904.png,0,0.995051265,204,0,726,499,522,499,fluttershy
773142.png,https://derpicdn.net/img/view/2014/11/27/773142.png,0,0.99861753,123,10,711,598,588,588,fluttershy
774613.png,https://derpicdn.net/img/view/2014/11/29/774613.png,0,0.998131096,127,0,525,347,398,347,fluttershy
782681.png,https://derpicdn.net/img/view/2014/12/11/782681.png,0,0.997906268,376,0,920,541,544,541,fluttershy
782988.png,https://derpicdn.net/img/view/2014/12/11/782988.png,0,0.973511517,394,0,938,544,544,544,fluttershy
783006.jpg,https://derpicdn.net/img/view/2014/12/11/783006.jpg,0,0.995091259,150,123,864,837,714,714,fluttershy
784433.jpg,https://derpicdn.net/img/view/2014/12/14/784433.jpg,0,0.998219609,493,50,969,526,476,476,fluttershy
786120.png,https://derpicdn.net/img/view/2014/12/16/786120.png,0,0.999889731,503,48,1261,806,758,758,fluttershy
791738.jpg,https://derpicdn.net/img/view/2014/12/24/791738.jpg,0,0.903177261,492,0,1024,533,532,533,fluttershy
797392.png,https://derpicdn.net/img/view/2015/1/1/797392.png,0,0.997695804,497,55,967,525,470,470,fluttershy
798616.png,https://derpicdn.net/img/view/2015/1/3/798616.png,0,0.97379303,504,0,1278,754,774,754,fluttershy
800949.png,https://derpicdn.net/img/view/2015/1/6/800949.png,0,0.949809134,734,0,1456,643,722,643,fluttershy
802816.jpg,https://derpicdn.net/img/view/2015/1/9/802816.jpg,0,0.997132778,187,94,463,370,276,276,fluttershy
803590.png,https://derpicdn.net/img/view/2015/1/10/803590.png,0,0.983349025,55,46,1259,1250,1204,1204,fluttershy
803736.png,https://derpicdn.net/img/view/2015/1/11/803736.png,0,0.997645497,316,0,848,522,532,522,fluttershy
806542.png,https://derpicdn.net/img/view/2015/1/14/806542.png,0,0.918653309,186,69,584,467,398,398,fluttershy
806955.png,https://derpicdn.net/img/view/2015/1/15/806955.png,0,0.97617346,0,5,447,463,447,458,fluttershy
807301.png,https://derpicdn.net/img/view/2015/1/15/807301.png,0,0.985819161,287,0,705,401,418,401,fluttershy
81210.png,https://derpicdn.net/img/view/2012/8/23/81210.png,0,0.996271312,436,22,882,468,446,446,fluttershy
813200.jpg,https://derpicdn.net/img/view/2015/1/24/813200.jpg,0,0.993223608,1371,1,2277,907,906,906,fluttershy
815317.png,https://derpicdn.net/img/view/2015/1/26/815317.png,0,0.960385144,639,0,1173,530,534,530,fluttershy
815964.png,https://derpicdn.net/img/view/2015/1/27/815964.png,0,0.997124314,245,14,789,558,544,544,fluttershy
817664.png,https://derpicdn.net/img/view/2015/1/30/817664.png,0,0.977165222,16,0,478,395,462,395,fluttershy
819740.png,https://derpicdn.net/img/view/2015/2/2/819740.png,0,0.977090299,248,73,1232,1057,984,984,fluttershy
821737.png,https://derpicdn.net/img/view/2015/2/5/821737.png,0,0.988956153,66,0,550,443,484,443,fluttershy
824190.png,https://derpicdn.net/img/view/2015/2/8/824190.png,0,0.971823752,56,0,1328,1215,1272,1215,fluttershy
824202.png,https://derpicdn.net/img/view/2015/2/8/824202.png,0,0.906416535,209,132,1177,1100,968,968,fluttershy
824390.jpg,https://derpicdn.net/img/view/2015/2/8/824390.jpg,0,0.995574236,1222,0,1802,464,580,464,fluttershy
824455.png,https://derpicdn.net/img/view/2015/2/8/824455.png,0,0.996254086,1217,0,1801,465,584,465,fluttershy
825513.png,https://derpicdn.net/img/view/2015/2/10/825513.png,0,0.984414876,93,0,645,527,552,527,fluttershy
834052.jpg,https://derpicdn.net/img/view/2015/2/21/834052.jpg,0,0.904349744,0,0,469,525,469,525,fluttershy
834302.png,https://derpicdn.net/img/view/2015/2/21/834302.png,0,0.991984963,369,27,937,595,568,568,fluttershy
834874.jpg,https://derpicdn.net/img/view/2015/2/22/834874.jpg,0,0.918959439,649,282,1875,1508,1226,1226,fluttershy
836017.jpg,https://derpicdn.net/img/view/2015/2/23/836017.jpg,0,0.996017098,2835,0,4000,1098,1165,1098,fluttershy
836017.jpg,https://derpicdn.net/img/view/2015/2/23/836017.jpg,1,0.909860313,407,0,1909,1272,1502,1272,fluttershy
836368.png,https://derpicdn.net/img/view/2015/2/24/836368.png,0,0.994475663,1380,196,2200,1120,820,924,fluttershy
837065.png,https://derpicdn.net/img/view/2015/2/25/837065.png,0,0.992620885,198,0,1338,1010,1140,1010,fluttershy
840309.png,https://derpicdn.net/img/view/2015/3/2/840309.png,0,0.989874065,54,0,560,483,506,483,fluttershy
843055.png,https://derpicdn.net/img/view/2015/3/5/843055.png,0,0.997399271,297,1,541,245,244,244,fluttershy
846550.png,https://derpicdn.net/img/view/2015/3/10/846550.png,0,0.962107778,149,82,651,584,502,502,fluttershy
846571.png,https://derpicdn.net/img/view/2015/3/10/846571.png,0,0.998156428,111,1,411,301,300,300,fluttershy
848191.png,https://derpicdn.net/img/view/2015/3/12/848191.png,0,0.995228469,230,4,630,404,400,400,fluttershy
850319.jpg,https://derpicdn.net/img/view/2015/3/15/850319.jpg,0,0.985687673,0,0,696,630,696,630,fluttershy
851611.png,https://derpicdn.net/img/view/2015/3/17/851611.png,0,0.993009448,0,0,3104,3067,3104,3067,fluttershy
851784.png,https://derpicdn.net/img/view/2015/3/17/851784.png,0,0.971319258,33,67,561,595,528,528,fluttershy
854824.png,https://derpicdn.net/img/view/2015/3/22/854824.png,0,0.997632682,312,0,1470,1067,1158,1067,fluttershy
855260.png,https://derpicdn.net/img/view/2015/3/23/855260.png,0,0.992078364,105,0,1891,1718,1786,1718,fluttershy
856308.png,https://derpicdn.net/img/view/2015/3/24/856308.png,0,0.997643352,890,97,1756,963,866,866,fluttershy
857431.jpg,https://derpicdn.net/img/view/2015/3/26/857431.jpg,0,0.996670425,712,0,1158,427,446,427,fluttershy
857431.jpg,https://derpicdn.net/img/view/2015/3/26/857431.jpg,1,0.974199057,1138,37,1514,413,376,376,fluttershy
857431.jpg,https://derpicdn.net/img/view/2015/3/26/857431.jpg,2,0.939005971,594,1183,1210,1799,616,616,fluttershy
857825.png,https://derpicdn.net/img/view/2015/3/26/857825.png,0,0.98025763,396,0,582,185,186,185,fluttershy
859514.png,https://derpicdn.net/img/view/2015/3/29/859514.png,0,0.998424113,40,92,406,458,366,366,fluttershy
859514.png,https://derpicdn.net/img/view/2015/3/29/859514.png,1,0.975820065,392,0,928,455,536,455,fluttershy
860641.png,https://derpicdn.net/img/view/2015/3/30/860641.png,0,0.942563951,93,24,607,538,514,514,fluttershy
863450.png,https://derpicdn.net/img/view/2015/4/3/863450.png,0,0.990546644,1299,40,2923,1664,1624,1624,fluttershy
864028.png,https://derpicdn.net/img/view/2015/4/3/864028.png,0,0.986852527,123,0,743,561,620,561,fluttershy
865253.png,https://derpicdn.net/img/view/2015/4/5/865253.png,0,0.997717083,138,40,1020,922,882,882,fluttershy
866776.png,https://derpicdn.net/img/view/2015/4/6/866776.png,0,0.979989946,175,0,921,631,746,631,fluttershy
868223.png,https://derpicdn.net/img/view/2015/4/7/868223.png,0,0.982736945,173,0,1044,819,871,819,fluttershy
873181.png,https://derpicdn.net/img/view/2015/4/13/873181.png,0,0.946551025,285,15,1135,865,850,850,fluttershy
873427.png,https://derpicdn.net/img/view/2015/4/13/873427.png,0,0.967709541,122,49,428,355,306,306,fluttershy
874208.png,https://derpicdn.net/img/view/2015/4/15/874208.png,0,0.974654555,49,46,467,464,418,418,fluttershy
878475.png,https://derpicdn.net/img/view/2015/4/20/878475.png,0,0.988329709,29,24,591,586,562,562,fluttershy
879242.png,https://derpicdn.net/img/view/2015/4/21/879242.png,0,0.960847437,141,89,527,475,386,386,fluttershy
881504.png,https://derpicdn.net/img/view/2015/4/24/881504.png,0,0.9662714,165,45,621,501,456,456,fluttershy
882626.png,https://derpicdn.net/img/view/2015/4/25/882626.png,0,0.984857202,10,0,430,405,420,405,fluttershy
884643.png,https://derpicdn.net/img/view/2015/4/28/884643.png,0,0.995770216,432,0,956,507,524,507,fluttershy
884929.png,https://derpicdn.net/img/view/2015/4/28/884929.png,0,0.994488299,804,0,1460,594,656,594,fluttershy
886792.png,https://derpicdn.net/img/view/2015/5/1/886792.png,0,0.956980169,10,210,424,624,414,414,fluttershy
888834.png,https://derpicdn.net/img/view/2015/5/4/888834.png,0,0.99160403,195,0,433,237,238,237,fluttershy
894722.png,https://derpicdn.net/img/view/2015/5/12/894722.png,0,0.996036291,211,0,993,712,782,712,fluttershy
897115.png,https://derpicdn.net/img/view/2015/5/16/897115.png,0,0.963283122,232,11,724,503,492,492,fluttershy
897611.png,https://derpicdn.net/img/view/2015/5/16/897611.png,0,0.998899758,415,0,1331,893,916,893,fluttershy
897791.png,https://derpicdn.net/img/view/2015/5/17/897791.png,0,0.903874278,92,147,516,571,424,424,fluttershy
897792.png,https://derpicdn.net/img/view/2015/5/17/897792.png,0,0.989491761,197,11,565,379,368,368,fluttershy
897792.png,https://derpicdn.net/img/view/2015/5/17/897792.png,1,0.989411533,758,101,1088,431,330,330,fluttershy
897793.png,https://derpicdn.net/img/view/2015/5/17/897793.png,0,0.941954553,550,362,948,760,398,398,fluttershy
902293.png,https://derpicdn.net/img/view/2015/5/23/902293.png,0,0.974663913,219,5,517,303,298,298,fluttershy
902674.png,https://derpicdn.net/img/view/2015/5/23/902674.png,0,0.917144001,151,0,2485,2229,2334,2229,fluttershy
910503.png,https://derpicdn.net/img/view/2015/6/5/910503.png,0,0.953631997,296,61,864,629,568,568,fluttershy
911589.png,https://derpicdn.net/img/view/2015/6/6/911589.png,0,0.994611084,853,0,2151,1098,1298,1098,fluttershy
912277.jpg,https://derpicdn.net/img/view/2015/6/7/912277.jpg,0,0.971575618,253,52,749,548,496,496,fluttershy
91576.jpg,https://derpicdn.net/img/view/2012/9/6/91576.jpg,0,0.99789691,179,0,489,310,310,310,fluttershy
926317.png,https://derpicdn.net/img/view/2015/6/29/926317.png,0,0.995029271,144,175,324,355,180,180,fluttershy
927490.png,https://derpicdn.net/img/view/2015/7/1/927490.png,0,0.908429563,34,70,718,754,684,684,fluttershy
932445.png,https://derpicdn.net/img/view/2015/7/8/932445.png,0,0.972056925,216,0,506,288,290,288,fluttershy
932549.png,https://derpicdn.net/img/view/2015/7/8/932549.png,0,0.998659968,128,2,492,366,364,364,fluttershy
932870.jpg,https://derpicdn.net/img/view/2015/7/8/932870.jpg,0,0.997574866,665,92,1599,1026,934,934,fluttershy
933755.png,https://derpicdn.net/img/view/2015/7/10/933755.png,0,0.980281413,121,0,561,406,440,406,fluttershy
934171.png,https://derpicdn.net/img/view/2015/7/10/934171.png,0,0.985356748,82,0,450,330,368,330,fluttershy
934823.png,https://derpicdn.net/img/view/2015/7/11/934823.png,0,0.917757273,224,108,594,478,370,370,fluttershy
936500.png,https://derpicdn.net/img/view/2015/7/13/936500.png,0,0.988360107,6,0,600,585,594,585,fluttershy
938122.png,https://derpicdn.net/img/view/2015/7/16/938122.png,0,0.998272121,248,2,988,742,740,740,fluttershy
939983.jpg,https://derpicdn.net/img/view/2015/7/19/939983.jpg,0,0.977948427,352,56,614,318,262,262,fluttershy
942622.png,https://derpicdn.net/img/view/2015/7/24/942622.png,0,0.992631018,162,10,640,488,478,478,fluttershy
943288.png,https://derpicdn.net/img/view/2015/7/25/943288.png,0,0.982534826,990,42,2092,1144,1102,1102,fluttershy
944551.png,https://derpicdn.net/img/view/2015/7/26/944551.png,0,0.999663472,975,265,1881,1171,906,906,fluttershy
944553.png,https://derpicdn.net/img/view/2015/7/26/944553.png,0,0.999533534,980,265,1882,1167,902,902,fluttershy
945282.jpg,https://derpicdn.net/img/view/2015/7/27/945282.jpg,0,0.996912003,956,1198,1590,1832,634,634,fluttershy
950464.png,https://derpicdn.net/img/view/2015/8/4/950464.png,0,0.99065876,292,0,732,422,440,422,fluttershy
951867.png,https://derpicdn.net/img/view/2015/8/6/951867.png,0,0.954769671,1449,0,3546,1975,2097,1975,fluttershy
955950.png,https://derpicdn.net/img/view/2015/8/12/955950.png,0,0.997576714,2967,0,4919,1820,1952,1820,fluttershy
958579.jpg,https://derpicdn.net/img/view/2015/8/16/958579.jpg,0,0.967743337,904,87,1500,683,596,596,fluttershy
965020.jpg,https://derpicdn.net/img/view/2015/8/24/965020.jpg,0,0.998311341,1274,0,1870,570,596,570,fluttershy
965137.png,https://derpicdn.net/img/view/2015/8/25/965137.png,1,0.992157102,603,279,1051,727,448,448,fluttershy
965996.png,https://derpicdn.net/img/view/2015/8/26/965996.png,0,0.996907115,668,81,1048,461,380,380,fluttershy
968097.jpg,https://derpicdn.net/img/view/2015/8/29/968097.jpg,0,0.999111354,461,0,1277,803,816,803,fluttershy
970229.jpg,https://derpicdn.net/img/view/2015/9/1/970229.jpg,0,0.997273684,1599,349,3153,1903,1554,1554,fluttershy
970383.png,https://derpicdn.net/img/view/2015/9/1/970383.png,0,0.979374588,148,153,1606,1611,1458,1458,fluttershy
972710.png,https://derpicdn.net/img/view/2015/9/4/972710.png,0,0.99906671,313,9,583,279,270,270,fluttershy
974602.png,https://derpicdn.net/img/view/2015/9/7/974602.png,0,0.951929152,228,65,698,535,470,470,fluttershy
978292.png,https://derpicdn.net/img/view/2015/9/12/978292.png,0,0.997036517,179,7,635,463,456,456,fluttershy
978449.png,https://derpicdn.net/img/view/2015/9/12/978449.png,0,0.97008568,758,0,1434,656,676,656,fluttershy
981062.png,https://derpicdn.net/img/view/2015/9/16/981062.png,0,0.995935857,78,0,540,396,462,396,fluttershy
984852.png,https://derpicdn.net/img/view/2015/9/21/984852.png,0,0.977910936,399,47,1115,763,716,716,fluttershy
985043.png,https://derpicdn.net/img/view/2015/9/22/985043.png,0,0.998220682,196,30,952,786,756,756,fluttershy
994171.png,https://derpicdn.net/img/view/2015/10/4/994171.png,0,0.998961568,228,109,460,341,232,232,fluttershy
995785.png,https://derpicdn.net/img/view/2015/10/6/995785.png,0,0.957884789,410,0,1120,572,710,572,fluttershy
1000943.png,https://derpicdn.net/img/view/2015/10/13/1000943.png,0,0.982617378,157,384,955,1182,798,798,fluttershy
1002151.png,https://derpicdn.net/img/view/2015/10/14/1002151.png,0,0.979266584,399,283,2093,1977,1694,1694,fluttershy
1002800.png,https://derpicdn.net/img/view/2015/10/15/1002800.png,0,0.99687475,593,0,4159,3525,3566,3525,fluttershy
1005752.png,https://derpicdn.net/img/view/2015/10/19/1005752.png,0,0.995512009,1543,0,3797,2251,2254,2251,fluttershy
1007630.png,https://derpicdn.net/img/view/2015/10/22/1007630.png,0,0.967579901,113,86,543,516,430,430,fluttershy
1008530.png,https://derpicdn.net/img/view/2015/10/24/1008530.png,0,0.983050764,562,32,1468,938,906,906,fluttershy
1011009.png,https://derpicdn.net/img/view/2015/10/28/1011009.png,0,0.908154666,306,0,1364,1034,1058,1034,fluttershy
1012524.png,https://derpicdn.net/img/view/2015/10/30/1012524.png,0,0.995706201,1613,720,4177,3284,2564,2564,fluttershy
1013166.png,https://derpicdn.net/img/view/2015/10/31/1013166.png,0,0.981096983,201,0,1305,938,1104,938,fluttershy
1013554.png,https://derpicdn.net/img/view/2015/10/31/1013554.png,0,0.964047551,120,25,510,435,390,410,fluttershy
1014083.jpg,https://derpicdn.net/img/view/2015/11/1/1014083.jpg,0,0.985599816,112,0,634,507,522,507,fluttershy
1014102.png,https://derpicdn.net/img/view/2015/11/1/1014102.png,0,0.989549875,59,215,1623,1779,1564,1564,fluttershy
1014489.png,https://derpicdn.net/img/view/2015/11/1/1014489.png,0,0.998335242,84,0,514,385,430,385,fluttershy
1014721.jpg,https://derpicdn.net/img/view/2015/11/2/1014721.jpg,0,0.98354882,596,268,992,664,396,396,fluttershy
1015727.jpg,https://derpicdn.net/img/view/2015/11/4/1015727.jpg,0,0.936544061,415,24,847,456,432,432,fluttershy
1017423.jpg,https://derpicdn.net/img/view/2015/11/6/1017423.jpg,0,0.945886433,441,786,869,1214,428,428,fluttershy
1019942.png,https://derpicdn.net/img/view/2015/11/9/1019942.png,0,0.973294318,243,16,1227,1000,984,984,fluttershy
1020767.png,https://derpicdn.net/img/view/2015/11/11/1020767.png,0,0.991653621,510,39,1480,1009,970,970,fluttershy
1022436.png,https://derpicdn.net/img/view/2015/11/14/1022436.png,0,0.980523765,0,0,1299,1495,1299,1495,fluttershy
1023231.png,https://derpicdn.net/img/view/2015/11/15/1023231.png,0,0.947752237,430,471,650,691,220,220,fluttershy
1024193.png,https://derpicdn.net/img/view/2015/11/16/1024193.png,0,0.99600482,151,23,525,397,374,374,fluttershy
1024387.png,https://derpicdn.net/img/view/2015/11/17/1024387.png,0,0.983773053,69,0,609,532,540,532,fluttershy
1027784.png,https://derpicdn.net/img/view/2015/11/22/1027784.png,0,0.946698308,2675,0,5263,2954,2588,2954,fluttershy
102825.jpg,https://derpicdn.net/img/view/2012/9/20/102825.jpg,0,0.978797376,96,0,850,735,754,735,fluttershy
1029079.png,https://derpicdn.net/img/view/2015/11/23/1029079.png,0,0.974578559,363,131,681,449,318,318,fluttershy
1029993.png,https://derpicdn.net/img/view/2015/11/25/1029993.png,0,0.992770612,94,0,1544,1443,1450,1443,fluttershy
1032295.png,https://derpicdn.net/img/view/2015/11/28/1032295.png,0,0.99093622,239,0,1499,1197,1260,1197,fluttershy
1036100.png,https://derpicdn.net/img/view/2015/12/3/1036100.png,0,0.93226707,295,0,1585,1269,1290,1269,fluttershy
1042798.png,https://derpicdn.net/img/view/2015/12/12/1042798.png,0,0.994055092,95,4,979,888,884,884,fluttershy
1045114.png,https://derpicdn.net/img/view/2015/12/15/1045114.png,0,0.99014765,91,141,255,305,164,164,fluttershy
1045114.png,https://derpicdn.net/img/view/2015/12/15/1045114.png,0,0.99014765,91,141,255,305,164,164,fluttershy
1045856.png,https://derpicdn.net/img/view/2015/12/16/1045856.png,0,0.99061656,294,27,1038,771,744,744,fluttershy
1051380.png,https://derpicdn.net/img/view/2015/12/24/1051380.png,0,0.993335664,0,0,366,366,366,366,fluttershy
1053473.png,https://derpicdn.net/img/view/2015/12/27/1053473.png,0,0.998450458,56,0,796,726,740,726,fluttershy
1055824.png,https://derpicdn.net/img/view/2015/12/30/1055824.png,0,0.987882555,133,0,565,426,432,426,fluttershy
1055833.png,https://derpicdn.net/img/view/2015/12/30/1055833.png,0,0.912856281,84,0,498,395,414,395,fluttershy
1055870.png,https://derpicdn.net/img/view/2015/12/30/1055870.png,0,0.942015529,5,0,327,272,322,272,fluttershy
1059173.png,https://derpicdn.net/img/view/2016/1/4/1059173.png,0,0.995984614,968,256,2866,2154,1898,1898,fluttershy
1059500.png,https://derpicdn.net/img/view/2016/1/4/1059500.png,0,0.902291477,787,0,1461,615,674,615,fluttershy
1063318.png,https://derpicdn.net/img/view/2016/1/10/1063318.png,0,0.978382528,627,0,1057,367,430,367,fluttershy
1063508.png,https://derpicdn.net/img/view/2016/1/10/1063508.png,0,0.996070802,1177,19,2057,899,880,880,fluttershy
1064028.png,https://derpicdn.net/img/view/2016/1/10/1064028.png,0,0.965019345,22,210,1165,1499,1143,1289,fluttershy
1064267.png,https://derpicdn.net/img/view/2016/1/11/1064267.png,0,0.964925647,226,21,1628,1423,1402,1402,fluttershy
1065848.jpg,https://derpicdn.net/img/view/2016/1/13/1065848.jpg,0,0.971058965,165,2,385,222,220,220,fluttershy
1072228.png,https://derpicdn.net/img/view/2016/1/23/1072228.png,0,0.927173257,102,0,1126,979,1024,979,fluttershy
1074862.png,https://derpicdn.net/img/view/2016/1/27/1074862.png,0,0.991103113,247,4,665,422,418,418,fluttershy
1074989.png,https://derpicdn.net/img/view/2016/1/27/1074989.png,0,0.997985959,184,0,1010,808,826,808,fluttershy
1080025.jpg,https://derpicdn.net/img/view/2016/2/4/1080025.jpg,0,0.910585046,414,50,1516,1152,1102,1102,fluttershy
1080805.png,https://derpicdn.net/img/view/2016/2/5/1080805.png,0,0.985735834,743,5,2031,1293,1288,1288,fluttershy
1081598.png,https://derpicdn.net/img/view/2016/2/6/1081598.png,0,0.977349281,1004,60,2834,1890,1830,1830,fluttershy
1085330.png,https://derpicdn.net/img/view/2016/2/11/1085330.png,0,0.995166481,161,18,763,620,602,602,fluttershy
1092511.png,https://derpicdn.net/img/view/2016/2/20/1092511.png,0,0.997217894,242,57,568,383,326,326,fluttershy
1108695.png,https://derpicdn.net/img/view/2016/3/14/1108695.png,0,0.903527796,54,46,562,554,508,508,fluttershy
1110310.png,https://derpicdn.net/img/view/2016/3/16/1110310.png,0,0.991000175,231,191,513,473,282,282,fluttershy
1112830.png,https://derpicdn.net/img/view/2016/3/20/1112830.png,0,0.993871331,199,0,683,469,484,469,fluttershy
1112831.png,https://derpicdn.net/img/view/2016/3/20/1112831.png,0,0.995887816,201,0,681,468,480,468,fluttershy
1112832.png,https://derpicdn.net/img/view/2016/3/20/1112832.png,0,0.992833912,192,0,680,472,488,472,fluttershy
1112897.png,https://derpicdn.net/img/view/2016/3/20/1112897.png,0,0.953194857,66,0,992,918,926,918,fluttershy
1113482.jpg,https://derpicdn.net/img/view/2016/3/21/1113482.jpg,0,0.999463737,541,101,1185,745,644,644,fluttershy
1115.jpg,https://derpicdn.net/img/view/2012/1/21/1115.jpg,0,0.987754881,195,0,2257,2009,2062,2009,fluttershy
1117193.png,https://derpicdn.net/img/view/2016/3/26/1117193.png,0,0.963851094,476,55,1060,639,584,584,fluttershy
1121905.png,https://derpicdn.net/img/view/2016/4/1/1121905.png,0,0.996832609,760,207,1136,583,376,376,fluttershy
11311.png,https://derpicdn.net/img/view/2012/6/20/11311.png,0,0.996548712,73,0,637,539,564,539,fluttershy
1134086.png,https://derpicdn.net/img/view/2016/4/17/1134086.png,0,0.981427014,147,0,989,820,842,820,fluttershy
1137113.png,https://derpicdn.net/img/view/2016/4/21/1137113.png,0,0.995560765,522,0,1374,686,852,686,fluttershy
1146018.png,https://derpicdn.net/img/view/2016/5/4/1146018.png,0,0.995397091,363,0,1695,1272,1332,1272,fluttershy
1148022.png,https://derpicdn.net/img/view/2016/5/6/1148022.png,0,0.936323166,41,0,801,734,760,734,fluttershy
114984.png,https://derpicdn.net/img/view/2012/10/6/114984.png,0,0.999452293,496,160,940,604,444,444,fluttershy
1151725.png,https://derpicdn.net/img/view/2016/5/11/1151725.png,0,0.973648727,853,90,4473,3710,3620,3620,fluttershy
1153838.png,https://derpicdn.net/img/view/2016/5/14/1153838.png,0,0.991921723,264,0,664,370,400,370,fluttershy
1157060.png,https://derpicdn.net/img/view/2016/5/18/1157060.png,0,0.989524186,100,12,540,452,440,440,fluttershy
1162100.png,https://derpicdn.net/img/view/2016/5/24/1162100.png,0,0.982179344,12,15,1000,1097,988,1082,fluttershy
1166844.jpg,https://derpicdn.net/img/view/2016/5/31/1166844.jpg,0,0.992163658,391,0,963,568,572,568,fluttershy
1168707.png,https://derpicdn.net/img/view/2016/6/2/1168707.png,0,0.999851704,289,2,887,600,598,598,fluttershy
1169867.png,https://derpicdn.net/img/view/2016/6/4/1169867.png,0,0.922028065,43,42,667,696,624,654,fluttershy
1170031.png,https://derpicdn.net/img/view/2016/6/4/1170031.png,0,0.91752243,0,69,578,757,578,688,fluttershy
1170149.png,https://derpicdn.net/img/view/2016/6/4/1170149.png,0,0.973991215,0,37,417,533,417,496,fluttershy
1170198.png,https://derpicdn.net/img/view/2016/6/4/1170198.png,0,0.98245436,19,16,335,332,316,316,fluttershy
1170206.png,https://derpicdn.net/img/view/2016/6/4/1170206.png,0,0.982770205,0,60,280,369,280,309,fluttershy
1170206.png,https://derpicdn.net/img/view/2016/6/4/1170206.png,1,0.929369926,0,3,255,267,255,264,fluttershy
1174346.png,https://derpicdn.net/img/view/2016/6/9/1174346.png,0,0.978063941,0,73,372,415,372,342,fluttershy
1174571.png,https://derpicdn.net/img/view/2016/6/9/1174571.png,0,0.997611761,671,87,1043,459,372,372,fluttershy
1174575.png,https://derpicdn.net/img/view/2016/6/9/1174575.png,0,0.997055411,669,83,1047,461,378,378,fluttershy
1174577.png,https://derpicdn.net/img/view/2016/6/9/1174577.png,0,0.99678123,670,83,1046,459,376,376,fluttershy
1175521.png,https://derpicdn.net/img/view/2016/6/11/1175521.png,0,0.973611832,0,0,611,600,611,600,fluttershy
1176326.jpg,https://derpicdn.net/img/view/2016/6/12/1176326.jpg,0,0.987587631,492,0,882,379,390,379,fluttershy
1177268.jpg,https://derpicdn.net/img/view/2016/6/13/1177268.jpg,0,0.991260767,670,178,1052,560,382,382,fluttershy
1183693.png,https://derpicdn.net/img/view/2016/6/21/1183693.png,0,0.997522295,409,73,1065,729,656,656,fluttershy
1184.jpg,https://derpicdn.net/img/view/2012/1/22/1184.jpg,0,0.987361252,391,112,669,390,278,278,fluttershy
1184797.png,https://derpicdn.net/img/view/2016/6/23/1184797.png,0,0.989532471,534,54,1022,542,488,488,fluttershy
1185652.png,https://derpicdn.net/img/view/2016/6/24/1185652.png,0,0.956114709,37,0,499,448,462,448,fluttershy
11892.jpg,https://derpicdn.net/img/view/2012/6/20/11892.jpg,0,0.998239875,341,74,719,452,378,378,fluttershy
11892.jpg,https://derpicdn.net/img/view/2012/6/20/11892.jpg,0,0.998239875,341,74,719,452,378,378,fluttershy
1190601.png,https://derpicdn.net/img/view/2016/7/1/1190601.png,0,0.997440755,608,0,1194,540,586,540,fluttershy
11948.jpg,https://derpicdn.net/img/view/2012/6/20/11948.jpg,0,0.986335635,44,31,848,835,804,804,fluttershy
119489.png,https://derpicdn.net/img/view/2012/10/11/119489.png,0,0.996059358,1240,202,1934,896,694,694,fluttershy
119489.png,https://derpicdn.net/img/view/2012/10/11/119489.png,1,0.950347781,2594,38,3128,572,534,534,fluttershy
119489.png,https://derpicdn.net/img/view/2012/10/11/119489.png,2,0.935339093,1761,109,2511,859,750,750,fluttershy
1194944.png,https://derpicdn.net/img/view/2016/7/6/1194944.png,0,0.961497784,1136,0,1560,411,424,411,fluttershy
1194944.png,https://derpicdn.net/img/view/2016/7/6/1194944.png,1,0.942758679,803,51,1167,415,364,364,fluttershy
1194944.png,https://derpicdn.net/img/view/2016/7/6/1194944.png,2,0.917763114,403,97,727,421,324,324,fluttershy
1196292.png,https://derpicdn.net/img/view/2016/7/8/1196292.png,0,0.972956061,108,45,820,757,712,712,fluttershy
1199296.png,https://derpicdn.net/img/view/2016/7/12/1199296.png,0,0.987970054,0,146,1956,2488,1956,2342,fluttershy
1199761.png,https://derpicdn.net/img/view/2016/7/13/1199761.png,0,0.924187779,71,242,1843,2014,1772,1772,fluttershy
1200806.png,https://derpicdn.net/img/view/2016/7/14/1200806.png,0,0.915046632,105,94,1035,1024,930,930,fluttershy
1201103.png,https://derpicdn.net/img/view/2016/7/15/1201103.png,0,0.98221308,151,0,1369,1188,1218,1188,fluttershy
1209836.png,https://derpicdn.net/img/view/2016/7/26/1209836.png,1,0.964693844,330,0,1856,1475,1526,1475,fluttershy
1214394.png,https://derpicdn.net/img/view/2016/8/1/1214394.png,0,0.994983196,421,259,883,721,462,462,fluttershy
1218474.png,https://derpicdn.net/img/view/2016/8/6/1218474.png,0,0.927929938,2994,243,5876,3125,2882,2882,fluttershy
1218894.png,https://derpicdn.net/img/view/2016/8/6/1218894.png,0,0.997161806,181,130,501,450,320,320,fluttershy
1224148.png,https://derpicdn.net/img/view/2016/8/13/1224148.png,0,0.925227046,94,0,1240,962,1146,962,fluttershy
1225542.png,https://derpicdn.net/img/view/2016/8/15/1225542.png,0,0.997358382,514,82,1762,1330,1248,1248,fluttershy
1230364.png,https://derpicdn.net/img/view/2016/8/21/1230364.png,0,0.993521094,113,0,635,479,522,479,fluttershy
1234997.png,https://derpicdn.net/img/view/2016/8/27/1234997.png,0,0.969361663,51,93,901,943,850,850,fluttershy
1234998.png,https://derpicdn.net/img/view/2016/8/27/1234998.png,0,0.968787551,25,75,437,472,412,397,fluttershy
1239930.png,https://derpicdn.net/img/view/2016/9/2/1239930.png,0,0.989698887,212,0,648,429,436,429,fluttershy
1240710.png,https://derpicdn.net/img/view/2016/9/3/1240710.png,0,0.975951731,236,20,666,450,430,430,fluttershy
1241842.png,https://derpicdn.net/img/view/2016/9/4/1241842.png,0,0.985954583,146,68,774,700,628,632,fluttershy
1242552.png,https://derpicdn.net/img/view/2016/9/5/1242552.png,0,0.989012361,341,80,1291,1030,950,950,fluttershy
1242846.png,https://derpicdn.net/img/view/2016/9/6/1242846.png,0,0.999334514,245,390,1243,1388,998,998,fluttershy
1244881.png,https://derpicdn.net/img/view/2016/9/8/1244881.png,0,0.966770291,793,0,5979,5093,5186,5093,fluttershy
1245852.png,https://derpicdn.net/img/view/2016/9/10/1245852.png,0,0.990210712,40,0,530,474,490,474,fluttershy
1250228.png,https://derpicdn.net/img/view/2016/9/16/1250228.png,0,0.992690921,326,71,1262,1007,936,936,fluttershy
125078.jpg,https://derpicdn.net/img/view/2012/10/17/125078.jpg,0,0.971096575,272,16,450,194,178,178,fluttershy
1257107.png,https://derpicdn.net/img/view/2016/9/24/1257107.png,0,0.940790772,99,0,648,630,549,630,fluttershy
1258105.png,https://derpicdn.net/img/view/2016/9/25/1258105.png,0,0.992203891,580,26,1074,520,494,494,fluttershy
1258441.png,https://derpicdn.net/img/view/2016/9/25/1258441.png,0,0.995824158,1306,33,2332,1059,1026,1026,fluttershy
1258824.png,https://derpicdn.net/img/view/2016/9/26/1258824.png,0,0.990994632,260,0,662,392,402,392,fluttershy
1258831.png,https://derpicdn.net/img/view/2016/9/26/1258831.png,0,0.992863476,0,0,574,533,574,533,fluttershy
1262286.png,https://derpicdn.net/img/view/2016/10/1/1262286.png,0,0.997491479,385,161,1203,979,818,818,fluttershy
1269357.png,https://derpicdn.net/img/view/2016/10/10/1269357.png,0,0.992632866,88,0,1962,1789,1874,1789,fluttershy
1273107.png,https://derpicdn.net/img/view/2016/10/15/1273107.png,0,0.943259001,818,369,1822,1373,1004,1004,fluttershy
127311.png,https://derpicdn.net/img/view/2012/10/19/127311.png,0,0.995659292,263,6,475,218,212,212,fluttershy
1273841.png,https://derpicdn.net/img/view/2016/10/15/1273841.png,0,0.999212444,0,0,540,498,540,498,fluttershy
1275347.png,https://derpicdn.net/img/view/2016/10/17/1275347.png,0,0.946724117,959,667,1463,1171,504,504,fluttershy
1281024.png,https://derpicdn.net/img/view/2016/10/25/1281024.png,0,0.928354442,526,0,1602,884,1076,884,fluttershy
1281940.png,https://derpicdn.net/img/view/2016/10/26/1281940.png,0,0.997186422,574,146,1400,972,826,826,fluttershy
1281940.png,https://derpicdn.net/img/view/2016/10/26/1281940.png,0,0.997186422,574,146,1400,972,826,826,fluttershy
1283295.png,https://derpicdn.net/img/view/2016/10/28/1283295.png,0,0.99343884,800,161,3122,2483,2322,2322,fluttershy
1283295.png,https://derpicdn.net/img/view/2016/10/28/1283295.png,0,0.99343884,800,161,3122,2483,2322,2322,fluttershy
1287522.png,https://derpicdn.net/img/view/2016/11/3/1287522.png,0,0.964574397,0,45,1787,1889,1787,1844,fluttershy
1288110.png,https://derpicdn.net/img/view/2016/11/3/1288110.png,0,0.994304895,45,0,267,210,222,210,fluttershy
1288760.png,https://derpicdn.net/img/view/2016/11/4/1288760.png,0,0.996680498,296,97,1336,1137,1040,1040,fluttershy
1293058.png,https://derpicdn.net/img/view/2016/11/11/1293058.png,0,0.907994688,799,10,1845,1056,1046,1046,fluttershy
1297261.png,https://derpicdn.net/img/view/2016/11/16/1297261.png,0,0.974261403,0,0,1800,2057,1800,2057,fluttershy
1299625.png,https://derpicdn.net/img/view/2016/11/20/1299625.png,0,0.991928935,278,0,776,487,498,487,fluttershy
1302143.png,https://derpicdn.net/img/view/2016/11/23/1302143.png,0,0.989637852,0,91,1801,1927,1801,1836,fluttershy
1303789.png,https://derpicdn.net/img/view/2016/11/26/1303789.png,0,0.996397495,263,0,863,543,600,543,fluttershy
1305154.png,https://derpicdn.net/img/view/2016/11/28/1305154.png,0,0.99542892,150,79,790,719,640,640,fluttershy
1308961.png,https://derpicdn.net/img/view/2016/12/3/1308961.png,0,0.928963244,241,403,1789,1951,1548,1548,fluttershy
131737.jpg,https://derpicdn.net/img/view/2012/10/25/131737.jpg,0,0.994730592,223,25,463,265,240,240,fluttershy
1334933.png,https://derpicdn.net/img/view/2017/1/8/1334933.png,0,0.969188869,255,16,667,428,412,412,fluttershy
1335286.png,https://derpicdn.net/img/view/2017/1/9/1335286.png,0,0.965222955,1565,242,2437,1114,872,872,fluttershy
1335286.png,https://derpicdn.net/img/view/2017/1/9/1335286.png,0,0.965222955,1565,242,2437,1114,872,872,fluttershy
133568.jpg,https://derpicdn.net/img/view/2012/10/27/133568.jpg,0,0.987722278,0,0,495,495,495,495,fluttershy
1336234.png,https://derpicdn.net/img/view/2017/1/10/1336234.png,0,0.946269929,323,36,1183,896,860,860,fluttershy
1340455.png,https://derpicdn.net/img/view/2017/1/16/1340455.png,0,0.983516395,370,2,736,368,366,366,fluttershy
1345204.png,https://derpicdn.net/img/view/2017/1/22/1345204.png,0,0.998387396,651,3,2307,1659,1656,1656,fluttershy
1348751.png,https://derpicdn.net/img/view/2017/1/27/1348751.png,0,0.997857511,259,0,779,462,520,462,fluttershy
1353.jpg,https://derpicdn.net/img/view/2012/1/22/1353.jpg,0,0.966841877,206,51,612,457,406,406,fluttershy
1354955.png,https://derpicdn.net/img/view/2017/2/4/1354955.png,0,0.991046071,225,3,529,307,304,304,fluttershy
1355512.png,https://derpicdn.net/img/view/2017/2/5/1355512.png,0,0.978009641,1036,662,1842,1468,806,806,fluttershy
1355512.png,https://derpicdn.net/img/view/2017/2/5/1355512.png,0,0.978009641,1036,662,1842,1468,806,806,fluttershy
1357591.png,https://derpicdn.net/img/view/2017/2/7/1357591.png,0,0.99732244,58,0,906,823,848,823,fluttershy
1357591.png,https://derpicdn.net/img/view/2017/2/7/1357591.png,0,0.99732244,58,0,906,823,848,823,fluttershy
1360355.png,https://derpicdn.net/img/view/2017/2/11/1360355.png,0,0.973444939,0,0,1020,1090,1020,1090,fluttershy
1361412.png,https://derpicdn.net/img/view/2017/2/12/1361412.png,0,0.946734369,232,333,752,853,520,520,fluttershy
1368151.png,https://derpicdn.net/img/view/2017/2/20/1368151.png,0,0.98373884,567,0,1575,982,1008,982,fluttershy
1368449.png,https://derpicdn.net/img/view/2017/2/20/1368449.png,0,0.995630145,363,0,1327,906,964,906,fluttershy
1370672.png,https://derpicdn.net/img/view/2017/2/23/1370672.png,0,0.922103226,386,4,854,472,468,468,fluttershy
1370672.png,https://derpicdn.net/img/view/2017/2/23/1370672.png,0,0.922103226,386,4,854,472,468,468,fluttershy
1372790.png,https://derpicdn.net/img/view/2017/2/25/1372790.png,0,0.989955366,56,0,622,554,566,554,fluttershy
1374428.png,https://derpicdn.net/img/view/2017/2/27/1374428.png,0,0.993762672,238,0,772,523,534,523,fluttershy
1374508.png,https://derpicdn.net/img/view/2017/2/27/1374508.png,0,0.97200036,121,0,1071,897,950,897,fluttershy
1376455.png,https://derpicdn.net/img/view/2017/3/1/1376455.png,0,0.954628408,168,6,796,634,628,628,fluttershy
1376598.png,https://derpicdn.net/img/view/2017/3/1/1376598.png,1,0.976260543,366,514,928,1076,562,562,fluttershy
1377023.png,https://derpicdn.net/img/view/2017/3/2/1377023.png,0,0.995030522,361,0,1329,909,968,909,fluttershy
1378970.png,https://derpicdn.net/img/view/2017/3/4/1378970.png,0,0.99792695,587,104,2593,2110,2006,2006,fluttershy
1379348.png,https://derpicdn.net/img/view/2017/3/4/1379348.png,0,0.960114956,222,14,516,308,294,294,fluttershy
1379803.png,https://derpicdn.net/img/view/2017/3/5/1379803.png,0,0.997122586,178,0,764,575,586,575,fluttershy
1380796.png,https://derpicdn.net/img/view/2017/3/6/1380796.png,0,0.994520485,177,0,927,655,750,655,fluttershy
1381255.png,https://derpicdn.net/img/view/2017/3/7/1381255.png,0,0.994741023,390,173,754,537,364,364,fluttershy
1382091.png,https://derpicdn.net/img/view/2017/3/8/1382091.png,0,0.986323535,286,7,1006,727,720,720,fluttershy
1385297.png,https://derpicdn.net/img/view/2017/3/12/1385297.png,0,0.932842493,1134,612,1700,1178,566,566,fluttershy
1394371.png,https://derpicdn.net/img/view/2017/3/23/1394371.png,0,0.996120453,367,0,961,555,594,555,fluttershy
1394379.png,https://derpicdn.net/img/view/2017/3/23/1394379.png,0,0.998202085,157,0,847,585,690,585,fluttershy
1394496.png,https://derpicdn.net/img/view/2017/3/23/1394496.png,0,0.989601314,1056,132,1646,722,590,590,fluttershy
1396100.png,https://derpicdn.net/img/view/2017/3/25/1396100.png,0,0.996383965,215,0,729,441,514,441,fluttershy
1402554.png,https://derpicdn.net/img/view/2017/4/2/1402554.png,0,0.916423798,107,74,827,794,720,720,fluttershy
1403168.png,https://derpicdn.net/img/view/2017/4/3/1403168.png,0,0.990845203,353,0,1934,1698,1581,1698,fluttershy
1403616.png,https://derpicdn.net/img/view/2017/4/4/1403616.png,0,0.998868406,214,130,600,516,386,386,fluttershy
1405556.png,https://derpicdn.net/img/view/2017/4/6/1405556.png,0,0.996872604,694,0,2588,1875,1894,1875,fluttershy
1408444.png,https://derpicdn.net/img/view/2017/4/10/1408444.png,0,0.98274672,4336,0,6932,2358,2596,2358,fluttershy
1411602.png,https://derpicdn.net/img/view/2017/4/15/1411602.png,0,0.919219971,321,0,3187,2736,2866,2736,fluttershy
1419825.png,https://derpicdn.net/img/view/2017/4/23/1419825.png,0,0.981713057,258,444,510,696,252,252,fluttershy
1419825.png,https://derpicdn.net/img/view/2017/4/23/1419825.png,0,0.981713057,258,444,510,696,252,252,fluttershy
1423570.png,https://derpicdn.net/img/view/2017/4/28/1423570.png,0,0.977496862,19,0,1171,1142,1152,1142,fluttershy
1424218.png,https://derpicdn.net/img/view/2017/4/29/1424218.png,0,0.980791688,1142,0,2546,1390,1404,1390,fluttershy
1425671.png,https://derpicdn.net/img/view/2017/4/30/1425671.png,0,0.990547597,838,599,3446,3207,2608,2608,fluttershy
1427925.png,https://derpicdn.net/img/view/2017/5/3/1427925.png,0,0.908846736,465,221,879,635,414,414,fluttershy
1430601.png,https://derpicdn.net/img/view/2017/5/7/1430601.png,0,0.91152519,432,165,634,367,202,202,fluttershy
1431305.png,https://derpicdn.net/img/view/2017/5/7/1431305.png,0,0.993925571,2590,0,6270,3313,3680,3313,fluttershy
1431481.png,https://derpicdn.net/img/view/2017/5/8/1431481.png,0,0.938030899,176,22,1967,1850,1791,1828,fluttershy
1434477.png,https://derpicdn.net/img/view/2017/5/12/1434477.png,0,0.993321061,43,0,457,363,414,363,fluttershy
1436720.png,https://derpicdn.net/img/view/2017/5/14/1436720.png,0,0.996891081,480,53,1108,681,628,628,fluttershy
1437449.png,https://derpicdn.net/img/view/2017/5/15/1437449.png,0,0.998858392,267,105,953,791,686,686,fluttershy
1438310.png,https://derpicdn.net/img/view/2017/5/16/1438310.png,0,0.909692407,0,0,1536,1575,1536,1575,fluttershy
1440999.png,https://derpicdn.net/img/view/2017/5/20/1440999.png,0,0.990625143,611,0,1289,673,678,673,fluttershy
1443032.png,https://derpicdn.net/img/view/2017/5/22/1443032.png,0,0.947301924,1132,391,2222,1481,1090,1090,fluttershy
1444671.png,https://derpicdn.net/img/view/2017/5/24/1444671.png,0,0.996108413,659,0,2939,2277,2280,2277,fluttershy
1446883.png,https://derpicdn.net/img/view/2017/5/27/1446883.png,0,0.927878797,374,308,688,622,314,314,fluttershy
1447297.png,https://derpicdn.net/img/view/2017/5/27/1447297.png,0,0.996825874,296,57,670,431,374,374,fluttershy
1447733.png,https://derpicdn.net/img/view/2017/5/28/1447733.png,0,0.998436451,1243,0,3957,2330,2714,2330,fluttershy
1449600.png,https://derpicdn.net/img/view/2017/5/30/1449600.png,0,0.997894406,1074,0,2738,1609,1664,1609,fluttershy
1450868.png,https://derpicdn.net/img/view/2017/5/31/1450868.png,0,0.999712765,337,0,927,533,590,533,fluttershy
1451858.png,https://derpicdn.net/img/view/2017/6/2/1451858.png,0,0.947814703,626,0,1406,700,780,700,fluttershy
1452244.png,https://derpicdn.net/img/view/2017/6/2/1452244.png,0,0.984599829,293,44,745,496,452,452,fluttershy
1452795.png,https://derpicdn.net/img/view/2017/6/3/1452795.png,0,0.998965025,207,0,545,303,338,303,fluttershy
1452903.png,https://derpicdn.net/img/view/2017/6/3/1452903.png,0,0.996440113,124,37,916,829,792,792,fluttershy
1454352.png,https://derpicdn.net/img/view/2017/6/5/1454352.png,0,0.993640363,262,420,1164,1322,902,902,fluttershy
14567.png,https://derpicdn.net/img/view/2012/6/21/14567.png,0,0.9499681,101,19,693,611,592,592,fluttershy
1457230.png,https://derpicdn.net/img/view/2017/6/8/1457230.png,0,0.98490262,227,0,2000,1647,1773,1647,fluttershy
1457230.png,https://derpicdn.net/img/view/2017/6/8/1457230.png,0,0.98490262,227,0,2000,1647,1773,1647,fluttershy
1457322.png,https://derpicdn.net/img/view/2017/6/9/1457322.png,0,0.99069339,150,0,1171,1121,1021,1121,fluttershy
1458515.png,https://derpicdn.net/img/view/2017/6/10/1458515.png,0,0.947815418,66,18,598,550,532,532,fluttershy
1460448.png,https://derpicdn.net/img/view/2017/6/13/1460448.png,0,0.998442709,450,35,1662,1247,1212,1212,fluttershy
1465342.png,https://derpicdn.net/img/view/2017/6/18/1465342.png,0,0.94467932,818,294,2008,1484,1190,1190,fluttershy
1468034.png,https://derpicdn.net/img/view/2017/6/21/1468034.png,0,0.986995518,66,0,638,499,572,499,fluttershy
1468746.png,https://derpicdn.net/img/view/2017/6/22/1468746.png,0,0.976723373,0,469,2220,3000,2220,2531,fluttershy
1470819.png,https://derpicdn.net/img/view/2017/6/24/1470819.png,0,0.99891305,298,0,778,475,480,475,fluttershy
1472639.png,https://derpicdn.net/img/view/2017/6/27/1472639.png,0,0.998128533,877,0,2806,2041,1929,2041,fluttershy
1475833.png,https://derpicdn.net/img/view/2017/7/1/1475833.png,0,0.967485189,0,113,210,327,210,214,fluttershy
1476595.png,https://derpicdn.net/img/view/2017/7/2/1476595.png,0,0.926545441,1261,395,2263,1397,1002,1002,fluttershy
1476866.png,https://derpicdn.net/img/view/2017/7/2/1476866.png,0,0.998985708,713,71,1505,863,792,792,fluttershy
1477456.png,https://derpicdn.net/img/view/2017/7/3/1477456.png,0,0.998801887,807,935,3037,3165,2230,2230,fluttershy
1477944.png,https://derpicdn.net/img/view/2017/7/3/1477944.png,0,0.956629038,1290,324,3692,2726,2402,2402,fluttershy
1477950.png,https://derpicdn.net/img/view/2017/7/4/1477950.png,0,0.969394386,0,0,2242,2184,2242,2184,fluttershy
1480301.png,https://derpicdn.net/img/view/2017/7/6/1480301.png,0,0.998299539,33,0,491,442,458,442,fluttershy
1480989.png,https://derpicdn.net/img/view/2017/7/7/1480989.png,0,0.993914485,287,127,795,635,508,508,fluttershy
1485757.png,https://derpicdn.net/img/view/2017/7/14/1485757.png,0,0.967465758,1012,54,1424,466,412,412,fluttershy
1489903.png,https://derpicdn.net/img/view/2017/7/19/1489903.png,0,0.992467463,266,27,692,453,426,426,fluttershy
1490086.png,https://derpicdn.net/img/view/2017/7/19/1490086.png,0,0.983832359,210,167,406,363,196,196,fluttershy
1490575.png,https://derpicdn.net/img/view/2017/7/20/1490575.png,0,0.970878065,0,23,733,1023,733,1000,fluttershy
1495631.png,https://derpicdn.net/img/view/2017/7/26/1495631.png,0,0.998019755,168,30,622,484,454,454,fluttershy
1496302.png,https://derpicdn.net/img/view/2017/7/27/1496302.png,0,0.983173311,73,217,889,1000,816,783,fluttershy
1496302.png,https://derpicdn.net/img/view/2017/7/27/1496302.png,0,0.983173311,73,217,889,1000,816,783,fluttershy
1496725.png,https://derpicdn.net/img/view/2017/7/28/1496725.png,0,0.923363209,356,0,914,537,558,537,fluttershy
1501672.png,https://derpicdn.net/img/view/2017/8/3/1501672.png,0,0.980715752,0,0,191,211,191,211,fluttershy
1501672.png,https://derpicdn.net/img/view/2017/8/3/1501672.png,0,0.980715752,0,0,191,211,191,211,fluttershy
1501858.png,https://derpicdn.net/img/view/2017/8/3/1501858.png,0,0.98079133,82,0,1558,1450,1476,1450,fluttershy
1501907.png,https://derpicdn.net/img/view/2017/8/3/1501907.png,0,0.969246745,1161,0,2487,1297,1326,1297,fluttershy
1502147.png,https://derpicdn.net/img/view/2017/8/3/1502147.png,0,0.990522742,353,0,1635,1161,1282,1161,fluttershy
1503693.png,https://derpicdn.net/img/view/2017/8/5/1503693.png,0,0.991807759,0,0,642,615,642,615,fluttershy
1503773.png,https://derpicdn.net/img/view/2017/8/6/1503773.png,0,0.986755192,388,397,1108,1117,720,720,fluttershy
1505033.png,https://derpicdn.net/img/view/2017/8/7/1505033.png,0,0.989154518,432,109,922,599,490,490,fluttershy
1505035.png,https://derpicdn.net/img/view/2017/8/7/1505035.png,0,0.998296499,486,106,1158,778,672,672,fluttershy
1506036.png,https://derpicdn.net/img/view/2017/8/8/1506036.png,0,0.985888362,0,0,3882,3915,3882,3915,fluttershy
1506036.png,https://derpicdn.net/img/view/2017/8/8/1506036.png,0,0.985888362,0,0,3882,3915,3882,3915,fluttershy
1507477.png,https://derpicdn.net/img/view/2017/8/10/1507477.png,0,0.996404588,475,8,1451,984,976,976,fluttershy
1508463.png,https://derpicdn.net/img/view/2017/8/12/1508463.png,0,0.980476379,469,0,931,421,462,421,fluttershy
1508548.png,https://derpicdn.net/img/view/2017/8/12/1508548.png,0,0.988815606,512,270,906,664,394,394,fluttershy
1509513.png,https://derpicdn.net/img/view/2017/8/13/1509513.png,0,0.999640584,138,0,494,340,356,340,fluttershy
1509513.png,https://derpicdn.net/img/view/2017/8/13/1509513.png,0,0.999640584,138,0,494,340,356,340,fluttershy
1510319.png,https://derpicdn.net/img/view/2017/8/14/1510319.png,0,0.957224309,163,0,829,635,666,635,fluttershy
1511838.png,https://derpicdn.net/img/view/2017/8/16/1511838.png,0,0.980166793,1574,0,4548,2839,2974,2839,fluttershy
1511951.png,https://derpicdn.net/img/view/2017/8/16/1511951.png,0,0.982480526,0,0,1748,1808,1748,1808,fluttershy
1511951.png,https://derpicdn.net/img/view/2017/8/16/1511951.png,0,0.982480526,0,0,1748,1808,1748,1808,fluttershy
1514762.png,https://derpicdn.net/img/view/2017/8/19/1514762.png,0,0.984416544,47,0,512,405,465,405,fluttershy
15156.png,https://derpicdn.net/img/view/2012/6/22/15156.png,0,0.994548798,52,0,2550,2481,2498,2481,fluttershy
1515672.png,https://derpicdn.net/img/view/2017/8/20/1515672.png,0,0.955106497,0,0,2590,2884,2590,2884,fluttershy
1516420.png,https://derpicdn.net/img/view/2017/8/21/1516420.png,0,0.982935727,1161,0,3751,2474,2590,2474,fluttershy
1518038.png,https://derpicdn.net/img/view/2017/8/23/1518038.png,0,0.948056757,40,21,524,505,484,484,fluttershy
1518095.png,https://derpicdn.net/img/view/2017/8/23/1518095.png,0,0.984305382,0,0,1519,1200,1519,1200,fluttershy
1519455.png,https://derpicdn.net/img/view/2017/8/25/1519455.png,0,0.997875154,234,0,1468,1052,1234,1052,fluttershy
1519457.png,https://derpicdn.net/img/view/2017/8/25/1519457.png,0,0.998334289,0,87,582,699,582,612,fluttershy
1522207.png,https://derpicdn.net/img/view/2017/8/28/1522207.png,0,0.998171806,211,13,543,345,332,332,fluttershy
1522508.png,https://derpicdn.net/img/view/2017/8/29/1522508.png,0,0.990957797,166,44,1524,1402,1358,1358,fluttershy
1523185.png,https://derpicdn.net/img/view/2017/8/30/1523185.png,0,0.996688485,127,38,909,820,782,782,fluttershy
1524176.png,https://derpicdn.net/img/view/2017/8/31/1524176.png,0,0.954111457,327,92,691,456,364,364,fluttershy
1530431.png,https://derpicdn.net/img/view/2017/9/8/1530431.png,0,0.972834945,600,0,2538,1810,1938,1810,fluttershy
1531435.png,https://derpicdn.net/img/view/2017/9/9/1531435.png,0,0.969574273,889,613,1463,1187,574,574,fluttershy
1531435.png,https://derpicdn.net/img/view/2017/9/9/1531435.png,1,0.963803828,165,102,553,490,388,388,fluttershy
1536170.png,https://derpicdn.net/img/view/2017/9/15/1536170.png,0,0.981535017,1243,523,2153,1433,910,910,fluttershy
1538690.png,https://derpicdn.net/img/view/2017/9/18/1538690.png,0,0.99799192,340,189,716,565,376,376,fluttershy
1539909.png,https://derpicdn.net/img/view/2017/9/20/1539909.png,0,0.994306445,162,264,610,712,448,448,fluttershy
1539909.png,https://derpicdn.net/img/view/2017/9/20/1539909.png,1,0.914678693,684,53,1272,641,588,588,fluttershy
1540249.png,https://derpicdn.net/img/view/2017/9/20/1540249.png,0,0.916273117,931,276,1273,618,342,342,fluttershy
1541051.png,https://derpicdn.net/img/view/2017/9/21/1541051.png,0,0.975334048,1702,226,2666,1190,964,964,fluttershy
1547080.png,https://derpicdn.net/img/view/2017/9/28/1547080.png,0,0.996341288,959,656,2835,2532,1876,1876,fluttershy
1547080.png,https://derpicdn.net/img/view/2017/9/28/1547080.png,0,0.996341288,959,656,2835,2532,1876,1876,fluttershy
1547163.png,https://derpicdn.net/img/view/2017/9/28/1547163.png,0,0.981229424,42,0,782,738,740,738,fluttershy
1548590.png,https://derpicdn.net/img/view/2017/9/30/1548590.png,0,0.995095551,708,48,1236,576,528,528,fluttershy
1549995.png,https://derpicdn.net/img/view/2017/10/2/1549995.png,0,0.952120125,157,106,500,460,343,354,fluttershy
1551853.png,https://derpicdn.net/img/view/2017/10/4/1551853.png,0,0.99886328,444,76,1590,1222,1146,1146,fluttershy
1552089.png,https://derpicdn.net/img/view/2017/10/4/1552089.png,0,0.982477009,0,0,1762,1904,1762,1904,fluttershy
1559877.png,https://derpicdn.net/img/view/2017/10/13/1559877.png,0,0.988708138,887,30,1685,828,798,798,fluttershy
1560133.png,https://derpicdn.net/img/view/2017/10/13/1560133.png,0,0.992647886,269,0,769,483,500,483,fluttershy
156188.jpg,https://derpicdn.net/img/view/2012/11/18/156188.jpg,0,0.990380764,347,246,1393,1292,1046,1046,fluttershy
1565183.png,https://derpicdn.net/img/view/2017/10/19/1565183.png,0,0.968496561,371,155,991,775,620,620,fluttershy
1567672.png,https://derpicdn.net/img/view/2017/10/22/1567672.png,0,0.957493365,366,0,1282,865,916,865,fluttershy
1568132.png,https://derpicdn.net/img/view/2017/10/23/1568132.png,0,0.991605639,149,0,793,614,644,614,fluttershy
1568132.png,https://derpicdn.net/img/view/2017/10/23/1568132.png,0,0.991605639,149,0,793,614,644,614,fluttershy
1570644.png,https://derpicdn.net/img/view/2017/10/26/1570644.png,0,0.975711346,566,0,1676,1088,1110,1088,fluttershy
1575685.png,https://derpicdn.net/img/view/2017/11/1/1575685.png,0,0.993571579,518,180,1282,944,764,764,fluttershy
1579195.png,https://derpicdn.net/img/view/2017/11/6/1579195.png,0,0.926263809,630,0,1378,716,748,716,fluttershy
1579580.png,https://derpicdn.net/img/view/2017/11/6/1579580.png,0,0.997803628,238,0,2368,2046,2130,2046,fluttershy
1580778.png,https://derpicdn.net/img/view/2017/11/7/1580778.png,0,0.998148859,224,163,990,929,766,766,fluttershy
1580866.png,https://derpicdn.net/img/view/2017/11/7/1580866.png,0,0.999435484,241,56,891,706,650,650,fluttershy
1587589.png,https://derpicdn.net/img/view/2017/11/16/1587589.png,0,0.986619115,124,292,1636,1794,1512,1502,fluttershy
1587589.png,https://derpicdn.net/img/view/2017/11/16/1587589.png,0,0.986619115,124,292,1636,1794,1512,1502,fluttershy
1587806.png,https://derpicdn.net/img/view/2017/11/16/1587806.png,0,0.975295663,149,34,599,484,450,450,fluttershy
158871.jpg,https://derpicdn.net/img/view/2012/11/21/158871.jpg,0,0.995513618,371,25,577,231,206,206,fluttershy
158871.jpg,https://derpicdn.net/img/view/2012/11/21/158871.jpg,1,0.906477153,398,631,632,865,234,234,fluttershy
1591811.png,https://derpicdn.net/img/view/2017/11/22/1591811.png,0,0.956571937,0,0,3588,3615,3588,3615,fluttershy
1594379.png,https://derpicdn.net/img/view/2017/11/26/1594379.png,0,0.937782288,1448,0,3806,2168,2358,2168,fluttershy
1597090.png,https://derpicdn.net/img/view/2017/11/29/1597090.png,0,0.977317512,214,0,846,616,632,616,fluttershy
1597562.png,https://derpicdn.net/img/view/2017/11/30/1597562.png,0,0.9930861,361,27,889,555,528,528,fluttershy
1597562.png,https://derpicdn.net/img/view/2017/11/30/1597562.png,1,0.987202644,741,79,1161,499,420,420,fluttershy
1597922.png,https://derpicdn.net/img/view/2017/12/1/1597922.png,0,0.965255618,679,97,1341,759,662,662,fluttershy
1598209.png,https://derpicdn.net/img/view/2017/12/1/1598209.png,0,0.987157702,324,0,1754,1377,1430,1377,fluttershy
1600399.png,https://derpicdn.net/img/view/2017/12/4/1600399.png,0,0.931159973,80,28,528,476,448,448,fluttershy
1602100.png,https://derpicdn.net/img/view/2017/12/6/1602100.png,0,0.953983426,186,147,534,495,348,348,fluttershy
1602334.png,https://derpicdn.net/img/view/2017/12/7/1602334.png,1,0.959175706,874,160,1176,462,302,302,fluttershy
1602929.png,https://derpicdn.net/img/view/2017/12/8/1602929.png,0,0.974796712,321,28,889,596,568,568,fluttershy
1609181.png,https://derpicdn.net/img/view/2017/12/16/1609181.png,0,0.950987637,141,0,851,593,710,593,fluttershy
1609421.png,https://derpicdn.net/img/view/2017/12/17/1609421.png,0,0.92235899,246,0,966,591,720,591,fluttershy
1613099.png,https://derpicdn.net/img/view/2017/12/22/1613099.png,0,0.978916585,441,144,785,488,344,344,fluttershy
1613479.png,https://derpicdn.net/img/view/2017/12/22/1613479.png,0,0.941002309,352,82,1046,776,694,694,fluttershy
1614070.png,https://derpicdn.net/img/view/2017/12/23/1614070.png,0,0.995856166,259,62,1931,1734,1672,1672,fluttershy
1615099.png,https://derpicdn.net/img/view/2017/12/24/1615099.png,0,0.992442966,276,0,1214,814,938,814,fluttershy
1616667.png,https://derpicdn.net/img/view/2017/12/26/1616667.png,0,0.944282115,48,3,482,437,434,434,fluttershy
1619359.png,https://derpicdn.net/img/view/2017/12/30/1619359.png,0,0.918767035,1044,378,1312,646,268,268,fluttershy
1622955.png,https://derpicdn.net/img/view/2018/1/3/1622955.png,0,0.980433047,587,0,1935,1087,1348,1087,fluttershy
1623539.png,https://derpicdn.net/img/view/2018/1/4/1623539.png,0,0.971342862,67,0,713,627,646,627,fluttershy
1623995.png,https://derpicdn.net/img/view/2018/1/4/1623995.png,0,0.991901338,278,0,592,281,314,281,fluttershy
1628141.png,https://derpicdn.net/img/view/2018/1/9/1628141.png,0,0.974298,1200,0,3658,2342,2458,2342,fluttershy
1628668.png,https://derpicdn.net/img/view/2018/1/10/1628668.png,0,0.998206437,957,0,3051,1945,2094,1945,fluttershy
1629182.png,https://derpicdn.net/img/view/2018/1/10/1629182.png,0,0.986476541,284,0,1402,862,1118,862,fluttershy
1629489.png,https://derpicdn.net/img/view/2018/1/11/1629489.png,0,0.98525244,0,0,431,447,431,447,fluttershy
1631628.png,https://derpicdn.net/img/view/2018/1/14/1631628.png,0,0.957352519,93,0,669,560,576,560,fluttershy
1632130.png,https://derpicdn.net/img/view/2018/1/14/1632130.png,0,0.936468065,207,0,1343,1119,1136,1119,fluttershy
1632300.png,https://derpicdn.net/img/view/2018/1/14/1632300.png,0,0.95162183,367,373,941,947,574,574,fluttershy
1632760.png,https://derpicdn.net/img/view/2018/1/15/1632760.png,0,0.996534467,2,0,596,577,594,577,fluttershy
1633047.png,https://derpicdn.net/img/view/2018/1/15/1633047.png,0,0.981962502,81,0,1024,888,943,888,fluttershy
1633047.png,https://derpicdn.net/img/view/2018/1/15/1633047.png,0,0.981962502,81,0,1024,888,943,888,fluttershy
1634872.png,https://derpicdn.net/img/view/2018/1/18/1634872.png,0,0.941071987,85,0,350,312,265,312,fluttershy
1635858.png,https://derpicdn.net/img/view/2018/1/19/1635858.png,0,0.979474723,0,707,965,1664,965,957,fluttershy
1635858.png,https://derpicdn.net/img/view/2018/1/19/1635858.png,1,0.933686078,0,0,970,1003,970,1003,fluttershy
1637597.png,https://derpicdn.net/img/view/2018/1/21/1637597.png,0,0.972015619,0,4,933,964,933,960,fluttershy
1637821.png,https://derpicdn.net/img/view/2018/1/21/1637821.png,0,0.988715768,231,120,605,494,374,374,fluttershy
1637821.png,https://derpicdn.net/img/view/2018/1/21/1637821.png,0,0.988715768,231,120,605,494,374,374,fluttershy
1638204.png,https://derpicdn.net/img/view/2018/1/22/1638204.png,0,0.945972741,0,0,1100,1189,1100,1189,fluttershy
1638365.png,https://derpicdn.net/img/view/2018/1/22/1638365.png,0,0.996212542,172,0,1052,832,880,832,fluttershy
1639521.png,https://derpicdn.net/img/view/2018/1/24/1639521.png,0,0.999031842,829,212,1565,948,736,736,fluttershy
1642857.png,https://derpicdn.net/img/view/2018/1/28/1642857.png,0,0.961191952,270,0,1496,1009,1226,1009,fluttershy
1643369.png,https://derpicdn.net/img/view/2018/1/29/1643369.png,0,0.98993361,560,151,966,557,406,406,fluttershy
1645093.png,https://derpicdn.net/img/view/2018/1/31/1645093.png,0,0.96107918,1102,232,1832,962,730,730,fluttershy
1646114.png,https://derpicdn.net/img/view/2018/2/1/1646114.png,0,0.931660354,331,90,625,384,294,294,fluttershy
1646690.png,https://derpicdn.net/img/view/2018/2/2/1646690.png,0,0.994665444,26,0,524,433,498,433,fluttershy
1646690.png,https://derpicdn.net/img/view/2018/2/2/1646690.png,0,0.994665444,26,0,524,433,498,433,fluttershy
1647389.png,https://derpicdn.net/img/view/2018/2/3/1647389.png,0,0.973950565,7,0,437,412,430,412,fluttershy
1648560.png,https://derpicdn.net/img/view/2018/2/4/1648560.png,0,0.97244066,0,0,1641,1767,1641,1767,fluttershy
1648610.png,https://derpicdn.net/img/view/2018/2/4/1648610.png,0,0.969883442,202,10,644,458,442,448,fluttershy
1648892.png,https://derpicdn.net/img/view/2018/2/5/1648892.png,0,0.940922916,1987,240,3171,1424,1184,1184,fluttershy
1650584.png,https://derpicdn.net/img/view/2018/2/7/1650584.png,0,0.920073271,34,0,978,961,944,961,fluttershy
1655848.png,https://derpicdn.net/img/view/2018/2/14/1655848.png,0,0.967452884,1258,0,2810,1461,1552,1461,fluttershy
1660450.png,https://derpicdn.net/img/view/2018/2/19/1660450.png,0,0.94937259,1567,287,1987,707,420,420,fluttershy
16622.png,https://derpicdn.net/img/view/2012/6/23/16622.png,0,0.969743907,338,524,564,750,226,226,fluttershy
1662840.png,https://derpicdn.net/img/view/2018/2/22/1662840.png,0,0.993235767,506,27,1322,843,816,816,fluttershy
1662840.png,https://derpicdn.net/img/view/2018/2/22/1662840.png,0,0.993235767,506,27,1322,843,816,816,fluttershy
1665120.png,https://derpicdn.net/img/view/2018/2/25/1665120.png,0,0.998793364,0,0,221,216,221,216,fluttershy
1665120.png,https://derpicdn.net/img/view/2018/2/25/1665120.png,1,0.996890903,247,0,541,247,294,247,fluttershy
1665120.png,https://derpicdn.net/img/view/2018/2/25/1665120.png,2,0.996055305,519,0,807,243,288,243,fluttershy
1665120.png,https://derpicdn.net/img/view/2018/2/25/1665120.png,3,0.992332876,24,281,350,607,326,326,fluttershy
1665120.png,https://derpicdn.net/img/view/2018/2/25/1665120.png,5,0.932475865,337,314,615,592,278,278,fluttershy
1665120.png,https://derpicdn.net/img/view/2018/2/25/1665120.png,0,0.998793364,0,0,221,216,221,216,fluttershy
1665120.png,https://derpicdn.net/img/view/2018/2/25/1665120.png,1,0.996890903,247,0,541,247,294,247,fluttershy
1665120.png,https://derpicdn.net/img/view/2018/2/25/1665120.png,2,0.996055305,519,0,807,243,288,243,fluttershy
1665120.png,https://derpicdn.net/img/view/2018/2/25/1665120.png,3,0.992332876,24,281,350,607,326,326,fluttershy
1665120.png,https://derpicdn.net/img/view/2018/2/25/1665120.png,5,0.932475865,337,314,615,592,278,278,fluttershy
1666592.png,https://derpicdn.net/img/view/2018/2/26/1666592.png,0,0.968354106,53,0,1115,883,1062,883,fluttershy
1668691.png,https://derpicdn.net/img/view/2018/3/1/1668691.png,0,0.997202575,821,0,4047,3058,3226,3058,fluttershy
1672356.png,https://derpicdn.net/img/view/2018/3/5/1672356.png,0,0.997007966,345,0,2329,1895,1984,1895,fluttershy
1673340.png,https://derpicdn.net/img/view/2018/3/6/1673340.png,0,0.996988714,346,0,2324,1890,1978,1890,fluttershy
1679447.png,https://derpicdn.net/img/view/2018/3/13/1679447.png,0,0.941768587,275,11,545,281,270,270,fluttershy
1681338.png,https://derpicdn.net/img/view/2018/3/15/1681338.png,0,0.959708214,247,0,955,681,708,681,fluttershy
1681385.png,https://derpicdn.net/img/view/2018/3/15/1681385.png,0,0.919192135,730,0,1964,1194,1234,1194,fluttershy
1685676.png,https://derpicdn.net/img/view/2018/3/20/1685676.png,0,0.980854511,0,0,385,381,385,381,fluttershy
1685905.png,https://derpicdn.net/img/view/2018/3/20/1685905.png,0,0.99188894,122,26,458,362,336,336,fluttershy
1686956.png,https://derpicdn.net/img/view/2018/3/21/1686956.png,0,0.981717944,545,28,1353,836,808,808,fluttershy
1687545.png,https://derpicdn.net/img/view/2018/3/22/1687545.png,0,0.968992174,283,0,757,466,474,466,fluttershy
1689911.png,https://derpicdn.net/img/view/2018/3/25/1689911.png,0,0.988292336,85,0,1137,720,1052,720,fluttershy
1689959.png,https://derpicdn.net/img/view/2018/3/25/1689959.png,0,0.993377328,585,0,2000,1415,1415,1415,fluttershy
1690310.png,https://derpicdn.net/img/view/2018/3/25/1690310.png,0,0.944351733,731,0,1667,916,936,916,fluttershy
169093.jpg,https://derpicdn.net/img/view/2012/12/1/169093.jpg,0,0.996001959,282,0,659,384,377,384,fluttershy
1691083.png,https://derpicdn.net/img/view/2018/3/26/1691083.png,0,0.96515584,312,455,1332,1475,1020,1020,fluttershy
1691083.png,https://derpicdn.net/img/view/2018/3/26/1691083.png,0,0.96515584,312,455,1332,1475,1020,1020,fluttershy
1692037.png,https://derpicdn.net/img/view/2018/3/27/1692037.png,0,0.985323787,1425,508,2455,1538,1030,1030,fluttershy
1695581.png,https://derpicdn.net/img/view/2018/3/31/1695581.png,0,0.999237716,509,2,1719,1212,1210,1210,fluttershy
1697134.png,https://derpicdn.net/img/view/2018/4/2/1697134.png,0,0.990665019,1194,824,3460,3090,2266,2266,fluttershy
1698602.png,https://derpicdn.net/img/view/2018/4/4/1698602.png,0,0.955059707,608,276,1236,904,628,628,fluttershy
1699630.png,https://derpicdn.net/img/view/2018/4/5/1699630.png,0,0.993306339,66,0,808,733,742,733,fluttershy
1701823.png,https://derpicdn.net/img/view/2018/4/7/1701823.png,0,0.930168986,206,131,1203,1323,997,1192,fluttershy
1701823.png,https://derpicdn.net/img/view/2018/4/7/1701823.png,0,0.930168986,206,131,1203,1323,997,1192,fluttershy
1702273.png,https://derpicdn.net/img/view/2018/4/8/1702273.png,0,0.994660199,82,1,2718,2637,2636,2636,fluttershy
1702446.png,https://derpicdn.net/img/view/2018/4/8/1702446.png,0,0.996985793,64,8,328,272,264,264,fluttershy
1702446.png,https://derpicdn.net/img/view/2018/4/8/1702446.png,0,0.996985793,64,8,328,272,264,264,fluttershy
1702639.png,https://derpicdn.net/img/view/2018/4/8/1702639.png,0,0.91376096,919,277,3615,2973,2696,2696,fluttershy
1702811.png,https://derpicdn.net/img/view/2018/4/8/1702811.png,0,0.989814639,96,43,711,658,615,615,fluttershy
1704123.png,https://derpicdn.net/img/view/2018/4/10/1704123.png,0,0.999028146,200,0,3146,2596,2946,2596,fluttershy
1704708.png,https://derpicdn.net/img/view/2018/4/11/1704708.png,0,0.940582871,52,0,2276,2123,2224,2123,fluttershy
1704764.png,https://derpicdn.net/img/view/2018/4/11/1704764.png,0,0.938213825,21,0,547,519,526,519,fluttershy
1704834.png,https://derpicdn.net/img/view/2018/4/11/1704834.png,0,0.992438436,316,206,724,614,408,408,fluttershy
1704854.png,https://derpicdn.net/img/view/2018/4/11/1704854.png,0,0.919310391,252,790,2370,2908,2118,2118,fluttershy
170519.png,https://derpicdn.net/img/view/2012/12/2/170519.png,0,0.9973315,596,11,950,369,354,358,fluttershy
170519.png,https://derpicdn.net/img/view/2012/12/2/170519.png,0,0.9973315,596,11,950,369,354,358,fluttershy
1705205.png,https://derpicdn.net/img/view/2018/4/11/1705205.png,0,0.988216579,253,8,597,352,344,344,fluttershy
1705257.png,https://derpicdn.net/img/view/2018/4/11/1705257.png,0,0.986079395,542,248,1588,1294,1046,1046,fluttershy
1705261.png,https://derpicdn.net/img/view/2018/4/11/1705261.png,0,0.914512217,543,205,1691,1353,1148,1148,fluttershy
1705971.png,https://derpicdn.net/img/view/2018/4/12/1705971.png,0,0.937310696,791,72,1739,1020,948,948,fluttershy
170626.png,https://derpicdn.net/img/view/2012/12/2/170626.png,0,0.998832285,116,0,706,574,590,574,fluttershy
1708645.png,https://derpicdn.net/img/view/2018/4/15/1708645.png,0,0.995698869,1985,405,2821,1241,836,836,fluttershy
1710107.png,https://derpicdn.net/img/view/2018/4/17/1710107.png,0,0.902080476,1162,61,2168,1067,1006,1006,fluttershy
171045.png,https://derpicdn.net/img/view/2012/12/3/171045.png,0,0.985337079,160,21,364,225,204,204,fluttershy
1710458.png,https://derpicdn.net/img/view/2018/4/17/1710458.png,0,0.996333241,89,0,1153,966,1064,966,fluttershy
1711206.png,https://derpicdn.net/img/view/2018/4/18/1711206.png,0,0.978590012,592,34,1374,816,782,782,fluttershy
1712477.png,https://derpicdn.net/img/view/2018/4/20/1712477.png,0,0.929822564,153,36,1347,1079,1194,1043,fluttershy
1712477.png,https://derpicdn.net/img/view/2018/4/20/1712477.png,0,0.929822564,153,36,1347,1079,1194,1043,fluttershy
1713344.png,https://derpicdn.net/img/view/2018/4/21/1713344.png,0,0.978651345,513,0,2873,2002,2360,2002,fluttershy
171591.png,https://derpicdn.net/img/view/2012/12/3/171591.png,0,0.949808955,0,0,457,523,457,523,fluttershy
1717546.png,https://derpicdn.net/img/view/2018/4/26/1717546.png,0,0.999535978,370,101,666,397,296,296,fluttershy
1719167.png,https://derpicdn.net/img/view/2018/4/28/1719167.png,0,0.941907763,0,76,444,548,444,472,fluttershy
1719167.png,https://derpicdn.net/img/view/2018/4/28/1719167.png,1,0.9100703,1305,701,1701,1097,396,396,fluttershy
1719917.png,https://derpicdn.net/img/view/2018/4/29/1719917.png,0,0.996257365,136,39,534,437,398,398,fluttershy
1720308.png,https://derpicdn.net/img/view/2018/4/29/1720308.png,0,0.989780068,36,51,394,409,358,358,fluttershy
1720453.png,https://derpicdn.net/img/view/2018/4/29/1720453.png,0,0.96340096,2225,394,2837,1006,612,612,fluttershy
1720827.png,https://derpicdn.net/img/view/2018/4/30/1720827.png,0,0.907358646,88,0,894,707,806,707,fluttershy
1720957.png,https://derpicdn.net/img/view/2018/4/30/1720957.png,0,0.992562056,966,111,1378,523,412,412,fluttershy
1720957.png,https://derpicdn.net/img/view/2018/4/30/1720957.png,1,0.984057367,564,307,850,593,286,286,fluttershy
1723875.png,https://derpicdn.net/img/view/2018/5/4/1723875.png,0,0.955693722,436,0,1250,801,814,801,fluttershy
1729577.png,https://derpicdn.net/img/view/2018/5/10/1729577.png,0,0.986068487,1410,312,2592,1494,1182,1182,fluttershy
1729689.png,https://derpicdn.net/img/view/2018/5/11/1729689.png,0,0.99012661,0,0,288,300,288,300,fluttershy
1731403.png,https://derpicdn.net/img/view/2018/5/13/1731403.png,0,0.98933357,1323,0,4167,2735,2844,2735,fluttershy
1732098.png,https://derpicdn.net/img/view/2018/5/13/1732098.png,0,0.985730112,0,0,553,549,553,549,fluttershy
1733267.png,https://derpicdn.net/img/view/2018/5/15/1733267.png,0,0.920146704,0,0,5386,5803,5386,5803,fluttershy
1735006.png,https://derpicdn.net/img/view/2018/5/17/1735006.png,0,0.907762945,923,0,1775,804,852,804,fluttershy
1740582.png,https://derpicdn.net/img/view/2018/5/24/1740582.png,0,0.998017192,687,439,945,697,258,258,fluttershy
1741479.png,https://derpicdn.net/img/view/2018/5/26/1741479.png,0,0.99795562,712,0,3044,2110,2332,2110,fluttershy
1744497.png,https://derpicdn.net/img/view/2018/5/29/1744497.png,0,0.99523592,474,270,1740,1536,1266,1266,fluttershy
1750905.png,https://derpicdn.net/img/view/2018/6/6/1750905.png,0,0.999752343,839,161,2215,1537,1376,1376,fluttershy
1751040.png,https://derpicdn.net/img/view/2018/6/6/1751040.png,0,0.976199746,31,0,379,318,348,318,fluttershy
1751242.png,https://derpicdn.net/img/view/2018/6/6/1751242.png,0,0.994377851,619,497,1581,1459,962,962,fluttershy
1751242.png,https://derpicdn.net/img/view/2018/6/6/1751242.png,0,0.994377851,619,497,1581,1459,962,962,fluttershy
1753144.png,https://derpicdn.net/img/view/2018/6/9/1753144.png,0,0.998478949,1347,67,2969,1689,1622,1622,fluttershy
1755058.png,https://derpicdn.net/img/view/2018/6/11/1755058.png,0,0.975446582,135,0,547,382,412,382,fluttershy
1755107.png,https://derpicdn.net/img/view/2018/6/11/1755107.png,0,0.915649831,389,225,1239,1075,850,850,fluttershy
1756271.png,https://derpicdn.net/img/view/2018/6/12/1756271.png,0,0.924973249,1052,547,2564,2059,1512,1512,fluttershy
1757723.png,https://derpicdn.net/img/view/2018/6/14/1757723.png,0,0.975470722,0,0,781,741,781,741,fluttershy
1758360.png,https://derpicdn.net/img/view/2018/6/15/1758360.png,0,0.997457862,1406,46,2066,706,660,660,fluttershy
1758683.png,https://derpicdn.net/img/view/2018/6/16/1758683.png,0,0.972904146,0,0,636,684,636,684,fluttershy
1758734.png,https://derpicdn.net/img/view/2018/6/16/1758734.png,0,0.985307515,8,155,640,787,632,632,fluttershy
1761201.png,https://derpicdn.net/img/view/2018/6/19/1761201.png,0,0.996700525,82,0,606,482,524,482,fluttershy
1762342.png,https://derpicdn.net/img/view/2018/6/20/1762342.png,0,0.965182781,52,50,392,390,340,340,fluttershy
1763468.png,https://derpicdn.net/img/view/2018/6/22/1763468.png,0,0.917737246,17,0,978,932,961,932,fluttershy
1763814.png,https://derpicdn.net/img/view/2018/6/22/1763814.png,0,0.993210137,92,0,648,519,556,519,fluttershy
1764315.png,https://derpicdn.net/img/view/2018/6/23/1764315.png,0,0.997891188,498,105,856,463,358,358,fluttershy
1764805.png,https://derpicdn.net/img/view/2018/6/24/1764805.png,0,0.950504005,91,577,607,1093,516,516,fluttershy
1766364.png,https://derpicdn.net/img/view/2018/6/26/1766364.png,0,0.981653273,56,0,528,437,472,437,fluttershy
1768053.png,https://derpicdn.net/img/view/2018/6/28/1768053.png,0,0.97960031,431,228,1831,1628,1400,1400,fluttershy
1768185.png,https://derpicdn.net/img/view/2018/6/28/1768185.png,0,0.977593422,465,0,1423,927,958,927,fluttershy
1769515.png,https://derpicdn.net/img/view/2018/6/30/1769515.png,0,0.972955406,90,0,790,684,700,684,fluttershy
1770804.png,https://derpicdn.net/img/view/2018/7/2/1770804.png,0,0.997474074,78,0,642,544,564,544,fluttershy
1770805.png,https://derpicdn.net/img/view/2018/7/2/1770805.png,0,0.924529612,68,0,558,460,490,460,fluttershy
1771424.png,https://derpicdn.net/img/view/2018/7/2/1771424.png,0,0.976668537,140,0,856,682,716,682,fluttershy
1771763.png,https://derpicdn.net/img/view/2018/7/3/1771763.png,0,0.984904766,825,407,1249,831,424,424,fluttershy
1771763.png,https://derpicdn.net/img/view/2018/7/3/1771763.png,1,0.980473161,374,750,910,1286,536,536,fluttershy
1771763.png,https://derpicdn.net/img/view/2018/7/3/1771763.png,0,0.984904766,825,407,1249,831,424,424,fluttershy
1771763.png,https://derpicdn.net/img/view/2018/7/3/1771763.png,1,0.980473161,374,750,910,1286,536,536,fluttershy
1771904.png,https://derpicdn.net/img/view/2018/7/3/1771904.png,0,0.968812406,0,0,433,425,433,425,fluttershy
1775163.png,https://derpicdn.net/img/view/2018/7/7/1775163.png,0,0.98257488,221,66,595,440,374,374,fluttershy
1778053.png,https://derpicdn.net/img/view/2018/7/11/1778053.png,0,0.997643769,248,15,876,643,628,628,fluttershy
1778074.png,https://derpicdn.net/img/view/2018/7/11/1778074.png,0,0.942252219,406,0,2166,1585,1760,1585,fluttershy
1780405.png,https://derpicdn.net/img/view/2018/7/13/1780405.png,0,0.990534723,5,0,379,337,374,337,fluttershy
1781300.png,https://derpicdn.net/img/view/2018/7/15/1781300.png,0,0.977596879,41,18,335,312,294,294,fluttershy
1782023.png,https://derpicdn.net/img/view/2018/7/16/1782023.png,0,0.944720984,0,0,780,772,780,772,fluttershy
178323.png,https://derpicdn.net/img/view/2012/12/10/178323.png,0,0.983629763,141,0,915,757,774,757,fluttershy
1784055.png,https://derpicdn.net/img/view/2018/7/18/1784055.png,0,0.98495543,1458,812,2464,1818,1006,1006,fluttershy
1784057.png,https://derpicdn.net/img/view/2018/7/18/1784057.png,0,0.981120229,1482,816,2472,1806,990,990,fluttershy
1786354.png,https://derpicdn.net/img/view/2018/7/21/1786354.png,0,0.993635714,1430,0,3138,1600,1708,1600,fluttershy
1786573.png,https://derpicdn.net/img/view/2018/7/22/1786573.png,0,0.988588214,348,53,642,347,294,294,fluttershy
1787370.png,https://derpicdn.net/img/view/2018/7/23/1787370.png,0,0.9696576,176,0,716,479,540,479,fluttershy
1787611.png,https://derpicdn.net/img/view/2018/7/23/1787611.png,0,0.988630831,399,113,1521,1235,1122,1122,fluttershy
1788437.png,https://derpicdn.net/img/view/2018/7/24/1788437.png,0,0.966795921,236,22,580,366,344,344,fluttershy
1788437.png,https://derpicdn.net/img/view/2018/7/24/1788437.png,0,0.966795921,236,22,580,366,344,344,fluttershy
1788794.png,https://derpicdn.net/img/view/2018/7/24/1788794.png,0,0.994861484,672,172,1216,716,544,544,fluttershy
1792484.png,https://derpicdn.net/img/view/2018/7/29/1792484.png,0,0.998070717,205,0,1451,1187,1246,1187,fluttershy
1792996.png,https://derpicdn.net/img/view/2018/7/29/1792996.png,0,0.977175117,112,0,1418,1092,1306,1092,fluttershy
1793326.png,https://derpicdn.net/img/view/2018/7/30/1793326.png,0,0.98020643,0,0,256,234,256,234,fluttershy
1794562.png,https://derpicdn.net/img/view/2018/7/31/1794562.png,0,0.99967742,672,0,2158,1214,1486,1214,fluttershy
1795870.png,https://derpicdn.net/img/view/2018/8/2/1795870.png,0,0.987316906,283,34,819,570,536,536,fluttershy
1796764.png,https://derpicdn.net/img/view/2018/8/3/1796764.png,0,0.932062387,226,10,3080,2864,2854,2854,fluttershy
1797787.png,https://derpicdn.net/img/view/2018/8/4/1797787.png,0,0.991170406,54,0,1266,1115,1212,1115,fluttershy
1799556.png,https://derpicdn.net/img/view/2018/8/6/1799556.png,0,0.991513193,659,0,2171,1509,1512,1509,fluttershy
1803846.png,https://derpicdn.net/img/view/2018/8/11/1803846.png,0,0.930220187,118,0,1181,1067,1063,1067,fluttershy
1804404.png,https://derpicdn.net/img/view/2018/8/11/1804404.png,0,0.990954161,1261,5,2099,843,838,838,fluttershy
1804404.png,https://derpicdn.net/img/view/2018/8/11/1804404.png,1,0.987366199,65,1008,825,1768,760,760,fluttershy
1806121.png,https://derpicdn.net/img/view/2018/8/13/1806121.png,0,0.98198086,64,241,2278,2449,2214,2208,fluttershy
1809203.png,https://derpicdn.net/img/view/2018/8/17/1809203.png,0,0.986531436,4,24,433,458,429,434,fluttershy
1811781.png,https://derpicdn.net/img/view/2018/8/20/1811781.png,0,0.993671954,1559,0,4995,3280,3436,3280,fluttershy
1812741.png,https://derpicdn.net/img/view/2018/8/21/1812741.png,0,0.970270395,0,0,864,837,864,837,fluttershy
1814270.png,https://derpicdn.net/img/view/2018/8/23/1814270.png,0,0.995959103,225,0,495,259,270,259,fluttershy
1816722.png,https://derpicdn.net/img/view/2018/8/26/1816722.png,0,0.939904094,481,633,1081,1233,600,600,fluttershy
1818838.png,https://derpicdn.net/img/view/2018/8/28/1818838.png,0,0.984661281,364,1220,1238,2094,874,874,fluttershy
1818838.png,https://derpicdn.net/img/view/2018/8/28/1818838.png,1,0.972914159,283,613,763,1093,480,480,fluttershy
1821753.png,https://derpicdn.net/img/view/2018/9/1/1821753.png,0,0.977915227,741,257,2577,2093,1836,1836,fluttershy
1832769.png,https://derpicdn.net/img/view/2018/9/14/1832769.png,0,0.954634011,290,0,1746,1431,1456,1431,fluttershy
1834523.png,https://derpicdn.net/img/view/2018/9/17/1834523.png,0,0.998551428,188,0,1894,1563,1706,1563,fluttershy
1838590.png,https://derpicdn.net/img/view/2018/9/22/1838590.png,0,0.998636127,120,0,740,552,620,552,fluttershy
1838599.png,https://derpicdn.net/img/view/2018/9/22/1838599.png,0,0.999628365,374,0,768,377,394,377,fluttershy
1838599.png,https://derpicdn.net/img/view/2018/9/22/1838599.png,0,0.999628365,374,0,768,377,394,377,fluttershy
1840455.png,https://derpicdn.net/img/view/2018/9/24/1840455.png,0,0.991904259,50,204,4000,4170,3950,3966,fluttershy
1843170.png,https://derpicdn.net/img/view/2018/9/28/1843170.png,0,0.988602102,191,0,1361,1159,1170,1159,fluttershy
1843348.png,https://derpicdn.net/img/view/2018/9/28/1843348.png,0,0.955884993,0,0,471,401,471,401,fluttershy
1843776.png,https://derpicdn.net/img/view/2018/9/29/1843776.png,0,0.994917929,1009,185,1975,1151,966,966,fluttershy
1843788.png,https://derpicdn.net/img/view/2018/9/29/1843788.png,0,0.997316599,425,0,1527,1006,1102,1006,fluttershy
1847041.png,https://derpicdn.net/img/view/2018/10/3/1847041.png,0,0.918084919,0,0,2364,2576,2364,2576,fluttershy
1847343.png,https://derpicdn.net/img/view/2018/10/3/1847343.png,0,0.976078808,90,0,978,887,888,887,fluttershy
1848935.png,https://derpicdn.net/img/view/2018/10/5/1848935.png,0,0.981859982,44,0,882,793,838,793,fluttershy
184910.png,https://derpicdn.net/img/view/2012/12/17/184910.png,0,0.985273361,263,2,1385,1124,1122,1122,fluttershy
1854384.png,https://derpicdn.net/img/view/2018/10/12/1854384.png,0,0.920860946,317,0,1341,955,1024,955,fluttershy
1855402.png,https://derpicdn.net/img/view/2018/10/13/1855402.png,0,0.900616109,145,0,605,426,460,426,fluttershy
1857237.png,https://derpicdn.net/img/view/2018/10/15/1857237.png,0,0.969103396,50,74,888,912,838,838,fluttershy
1857258.png,https://derpicdn.net/img/view/2018/10/15/1857258.png,0,0.979151964,429,91,1183,845,754,754,fluttershy
1857512.png,https://derpicdn.net/img/view/2018/10/15/1857512.png,0,0.996660233,190,0,728,520,538,520,fluttershy
1858300.png,https://derpicdn.net/img/view/2018/10/16/1858300.png,0,0.984554589,1201,440,2423,1662,1222,1222,fluttershy
1860018.png,https://derpicdn.net/img/view/2018/10/18/1860018.png,0,0.998780608,412,3,1036,627,624,624,fluttershy
1860511.png,https://derpicdn.net/img/view/2018/10/19/1860511.png,0,0.909347236,196,0,1242,1026,1046,1026,fluttershy
1862283.png,https://derpicdn.net/img/view/2018/10/21/1862283.png,0,0.999308765,368,0,1332,873,964,873,fluttershy
1863161.png,https://derpicdn.net/img/view/2018/10/22/1863161.png,0,0.926482558,296,191,2486,2381,2190,2190,fluttershy
1863216.png,https://derpicdn.net/img/view/2018/10/22/1863216.png,0,0.940066516,979,315,1977,1313,998,998,fluttershy
1863544.png,https://derpicdn.net/img/view/2018/10/23/1863544.png,0,0.976456881,382,24,2238,1880,1856,1856,fluttershy
1867714.png,https://derpicdn.net/img/view/2018/10/27/1867714.png,0,0.947579563,602,0,1920,1080,1318,1080,fluttershy
186776.jpg,https://derpicdn.net/img/view/2012/12/18/186776.jpg,0,0.997582436,289,18,547,276,258,258,fluttershy
1868220.png,https://derpicdn.net/img/view/2018/10/28/1868220.png,0,0.983245254,48,209,978,1078,930,869,fluttershy
1869532.png,https://derpicdn.net/img/view/2018/10/29/1869532.png,0,0.999009848,207,57,841,691,634,634,fluttershy
1869824.png,https://derpicdn.net/img/view/2018/10/29/1869824.png,0,0.992566347,1186,0,3424,2065,2238,2065,fluttershy
1871971.png,https://derpicdn.net/img/view/2018/11/1/1871971.png,0,0.905965567,201,75,685,559,484,484,fluttershy
1872947.png,https://derpicdn.net/img/view/2018/11/2/1872947.png,0,0.99018091,1545,0,3899,1930,2354,1930,fluttershy
1872947.png,https://derpicdn.net/img/view/2018/11/2/1872947.png,1,0.967956066,0,815,2104,2894,2104,2079,fluttershy
1874385.png,https://derpicdn.net/img/view/2018/11/3/1874385.png,0,0.994644701,21,0,839,789,818,789,fluttershy
1874440.png,https://derpicdn.net/img/view/2018/11/4/1874440.png,0,0.985847712,31,0,341,281,310,281,fluttershy
1875792.png,https://derpicdn.net/img/view/2018/11/5/1875792.png,0,0.978641391,183,0,2347,2065,2164,2065,fluttershy
1876977.png,https://derpicdn.net/img/view/2018/11/7/1876977.png,0,0.968941927,1210,0,4454,2709,3244,2709,fluttershy
1877266.png,https://derpicdn.net/img/view/2018/11/7/1877266.png,0,0.987729609,356,681,686,1011,330,330,fluttershy
1877266.png,https://derpicdn.net/img/view/2018/11/7/1877266.png,0,0.987729609,356,681,686,1011,330,330,fluttershy
1877387.png,https://derpicdn.net/img/view/2018/11/7/1877387.png,0,0.981145859,0,4,2193,2326,2193,2322,fluttershy
1878374.png,https://derpicdn.net/img/view/2018/11/9/1878374.png,0,0.98018229,962,0,3856,2649,2894,2649,fluttershy
1879116.png,https://derpicdn.net/img/view/2018/11/10/1879116.png,0,0.948305964,48,0,680,569,632,569,fluttershy
1880064.png,https://derpicdn.net/img/view/2018/11/11/1880064.png,0,0.991683185,2685,0,6859,3464,4174,3464,fluttershy
1881389.png,https://derpicdn.net/img/view/2018/11/13/1881389.png,0,0.933889627,3272,0,5000,1703,1728,1703,fluttershy
1882792.png,https://derpicdn.net/img/view/2018/11/15/1882792.png,0,0.995238245,158,0,1078,919,920,919,fluttershy
1885664.png,https://derpicdn.net/img/view/2018/11/19/1885664.png,0,0.98089689,103,0,2597,2381,2494,2381,fluttershy
1886240.png,https://derpicdn.net/img/view/2018/11/19/1886240.png,0,0.989772201,1537,426,2979,1868,1442,1442,fluttershy
1886986.png,https://derpicdn.net/img/view/2018/11/20/1886986.png,0,0.994159937,1240,60,2232,1052,992,992,fluttershy
1887995.png,https://derpicdn.net/img/view/2018/11/22/1887995.png,0,0.960609913,459,0,1275,638,816,638,fluttershy
1888588.png,https://derpicdn.net/img/view/2018/11/22/1888588.png,0,0.952998877,0,33,1135,1349,1135,1316,fluttershy
1890078.png,https://derpicdn.net/img/view/2018/11/24/1890078.png,0,0.98054409,217,195,2777,2755,2560,2560,fluttershy
1890606.png,https://derpicdn.net/img/view/2018/11/25/1890606.png,0,0.989391208,131,0,1271,1080,1140,1080,fluttershy
1892970.png,https://derpicdn.net/img/view/2018/11/28/1892970.png,0,0.992959142,538,369,2986,2817,2448,2448,fluttershy
1893999.png,https://derpicdn.net/img/view/2018/11/29/1893999.png,0,0.968764961,157,0,1109,785,952,785,fluttershy
1894148.png,https://derpicdn.net/img/view/2018/11/30/1894148.png,0,0.915780067,1091,0,3787,2365,2696,2365,fluttershy
1895053.png,https://derpicdn.net/img/view/2018/12/1/1895053.png,0,0.988755107,545,64,903,422,358,358,fluttershy
1895053.png,https://derpicdn.net/img/view/2018/12/1/1895053.png,1,0.969833493,293,64,521,292,228,228,fluttershy
189670.png,https://derpicdn.net/img/view/2012/12/21/189670.png,0,0.968185484,137,64,427,354,290,290,fluttershy
1896962.png,https://derpicdn.net/img/view/2018/12/3/1896962.png,0,0.997133911,480,157,1320,997,840,840,fluttershy
1897755.png,https://derpicdn.net/img/view/2018/12/4/1897755.png,0,0.999477506,149,0,387,234,238,234,fluttershy
1899807.png,https://derpicdn.net/img/view/2018/12/6/1899807.png,0,0.998924792,207,22,617,432,410,410,fluttershy
190.jpg,https://derpicdn.net/img/view/2012/1/12/190.jpg,0,0.969684362,428,555,610,737,182,182,fluttershy
1902632.png,https://derpicdn.net/img/view/2018/12/8/1902632.png,0,0.963525653,309,0,1065,726,756,726,fluttershy
1906093.png,https://derpicdn.net/img/view/2018/12/12/1906093.png,0,0.995356023,86,0,1750,1589,1664,1589,fluttershy
1906356.png,https://derpicdn.net/img/view/2018/12/12/1906356.png,0,0.995977342,1293,0,2287,994,994,994,fluttershy
1908392.png,https://derpicdn.net/img/view/2018/12/14/1908392.png,0,0.95337671,43,22,435,414,392,392,fluttershy
1908690.png,https://derpicdn.net/img/view/2018/12/15/1908690.png,0,0.984463513,34,14,284,264,250,250,fluttershy
1909017.png,https://derpicdn.net/img/view/2018/12/15/1909017.png,0,0.997504234,22,125,636,739,614,614,fluttershy
1909575.png,https://derpicdn.net/img/view/2018/12/16/1909575.png,0,0.998093665,2054,411,2802,1159,748,748,fluttershy
1909575.png,https://derpicdn.net/img/view/2018/12/16/1909575.png,1,0.960646152,648,398,1396,1146,748,748,fluttershy
1912726.png,https://derpicdn.net/img/view/2018/12/19/1912726.png,0,0.989350021,965,0,3000,1993,2035,1993,fluttershy
1913663.png,https://derpicdn.net/img/view/2018/12/20/1913663.png,0,0.965676546,580,246,1668,1334,1088,1088,fluttershy
1913897.png,https://derpicdn.net/img/view/2018/12/20/1913897.png,0,0.931905448,19,0,507,477,488,477,fluttershy
1917760.png,https://derpicdn.net/img/view/2018/12/24/1917760.png,0,0.992554724,0,71,828,969,828,898,fluttershy
1917760.png,https://derpicdn.net/img/view/2018/12/24/1917760.png,0,0.992554724,0,71,828,969,828,898,fluttershy
1919179.png,https://derpicdn.net/img/view/2018/12/26/1919179.png,0,0.989757836,121,0,669,532,548,532,fluttershy
1921021.png,https://derpicdn.net/img/view/2018/12/28/1921021.png,0,0.989168227,280,16,1276,1012,996,996,fluttershy
1921227.png,https://derpicdn.net/img/view/2018/12/29/1921227.png,0,0.988843143,63,0,1209,1023,1146,1023,fluttershy
1921467.png,https://derpicdn.net/img/view/2018/12/29/1921467.png,0,0.998977423,210,20,510,320,300,300,fluttershy
1921510.png,https://derpicdn.net/img/view/2018/12/29/1921510.png,0,0.904630005,43,12,629,598,586,586,fluttershy
1922596.png,https://derpicdn.net/img/view/2018/12/31/1922596.png,0,0.96233207,643,685,937,979,294,294,fluttershy
1922596.png,https://derpicdn.net/img/view/2018/12/31/1922596.png,0,0.96233207,643,685,937,979,294,294,fluttershy
1923579.png,https://derpicdn.net/img/view/2019/1/1/1923579.png,0,0.990115583,0,16,234,270,234,254,fluttershy
1924135.png,https://derpicdn.net/img/view/2019/1/1/1924135.png,0,0.921949148,0,0,2305,2474,2305,2474,fluttershy
1924135.png,https://derpicdn.net/img/view/2019/1/1/1924135.png,0,0.921949148,0,0,2305,2474,2305,2474,fluttershy
1928425.png,https://derpicdn.net/img/view/2019/1/6/1928425.png,0,0.97913003,41,87,1103,1149,1062,1062,fluttershy
1929837.png,https://derpicdn.net/img/view/2019/1/8/1929837.png,0,0.977869451,1165,217,2445,1497,1280,1280,fluttershy
1931029.png,https://derpicdn.net/img/view/2019/1/9/1931029.png,0,0.986455023,180,79,1070,969,890,890,fluttershy
1931153.png,https://derpicdn.net/img/view/2019/1/9/1931153.png,0,0.995419919,67,0,475,386,408,386,fluttershy
1931153.png,https://derpicdn.net/img/view/2019/1/9/1931153.png,0,0.995419919,67,0,475,386,408,386,fluttershy
1931702.png,https://derpicdn.net/img/view/2019/1/10/1931702.png,0,0.985422611,213,0,831,493,618,493,fluttershy
1931954.png,https://derpicdn.net/img/view/2019/1/11/1931954.png,0,0.961173892,686,3,5342,4659,4656,4656,fluttershy
1932349.png,https://derpicdn.net/img/view/2019/1/11/1932349.png,0,0.997840881,586,0,956,360,370,360,fluttershy
1933197.png,https://derpicdn.net/img/view/2019/1/12/1933197.png,0,0.946500599,241,208,879,846,638,638,fluttershy
1934307.png,https://derpicdn.net/img/view/2019/1/13/1934307.png,0,0.960233808,807,149,2403,1745,1596,1596,fluttershy
1938906.png,https://derpicdn.net/img/view/2019/1/19/1938906.png,0,0.994228125,151,0,873,670,722,670,fluttershy
1942228.png,https://derpicdn.net/img/view/2019/1/23/1942228.png,0,0.996319413,73,0,721,632,648,632,fluttershy
1944221.png,https://derpicdn.net/img/view/2019/1/25/1944221.png,0,0.998075962,542,0,1136,564,594,564,fluttershy
1944458.png,https://derpicdn.net/img/view/2019/1/25/1944458.png,0,0.989232183,229,0,1099,837,870,837,fluttershy
1945647.png,https://derpicdn.net/img/view/2019/1/27/1945647.png,0,0.981468737,629,193,1063,627,434,434,fluttershy
1947193.png,https://derpicdn.net/img/view/2019/1/28/1947193.png,0,0.974055767,277,0,1239,922,962,922,fluttershy
1950977.png,https://derpicdn.net/img/view/2019/2/2/1950977.png,0,0.969392419,25,22,1147,1144,1122,1122,fluttershy
1954364.png,https://derpicdn.net/img/view/2019/2/5/1954364.png,0,0.995945454,289,0,2449,2112,2160,2112,fluttershy
1954364.png,https://derpicdn.net/img/view/2019/2/5/1954364.png,0,0.995945454,289,0,2449,2112,2160,2112,fluttershy
1954805.png,https://derpicdn.net/img/view/2019/2/6/1954805.png,0,0.995988488,328,0,1664,1289,1336,1289,fluttershy
1955352.png,https://derpicdn.net/img/view/2019/2/6/1955352.png,0,0.998687983,185,0,861,669,676,669,fluttershy
1957282.png,https://derpicdn.net/img/view/2019/2/9/1957282.png,0,0.930921555,2343,329,3611,1597,1268,1268,fluttershy
1958367.png,https://derpicdn.net/img/view/2019/2/10/1958367.png,0,0.959769726,135,0,1781,1479,1646,1479,fluttershy
1958367.png,https://derpicdn.net/img/view/2019/2/10/1958367.png,0,0.959769726,135,0,1781,1479,1646,1479,fluttershy
1962830.png,https://derpicdn.net/img/view/2019/2/15/1962830.png,0,0.965214252,224,28,600,404,376,376,fluttershy
1965588.png,https://derpicdn.net/img/view/2019/2/18/1965588.png,0,0.992372334,265,0,1323,1021,1058,1021,fluttershy
1967075.png,https://derpicdn.net/img/view/2019/2/20/1967075.png,0,0.990666091,535,19,2279,1763,1744,1744,fluttershy
1967465.png,https://derpicdn.net/img/view/2019/2/20/1967465.png,0,0.997199953,253,0,947,670,694,670,fluttershy
1969967.png,https://derpicdn.net/img/view/2019/2/23/1969967.png,0,0.965875208,371,0,1057,660,686,660,fluttershy
1969967.png,https://derpicdn.net/img/view/2019/2/23/1969967.png,0,0.965875208,371,0,1057,660,686,660,fluttershy
1972479.png,https://derpicdn.net/img/view/2019/2/26/1972479.png,0,0.917596936,409,0,2649,2185,2240,2185,fluttershy
1973165.png,https://derpicdn.net/img/view/2019/2/27/1973165.png,0,0.967895627,293,300,469,476,176,176,fluttershy
1973339.png,https://derpicdn.net/img/view/2019/2/28/1973339.png,1,0.987513304,2374,266,3300,1198,926,932,fluttershy
1973339.png,https://derpicdn.net/img/view/2019/2/28/1973339.png,1,0.987513304,2374,266,3300,1198,926,932,fluttershy
1976713.png,https://derpicdn.net/img/view/2019/3/3/1976713.png,0,0.936843455,588,2,1564,978,976,976,fluttershy
1978839.png,https://derpicdn.net/img/view/2019/3/6/1978839.png,0,0.956214309,0,0,814,802,814,802,fluttershy
1979035.png,https://derpicdn.net/img/view/2019/3/6/1979035.png,0,0.975049973,1720,103,3118,1501,1398,1398,fluttershy
1979163.png,https://derpicdn.net/img/view/2019/3/7/1979163.png,0,0.984365225,49,0,529,471,480,471,fluttershy
198221.png,https://derpicdn.net/img/view/2012/12/31/198221.png,0,0.960282087,0,136,712,858,712,722,fluttershy
1982743.png,https://derpicdn.net/img/view/2019/3/11/1982743.png,0,0.996827424,251,9,615,373,364,364,fluttershy
1982796.png,https://derpicdn.net/img/view/2019/3/11/1982796.png,0,0.996553838,49,0,983,857,934,857,fluttershy
1983248.png,https://derpicdn.net/img/view/2019/3/11/1983248.png,0,0.988187909,1207,787,2625,2205,1418,1418,fluttershy
1983325.png,https://derpicdn.net/img/view/2019/3/11/1983325.png,0,0.951836824,407,73,2423,2078,2016,2005,fluttershy
1983325.png,https://derpicdn.net/img/view/2019/3/11/1983325.png,0,0.951836824,407,73,2423,2078,2016,2005,fluttershy
1989049.png,https://derpicdn.net/img/view/2019/3/18/1989049.png,0,0.999175251,3535,140,5687,2292,2152,2152,fluttershy
1989502.png,https://derpicdn.net/img/view/2019/3/18/1989502.png,0,0.996295452,134,0,736,583,602,583,fluttershy
1990187.png,https://derpicdn.net/img/view/2019/3/19/1990187.png,0,0.983302057,0,0,753,782,753,782,fluttershy
1991172.png,https://derpicdn.net/img/view/2019/3/21/1991172.png,0,0.950134039,430,0,1380,907,950,907,fluttershy
1998021.png,https://derpicdn.net/img/view/2019/3/30/1998021.png,0,0.990203977,481,180,1139,838,658,658,fluttershy
2000800.png,https://derpicdn.net/img/view/2019/4/2/2000800.png,0,0.992401123,0,0,1780,1698,1780,1698,fluttershy
2001130.png,https://derpicdn.net/img/view/2019/4/2/2001130.png,0,0.994925559,173,0,1500,1302,1327,1302,fluttershy
2002153.png,https://derpicdn.net/img/view/2019/4/3/2002153.png,0,0.921915352,860,135,1818,1093,958,958,fluttershy
2002787.png,https://derpicdn.net/img/view/2019/4/4/2002787.png,0,0.960731447,680,0,1654,787,974,787,fluttershy
2003771.png,https://derpicdn.net/img/view/2019/4/5/2003771.png,0,0.995291114,0,11,608,715,608,704,fluttershy
2003799.png,https://derpicdn.net/img/view/2019/4/5/2003799.png,0,0.984014213,429,11,901,483,472,472,fluttershy
2004242.png,https://derpicdn.net/img/view/2019/4/6/2004242.png,0,0.980591834,269,0,2463,2078,2194,2078,fluttershy
2004780.png,https://derpicdn.net/img/view/2019/4/6/2004780.png,0,0.975583792,135,0,1983,1826,1848,1826,fluttershy
2005807.png,https://derpicdn.net/img/view/2019/4/7/2005807.png,0,0.986266077,278,64,1190,976,912,912,fluttershy
2006961.png,https://derpicdn.net/img/view/2019/4/8/2006961.png,0,0.976218939,438,0,970,509,532,509,fluttershy
2006961.png,https://derpicdn.net/img/view/2019/4/8/2006961.png,0,0.976218939,438,0,970,509,532,509,fluttershy
2010083.png,https://derpicdn.net/img/view/2019/4/12/2010083.png,0,0.99897182,395,44,779,428,384,384,fluttershy
2011431.png,https://derpicdn.net/img/view/2019/4/14/2011431.png,0,0.998134434,345,0,3917,3308,3572,3308,fluttershy
2013795.png,https://derpicdn.net/img/view/2019/4/16/2013795.png,0,0.928500056,107,0,1032,886,925,886,fluttershy
2015338.png,https://derpicdn.net/img/view/2019/4/17/2015338.png,0,0.999136448,1489,1122,2365,1998,876,876,fluttershy
2015449.png,https://derpicdn.net/img/view/2019/4/17/2015449.png,0,0.954391599,360,0,1298,790,938,790,fluttershy
2018762.png,https://derpicdn.net/img/view/2019/4/21/2018762.png,0,0.982375383,156,278,808,930,652,652,fluttershy
2021360.png,https://derpicdn.net/img/view/2019/4/23/2021360.png,0,0.98638612,763,0,1483,720,720,720,fluttershy
2022191.png,https://derpicdn.net/img/view/2019/4/24/2022191.png,0,0.995250285,32,75,1410,1453,1378,1378,fluttershy
2022969.png,https://derpicdn.net/img/view/2019/4/25/2022969.png,0,0.984309137,0,0,406,405,406,405,fluttershy
2023015.png,https://derpicdn.net/img/view/2019/4/26/2023015.png,0,0.996760905,937,52,2687,1802,1750,1750,fluttershy
2025124.png,https://derpicdn.net/img/view/2019/4/28/2025124.png,0,0.990040958,78,0,568,451,490,451,fluttershy
2025653.png,https://derpicdn.net/img/view/2019/4/28/2025653.png,0,0.93079555,1164,0,1974,774,810,774,fluttershy
2027756.png,https://derpicdn.net/img/view/2019/5/1/2027756.png,0,0.978419065,4092,0,8028,3692,3936,3692,fluttershy
2027993.png,https://derpicdn.net/img/view/2019/5/1/2027993.png,0,0.990267694,2146,0,3370,1194,1224,1194,fluttershy
2028190.png,https://derpicdn.net/img/view/2019/5/1/2028190.png,0,0.958920956,0,0,1080,1345,1080,1345,fluttershy
2028636.png,https://derpicdn.net/img/view/2019/5/1/2028636.png,0,0.949204266,60,0,654,523,594,523,fluttershy
2034328.png,https://derpicdn.net/img/view/2019/5/9/2034328.png,0,0.98285532,78,8,650,580,572,572,fluttershy
2035143.png,https://derpicdn.net/img/view/2019/5/10/2035143.png,0,0.999866366,515,4,1585,1074,1070,1070,fluttershy
2040622.png,https://derpicdn.net/img/view/2019/5/16/2040622.png,0,0.968899548,1267,41,2015,789,748,748,fluttershy
2040622.png,https://derpicdn.net/img/view/2019/5/16/2040622.png,0,0.968899548,1267,41,2015,789,748,748,fluttershy
2040686.png,https://derpicdn.net/img/view/2019/5/16/2040686.png,0,0.947020113,35,0,503,459,468,459,fluttershy
2041598.png,https://derpicdn.net/img/view/2019/5/17/2041598.png,0,0.996293724,357,109,1711,1463,1354,1354,fluttershy
2046356.png,https://derpicdn.net/img/view/2019/5/22/2046356.png,0,0.996685863,318,0,1110,700,792,700,fluttershy
2048750.png,https://derpicdn.net/img/view/2019/5/25/2048750.png,0,0.907432139,0,55,709,769,709,714,fluttershy
2049833.png,https://derpicdn.net/img/view/2019/5/26/2049833.png,0,0.962231398,679,0,2135,1373,1456,1373,fluttershy
2050058.png,https://derpicdn.net/img/view/2019/5/26/2050058.png,0,0.983858228,19,0,1127,949,1108,949,fluttershy
2050060.png,https://derpicdn.net/img/view/2019/5/26/2050060.png,0,0.967714429,47,0,1767,1080,1720,1080,fluttershy
2054136.png,https://derpicdn.net/img/view/2019/5/31/2054136.png,0,0.958301723,65,6,3512,3526,3447,3520,fluttershy
2054219.png,https://derpicdn.net/img/view/2019/5/31/2054219.png,0,0.989025116,1386,0,4785,3358,3399,3358,fluttershy
2055623.png,https://derpicdn.net/img/view/2019/6/1/2055623.png,0,0.994575381,1033,89,1783,839,750,750,fluttershy
2055623.png,https://derpicdn.net/img/view/2019/6/1/2055623.png,1,0.968955517,964,621,1466,1123,502,502,fluttershy
2057053.png,https://derpicdn.net/img/view/2019/6/3/2057053.png,0,0.995479882,90,22,532,464,442,442,fluttershy
2059426.png,https://derpicdn.net/img/view/2019/6/6/2059426.png,0,0.991182446,458,12,916,470,458,458,fluttershy
2063166.png,https://derpicdn.net/img/view/2019/6/11/2063166.png,0,0.99167484,463,26,1063,626,600,600,fluttershy
2063289.png,https://derpicdn.net/img/view/2019/6/11/2063289.png,0,0.998921871,2790,0,5668,2748,2878,2748,fluttershy
2067239.png,https://derpicdn.net/img/view/2019/6/16/2067239.png,0,0.948058903,378,53,688,363,310,310,fluttershy
2068338.png,https://derpicdn.net/img/view/2019/6/17/2068338.png,0,0.990756512,370,155,1128,913,758,758,fluttershy
2075223.png,https://derpicdn.net/img/view/2019/6/25/2075223.png,0,0.993041337,544,72,1622,1150,1078,1078,fluttershy
2075476.png,https://derpicdn.net/img/view/2019/6/26/2075476.png,0,0.991770267,336,61,1042,767,706,706,fluttershy
2076390.png,https://derpicdn.net/img/view/2019/6/27/2076390.png,0,0.980279207,269,0,951,593,682,593,fluttershy
2078655.png,https://derpicdn.net/img/view/2019/6/29/2078655.png,0,0.999388576,43,0,533,441,490,441,fluttershy
2079394.png,https://derpicdn.net/img/view/2019/6/30/2079394.png,0,0.998842418,0,0,1123,1021,1123,1021,fluttershy
2079394.png,https://derpicdn.net/img/view/2019/6/30/2079394.png,1,0.995932281,1411,418,2541,1548,1130,1130,fluttershy
2080910.png,https://derpicdn.net/img/view/2019/7/2/2080910.png,0,0.998035967,411,37,1507,1133,1096,1096,fluttershy
2085737.png,https://derpicdn.net/img/view/2019/7/8/2085737.png,0,0.976924658,702,197,1054,549,352,352,fluttershy
2090015.png,https://derpicdn.net/img/view/2019/7/12/2090015.png,0,0.981427908,108,0,970,807,862,807,fluttershy
2090709.png,https://derpicdn.net/img/view/2019/7/13/2090709.png,0,0.978247046,263,0,1913,1534,1650,1534,fluttershy
2094999.png,https://derpicdn.net/img/view/2019/7/18/2094999.png,0,0.968030453,162,0,652,417,490,417,fluttershy
2095170.png,https://derpicdn.net/img/view/2019/7/18/2095170.png,0,0.980545759,186,0,1494,1249,1308,1249,fluttershy
2096180.png,https://derpicdn.net/img/view/2019/7/19/2096180.png,0,0.998608232,164,0,832,612,668,612,fluttershy
2096180.png,https://derpicdn.net/img/view/2019/7/19/2096180.png,0,0.998608232,164,0,832,612,668,612,fluttershy
2096367.png,https://derpicdn.net/img/view/2019/7/20/2096367.png,0,0.927746952,12,109,738,835,726,726,fluttershy
2097091.png,https://derpicdn.net/img/view/2019/7/20/2097091.png,0,0.923152685,0,251,2314,2679,2314,2428,fluttershy
2097814.png,https://derpicdn.net/img/view/2019/7/21/2097814.png,0,0.978597105,738,758,6488,6187,5750,5429,fluttershy
2100992.png,https://derpicdn.net/img/view/2019/7/25/2100992.png,0,0.976181328,129,0,1134,1043,1005,1043,fluttershy
2109767.png,https://derpicdn.net/img/view/2019/8/5/2109767.png,0,0.996759295,290,0,1052,700,762,700,fluttershy
2112656.png,https://derpicdn.net/img/view/2019/8/9/2112656.png,0,0.991042554,162,11,856,705,694,694,fluttershy
2115914.png,https://derpicdn.net/img/view/2019/8/12/2115914.png,0,0.987455964,105,0,1043,820,938,820,fluttershy
2118136.png,https://derpicdn.net/img/view/2019/8/14/2118136.png,0,0.980514228,0,0,1290,1223,1290,1223,fluttershy
2126974.png,https://derpicdn.net/img/view/2019/8/25/2126974.png,0,0.991161764,4983,42,9331,4390,4348,4348,fluttershy
2127030.png,https://derpicdn.net/img/view/2019/8/25/2127030.png,1,0.994461715,1333,364,1951,982,618,618,fluttershy
2127030.png,https://derpicdn.net/img/view/2019/8/25/2127030.png,2,0.992318749,51,177,687,813,636,636,fluttershy
2130879.png,https://derpicdn.net/img/view/2019/8/29/2130879.png,0,0.990119636,197,30,1721,1554,1524,1524,fluttershy
2133615.png,https://derpicdn.net/img/view/2019/9/1/2133615.png,0,0.96546793,0,318,768,1210,768,892,fluttershy
213497.jpg,https://derpicdn.net/img/view/2013/1/15/213497.jpg,0,0.996931612,221,0,555,320,334,320,fluttershy
2139134.png,https://derpicdn.net/img/view/2019/9/8/2139134.png,1,0.987515211,9,1132,813,1936,804,804,fluttershy
2139134.png,https://derpicdn.net/img/view/2019/9/8/2139134.png,1,0.987515211,9,1132,813,1936,804,804,fluttershy
2141086.png,https://derpicdn.net/img/view/2019/9/10/2141086.png,0,0.945517123,651,1746,2167,3262,1516,1516,fluttershy
2142600.png,https://derpicdn.net/img/view/2019/9/12/2142600.png,0,0.961467266,128,108,782,762,654,654,fluttershy
2143265.png,https://derpicdn.net/img/view/2019/9/13/2143265.png,0,0.990934491,131,6,495,370,364,364,fluttershy
2145031.png,https://derpicdn.net/img/view/2019/9/15/2145031.png,0,0.991654396,0,0,952,1064,952,1064,fluttershy
2147886.png,https://derpicdn.net/img/view/2019/9/19/2147886.png,0,0.99580431,76,958,1370,2252,1294,1294,fluttershy
2147886.png,https://derpicdn.net/img/view/2019/9/19/2147886.png,1,0.978212535,1488,100,3400,2126,1912,2026,fluttershy
2149105.png,https://derpicdn.net/img/view/2019/9/21/2149105.png,0,0.97788918,326,132,568,374,242,242,fluttershy
2149105.png,https://derpicdn.net/img/view/2019/9/21/2149105.png,0,0.97788918,326,132,568,374,242,242,fluttershy
2153253.png,https://derpicdn.net/img/view/2019/9/26/2153253.png,0,0.998789012,709,0,1913,1158,1204,1158,fluttershy
2153562.png,https://derpicdn.net/img/view/2019/9/26/2153562.png,0,0.984493196,1197,0,2901,1555,1704,1555,fluttershy
2154616.png,https://derpicdn.net/img/view/2019/9/28/2154616.png,0,0.995165467,2472,562,4620,2710,2148,2148,fluttershy
2155520.png,https://derpicdn.net/img/view/2019/9/29/2155520.png,0,0.991221249,671,0,2085,1365,1414,1365,fluttershy
2157081.png,https://derpicdn.net/img/view/2019/9/30/2157081.png,0,0.991298258,838,32,1804,998,966,966,fluttershy
2158941.png,https://derpicdn.net/img/view/2019/10/3/2158941.png,0,0.996959925,554,0,1353,742,799,742,fluttershy
2161753.png,https://derpicdn.net/img/view/2019/10/6/2161753.png,1,0.9635607,205,40,593,428,388,388,fluttershy
2165552.png,https://derpicdn.net/img/view/2019/10/11/2165552.png,0,0.999650121,920,0,2430,1329,1510,1329,fluttershy
2165552.png,https://derpicdn.net/img/view/2019/10/11/2165552.png,0,0.999650121,920,0,2430,1329,1510,1329,fluttershy
2170180.png,https://derpicdn.net/img/view/2019/10/16/2170180.png,0,0.990455151,235,135,873,773,638,638,fluttershy
2173606.png,https://derpicdn.net/img/view/2019/10/19/2173606.png,0,0.957827151,269,61,717,509,448,448,fluttershy
217909.png,https://derpicdn.net/img/view/2013/1/19/217909.png,0,0.951045752,256,6,520,270,264,264,fluttershy
2183176.png,https://derpicdn.net/img/view/2019/10/30/2183176.png,0,0.993376195,690,68,1562,940,872,872,fluttershy
2184855.png,https://derpicdn.net/img/view/2019/11/1/2184855.png,0,0.997893929,236,74,764,602,528,528,fluttershy
2184866.png,https://derpicdn.net/img/view/2019/11/1/2184866.png,0,0.95610714,1595,0,4053,2347,2458,2347,fluttershy
2188049.png,https://derpicdn.net/img/view/2019/11/5/2188049.png,0,0.989903092,572,136,1526,1090,954,954,fluttershy
2188928.png,https://derpicdn.net/img/view/2019/11/6/2188928.png,0,0.999637842,556,0,1354,764,798,764,fluttershy
2192174.png,https://derpicdn.net/img/view/2019/11/10/2192174.png,0,0.99842,261,0,549,277,288,277,fluttershy
2192556.png,https://derpicdn.net/img/view/2019/11/10/2192556.png,0,0.94181788,0,0,1436,1524,1436,1524,fluttershy
2195437.png,https://derpicdn.net/img/view/2019/11/14/2195437.png,0,0.988052905,135,0,690,565,555,565,fluttershy
2199339.png,https://derpicdn.net/img/view/2019/11/18/2199339.png,0,0.996670723,177,0,1057,819,880,819,fluttershy
2199721.png,https://derpicdn.net/img/view/2019/11/18/2199721.png,0,0.960793376,76,18,534,476,458,458,fluttershy
2203230.png,https://derpicdn.net/img/view/2019/11/23/2203230.png,0,0.985822737,29,0,481,442,452,442,fluttershy
2204148.png,https://derpicdn.net/img/view/2019/11/24/2204148.png,0,0.969912231,571,683,1569,1681,998,998,fluttershy
2204763.png,https://derpicdn.net/img/view/2019/11/24/2204763.png,0,0.947604358,188,0,2358,2068,2170,2068,fluttershy
2209482.png,https://derpicdn.net/img/view/2019/11/30/2209482.png,0,0.961651921,433,23,983,573,550,550,fluttershy
2210384.jpg,https://derpicdn.net/img/view/2019/12/1/2210384.jpg,0,0.976611316,1145,35,2125,1015,980,980,fluttershy
2211205.png,https://derpicdn.net/img/view/2019/12/2/2211205.png,0,0.994642377,720,568,1718,1566,998,998,fluttershy
2216862.png,https://derpicdn.net/img/view/2019/12/9/2216862.png,0,0.981579661,92,0,528,422,436,422,fluttershy
2217829.png,https://derpicdn.net/img/view/2019/12/11/2217829.png,0,0.984393835,961,197,1839,1075,878,878,fluttershy
2218191.png,https://derpicdn.net/img/view/2019/12/11/2218191.png,0,0.993232191,215,65,453,303,238,238,fluttershy
2218481.png,https://derpicdn.net/img/view/2019/12/12/2218481.png,0,0.976950467,798,197,1194,593,396,396,fluttershy
2218481.png,https://derpicdn.net/img/view/2019/12/12/2218481.png,1,0.940416217,254,450,588,784,334,334,fluttershy
2221988.jpg,https://derpicdn.net/img/view/2019/12/16/2221988.jpg,0,0.998077869,1295,345,2097,1147,802,802,fluttershy
2222163.png,https://derpicdn.net/img/view/2019/12/16/2222163.png,0,0.977729142,259,130,871,742,612,612,fluttershy
2224052.png,https://derpicdn.net/img/view/2019/12/18/2224052.png,0,0.991744161,507,0,2109,1562,1602,1562,fluttershy
2224527.png,https://derpicdn.net/img/view/2019/12/19/2224527.png,0,0.988409519,301,691,903,1293,602,602,fluttershy
2227124.jpg,https://derpicdn.net/img/view/2019/12/22/2227124.jpg,0,0.943898559,440,532,2296,2388,1856,1856,fluttershy
2228566.png,https://derpicdn.net/img/view/2019/12/24/2228566.png,0,0.965079129,386,69,966,649,580,580,fluttershy
2229303.png,https://derpicdn.net/img/view/2019/12/25/2229303.png,0,0.938657343,210,0,1118,886,908,886,fluttershy
2229776.png,https://derpicdn.net/img/view/2019/12/25/2229776.png,1,0.949357152,189,611,853,1275,664,664,fluttershy
2230002.png,https://derpicdn.net/img/view/2019/12/25/2230002.png,0,0.967789829,225,27,1057,859,832,832,fluttershy
2230209.jpg,https://derpicdn.net/img/view/2019/12/26/2230209.jpg,0,0.922023535,0,12,534,564,534,552,fluttershy
2232329.png,https://derpicdn.net/img/view/2019/12/28/2232329.png,0,0.993011951,0,0,558,489,558,489,fluttershy
2233071.jpg,https://derpicdn.net/img/view/2019/12/29/2233071.jpg,0,0.993075192,127,0,999,775,872,775,fluttershy
2233084.jpg,https://derpicdn.net/img/view/2019/12/29/2233084.jpg,0,0.951187968,144,0,1086,903,942,903,fluttershy
2233148.png,https://derpicdn.net/img/view/2019/12/29/2233148.png,0,0.934902549,1207,277,1555,625,348,348,fluttershy
2233307.png,https://derpicdn.net/img/view/2019/12/29/2233307.png,0,0.995080411,161,0,999,725,838,725,fluttershy
2235502.png,https://derpicdn.net/img/view/2020/1/1/2235502.png,0,0.998133302,1181,31,2817,1667,1636,1636,fluttershy
2236577.png,https://derpicdn.net/img/view/2020/1/2/2236577.png,0,0.992200196,387,0,1469,1059,1082,1059,fluttershy
2238177.png,https://derpicdn.net/img/view/2020/1/4/2238177.png,0,0.985712349,800,0,1432,629,632,629,fluttershy
2239378.png,https://derpicdn.net/img/view/2020/1/5/2239378.png,0,0.988959193,770,175,4842,4000,4072,3825,fluttershy
2239407.png,https://derpicdn.net/img/view/2020/1/5/2239407.png,0,0.969089866,188,0,1408,1182,1220,1182,fluttershy
2242478.png,https://derpicdn.net/img/view/2020/1/9/2242478.png,0,0.991616428,653,561,1593,1501,940,940,fluttershy
2242493.png,https://derpicdn.net/img/view/2020/1/9/2242493.png,0,0.930277467,0,9,324,365,324,356,fluttershy
2242619.jpg,https://derpicdn.net/img/view/2020/1/9/2242619.jpg,0,0.998250246,1813,291,2653,1131,840,840,fluttershy
2244081.jpg,https://derpicdn.net/img/view/2020/1/11/2244081.jpg,0,0.997024655,82,22,478,418,396,396,fluttershy
2244097.jpg,https://derpicdn.net/img/view/2020/1/11/2244097.jpg,0,0.999269843,890,14,1832,956,942,942,fluttershy
2244868.jpg,https://derpicdn.net/img/view/2020/1/11/2244868.jpg,0,0.950642109,286,17,936,667,650,650,fluttershy
2245417.png,https://derpicdn.net/img/view/2020/1/12/2245417.png,0,0.988620877,55,0,549,440,494,440,fluttershy
2247127.jpg,https://derpicdn.net/img/view/2020/1/14/2247127.jpg,0,0.951851964,383,0,1485,1006,1102,1006,fluttershy
2247358.jpg,https://derpicdn.net/img/view/2020/1/14/2247358.jpg,0,0.994900644,391,45,1077,731,686,686,fluttershy
2247359.jpg,https://derpicdn.net/img/view/2020/1/14/2247359.jpg,0,0.997439623,372,48,1026,702,654,654,fluttershy
2247592.png,https://derpicdn.net/img/view/2020/1/14/2247592.png,0,0.987871945,186,0,1000,690,814,690,fluttershy
2251464.jpg,https://derpicdn.net/img/view/2020/1/19/2251464.jpg,0,0.901008606,0,0,1218,1059,1218,1059,fluttershy
2253597.png,https://derpicdn.net/img/view/2020/1/21/2253597.png,0,0.941827953,1047,0,2007,937,960,937,fluttershy
2253839.png,https://derpicdn.net/img/view/2020/1/22/2253839.png,0,0.994437099,76,12,1070,1006,994,994,fluttershy
2254776.jpg,https://derpicdn.net/img/view/2020/1/23/2254776.jpg,0,0.977461457,428,0,1206,725,778,725,fluttershy
2254790.jpg,https://derpicdn.net/img/view/2020/1/23/2254790.jpg,0,0.947075903,447,32,1318,920,871,888,fluttershy
2254790.jpg,https://derpicdn.net/img/view/2020/1/23/2254790.jpg,0,0.947075903,447,32,1318,920,871,888,fluttershy
2255947.png,https://derpicdn.net/img/view/2020/1/24/2255947.png,0,0.987592697,257,0,863,565,606,565,fluttershy
2256324.png,https://derpicdn.net/img/view/2020/1/25/2256324.png,0,0.943394125,193,0,563,312,370,312,fluttershy
2260585.png,https://derpicdn.net/img/view/2020/1/29/2260585.png,0,0.99228996,47,0,863,780,816,780,fluttershy
2260585.png,https://derpicdn.net/img/view/2020/1/29/2260585.png,0,0.99228996,47,0,863,780,816,780,fluttershy
2265782.jpg,https://derpicdn.net/img/view/2020/2/4/2265782.jpg,0,0.9902426,49,33,991,975,942,942,fluttershy
2267181.png,https://derpicdn.net/img/view/2020/2/6/2267181.png,0,0.910344779,296,0,1828,1495,1532,1495,fluttershy
2268355.png,https://derpicdn.net/img/view/2020/2/8/2268355.png,0,0.986349165,166,0,680,505,514,505,fluttershy
2268812.png,https://derpicdn.net/img/view/2020/2/8/2268812.png,0,0.965065122,0,0,431,468,431,468,fluttershy
2269057.png,https://derpicdn.net/img/view/2020/2/8/2269057.png,0,0.99340868,60,0,602,486,542,486,fluttershy
2269057.png,https://derpicdn.net/img/view/2020/2/8/2269057.png,0,0.99340868,60,0,602,486,542,486,fluttershy
2272427.png,https://derpicdn.net/img/view/2020/2/12/2272427.png,0,0.970710218,843,203,4387,3747,3544,3544,fluttershy
2272678.jpg,https://derpicdn.net/img/view/2020/2/13/2272678.jpg,0,0.992289603,945,1755,2023,2833,1078,1078,fluttershy
2276076.png,https://derpicdn.net/img/view/2020/2/16/2276076.png,0,0.996093571,416,0,1642,1143,1226,1143,fluttershy
2276204.jpg,https://derpicdn.net/img/view/2020/2/16/2276204.jpg,0,0.990235388,330,113,942,725,612,612,fluttershy
2276774.jpg,https://derpicdn.net/img/view/2020/2/17/2276774.jpg,0,0.999935865,640,38,1836,1234,1196,1196,fluttershy
2277993.jpg,https://derpicdn.net/img/view/2020/2/18/2277993.jpg,0,0.915416121,211,0,843,600,632,600,fluttershy
2278493.png,https://derpicdn.net/img/view/2020/2/19/2278493.png,0,0.989766002,0,44,1166,1292,1166,1248,fluttershy
2278493.png,https://derpicdn.net/img/view/2020/2/19/2278493.png,1,0.902266562,151,0,1416,1459,1265,1459,fluttershy
2281670.jpg,https://derpicdn.net/img/view/2020/2/23/2281670.jpg,0,0.955758035,0,0,1092,1239,1092,1239,fluttershy
2282502.jpg,https://derpicdn.net/img/view/2020/2/24/2282502.jpg,0,0.967622578,0,0,1088,1293,1088,1293,fluttershy
2282510.png,https://derpicdn.net/img/view/2020/2/24/2282510.png,0,0.988670468,639,0,1385,646,746,646,fluttershy
2284458.jpg,https://derpicdn.net/img/view/2020/2/27/2284458.jpg,0,0.992551625,336,0,634,285,298,285,fluttershy
2284484.png,https://derpicdn.net/img/view/2020/2/27/2284484.png,0,0.993377864,723,0,1885,1154,1162,1154,fluttershy
2285510.jpg,https://derpicdn.net/img/view/2020/2/28/2285510.jpg,0,0.987334669,253,0,1273,839,1020,839,fluttershy
2286567.png,https://derpicdn.net/img/view/2020/2/29/2286567.png,0,0.982861698,75,0,1577,1452,1502,1452,fluttershy
2291679.png,https://derpicdn.net/img/view/2020/3/7/2291679.png,0,0.993744195,500,46,894,440,394,394,fluttershy
2292831.jpg,https://derpicdn.net/img/view/2020/3/8/2292831.jpg,0,0.988706529,309,0,1401,1067,1092,1067,fluttershy
2293659.jpg,https://derpicdn.net/img/view/2020/3/9/2293659.jpg,0,0.986758113,292,0,2008,1665,1716,1665,fluttershy
2294079.jpg,https://derpicdn.net/img/view/2020/3/10/2294079.jpg,0,0.998846948,243,47,695,499,452,452,fluttershy
2297384.jpg,https://derpicdn.net/img/view/2020/3/14/2297384.jpg,0,0.999304295,309,0,849,533,540,533,fluttershy
2297472.jpg,https://derpicdn.net/img/view/2020/3/14/2297472.jpg,0,0.918227136,609,0,2395,1484,1786,1484,fluttershy
2298474.png,https://derpicdn.net/img/view/2020/3/15/2298474.png,0,0.985039532,92,0,506,396,414,396,fluttershy
2301055.jpg,https://derpicdn.net/img/view/2020/3/19/2301055.jpg,0,0.994511187,595,0,895,293,300,293,fluttershy
2301915.png,https://derpicdn.net/img/view/2020/3/20/2301915.png,0,0.995785117,331,0,707,338,376,338,fluttershy
2302600.jpg,https://derpicdn.net/img/view/2020/3/21/2302600.jpg,0,0.93493253,804,0,2270,1315,1466,1315,fluttershy
2302772.jpg,https://derpicdn.net/img/view/2020/3/21/2302772.jpg,0,0.998054326,2268,88,2956,776,688,688,fluttershy
2302772.jpg,https://derpicdn.net/img/view/2020/3/21/2302772.jpg,1,0.997549832,1684,6,2354,676,670,670,fluttershy
2302772.jpg,https://derpicdn.net/img/view/2020/3/21/2302772.jpg,2,0.93828845,608,149,1668,1209,1060,1060,fluttershy
2305259.jpg,https://derpicdn.net/img/view/2020/3/24/2305259.jpg,0,0.986428797,440,7,854,421,414,414,fluttershy
2305259.jpg,https://derpicdn.net/img/view/2020/3/24/2305259.jpg,0,0.986428797,440,7,854,421,414,414,fluttershy
2305819.png,https://derpicdn.net/img/view/2020/3/25/2305819.png,0,0.965172172,0,147,1698,1973,1698,1826,fluttershy
2306675.jpg,https://derpicdn.net/img/view/2020/3/26/2306675.jpg,0,0.994893789,553,0,1437,870,884,870,fluttershy
2308028.jpg,https://derpicdn.net/img/view/2020/3/28/2308028.jpg,0,0.927897871,1621,744,2863,1986,1242,1242,fluttershy
2308804.jpg,https://derpicdn.net/img/view/2020/3/29/2308804.jpg,0,0.97858417,438,0,1930,1364,1492,1364,fluttershy
2309273.png,https://derpicdn.net/img/view/2020/3/29/2309273.png,0,0.959214449,4178,92,5166,1080,988,988,fluttershy
2309644.png,https://derpicdn.net/img/view/2020/3/30/2309644.png,0,0.984422266,154,0,688,485,534,485,fluttershy
2312274.png,https://derpicdn.net/img/view/2020/4/2/2312274.png,0,0.935683906,144,172,424,452,280,280,fluttershy
2312560.jpg,https://derpicdn.net/img/view/2020/4/2/2312560.jpg,0,0.955444634,547,585,729,767,182,182,fluttershy
2312833.png,https://derpicdn.net/img/view/2020/4/3/2312833.png,0,0.944889426,269,0,3685,2160,3416,2160,fluttershy
2313391.png,https://derpicdn.net/img/view/2020/4/3/2313391.png,0,0.99538064,192,0,560,330,368,330,fluttershy
2313830.jpg,https://derpicdn.net/img/view/2020/4/4/2313830.jpg,0,0.984828949,172,0,1408,1065,1236,1065,fluttershy
2319360.jpg,https://derpicdn.net/img/view/2020/4/11/2319360.jpg,0,0.971387625,893,110,2033,1250,1140,1140,fluttershy
2319555.jpg,https://derpicdn.net/img/view/2020/4/11/2319555.jpg,0,0.940233231,18,0,932,875,914,875,fluttershy
2319646.png,https://derpicdn.net/img/view/2020/4/11/2319646.png,0,0.967841685,11,0,607,570,596,570,fluttershy
2320657.png,https://derpicdn.net/img/view/2020/4/12/2320657.png,0,0.972031951,107,128,2315,2336,2208,2208,fluttershy
2320724.png,https://derpicdn.net/img/view/2020/4/12/2320724.png,0,0.967094719,1075,1908,2979,3812,1904,1904,fluttershy
2322696.png,https://derpicdn.net/img/view/2020/4/14/2322696.png,0,0.968752563,337,0,1233,882,896,882,fluttershy
2323679.jpg,https://derpicdn.net/img/view/2020/4/16/2323679.jpg,0,0.996253669,129,113,521,505,392,392,fluttershy
2324862.png,https://derpicdn.net/img/view/2020/4/17/2324862.png,0,0.923613846,81,12,461,392,380,380,fluttershy
2325429.jpg,https://derpicdn.net/img/view/2020/4/18/2325429.jpg,0,0.995259941,65,0,587,517,522,517,fluttershy
2327560.jpg,https://derpicdn.net/img/view/2020/4/21/2327560.jpg,0,0.995524585,314,0,1186,869,872,869,fluttershy
2328725.jpg,https://derpicdn.net/img/view/2020/4/22/2328725.jpg,0,0.996565223,135,38,943,846,808,808,fluttershy
2329695.jpg,https://derpicdn.net/img/view/2020/4/23/2329695.jpg,0,0.999144137,315,264,743,692,428,428,fluttershy
2330071.jpg,https://derpicdn.net/img/view/2020/4/24/2330071.jpg,0,0.998492241,143,103,1015,975,872,872,fluttershy
2333257.jpg,https://derpicdn.net/img/view/2020/4/27/2333257.jpg,0,0.997717381,48,0,814,699,766,699,fluttershy
2333648.png,https://derpicdn.net/img/view/2020/4/28/2333648.png,0,0.994550109,190,6,558,374,368,368,fluttershy
2334449.png,https://derpicdn.net/img/view/2020/4/29/2334449.png,0,0.976388693,564,0,2666,1992,2102,1992,fluttershy
2334466.png,https://derpicdn.net/img/view/2020/4/29/2334466.png,0,0.985094666,494,42,1024,572,530,530,fluttershy
2334519.jpg,https://derpicdn.net/img/view/2020/4/29/2334519.jpg,0,0.996825874,675,28,1515,868,840,840,fluttershy
2335277.png,https://derpicdn.net/img/view/2020/4/30/2335277.png,0,0.997332156,2154,0,3818,1346,1664,1346,fluttershy
2335277.png,https://derpicdn.net/img/view/2020/4/30/2335277.png,0,0.997332156,2154,0,3818,1346,1664,1346,fluttershy
2335301.jpg,https://derpicdn.net/img/view/2020/4/30/2335301.jpg,0,0.991799295,229,19,565,355,336,336,fluttershy
2335301.jpg,https://derpicdn.net/img/view/2020/4/30/2335301.jpg,1,0.989913583,471,43,747,319,276,276,fluttershy
2335672.jpg,https://derpicdn.net/img/view/2020/4/30/2335672.jpg,0,0.997510016,437,0,1103,575,666,575,fluttershy
2338359.png,https://derpicdn.net/img/view/2020/5/3/2338359.png,0,0.960437536,1826,380,2584,1138,758,758,fluttershy
2338378.jpg,https://derpicdn.net/img/view/2020/5/3/2338378.jpg,0,0.989025056,511,156,849,494,338,338,fluttershy
2338883.png,https://derpicdn.net/img/view/2020/5/4/2338883.png,0,0.96322453,0,0,390,377,390,377,fluttershy
2341048.png,https://derpicdn.net/img/view/2020/5/6/2341048.png,0,0.984578431,747,16,1393,662,646,646,fluttershy
2341145.jpg,https://derpicdn.net/img/view/2020/5/6/2341145.jpg,0,0.998181999,171,0,789,611,618,611,fluttershy
2343059.png,https://derpicdn.net/img/view/2020/5/8/2343059.png,0,0.990243971,285,0,517,223,232,223,fluttershy
2346450.jpg,https://derpicdn.net/img/view/2020/5/12/2346450.jpg,0,0.984550655,458,305,1232,1079,774,774,fluttershy
2346618.jpg,https://derpicdn.net/img/view/2020/5/12/2346618.jpg,0,0.91124022,180,69,842,731,662,662,fluttershy
2347014.jpg,https://derpicdn.net/img/view/2020/5/13/2347014.jpg,0,0.994514704,614,77,1752,1215,1138,1138,fluttershy
2349423.png,https://derpicdn.net/img/view/2020/5/15/2349423.png,0,0.93299669,465,0,1575,1009,1110,1009,fluttershy
2351041.png,https://derpicdn.net/img/view/2020/5/17/2351041.png,0,0.961062253,467,505,799,837,332,332,fluttershy
2352327.png,https://derpicdn.net/img/view/2020/5/19/2352327.png,0,0.999372125,1116,0,2126,983,1010,983,fluttershy
2352986.jpg,https://derpicdn.net/img/view/2020/5/19/2352986.jpg,1,0.992787421,1034,0,1532,473,498,473,fluttershy
2352986.jpg,https://derpicdn.net/img/view/2020/5/19/2352986.jpg,3,0.934764981,556,34,1030,508,474,474,fluttershy
2355530.png,https://derpicdn.net/img/view/2020/5/22/2355530.png,0,0.996076167,35,0,293,238,258,238,fluttershy
2355530.png,https://derpicdn.net/img/view/2020/5/22/2355530.png,0,0.996076167,35,0,293,238,258,238,fluttershy
23655.jpg,https://derpicdn.net/img/view/2012/6/28/23655.jpg,0,0.988774359,280,9,622,351,342,342,fluttershy
247307.png,https://derpicdn.net/img/view/2013/2/18/247307.png,0,0.997042716,343,0,873,524,530,524,fluttershy
252610.png,https://derpicdn.net/img/view/2013/2/23/252610.png,0,0.994502664,0,26,445,476,445,450,fluttershy
2527.png,https://derpicdn.net/img/view/2012/1/28/2527.png,0,0.999224782,389,0,865,441,476,441,fluttershy
262656.png,https://derpicdn.net/img/view/2013/3/4/262656.png,0,0.996655583,142,2,410,270,268,268,fluttershy
285542.jpg,https://derpicdn.net/img/view/2013/4/1/285542.jpg,0,0.974512696,102,0,460,377,358,377,fluttershy
3001.jpg,https://derpicdn.net/img/view/2012/2/12/3001.jpg,0,0.907261133,307,113,809,615,502,502,fluttershy
3014.jpg,https://derpicdn.net/img/view/2012/2/13/3014.jpg,0,0.993757606,25,0,495,455,470,455,fluttershy
319300.png,https://derpicdn.net/img/view/2013/5/7/319300.png,0,0.988331974,0,10,600,640,600,630,fluttershy
319836.png,https://derpicdn.net/img/view/2013/5/8/319836.png,0,0.98991698,42,0,424,337,382,337,fluttershy
320137.jpg,https://derpicdn.net/img/view/2013/5/8/320137.jpg,0,0.965489805,1015,0,1753,658,738,658,fluttershy
322515.png,https://derpicdn.net/img/view/2013/5/11/322515.png,0,0.97282964,153,0,723,479,570,479,fluttershy
324895.png,https://derpicdn.net/img/view/2013/5/14/324895.png,0,0.994964063,264,63,460,259,196,196,fluttershy
337274.png,https://derpicdn.net/img/view/2013/5/30/337274.png,0,0.974239647,90,221,296,427,206,206,fluttershy
340592.png,https://derpicdn.net/img/view/2013/6/4/340592.png,0,0.980567396,354,193,1231,1137,877,944,fluttershy
343213.png,https://derpicdn.net/img/view/2013/6/8/343213.png,0,0.973536015,108,22,798,712,690,690,fluttershy
346.png,https://derpicdn.net/img/view/2012/1/15/346.png,0,0.997094929,0,304,1478,1954,1478,1650,fluttershy
355777.jpg,https://derpicdn.net/img/view/2013/6/24/355777.jpg,0,0.99795258,382,0,714,317,332,317,fluttershy
355853.png,https://derpicdn.net/img/view/2013/6/24/355853.png,0,0.996976137,255,83,463,291,208,208,fluttershy
358547.png,https://derpicdn.net/img/view/2013/6/27/358547.png,0,0.989828467,627,230,1637,1240,1010,1010,fluttershy
364905.png,https://derpicdn.net/img/view/2013/7/5/364905.png,0,0.99791497,97,0,505,398,408,398,fluttershy
371918.png,https://derpicdn.net/img/view/2013/7/12/371918.png,0,0.972532451,270,0,476,199,206,199,fluttershy
377104.png,https://derpicdn.net/img/view/2013/7/18/377104.png,0,0.94828099,741,0,2387,1527,1646,1527,fluttershy
379702.png,https://derpicdn.net/img/view/2013/7/20/379702.png,0,0.9945274,465,1,975,511,510,510,fluttershy
379702.png,https://derpicdn.net/img/view/2013/7/20/379702.png,1,0.992770374,75,0,539,419,464,419,fluttershy
392597.png,https://derpicdn.net/img/view/2013/8/6/392597.png,0,0.919430017,72,0,504,421,432,421,fluttershy
393215.png,https://derpicdn.net/img/view/2013/8/6/393215.png,0,0.997126937,1296,550,1818,1072,522,522,fluttershy
398196.jpg,https://derpicdn.net/img/view/2013/8/12/398196.jpg,0,0.939725816,32,150,476,574,444,424,fluttershy
405465.png,https://derpicdn.net/img/view/2013/8/20/405465.png,0,0.997913539,418,76,770,428,352,352,fluttershy
405465.png,https://derpicdn.net/img/view/2013/8/20/405465.png,0,0.997913539,418,76,770,428,352,352,fluttershy
409887.png,https://derpicdn.net/img/view/2013/8/25/409887.png,0,0.955079973,349,28,971,650,622,622,fluttershy
409887.png,https://derpicdn.net/img/view/2013/8/25/409887.png,0,0.955079973,349,28,971,650,622,622,fluttershy
4103.jpg,https://derpicdn.net/img/view/2012/5/27/4103.jpg,0,0.997107387,34,18,420,404,386,386,fluttershy
412795.png,https://derpicdn.net/img/view/2013/8/28/412795.png,1,0.922345936,1287,575,2365,1653,1078,1078,fluttershy
413705.png,https://derpicdn.net/img/view/2013/8/29/413705.png,0,0.990251064,271,0,605,332,334,332,fluttershy
413976.png,https://derpicdn.net/img/view/2013/8/29/413976.png,0,0.95009023,272,0,1000,721,728,721,fluttershy
416224.png,https://derpicdn.net/img/view/2013/9/1/416224.png,0,0.981089532,104,14,400,296,296,282,fluttershy
428448.png,https://derpicdn.net/img/view/2013/9/15/428448.png,0,0.997511983,1697,48,2543,894,846,846,fluttershy
428448.png,https://derpicdn.net/img/view/2013/9/15/428448.png,1,0.996701956,115,492,1349,1726,1234,1234,fluttershy
43.jpg,https://derpicdn.net/img/view/2012/1/6/43.jpg,0,0.983008385,302,188,644,530,342,342,fluttershy
43.jpg,https://derpicdn.net/img/view/2012/1/6/43.jpg,0,0.983008385,302,188,644,530,342,342,fluttershy
43000.png,https://derpicdn.net/img/view/2012/7/13/43000.png,0,0.969494462,270,10,482,222,212,212,fluttershy
430496.png,https://derpicdn.net/img/view/2013/9/19/430496.png,0,0.970226705,75,1,545,471,470,470,fluttershy
435577.jpg,https://derpicdn.net/img/view/2013/9/26/435577.jpg,0,0.997333109,1367,1106,2233,1972,866,866,fluttershy
436031.png,https://derpicdn.net/img/view/2013/9/27/436031.png,0,0.994922042,141,11,673,543,532,532,fluttershy
439139.jpg,https://derpicdn.net/img/view/2013/10/1/439139.jpg,0,0.989173889,0,0,241,220,241,220,fluttershy
439865.png,https://derpicdn.net/img/view/2013/10/2/439865.png,0,0.972511232,0,0,375,366,375,366,fluttershy
441712.png,https://derpicdn.net/img/view/2013/10/4/441712.png,0,0.966889262,306,0,1000,691,694,691,fluttershy
443750.png,https://derpicdn.net/img/view/2013/10/7/443750.png,0,0.997811675,400,73,852,525,452,452,fluttershy
446943.png,https://derpicdn.net/img/view/2013/10/12/446943.png,0,0.999709547,2059,0,3311,1140,1252,1140,fluttershy
457914.png,https://derpicdn.net/img/view/2013/10/27/457914.png,0,0.999258578,503,0,1605,1039,1102,1039,fluttershy
457914.png,https://derpicdn.net/img/view/2013/10/27/457914.png,0,0.999258578,503,0,1605,1039,1102,1039,fluttershy
458262.png,https://derpicdn.net/img/view/2013/10/28/458262.png,0,0.998533905,218,0,766,543,548,543,fluttershy
469187.png,https://derpicdn.net/img/view/2013/11/10/469187.png,0,0.96186173,56,0,496,407,440,407,fluttershy
47250.png,https://derpicdn.net/img/view/2012/7/17/47250.png,0,0.989163756,7,3,289,285,282,282,fluttershy
476666.jpg,https://derpicdn.net/img/view/2013/11/20/476666.jpg,0,0.996296704,606,23,1684,1101,1078,1078,fluttershy
498006.jpg,https://derpicdn.net/img/view/2013/12/15/498006.jpg,0,0.939369202,133,0,767,564,634,564,fluttershy
504244.png,https://derpicdn.net/img/view/2013/12/23/504244.png,0,0.941057026,16,97,446,527,430,430,fluttershy
504614.png,https://derpicdn.net/img/view/2013/12/23/504614.png,0,0.97124052,171,109,541,479,370,370,fluttershy
508046.png,https://derpicdn.net/img/view/2013/12/28/508046.png,0,0.991893351,72,0,448,348,376,348,fluttershy
508286.png,https://derpicdn.net/img/view/2013/12/28/508286.png,0,0.978623867,0,36,427,476,427,440,fluttershy
508364.png,https://derpicdn.net/img/view/2013/12/28/508364.png,0,0.986849546,0,0,900,906,900,906,fluttershy
508595.png,https://derpicdn.net/img/view/2013/12/28/508595.png,0,0.992120981,280,0,880,592,600,592,fluttershy
508930.png,https://derpicdn.net/img/view/2013/12/29/508930.png,0,0.953877687,169,413,399,643,230,230,fluttershy
509312.png,https://derpicdn.net/img/view/2013/12/29/509312.png,0,0.994022548,100,181,2158,2239,2058,2058,fluttershy
509500.jpg,https://derpicdn.net/img/view/2013/12/29/509500.jpg,0,0.969611704,236,0,946,650,710,650,fluttershy
509500.jpg,https://derpicdn.net/img/view/2013/12/29/509500.jpg,0,0.969611704,236,0,946,650,710,650,fluttershy
510295.png,https://derpicdn.net/img/view/2013/12/30/510295.png,0,0.992805481,86,7,1370,1291,1284,1284,fluttershy
510663.png,https://derpicdn.net/img/view/2013/12/31/510663.png,0,0.994460404,377,0,1275,902,898,902,fluttershy
510859.png,https://derpicdn.net/img/view/2013/12/31/510859.png,0,0.971197248,75,0,501,387,426,387,fluttershy
510920.png,https://derpicdn.net/img/view/2013/12/31/510920.png,0,0.958798051,2,107,226,331,224,224,fluttershy
511908.png,https://derpicdn.net/img/view/2014/1/1/511908.png,0,0.980800629,274,0,986,686,712,686,fluttershy
512067.png,https://derpicdn.net/img/view/2014/1/1/512067.png,0,0.978461742,0,0,1000,1066,1000,1066,fluttershy
512372.png,https://derpicdn.net/img/view/2014/1/2/512372.png,0,0.96858871,138,0,514,335,376,335,fluttershy
512612.jpg,https://derpicdn.net/img/view/2014/1/2/512612.jpg,0,0.9426893,320,0,886,564,566,564,fluttershy
514193.png,https://derpicdn.net/img/view/2014/1/3/514193.png,0,0.994291067,0,0,236,198,236,198,fluttershy
514398.png,https://derpicdn.net/img/view/2014/1/4/514398.png,0,0.996114016,242,511,3518,3787,3276,3276,fluttershy
514398.png,https://derpicdn.net/img/view/2014/1/4/514398.png,0,0.996114016,242,511,3518,3787,3276,3276,fluttershy
520936.png,https://derpicdn.net/img/view/2014/1/11/520936.png,0,0.996873856,306,169,1170,1033,864,864,fluttershy
522597.png,https://derpicdn.net/img/view/2014/1/12/522597.png,0,0.999421418,532,160,1648,1276,1116,1116,fluttershy
525089.png,https://derpicdn.net/img/view/2014/1/15/525089.png,0,0.945883691,806,224,1198,616,392,392,fluttershy
525089.png,https://derpicdn.net/img/view/2014/1/15/525089.png,1,0.934105337,358,0,770,325,412,325,fluttershy
525414.png,https://derpicdn.net/img/view/2014/1/16/525414.png,0,0.991267383,179,0,687,469,508,469,fluttershy
525477.png,https://derpicdn.net/img/view/2014/1/16/525477.png,0,0.990380287,186,52,664,530,478,478,fluttershy
526285.png,https://derpicdn.net/img/view/2014/1/17/526285.png,0,0.992590964,332,374,808,850,476,476,fluttershy
527708.png,https://derpicdn.net/img/view/2014/1/18/527708.png,0,0.995700002,553,206,893,546,340,340,fluttershy
527708.png,https://derpicdn.net/img/view/2014/1/18/527708.png,1,0.98707521,882,315,1098,531,216,216,fluttershy
530165.jpg,https://derpicdn.net/img/view/2014/1/21/530165.jpg,0,0.968581259,398,0,698,279,300,279,fluttershy
530165.jpg,https://derpicdn.net/img/view/2014/1/21/530165.jpg,1,0.944288492,149,135,483,469,334,334,fluttershy
530661.png,https://derpicdn.net/img/view/2014/1/21/530661.png,0,0.963107049,79,0,442,336,363,336,fluttershy
532152.png,https://derpicdn.net/img/view/2014/1/23/532152.png,0,0.98079896,390,24,810,444,420,420,fluttershy
532966.png,https://derpicdn.net/img/view/2014/1/24/532966.png,0,0.984171093,318,81,748,511,430,430,fluttershy
535087.png,https://derpicdn.net/img/view/2014/1/26/535087.png,0,0.992657244,134,26,464,356,330,330,fluttershy
535320.png,https://derpicdn.net/img/view/2014/1/26/535320.png,0,0.98003,553,62,1463,972,910,910,fluttershy
542427.png,https://derpicdn.net/img/view/2014/2/3/542427.png,0,0.928091168,0,0,2998,2885,2998,2885,fluttershy
543783.png,https://derpicdn.net/img/view/2014/2/5/543783.png,0,0.998051465,1583,0,3637,1939,2054,1939,fluttershy
545773.png,https://derpicdn.net/img/view/2014/2/7/545773.png,0,0.988371134,45,0,843,787,798,787,fluttershy
551164.png,https://derpicdn.net/img/view/2014/2/13/551164.png,0,0.994610488,249,0,1167,852,918,852,fluttershy
552830.png,https://derpicdn.net/img/view/2014/2/15/552830.png,0,0.98905009,178,29,878,729,700,700,fluttershy
567605.png,https://derpicdn.net/img/view/2014/3/5/567605.png,0,0.986526489,0,0,820,777,820,777,fluttershy
570851.png,https://derpicdn.net/img/view/2014/3/9/570851.png,0,0.990613759,479,266,985,772,506,506,fluttershy
570851.png,https://derpicdn.net/img/view/2014/3/9/570851.png,0,0.990613759,479,266,985,772,506,506,fluttershy
57537.jpg,https://derpicdn.net/img/view/2012/7/26/57537.jpg,0,0.991517484,867,774,1417,1324,550,550,fluttershy
57537.jpg,https://derpicdn.net/img/view/2012/7/26/57537.jpg,1,0.958825529,1333,360,2023,1050,690,690,fluttershy
584638.png,https://derpicdn.net/img/view/2014/3/25/584638.png,0,0.994579375,979,208,1873,1102,894,894,fluttershy
593458.png,https://derpicdn.net/img/view/2014/4/5/593458.png,0,0.982912719,561,183,1659,1281,1098,1098,fluttershy
593458.png,https://derpicdn.net/img/view/2014/4/5/593458.png,0,0.982912719,561,183,1659,1281,1098,1098,fluttershy
593508.png,https://derpicdn.net/img/view/2014/4/5/593508.png,0,0.977631688,108,24,764,680,656,656,fluttershy
596786.png,https://derpicdn.net/img/view/2014/4/9/596786.png,0,0.901850879,1362,720,3548,2906,2186,2186,fluttershy
597522.png,https://derpicdn.net/img/view/2014/4/10/597522.png,0,0.992581487,383,21,1203,841,820,820,fluttershy
597623.png,https://derpicdn.net/img/view/2014/4/11/597623.png,0,0.999592602,293,24,607,338,314,314,fluttershy
599281.png,https://derpicdn.net/img/view/2014/4/13/599281.png,0,0.955510855,856,405,5806,5355,4950,4950,fluttershy
599851.png,https://derpicdn.net/img/view/2014/4/13/599851.png,0,0.997259915,283,56,989,762,706,706,fluttershy
599851.png,https://derpicdn.net/img/view/2014/4/13/599851.png,0,0.997259915,283,56,989,762,706,706,fluttershy
611737.png,https://derpicdn.net/img/view/2014/4/27/611737.png,0,0.990934253,314,0,754,391,440,391,fluttershy
6244.png,https://derpicdn.net/img/view/2012/6/18/6244.png,0,0.996326566,136,0,676,504,540,504,fluttershy
629541.png,https://derpicdn.net/img/view/2014/5/17/629541.png,0,0.992497385,309,164,1077,932,768,768,fluttershy
631911.jpg,https://derpicdn.net/img/view/2014/5/20/631911.jpg,0,0.957073271,128,0,1028,843,900,843,fluttershy
635524.png,https://derpicdn.net/img/view/2014/5/24/635524.png,0,0.981197178,58,24,332,298,274,274,fluttershy
639.jpg,https://derpicdn.net/img/view/2012/1/17/639.jpg,0,0.999660611,0,770,412,1218,412,448,fluttershy
639.jpg,https://derpicdn.net/img/view/2012/1/17/639.jpg,1,0.999575078,1109,1321,1509,1737,400,416,fluttershy
639.jpg,https://derpicdn.net/img/view/2012/1/17/639.jpg,2,0.999410987,1072,145,1509,607,437,462,fluttershy
639.jpg,https://derpicdn.net/img/view/2012/1/17/639.jpg,3,0.999147058,0,1327,425,1783,425,456,fluttershy
639.jpg,https://derpicdn.net/img/view/2012/1/17/639.jpg,4,0.998395026,0,149,445,627,445,478,fluttershy
639.jpg,https://derpicdn.net/img/view/2012/1/17/639.jpg,5,0.998142898,756,739,1160,1143,404,404,fluttershy
639.jpg,https://derpicdn.net/img/view/2012/1/17/639.jpg,6,0.997961581,366,1303,820,1757,454,454,fluttershy
639.jpg,https://derpicdn.net/img/view/2012/1/17/639.jpg,7,0.997764587,752,169,1160,577,408,408,fluttershy
639.jpg,https://derpicdn.net/img/view/2012/1/17/639.jpg,8,0.992722929,358,204,758,604,400,400,fluttershy
639.jpg,https://derpicdn.net/img/view/2012/1/17/639.jpg,9,0.987481475,742,1337,1130,1725,388,388,fluttershy
639.jpg,https://derpicdn.net/img/view/2012/1/17/639.jpg,10,0.985949993,1104,787,1494,1177,390,390,fluttershy
644007.png,https://derpicdn.net/img/view/2014/6/3/644007.png,0,0.957097113,0,0,1263,1220,1263,1220,fluttershy
646358.png,https://derpicdn.net/img/view/2014/6/6/646358.png,0,0.985331595,0,0,834,753,834,753,fluttershy
649539.png,https://derpicdn.net/img/view/2014/6/10/649539.png,0,0.980757475,159,25,657,523,498,498,fluttershy
651269.png,https://derpicdn.net/img/view/2014/6/12/651269.png,0,0.971115351,0,0,1218,1188,1218,1188,fluttershy
651300.png,https://derpicdn.net/img/view/2014/6/12/651300.png,0,0.963871896,0,0,1245,1218,1245,1218,fluttershy
653033.png,https://derpicdn.net/img/view/2014/6/14/653033.png,0,0.921607614,290,0,696,351,406,351,fluttershy
658481.png,https://derpicdn.net/img/view/2014/6/21/658481.png,0,0.994340956,316,16,742,442,426,426,fluttershy
664337.png,https://derpicdn.net/img/view/2014/6/30/664337.png,0,0.975808084,0,0,2647,2568,2647,2568,fluttershy
665545.png,https://derpicdn.net/img/view/2014/7/1/665545.png,0,0.979566693,224,62,532,370,308,308,fluttershy
680380.png,https://derpicdn.net/img/view/2014/7/21/680380.png,0,0.998246372,382,0,1260,863,878,863,fluttershy
680481.jpg,https://derpicdn.net/img/view/2014/7/21/680481.jpg,0,0.98642993,254,7,534,287,280,280,fluttershy
681405.png,https://derpicdn.net/img/view/2014/7/23/681405.png,0,0.987212956,1085,59,2049,1023,964,964,fluttershy
681969.png,https://derpicdn.net/img/view/2014/7/24/681969.png,0,0.997639358,0,0,812,694,812,694,fluttershy
681969.png,https://derpicdn.net/img/view/2014/7/24/681969.png,0,0.997639358,0,0,812,694,812,694,fluttershy
687607.png,https://derpicdn.net/img/view/2014/7/31/687607.png,0,0.991936505,220,297,826,903,606,606,fluttershy
692629.png,https://derpicdn.net/img/view/2014/8/6/692629.png,0,0.987621069,318,0,810,447,492,447,fluttershy
697224.png,https://derpicdn.net/img/view/2014/8/11/697224.png,0,0.978904545,93,0,525,389,432,389,fluttershy
697224.png,https://derpicdn.net/img/view/2014/8/11/697224.png,1,0.974744856,570,474,786,690,216,216,fluttershy
697282.png,https://derpicdn.net/img/view/2014/8/11/697282.png,0,0.992985904,200,129,658,587,458,458,fluttershy
704933.png,https://derpicdn.net/img/view/2014/8/21/704933.png,0,0.995651186,132,8,370,246,238,238,fluttershy
706312.jpg,https://derpicdn.net/img/view/2014/8/23/706312.jpg,0,0.955371022,165,34,709,578,544,544,fluttershy
706460.png,https://derpicdn.net/img/view/2014/8/23/706460.png,0,0.99583143,148,0,538,363,390,363,fluttershy
706561.png,https://derpicdn.net/img/view/2014/8/24/706561.png,0,0.976862311,0,90,933,1036,933,946,fluttershy
708689.jpg,https://derpicdn.net/img/view/2014/8/26/708689.jpg,0,0.998378873,316,145,642,471,326,326,fluttershy
708849.png,https://derpicdn.net/img/view/2014/8/26/708849.png,0,0.917901993,80,0,490,351,410,351,fluttershy
7100.png,https://derpicdn.net/img/view/2012/6/18/7100.png,0,0.985537827,1614,0,3027,1392,1413,1392,fluttershy
711963.png,https://derpicdn.net/img/view/2014/8/31/711963.png,0,0.974113226,11,0,975,917,964,917,fluttershy
717937.png,https://derpicdn.net/img/view/2014/9/8/717937.png,0,0.992080927,804,101,1112,409,308,308,fluttershy
721793.png,https://derpicdn.net/img/view/2014/9/14/721793.png,0,0.973270893,519,87,1193,761,674,674,fluttershy
724134.png,https://derpicdn.net/img/view/2014/9/17/724134.png,0,0.9989748,231,83,589,441,358,358,fluttershy
730312.png,https://derpicdn.net/img/view/2014/9/27/730312.png,0,0.975201547,144,0,574,419,430,419,fluttershy
730360.png,https://derpicdn.net/img/view/2014/9/27/730360.png,0,0.99739331,187,74,699,586,512,512,fluttershy
730799.png,https://derpicdn.net/img/view/2014/9/28/730799.png,0,0.944322348,410,0,1562,1121,1152,1121,fluttershy
730799.png,https://derpicdn.net/img/view/2014/9/28/730799.png,0,0.944322348,410,0,1562,1121,1152,1121,fluttershy
730831.png,https://derpicdn.net/img/view/2014/9/28/730831.png,0,0.953410208,0,0,874,871,874,871,fluttershy
733742.png,https://derpicdn.net/img/view/2014/10/1/733742.png,0,0.97785604,189,0,2221,1984,2032,1984,fluttershy
733742.png,https://derpicdn.net/img/view/2014/10/1/733742.png,0,0.97785604,189,0,2221,1984,2032,1984,fluttershy
735195.png,https://derpicdn.net/img/view/2014/10/4/735195.png,0,0.96286428,0,1,364,381,364,380,fluttershy
735311.png,https://derpicdn.net/img/view/2014/10/4/735311.png,0,0.914162397,123,88,367,332,244,244,fluttershy
735585.jpg,https://derpicdn.net/img/view/2014/10/4/735585.jpg,0,0.990973055,1053,396,1615,958,562,562,fluttershy
735602.png,https://derpicdn.net/img/view/2014/10/4/735602.png,0,0.99881953,676,80,1592,996,916,916,fluttershy
738047.jpg,https://derpicdn.net/img/view/2014/10/7/738047.jpg,0,0.982013762,92,0,766,643,674,643,fluttershy
739324.png,https://derpicdn.net/img/view/2014/10/9/739324.png,0,0.989079416,310,45,508,243,198,198,fluttershy
74819.png,https://derpicdn.net/img/view/2012/8/15/74819.png,0,0.936222911,306,0,814,493,508,493,fluttershy
749068.png,https://derpicdn.net/img/view/2014/10/23/749068.png,0,0.933103204,103,348,383,628,280,280,fluttershy
749079.png,https://derpicdn.net/img/view/2014/10/23/749079.png,0,0.9941203,207,123,727,643,520,520,fluttershy
750213.png,https://derpicdn.net/img/view/2014/10/25/750213.png,0,0.986102402,1,0,595,535,594,535,fluttershy
750213.png,https://derpicdn.net/img/view/2014/10/25/750213.png,0,0.986102402,1,0,595,535,594,535,fluttershy
756413.png,https://derpicdn.net/img/view/2014/11/2/756413.png,1,0.9888556,531,1018,1131,1618,600,600,fluttershy
756460.png,https://derpicdn.net/img/view/2014/11/2/756460.png,0,0.982611716,201,0,581,377,380,377,fluttershy
756460.png,https://derpicdn.net/img/view/2014/11/2/756460.png,0,0.982611716,201,0,581,377,380,377,fluttershy
757174.png,https://derpicdn.net/img/view/2014/11/3/757174.png,0,0.975726306,31,556,785,1310,754,754,fluttershy
760439.jpg,https://derpicdn.net/img/view/2014/11/8/760439.jpg,0,0.954214871,18,0,300,311,282,311,fluttershy
764962.png,https://derpicdn.net/img/view/2014/11/15/764962.png,0,0.971232057,221,13,525,317,304,304,fluttershy
766421.png,https://derpicdn.net/img/view/2014/11/17/766421.png,0,0.967018962,146,40,2000,2094,1854,2054,fluttershy
767695.png,https://derpicdn.net/img/view/2014/11/19/767695.png,0,0.920464456,68,71,854,857,786,786,fluttershy
774.jpg,https://derpicdn.net/img/view/2012/1/19/774.jpg,0,0.969079196,120,0,900,751,780,751,fluttershy
774570.jpg,https://derpicdn.net/img/view/2014/11/29/774570.jpg,0,0.995370507,207,0,837,563,630,563,fluttershy
776752.png,https://derpicdn.net/img/view/2014/12/2/776752.png,0,0.986801624,350,0,926,476,576,476,fluttershy
778906.png,https://derpicdn.net/img/view/2014/12/6/778906.png,0,0.992544591,0,0,797,812,797,812,fluttershy
779073.png,https://derpicdn.net/img/view/2014/12/6/779073.png,0,0.99446702,413,2,729,318,316,316,fluttershy
785093.png,https://derpicdn.net/img/view/2014/12/14/785093.png,0,0.983613372,435,471,1195,1231,760,760,fluttershy
787640.jpg,https://derpicdn.net/img/view/2014/12/18/787640.jpg,0,0.979280293,1329,0,3009,1644,1680,1644,fluttershy
788843.png,https://derpicdn.net/img/view/2014/12/20/788843.png,0,0.967404544,182,189,1430,1437,1248,1248,fluttershy
788843.png,https://derpicdn.net/img/view/2014/12/20/788843.png,0,0.967404544,182,189,1430,1437,1248,1248,fluttershy
790217.png,https://derpicdn.net/img/view/2014/12/22/790217.png,0,0.999625444,0,0,514,503,514,503,fluttershy
794049.png,https://derpicdn.net/img/view/2014/12/27/794049.png,0,0.980107725,112,0,1742,1331,1630,1331,fluttershy
795346.png,https://derpicdn.net/img/view/2014/12/29/795346.png,0,0.938101888,109,0,631,481,522,481,fluttershy
812490.png,https://derpicdn.net/img/view/2015/1/22/812490.png,0,0.993877053,372,52,1200,880,828,828,fluttershy
812513.jpg,https://derpicdn.net/img/view/2015/1/22/812513.jpg,0,0.957939446,124,58,740,682,616,624,fluttershy
816868.png,https://derpicdn.net/img/view/2015/1/29/816868.png,0,0.997865856,101,0,851,732,750,732,fluttershy
819813.jpg,https://derpicdn.net/img/view/2015/2/2/819813.jpg,0,0.99694705,57,5,555,503,498,498,fluttershy
822225.png,https://derpicdn.net/img/view/2015/2/5/822225.png,0,0.99126476,42,0,566,462,524,462,fluttershy
828405.png,https://derpicdn.net/img/view/2015/2/14/828405.png,0,0.987663269,354,0,850,444,496,444,fluttershy
829738.png,https://derpicdn.net/img/view/2015/2/16/829738.png,0,0.992080152,42,0,522,473,480,473,fluttershy
834416.png,https://derpicdn.net/img/view/2015/2/22/834416.png,0,0.901592195,239,46,803,610,564,564,fluttershy
834416.png,https://derpicdn.net/img/view/2015/2/22/834416.png,0,0.901592195,239,46,803,610,564,564,fluttershy
836289.png,https://derpicdn.net/img/view/2015/2/24/836289.png,0,0.992455244,252,78,618,444,366,366,fluttershy
838615.png,https://derpicdn.net/img/view/2015/2/27/838615.png,0,0.92602545,357,79,1439,1161,1082,1082,fluttershy
840921.png,https://derpicdn.net/img/view/2015/3/2/840921.png,0,0.98298502,1048,0,2664,1572,1616,1572,fluttershy
842460.png,https://derpicdn.net/img/view/2015/3/5/842460.png,0,0.986503422,392,28,700,336,308,308,fluttershy
842460.png,https://derpicdn.net/img/view/2015/3/5/842460.png,0,0.986503422,392,28,700,336,308,308,fluttershy
845349.png,https://derpicdn.net/img/view/2015/3/8/845349.png,0,0.988590181,110,0,400,287,290,287,fluttershy
845351.png,https://derpicdn.net/img/view/2015/3/8/845351.png,0,0.990112543,112,0,400,285,288,285,fluttershy
845351.png,https://derpicdn.net/img/view/2015/3/8/845351.png,0,0.990112543,112,0,400,285,288,285,fluttershy
845352.png,https://derpicdn.net/img/view/2015/3/8/845352.png,0,0.988061965,109,0,403,289,294,289,fluttershy
845352.png,https://derpicdn.net/img/view/2015/3/8/845352.png,0,0.988061965,109,0,403,289,294,289,fluttershy
845354.png,https://derpicdn.net/img/view/2015/3/8/845354.png,0,0.989338815,113,0,399,285,286,285,fluttershy
845756.png,https://derpicdn.net/img/view/2015/3/9/845756.png,0,0.99292618,227,4,529,306,302,302,fluttershy
847662.png,https://derpicdn.net/img/view/2015/3/12/847662.png,0,0.997800052,190,118,482,410,292,292,fluttershy
851593.png,https://derpicdn.net/img/view/2015/3/17/851593.png,0,0.997350037,15,0,339,310,324,310,fluttershy
853315.png,https://derpicdn.net/img/view/2015/3/20/853315.png,0,0.912107706,573,0,1285,703,712,703,fluttershy
853568.jpg,https://derpicdn.net/img/view/2015/3/20/853568.jpg,0,0.987684131,297,0,651,341,354,341,fluttershy
858199.png,https://derpicdn.net/img/view/2015/3/27/858199.png,0,0.98802191,0,0,1213,1314,1213,1314,fluttershy
8597.jpg,https://derpicdn.net/img/view/2012/6/18/8597.jpg,0,0.981317759,133,11,491,369,358,358,fluttershy
863612.jpg,https://derpicdn.net/img/view/2015/4/3/863612.jpg,0,0.998252094,156,0,470,304,314,304,fluttershy
863792.png,https://derpicdn.net/img/view/2015/4/3/863792.png,0,0.935092866,654,151,1562,1059,908,908,fluttershy
864926.png,https://derpicdn.net/img/view/2015/4/4/864926.png,0,0.964808345,0,0,5232,4860,5232,4860,fluttershy
868323.png,https://derpicdn.net/img/view/2015/4/7/868323.png,0,0.989858747,398,10,734,346,336,336,fluttershy
87313.png,https://derpicdn.net/img/view/2012/8/31/87313.png,0,0.988139451,0,0,564,560,564,560,fluttershy
878473.png,https://derpicdn.net/img/view/2015/4/20/878473.png,0,0.956086636,220,24,820,624,600,600,fluttershy
878657.jpg,https://derpicdn.net/img/view/2015/4/20/878657.jpg,0,0.900704741,0,229,1165,1479,1165,1250,fluttershy
883854.png,https://derpicdn.net/img/view/2015/4/27/883854.png,0,0.950145841,121,0,1025,776,904,776,fluttershy
884964.png,https://derpicdn.net/img/view/2015/4/28/884964.png,0,0.990537822,1310,24,1740,454,430,430,fluttershy
886631.png,https://derpicdn.net/img/view/2015/5/1/886631.png,0,0.961051464,1287,461,2241,1415,954,954,fluttershy
886631.png,https://derpicdn.net/img/view/2015/5/1/886631.png,0,0.961051464,1287,461,2241,1415,954,954,fluttershy
887396.jpg,https://derpicdn.net/img/view/2015/5/2/887396.jpg,0,0.985680759,420,0,1382,928,962,928,fluttershy
889115.png,https://derpicdn.net/img/view/2015/5/4/889115.png,0,0.984392524,832,26,1876,1070,1044,1044,fluttershy
889535.png,https://derpicdn.net/img/view/2015/5/5/889535.png,0,0.943329573,277,17,611,351,334,334,fluttershy
893938.png,https://derpicdn.net/img/view/2015/5/11/893938.png,0,0.958691716,221,12,727,518,506,506,fluttershy
899523.png,https://derpicdn.net/img/view/2015/5/18/899523.png,0,0.993585944,0,1,612,625,612,624,fluttershy
899523.png,https://derpicdn.net/img/view/2015/5/18/899523.png,1,0.982056499,825,0,1505,652,680,652,fluttershy
900744.png,https://derpicdn.net/img/view/2015/5/20/900744.png,0,0.985640824,42,0,880,786,838,786,fluttershy
904338.png,https://derpicdn.net/img/view/2015/5/26/904338.png,0,0.998401344,361,0,1677,1267,1316,1267,fluttershy
904338.png,https://derpicdn.net/img/view/2015/5/26/904338.png,0,0.998401344,361,0,1677,1267,1316,1267,fluttershy
907833.png,https://derpicdn.net/img/view/2015/5/31/907833.png,0,0.994974196,4,0,428,417,424,417,fluttershy
9081.png,https://derpicdn.net/img/view/2012/6/19/9081.png,0,0.981687725,249,5,511,267,262,262,fluttershy
9081.png,https://derpicdn.net/img/view/2012/6/19/9081.png,0,0.981687725,249,5,511,267,262,262,fluttershy
910270.png,https://derpicdn.net/img/view/2015/6/5/910270.png,0,0.988591969,303,541,1273,1511,970,970,fluttershy
910270.png,https://derpicdn.net/img/view/2015/6/5/910270.png,0,0.988591969,303,541,1273,1511,970,970,fluttershy
910492.png,https://derpicdn.net/img/view/2015/6/5/910492.png,0,0.998412848,228,184,752,708,524,524,fluttershy
912233.png,https://derpicdn.net/img/view/2015/6/7/912233.png,0,0.969365299,395,0,655,249,260,249,fluttershy
919522.png,https://derpicdn.net/img/view/2015/6/19/919522.png,0,0.988754511,945,146,1793,994,848,848,fluttershy
922134.png,https://derpicdn.net/img/view/2015/6/23/922134.png,0,0.955388963,278,0,572,293,294,293,fluttershy
922316.png,https://derpicdn.net/img/view/2015/6/23/922316.png,0,0.9697842,0,0,656,571,656,571,fluttershy
923671.png,https://derpicdn.net/img/view/2015/6/25/923671.png,0,0.994301498,28,0,380,351,352,351,fluttershy
930495.png,https://derpicdn.net/img/view/2015/7/5/930495.png,0,0.988714933,571,272,975,676,404,404,fluttershy
930891.png,https://derpicdn.net/img/view/2015/7/6/930891.png,0,0.993508756,546,59,1904,1417,1358,1358,fluttershy
936498.png,https://derpicdn.net/img/view/2015/7/13/936498.png,0,0.978539765,15,0,621,497,606,497,fluttershy
936534.png,https://derpicdn.net/img/view/2015/7/13/936534.png,0,0.921581864,404,64,1286,946,882,882,fluttershy
936777.png,https://derpicdn.net/img/view/2015/7/14/936777.png,0,0.997217476,172,9,1042,879,870,870,fluttershy
937559.png,https://derpicdn.net/img/view/2015/7/15/937559.png,0,0.999762356,440,12,748,320,308,308,fluttershy
937559.png,https://derpicdn.net/img/view/2015/7/15/937559.png,0,0.999762356,440,12,748,320,308,308,fluttershy
937560.png,https://derpicdn.net/img/view/2015/7/15/937560.png,0,0.999766648,439,10,749,320,310,310,fluttershy
938426.png,https://derpicdn.net/img/view/2015/7/17/938426.png,0,0.978466809,11,0,649,558,638,558,fluttershy
938474.png,https://derpicdn.net/img/view/2015/7/17/938474.png,0,0.991782069,613,0,2241,1485,1628,1485,fluttershy
938474.png,https://derpicdn.net/img/view/2015/7/17/938474.png,0,0.991782069,613,0,2241,1485,1628,1485,fluttershy
940216.png,https://derpicdn.net/img/view/2015/7/20/940216.png,0,0.941062272,712,348,1400,1036,688,688,fluttershy
941308.png,https://derpicdn.net/img/view/2015/7/21/941308.png,0,0.975993931,276,45,694,463,418,418,fluttershy
942409.png,https://derpicdn.net/img/view/2015/7/23/942409.png,0,0.980022788,30,0,1054,1008,1024,1008,fluttershy
944720.png,https://derpicdn.net/img/view/2015/7/27/944720.png,0,0.986690342,190,0,888,682,698,682,fluttershy
944720.png,https://derpicdn.net/img/view/2015/7/27/944720.png,0,0.986690342,190,0,888,682,698,682,fluttershy
945180.png,https://derpicdn.net/img/view/2015/7/27/945180.png,0,0.96484983,83,0,455,358,372,358,fluttershy
945432.png,https://derpicdn.net/img/view/2015/7/28/945432.png,0,0.988512635,2586,0,4876,2266,2290,2266,fluttershy
946773.png,https://derpicdn.net/img/view/2015/7/29/946773.png,0,0.995274723,8,410,378,780,370,370,fluttershy
947303.png,https://derpicdn.net/img/view/2015/7/30/947303.png,0,0.995911777,124,0,482,335,358,335,fluttershy
948557.jpg,https://derpicdn.net/img/view/2015/8/1/948557.jpg,0,0.993010879,325,24,813,512,488,488,fluttershy
9489.png,https://derpicdn.net/img/view/2012/6/19/9489.png,0,0.947531581,0,0,702,706,702,706,fluttershy
9489.png,https://derpicdn.net/img/view/2012/6/19/9489.png,0,0.947531581,0,0,702,706,702,706,fluttershy
950490.png,https://derpicdn.net/img/view/2015/8/4/950490.png,0,0.975174963,251,0,513,260,262,260,fluttershy
950499.png,https://derpicdn.net/img/view/2015/8/4/950499.png,0,0.99593246,121,0,1087,961,966,961,fluttershy
951640.jpg,https://derpicdn.net/img/view/2015/8/5/951640.jpg,0,0.996376216,65,0,591,514,526,514,fluttershy
952459.png,https://derpicdn.net/img/view/2015/8/6/952459.png,0,0.998179972,179,0,441,254,262,254,fluttershy
958319.png,https://derpicdn.net/img/view/2015/8/15/958319.png,0,0.966396511,1605,0,3299,1621,1694,1621,fluttershy
958580.jpg,https://derpicdn.net/img/view/2015/8/16/958580.jpg,0,0.939777732,686,0,1578,756,892,756,fluttershy
960019.png,https://derpicdn.net/img/view/2015/8/18/960019.png,0,0.983444452,67,0,590,532,523,532,fluttershy
961357.png,https://derpicdn.net/img/view/2015/8/20/961357.png,0,0.999441683,991,337,1395,741,404,404,fluttershy
964631.png,https://derpicdn.net/img/view/2015/8/24/964631.png,0,0.993373036,62,0,714,605,652,605,fluttershy
973880.png,https://derpicdn.net/img/view/2015/9/6/973880.png,0,0.974465132,630,38,1070,478,440,440,fluttershy
974404.png,https://derpicdn.net/img/view/2015/9/7/974404.png,0,0.988544405,254,43,712,501,458,458,fluttershy
975602.png,https://derpicdn.net/img/view/2015/9/8/975602.png,0,0.964276612,275,45,1141,911,866,866,fluttershy
977274.png,https://derpicdn.net/img/view/2015/9/11/977274.png,0,0.930908859,2344,51,2834,541,490,490,fluttershy
978609.png,https://derpicdn.net/img/view/2015/9/13/978609.png,0,0.978637516,194,35,512,353,318,318,fluttershy
979271.png,https://derpicdn.net/img/view/2015/9/13/979271.png,0,0.972448051,56,0,692,600,636,600,fluttershy
983296.png,https://derpicdn.net/img/view/2015/9/19/983296.png,0,0.976108253,410,0,808,365,398,365,fluttershy
983305.jpg,https://derpicdn.net/img/view/2015/9/19/983305.jpg,0,0.901157618,191,287,507,603,316,316,fluttershy
984693.png,https://derpicdn.net/img/view/2015/9/21/984693.png,0,0.996632576,12,27,700,715,688,688,fluttershy
984826.png,https://derpicdn.net/img/view/2015/9/21/984826.png,0,0.996416628,19,0,901,801,882,801,fluttershy
986837.jpg,https://derpicdn.net/img/view/2015/9/24/986837.jpg,0,0.980019987,1660,186,2524,1050,864,864,fluttershy
987974.png,https://derpicdn.net/img/view/2015/9/26/987974.png,0,0.957529128,322,0,916,591,594,591,fluttershy
990246.png,https://derpicdn.net/img/view/2015/9/28/990246.png,0,0.920893967,207,0,1079,867,872,867,fluttershy
992120.png,https://derpicdn.net/img/view/2015/10/1/992120.png,0,0.98909384,32,184,1402,1554,1370,1370,fluttershy
994179.png,https://derpicdn.net/img/view/2015/10/4/994179.png,0,0.997228324,116,0,804,680,688,680,fluttershy
994502.png,https://derpicdn.net/img/view/2015/10/4/994502.png,0,0.988698065,269,45,639,415,370,370,fluttershy
999278.png,https://derpicdn.net/img/view/2015/10/11/999278.png,0,0.997413397,223,75,681,533,458,458,fluttershy
1000423.png,https://derpicdn.net/img/view/2015/10/12/1000423.png,0,0.988610506,0,0,4853,4092,4853,4092,fluttershy
1004254.png,https://derpicdn.net/img/view/2015/10/17/1004254.png,0,0.978909492,615,30,1011,426,396,396,fluttershy
1007481.png,https://derpicdn.net/img/view/2015/10/22/1007481.png,0,0.935146511,465,0,851,369,386,369,fluttershy
1013102.png,https://derpicdn.net/img/view/2015/10/31/1013102.png,0,0.977990806,71,0,779,704,708,704,fluttershy
1013635.jpg,https://derpicdn.net/img/view/2015/10/31/1013635.jpg,0,0.975993693,275,55,565,345,290,290,fluttershy
1017625.png,https://derpicdn.net/img/view/2015/11/6/1017625.png,0,0.907900453,93,0,869,742,776,742,fluttershy
1018185.png,https://derpicdn.net/img/view/2015/11/7/1018185.png,0,0.994491816,122,0,272,141,150,141,fluttershy
1018228.png,https://derpicdn.net/img/view/2015/11/7/1018228.png,0,0.99524343,4006,0,7332,3303,3326,3303,fluttershy
1018470.png,https://derpicdn.net/img/view/2015/11/7/1018470.png,0,0.990207076,990,0,4360,3234,3370,3234,fluttershy
1020052.png,https://derpicdn.net/img/view/2015/11/10/1020052.png,0,0.903882623,569,1444,3921,4796,3352,3352,fluttershy
1020388.png,https://derpicdn.net/img/view/2015/11/10/1020388.png,0,0.995276392,1615,241,2887,1513,1272,1272,fluttershy
1020795.jpg,https://derpicdn.net/img/view/2015/11/11/1020795.jpg,0,0.97589916,298,0,1800,1460,1502,1460,fluttershy
1021935.png,https://derpicdn.net/img/view/2015/11/13/1021935.png,0,0.997708976,274,3,610,339,336,336,fluttershy
1022589.jpg,https://derpicdn.net/img/view/2015/11/14/1022589.jpg,0,0.999343753,148,0,948,779,800,779,fluttershy
1025383.png,https://derpicdn.net/img/view/2015/11/18/1025383.png,0,0.99634105,34,0,406,364,372,364,fluttershy
1026480.png,https://derpicdn.net/img/view/2015/11/20/1026480.png,0,0.995352805,280,12,738,470,458,458,fluttershy
10280.png,https://derpicdn.net/img/view/2012/6/19/10280.png,0,0.985259473,100,0,302,196,202,196,fluttershy
1032515.png,https://derpicdn.net/img/view/2015/11/29/1032515.png,0,0.942334116,0,0,232,256,232,256,fluttershy
1037065.png,https://derpicdn.net/img/view/2015/12/5/1037065.png,0,0.93360424,848,124,2388,1664,1540,1540,fluttershy
1038487.png,https://derpicdn.net/img/view/2015/12/6/1038487.png,0,0.994048059,201,21,779,599,578,578,fluttershy
1041206.png,https://derpicdn.net/img/view/2015/12/10/1041206.png,0,0.983417571,542,25,1492,975,950,950,fluttershy
1041921.png,https://derpicdn.net/img/view/2015/12/11/1041921.png,0,0.943359256,243,96,757,610,514,514,fluttershy
1043438.png,https://derpicdn.net/img/view/2015/12/13/1043438.png,0,0.996029198,555,693,1755,1893,1200,1200,fluttershy
1052619.png,https://derpicdn.net/img/view/2015/12/25/1052619.png,0,0.912668705,176,14,593,492,417,478,fluttershy
1055832.png,https://derpicdn.net/img/view/2015/12/30/1055832.png,0,0.996474504,77,0,447,367,370,367,fluttershy
1064265.png,https://derpicdn.net/img/view/2016/1/11/1064265.png,0,0.984515429,0,0,2062,2112,2062,2112,fluttershy
1066214.png,https://derpicdn.net/img/view/2016/1/14/1066214.png,0,0.929686666,9,0,417,396,408,396,fluttershy
107153.png,https://derpicdn.net/img/view/2012/9/26/107153.png,0,0.959525168,124,38,550,480,426,442,fluttershy
1072592.png,https://derpicdn.net/img/view/2016/1/24/1072592.png,0,0.997789025,325,0,1395,1038,1070,1038,fluttershy
1078924.png,https://derpicdn.net/img/view/2016/2/2/1078924.png,0,0.994250059,0,387,511,913,511,526,fluttershy
1082409.png,https://derpicdn.net/img/view/2016/2/7/1082409.png,0,0.989305079,281,33,797,549,516,516,fluttershy
1089662.jpg,https://derpicdn.net/img/view/2016/2/16/1089662.jpg,0,0.994553685,390,0,946,495,556,495,fluttershy
1095323.png,https://derpicdn.net/img/view/2016/2/23/1095323.png,0,0.98894304,26,0,642,540,616,540,fluttershy
1097398.png,https://derpicdn.net/img/view/2016/2/26/1097398.png,0,0.984084427,61,63,557,559,496,496,fluttershy
1104469.png,https://derpicdn.net/img/view/2016/3/8/1104469.png,0,0.991128147,220,3,508,291,288,288,fluttershy
1104712.png,https://derpicdn.net/img/view/2016/3/8/1104712.png,0,0.96504277,571,0,2395,1812,1824,1812,fluttershy
1112580.png,https://derpicdn.net/img/view/2016/3/19/1112580.png,0,0.992354095,542,0,1498,945,956,945,fluttershy
1113320.jpg,https://derpicdn.net/img/view/2016/3/20/1113320.jpg,0,0.998994648,668,0,1060,384,392,384,fluttershy
1115833.png,https://derpicdn.net/img/view/2016/3/24/1115833.png,0,0.966275334,351,99,1869,1617,1518,1518,fluttershy
1126230.png,https://derpicdn.net/img/view/2016/4/6/1126230.png,0,0.993122876,479,0,1013,512,534,512,fluttershy
1126640.png,https://derpicdn.net/img/view/2016/4/7/1126640.png,0,0.995174468,149,0,991,789,842,789,fluttershy
1135116.png,https://derpicdn.net/img/view/2016/4/18/1135116.png,0,0.995823443,2380,0,5000,2989,2620,2989,fluttershy
1145646.png,https://derpicdn.net/img/view/2016/5/3/1145646.png,0,0.991811872,44,195,398,549,354,354,fluttershy
1145646.png,https://derpicdn.net/img/view/2016/5/3/1145646.png,1,0.961928129,401,303,661,563,260,260,fluttershy
1147761.png,https://derpicdn.net/img/view/2016/5/6/1147761.png,0,0.999443114,434,141,774,481,340,340,fluttershy
1147761.png,https://derpicdn.net/img/view/2016/5/6/1147761.png,1,0.996187329,26,21,450,445,424,424,fluttershy
1147891.png,https://derpicdn.net/img/view/2016/5/6/1147891.png,0,0.994025648,0,7,508,531,508,524,fluttershy
1157113.png,https://derpicdn.net/img/view/2016/5/18/1157113.png,0,0.996201336,239,0,1109,846,870,846,fluttershy
1160523.jpg,https://derpicdn.net/img/view/2016/5/22/1160523.jpg,0,0.956799507,1378,272,2108,1002,730,730,fluttershy
1163455.png,https://derpicdn.net/img/view/2016/5/26/1163455.png,0,0.993802309,108,96,394,382,286,286,fluttershy
1169460.png,https://derpicdn.net/img/view/2016/6/3/1169460.png,0,0.989356816,275,94,1289,1108,1014,1014,fluttershy
1169974.png,https://derpicdn.net/img/view/2016/6/4/1169974.png,0,0.991741717,250,0,1764,1080,1514,1080,fluttershy
1170017.png,https://derpicdn.net/img/view/2016/6/4/1170017.png,0,0.993090451,0,110,740,854,740,744,fluttershy
1170017.png,https://derpicdn.net/img/view/2016/6/4/1170017.png,1,0.906192839,255,153,1011,879,756,726,fluttershy
1170208.jpg,https://derpicdn.net/img/view/2016/6/4/1170208.jpg,0,0.989084423,44,90,380,411,336,321,fluttershy
1170263.png,https://derpicdn.net/img/view/2016/6/4/1170263.png,0,0.922332466,30,46,422,438,392,392,fluttershy
1170272.png,https://derpicdn.net/img/view/2016/6/4/1170272.png,0,0.990570605,0,0,247,277,247,277,fluttershy
1171113.png,https://derpicdn.net/img/view/2016/6/5/1171113.png,0,0.912418664,758,264,3010,2516,2252,2252,fluttershy
1171239.png,https://derpicdn.net/img/view/2016/6/5/1171239.png,0,0.9961586,217,0,1803,1540,1586,1540,fluttershy
1172365.png,https://derpicdn.net/img/view/2016/6/7/1172365.png,0,0.944271386,198,16,962,780,764,764,fluttershy
1179157.png,https://derpicdn.net/img/view/2016/6/15/1179157.png,0,0.998557448,399,25,949,575,550,550,fluttershy
1180727.png,https://derpicdn.net/img/view/2016/6/18/1180727.png,0,0.927081227,110,0,782,524,672,524,fluttershy
1181699.png,https://derpicdn.net/img/view/2016/6/19/1181699.png,0,0.991650999,23,0,705,636,682,636,fluttershy
1187635.png,https://derpicdn.net/img/view/2016/6/27/1187635.png,0,0.967849612,2940,558,4302,1920,1362,1362,fluttershy
1195.png,https://derpicdn.net/img/view/2012/1/22/1195.png,0,0.985648155,156,8,566,418,410,410,fluttershy
1201480.png,https://derpicdn.net/img/view/2016/7/15/1201480.png,0,0.999246478,983,0,2053,1047,1070,1047,fluttershy
1205354.png,https://derpicdn.net/img/view/2016/7/20/1205354.png,0,0.989251852,191,0,1473,1194,1282,1194,fluttershy
1217278.png,https://derpicdn.net/img/view/2016/8/5/1217278.png,0,0.954982758,380,0,871,506,491,506,fluttershy
121921.png,https://derpicdn.net/img/view/2012/10/14/121921.png,0,0.91745621,74,0,538,410,464,410,fluttershy
12248.jpg,https://derpicdn.net/img/view/2012/6/20/12248.jpg,0,0.968980134,275,31,651,407,376,376,fluttershy
1233019.png,https://derpicdn.net/img/view/2016/8/24/1233019.png,0,0.98539573,83,20,755,692,672,672,fluttershy
1234942.png,https://derpicdn.net/img/view/2016/8/27/1234942.png,0,0.959133565,90,0,686,505,596,505,fluttershy
1234996.png,https://derpicdn.net/img/view/2016/8/27/1234996.png,0,0.956103325,0,0,232,234,232,234,fluttershy
1235701.png,https://derpicdn.net/img/view/2016/8/28/1235701.png,0,0.991580486,306,0,1150,756,844,756,fluttershy
1236897.png,https://derpicdn.net/img/view/2016/8/29/1236897.png,0,0.922078311,196,131,1562,1497,1366,1366,fluttershy
1240777.png,https://derpicdn.net/img/view/2016/9/3/1240777.png,0,0.92448622,980,101,1730,851,750,750,fluttershy
1241495.png,https://derpicdn.net/img/view/2016/9/4/1241495.png,0,0.970895886,0,0,1648,1598,1648,1598,fluttershy
1252346.png,https://derpicdn.net/img/view/2016/9/18/1252346.png,0,0.964964688,168,0,1908,1691,1740,1691,fluttershy
1252897.png,https://derpicdn.net/img/view/2016/9/19/1252897.png,0,0.987299621,498,402,902,806,404,404,fluttershy
1255674.png,https://derpicdn.net/img/view/2016/9/22/1255674.png,0,0.916015804,0,17,476,531,476,514,fluttershy
126417.png,https://derpicdn.net/img/view/2012/10/19/126417.png,0,0.98099649,203,38,617,452,414,414,fluttershy
1267777.png,https://derpicdn.net/img/view/2016/10/8/1267777.png,0,0.986908257,119,0,646,521,527,521,fluttershy
1268421.png,https://derpicdn.net/img/view/2016/10/8/1268421.png,0,0.957384646,0,0,679,625,679,625,fluttershy
1271963.png,https://derpicdn.net/img/view/2016/10/13/1271963.png,0,0.990939379,637,0,2255,1599,1618,1599,fluttershy
1274739.png,https://derpicdn.net/img/view/2016/10/16/1274739.png,0,0.980404258,429,391,891,853,462,462,fluttershy
1282287.png,https://derpicdn.net/img/view/2016/10/27/1282287.png,0,0.992467165,1043,172,3481,2610,2438,2438,fluttershy
128328.png,https://derpicdn.net/img/view/2012/10/20/128328.png,0,0.950195849,306,0,756,418,450,418,fluttershy
1286201.png,https://derpicdn.net/img/view/2016/11/1/1286201.png,0,0.929720104,124,14,984,874,860,860,fluttershy
1289837.png,https://derpicdn.net/img/view/2016/11/6/1289837.png,0,0.996185899,1346,0,3034,1655,1688,1655,fluttershy
1293610.png,https://derpicdn.net/img/view/2016/11/11/1293610.png,1,0.957347929,2938,2387,3496,2945,558,558,fluttershy
1293610.png,https://derpicdn.net/img/view/2016/11/11/1293610.png,2,0.949186623,2876,1064,3514,1702,638,638,fluttershy
1303190.png,https://derpicdn.net/img/view/2016/11/25/1303190.png,0,0.998770654,169,0,605,417,436,417,fluttershy
1311547.png,https://derpicdn.net/img/view/2016/12/6/1311547.png,0,0.940953493,222,0,964,689,742,689,fluttershy
1311819.png,https://derpicdn.net/img/view/2016/12/7/1311819.png,0,0.995192826,241,0,1709,1307,1468,1307,fluttershy
1314133.png,https://derpicdn.net/img/view/2016/12/10/1314133.png,0,0.999031305,0,35,537,601,537,566,fluttershy
1332374.png,https://derpicdn.net/img/view/2017/1/5/1332374.png,0,0.945162475,274,43,1312,1081,1038,1038,fluttershy
1341788.png,https://derpicdn.net/img/view/2017/1/18/1341788.png,0,0.950168788,346,175,1001,872,655,697,fluttershy
1342168.png,https://derpicdn.net/img/view/2017/1/18/1342168.png,0,0.993701875,133,0,1425,1242,1292,1242,fluttershy
1342736.png,https://derpicdn.net/img/view/2017/1/19/1342736.png,0,0.96232146,102,0,1972,1541,1870,1541,fluttershy
1344495.png,https://derpicdn.net/img/view/2017/1/21/1344495.png,0,0.998557806,988,0,2068,987,1080,987,fluttershy
1344495.png,https://derpicdn.net/img/view/2017/1/21/1344495.png,1,0.998191476,0,143,979,1211,979,1068,fluttershy
1344495.png,https://derpicdn.net/img/view/2017/1/21/1344495.png,2,0.973585367,967,1719,1453,2205,486,486,fluttershy
1346532.png,https://derpicdn.net/img/view/2017/1/24/1346532.png,0,0.989977658,135,19,369,253,234,234,fluttershy
1347121.png,https://derpicdn.net/img/view/2017/1/24/1347121.png,0,0.986179352,41,0,466,412,425,412,fluttershy
1362820.png,https://derpicdn.net/img/view/2017/2/14/1362820.png,0,0.994805455,44,0,484,432,440,432,fluttershy
1365486.png,https://derpicdn.net/img/view/2017/2/17/1365486.png,0,0.997814178,303,49,563,309,260,260,fluttershy
1366410.png,https://derpicdn.net/img/view/2017/2/18/1366410.png,0,0.975174487,211,9,1229,1027,1018,1018,fluttershy
1367379.png,https://derpicdn.net/img/view/2017/2/19/1367379.png,0,0.965818107,0,164,2732,2690,2732,2526,fluttershy
1373209.png,https://derpicdn.net/img/view/2017/2/25/1373209.png,0,0.995656133,524,0,1662,1134,1138,1134,fluttershy
1375419.png,https://derpicdn.net/img/view/2017/2/28/1375419.png,0,0.993086636,61,47,531,517,470,470,fluttershy
1387648.png,https://derpicdn.net/img/view/2017/3/15/1387648.png,0,0.988143504,52,0,944,905,892,905,fluttershy
1394064.png,https://derpicdn.net/img/view/2017/3/22/1394064.png,0,0.993736088,2255,167,3283,1195,1028,1028,fluttershy
1395450.png,https://derpicdn.net/img/view/2017/3/24/1395450.png,0,0.982954741,449,0,917,454,468,454,fluttershy
1398340.png,https://derpicdn.net/img/view/2017/3/28/1398340.png,0,0.944499731,126,0,874,742,748,742,fluttershy
1398888.png,https://derpicdn.net/img/view/2017/3/29/1398888.png,0,0.965685904,775,140,1683,1048,908,908,fluttershy
1403857.png,https://derpicdn.net/img/view/2017/4/4/1403857.png,0,0.995602131,270,31,1070,831,800,800,fluttershy
1404024.png,https://derpicdn.net/img/view/2017/4/4/1404024.png,0,0.981231987,12,0,248,226,236,226,fluttershy
1407929.png,https://derpicdn.net/img/view/2017/4/9/1407929.png,0,0.980408907,0,0,1045,1112,1045,1112,fluttershy
1409738.png,https://derpicdn.net/img/view/2017/4/12/1409738.png,0,0.985559344,160,0,522,345,362,345,fluttershy
1410008.png,https://derpicdn.net/img/view/2017/4/12/1410008.png,0,0.942858398,91,3,779,691,688,688,fluttershy
1410868.png,https://derpicdn.net/img/view/2017/4/13/1410868.png,0,0.986737192,1680,0,7006,5228,5326,5228,fluttershy
1411549.png,https://derpicdn.net/img/view/2017/4/15/1411549.png,0,0.92164135,1293,108,3479,2294,2186,2186,fluttershy
1412442.png,https://derpicdn.net/img/view/2017/4/15/1412442.png,0,0.996553421,435,30,909,504,474,474,fluttershy
1416215.png,https://derpicdn.net/img/view/2017/4/19/1416215.png,0,0.940518081,811,45,2951,2185,2140,2140,fluttershy
1418674.png,https://derpicdn.net/img/view/2017/4/22/1418674.png,0,0.988598228,960,146,1600,786,640,640,fluttershy
1419285.png,https://derpicdn.net/img/view/2017/4/23/1419285.png,0,0.995635748,135,9,641,515,506,506,fluttershy
1421632.png,https://derpicdn.net/img/view/2017/4/25/1421632.png,0,0.99837172,416,0,1038,563,622,563,fluttershy
1426401.png,https://derpicdn.net/img/view/2017/5/1/1426401.png,0,0.954538941,441,0,1331,888,890,888,fluttershy
1426938.png,https://derpicdn.net/img/view/2017/5/2/1426938.png,0,0.968520522,652,982,2776,3106,2124,2124,fluttershy
1428660.png,https://derpicdn.net/img/view/2017/5/4/1428660.png,0,0.995326221,79,0,627,501,548,501,fluttershy
1430056.png,https://derpicdn.net/img/view/2017/5/6/1430056.png,0,0.963773012,229,0,2801,2498,2572,2498,fluttershy
1430278.png,https://derpicdn.net/img/view/2017/5/6/1430278.png,0,0.982843041,602,22,1402,822,800,800,fluttershy
1431738.png,https://derpicdn.net/img/view/2017/5/8/1431738.png,0,0.931132853,144,0,1842,1090,1698,1090,fluttershy
1431739.png,https://derpicdn.net/img/view/2017/5/8/1431739.png,0,0.952756941,0,0,1555,1090,1555,1090,fluttershy
1432797.png,https://derpicdn.net/img/view/2017/5/9/1432797.png,0,0.996185184,138,0,904,726,766,726,fluttershy
1433179.png,https://derpicdn.net/img/view/2017/5/10/1433179.png,0,0.992007852,20,101,3120,3163,3100,3062,fluttershy
1434836.png,https://derpicdn.net/img/view/2017/5/12/1434836.png,0,0.984355628,183,323,2761,2901,2578,2578,fluttershy
1434939.png,https://derpicdn.net/img/view/2017/5/12/1434939.png,0,0.970041037,83,0,469,369,386,369,fluttershy
1435335.png,https://derpicdn.net/img/view/2017/5/13/1435335.png,0,0.998755097,295,6,957,668,662,662,fluttershy
1437822.png,https://derpicdn.net/img/view/2017/5/16/1437822.png,0,0.944626689,141,110,621,590,480,480,fluttershy
1439373.png,https://derpicdn.net/img/view/2017/5/18/1439373.png,0,0.997057319,867,296,1175,604,308,308,fluttershy
1439770.png,https://derpicdn.net/img/view/2017/5/18/1439770.png,0,0.959411561,0,0,1772,1698,1772,1698,fluttershy
1443156.png,https://derpicdn.net/img/view/2017/5/22/1443156.png,0,0.997224212,332,0,740,385,408,385,fluttershy
1447269.png,https://derpicdn.net/img/view/2017/5/27/1447269.png,0,0.984698594,0,0,606,589,606,589,fluttershy
1449120.png,https://derpicdn.net/img/view/2017/5/29/1449120.png,0,0.996479511,934,52,3440,2558,2506,2506,fluttershy
1452438.png,https://derpicdn.net/img/view/2017/6/2/1452438.png,0,0.991469681,318,101,1000,783,682,682,fluttershy
1453567.png,https://derpicdn.net/img/view/2017/6/4/1453567.png,0,0.997743964,1096,0,2240,1003,1144,1003,fluttershy
1453567.png,https://derpicdn.net/img/view/2017/6/4/1453567.png,1,0.94432652,1688,713,2692,1717,1004,1004,fluttershy
1455938.png,https://derpicdn.net/img/view/2017/6/7/1455938.png,0,0.986296654,230,35,1280,1185,1050,1150,fluttershy
1456389.png,https://derpicdn.net/img/view/2017/6/7/1456389.png,0,0.949664712,77,52,593,527,516,475,fluttershy
1457178.png,https://derpicdn.net/img/view/2017/6/8/1457178.png,0,0.952680051,539,118,2595,2174,2056,2056,fluttershy
1458104.png,https://derpicdn.net/img/view/2017/6/10/1458104.png,0,0.998344898,1775,38,2591,854,816,816,fluttershy
1458104.png,https://derpicdn.net/img/view/2017/6/10/1458104.png,2,0.960283816,63,1327,921,2185,858,858,fluttershy
1458104.png,https://derpicdn.net/img/view/2017/6/10/1458104.png,3,0.939211905,1825,1311,2625,2111,800,800,fluttershy
1461334.png,https://derpicdn.net/img/view/2017/6/14/1461334.png,0,0.963363171,0,84,1016,1206,1016,1122,fluttershy
1463717.png,https://derpicdn.net/img/view/2017/6/17/1463717.png,0,0.985409558,232,555,584,907,352,352,fluttershy
1469399.png,https://derpicdn.net/img/view/2017/6/23/1469399.png,0,0.986347318,1925,233,2735,1043,810,810,fluttershy
1469856.png,https://derpicdn.net/img/view/2017/6/23/1469856.png,0,0.986168146,19,40,395,416,376,376,fluttershy
1469946.png,https://derpicdn.net/img/view/2017/6/23/1469946.png,0,0.967055798,0,0,523,543,523,543,fluttershy
1470272.png,https://derpicdn.net/img/view/2017/6/24/1470272.png,0,0.934061885,0,499,2346,2758,2346,2259,fluttershy
1472311.png,https://derpicdn.net/img/view/2017/6/26/1472311.png,0,0.9954862,251,0,737,480,486,480,fluttershy
1472686.png,https://derpicdn.net/img/view/2017/6/27/1472686.png,0,0.949659884,290,0,2884,2610,2594,2610,fluttershy
1473388.png,https://derpicdn.net/img/view/2017/6/28/1473388.png,0,0.998166442,908,37,1508,637,600,600,fluttershy
1475097.png,https://derpicdn.net/img/view/2017/6/30/1475097.png,0,0.975127339,915,0,2629,1584,1714,1584,fluttershy
1476805.png,https://derpicdn.net/img/view/2017/7/2/1476805.png,0,0.95768863,24,0,500,469,476,469,fluttershy
147870.png,https://derpicdn.net/img/view/2012/11/10/147870.png,0,0.996331334,21,0,543,474,522,474,fluttershy
1483888.png,https://derpicdn.net/img/view/2017/7/11/1483888.png,0,0.964103937,496,225,1324,1053,828,828,fluttershy
1485423.png,https://derpicdn.net/img/view/2017/7/13/1485423.png,0,0.998849809,78,0,668,545,590,545,fluttershy
1489232.png,https://derpicdn.net/img/view/2017/7/18/1489232.png,0,0.992802918,288,32,564,308,276,276,fluttershy
1494264.png,https://derpicdn.net/img/view/2017/7/25/1494264.png,0,0.957478046,16,0,490,462,474,462,fluttershy
1496092.png,https://derpicdn.net/img/view/2017/7/27/1496092.png,0,0.984635055,95,0,7000,7304,6905,7304,fluttershy
1496426.png,https://derpicdn.net/img/view/2017/7/27/1496426.png,0,0.998694956,210,44,774,608,564,564,fluttershy
1497622.png,https://derpicdn.net/img/view/2017/7/29/1497622.png,0,0.995112717,19,0,373,344,354,344,fluttershy
1497719.png,https://derpicdn.net/img/view/2017/7/29/1497719.png,0,0.997805059,72,0,934,834,862,834,fluttershy
1498506.png,https://derpicdn.net/img/view/2017/7/30/1498506.png,0,0.955345154,93,45,413,365,320,320,fluttershy
1498721.png,https://derpicdn.net/img/view/2017/7/30/1498721.png,0,0.995193303,300,0,722,403,422,403,fluttershy
1501795.png,https://derpicdn.net/img/view/2017/8/3/1501795.png,0,0.998884559,186,214,1136,1164,950,950,fluttershy
1502265.png,https://derpicdn.net/img/view/2017/8/4/1502265.png,0,0.996616364,384,71,762,449,378,378,fluttershy
1502674.png,https://derpicdn.net/img/view/2017/8/4/1502674.png,0,0.991028309,122,6,526,410,404,404,fluttershy
1502968.png,https://derpicdn.net/img/view/2017/8/5/1502968.png,0,0.991586745,492,0,856,362,364,362,fluttershy
1504499.png,https://derpicdn.net/img/view/2017/8/6/1504499.png,0,0.974388778,215,55,867,707,652,652,fluttershy
1510369.png,https://derpicdn.net/img/view/2017/8/14/1510369.png,0,0.974553943,0,0,2226,2177,2226,2177,fluttershy
1518050.png,https://derpicdn.net/img/view/2017/8/23/1518050.png,0,0.968132019,150,0,1382,1080,1232,1080,fluttershy
1523657.png,https://derpicdn.net/img/view/2017/8/30/1523657.png,0,0.998312891,887,377,1487,977,600,600,fluttershy
1533326.png,https://derpicdn.net/img/view/2017/9/11/1533326.png,0,0.970335364,32,57,454,479,422,422,fluttershy
1536532.png,https://derpicdn.net/img/view/2017/9/16/1536532.png,0,0.995444357,651,432,1249,1030,598,598,fluttershy
1542570.png,https://derpicdn.net/img/view/2017/9/23/1542570.png,0,0.964866996,87,52,334,320,247,268,fluttershy
1543469.png,https://derpicdn.net/img/view/2017/9/24/1543469.png,0,0.917186201,152,0,782,531,630,531,fluttershy
1545612.png,https://derpicdn.net/img/view/2017/9/26/1545612.png,0,0.999271989,38,0,410,369,372,369,fluttershy
1547824.png,https://derpicdn.net/img/view/2017/9/29/1547824.png,0,0.941999078,159,0,1031,745,872,745,fluttershy
1549416.png,https://derpicdn.net/img/view/2017/10/1/1549416.png,0,0.966075003,47,0,659,530,612,530,fluttershy
1549418.png,https://derpicdn.net/img/view/2017/10/1/1549418.png,0,0.987793326,34,0,628,512,594,512,fluttershy
1551013.png,https://derpicdn.net/img/view/2017/10/3/1551013.png,0,0.920742869,2291,80,6123,3912,3832,3832,fluttershy
1561761.png,https://derpicdn.net/img/view/2017/10/15/1561761.png,0,0.963653326,197,0,607,402,410,402,fluttershy
1568334.png,https://derpicdn.net/img/view/2017/10/23/1568334.png,0,0.915235341,1286,0,3196,1966,1910,1966,fluttershy
1572079.png,https://derpicdn.net/img/view/2017/10/28/1572079.png,0,0.954001009,22,5,454,437,432,432,fluttershy
1577876.png,https://derpicdn.net/img/view/2017/11/4/1577876.png,0,0.985332847,1489,102,3245,1858,1756,1756,fluttershy
1579994.png,https://derpicdn.net/img/view/2017/11/6/1579994.png,0,0.9877581,0,0,1639,1411,1639,1411,fluttershy
1584763.png,https://derpicdn.net/img/view/2017/11/12/1584763.png,0,0.985483408,611,1282,921,1592,310,310,fluttershy
1585727.png,https://derpicdn.net/img/view/2017/11/13/1585727.png,0,0.997932374,296,26,1136,866,840,840,fluttershy
1585729.png,https://derpicdn.net/img/view/2017/11/13/1585729.png,0,0.965663075,48,0,884,801,836,801,fluttershy
158698.png,https://derpicdn.net/img/view/2012/11/21/158698.png,0,0.989204586,1512,0,2778,1176,1266,1176,fluttershy
1588563.png,https://derpicdn.net/img/view/2017/11/17/1588563.png,0,0.991137326,251,0,599,317,348,317,fluttershy
1592425.png,https://derpicdn.net/img/view/2017/11/23/1592425.png,0,0.911912978,115,26,712,642,597,616,fluttershy
1593515.png,https://derpicdn.net/img/view/2017/11/24/1593515.png,0,0.974258304,1076,146,2728,1798,1652,1652,fluttershy
1593806.png,https://derpicdn.net/img/view/2017/11/25/1593806.png,0,0.976053417,14,0,84,65,70,65,fluttershy
1597030.png,https://derpicdn.net/img/view/2017/11/29/1597030.png,0,0.99591279,0,0,448,452,448,452,fluttershy
1602251.png,https://derpicdn.net/img/view/2017/12/7/1602251.png,0,0.975586236,1132,475,1982,1325,850,850,fluttershy
1607192.png,https://derpicdn.net/img/view/2017/12/13/1607192.png,0,0.991196334,0,0,745,739,745,739,fluttershy
1607785.png,https://derpicdn.net/img/view/2017/12/14/1607785.png,0,0.978846669,73,0,687,564,614,564,fluttershy
1610842.png,https://derpicdn.net/img/view/2017/12/18/1610842.png,0,0.981524646,80,0,1350,1078,1270,1078,fluttershy
1615064.png,https://derpicdn.net/img/view/2017/12/24/1615064.png,0,0.997278929,152,86,816,750,664,664,fluttershy
1616994.png,https://derpicdn.net/img/view/2017/12/27/1616994.png,0,0.99804163,388,0,1560,1123,1172,1123,fluttershy
1622996.png,https://derpicdn.net/img/view/2018/1/3/1622996.png,1,0.970178246,198,336,1002,1140,804,804,fluttershy
1624788.png,https://derpicdn.net/img/view/2018/1/5/1624788.png,0,0.955080688,12,0,458,397,446,397,fluttershy
1626518.png,https://derpicdn.net/img/view/2018/1/7/1626518.png,0,0.983801901,0,0,270,255,270,255,fluttershy
1628115.png,https://derpicdn.net/img/view/2018/1/9/1628115.png,0,0.956181467,3724,0,7000,3310,3276,3310,fluttershy
1636525.png,https://derpicdn.net/img/view/2018/1/20/1636525.png,0,0.997889936,1053,0,2655,1406,1602,1406,fluttershy
1639474.png,https://derpicdn.net/img/view/2018/1/24/1639474.png,0,0.99283427,173,14,1027,868,854,854,fluttershy
1639993.png,https://derpicdn.net/img/view/2018/1/24/1639993.png,0,0.999406874,523,79,1143,699,620,620,fluttershy
1643384.png,https://derpicdn.net/img/view/2018/1/29/1643384.png,0,0.903856039,269,0,725,455,456,455,fluttershy
1644202.png,https://derpicdn.net/img/view/2018/1/30/1644202.png,0,0.941697419,484,0,2150,1503,1666,1503,fluttershy
1645001.png,https://derpicdn.net/img/view/2018/1/31/1645001.png,0,0.995060802,69,66,723,720,654,654,fluttershy
1645438.png,https://derpicdn.net/img/view/2018/1/31/1645438.png,0,0.972935498,76,9,498,431,422,422,fluttershy
1649651.png,https://derpicdn.net/img/view/2018/2/6/1649651.png,0,0.98350209,42,0,572,479,530,479,fluttershy
1649709.png,https://derpicdn.net/img/view/2018/2/6/1649709.png,0,0.996845961,381,2,1393,1014,1012,1012,fluttershy
1649879.png,https://derpicdn.net/img/view/2018/2/6/1649879.png,0,0.981200278,10,0,1200,1323,1190,1323,fluttershy
1651178.png,https://derpicdn.net/img/view/2018/2/8/1651178.png,0,0.957429886,491,0,1000,516,509,516,fluttershy
1652741.png,https://derpicdn.net/img/view/2018/2/10/1652741.png,0,0.909438431,430,412,2472,2454,2042,2042,fluttershy
1655215.png,https://derpicdn.net/img/view/2018/2/13/1655215.png,0,0.999161124,317,0,801,468,484,468,fluttershy
1655215.png,https://derpicdn.net/img/view/2018/2/13/1655215.png,1,0.986982524,1089,7,1613,531,524,524,fluttershy
1656076.png,https://derpicdn.net/img/view/2018/2/14/1656076.png,0,0.999161899,190,0,1262,1027,1072,1027,fluttershy
1660759.png,https://derpicdn.net/img/view/2018/2/19/1660759.png,0,0.997263074,275,18,943,686,668,668,fluttershy
16621.png,https://derpicdn.net/img/view/2012/6/23/16621.png,0,0.988575339,746,310,1230,794,484,484,fluttershy
1668680.png,https://derpicdn.net/img/view/2018/3/1/1668680.png,0,0.980452359,115,0,847,721,732,721,fluttershy
1672461.png,https://derpicdn.net/img/view/2018/3/5/1672461.png,0,0.986939549,63,0,2177,2040,2114,2040,fluttershy
1673432.png,https://derpicdn.net/img/view/2018/3/6/1673432.png,0,0.92519635,361,179,1325,1143,964,964,fluttershy
1683664.png,https://derpicdn.net/img/view/2018/3/18/1683664.png,0,0.986676157,473,183,947,657,474,474,fluttershy
1684941.png,https://derpicdn.net/img/view/2018/3/19/1684941.png,0,0.998544157,548,10,1750,1212,1202,1202,fluttershy
1690670.png,https://derpicdn.net/img/view/2018/3/25/1690670.png,0,0.998725355,77,5,347,275,270,270,fluttershy
1692070.png,https://derpicdn.net/img/view/2018/3/27/1692070.png,0,0.991931915,0,699,6935,7738,6935,7039,fluttershy
1692967.png,https://derpicdn.net/img/view/2018/3/28/1692967.png,0,0.963185012,82,116,480,514,398,398,fluttershy
1696769.png,https://derpicdn.net/img/view/2018/4/1/1696769.png,0,0.961641908,0,5,178,195,178,190,fluttershy
1696796.png,https://derpicdn.net/img/view/2018/4/1/1696796.png,1,0.998205364,148,1066,746,1664,598,598,fluttershy
1696796.png,https://derpicdn.net/img/view/2018/4/1/1696796.png,2,0.982932925,102,56,626,580,524,524,fluttershy
1701690.png,https://derpicdn.net/img/view/2018/4/7/1701690.png,0,0.988709807,0,43,884,985,884,942,fluttershy
170175.png,https://derpicdn.net/img/view/2012/12/2/170175.png,0,0.987586558,0,0,271,292,271,292,fluttershy
1702443.png,https://derpicdn.net/img/view/2018/4/8/1702443.png,0,0.99524051,111,0,427,305,316,305,fluttershy
1702453.png,https://derpicdn.net/img/view/2018/4/8/1702453.png,0,0.991804481,138,0,499,345,361,345,fluttershy
1702456.png,https://derpicdn.net/img/view/2018/4/8/1702456.png,0,0.992346644,141,0,407,265,266,265,fluttershy
1703962.png,https://derpicdn.net/img/view/2018/4/10/1703962.png,0,0.97316438,518,130,720,358,202,228,fluttershy
1705172.png,https://derpicdn.net/img/view/2018/4/11/1705172.png,0,0.996330261,259,13,893,647,634,634,fluttershy
1707694.png,https://derpicdn.net/img/view/2018/4/14/1707694.png,0,0.987939119,65,46,1105,1086,1040,1040,fluttershy
1708071.png,https://derpicdn.net/img/view/2018/4/15/1708071.png,0,0.922203302,412,138,912,638,500,500,fluttershy
1709309.png,https://derpicdn.net/img/view/2018/4/16/1709309.png,0,0.970627844,180,17,1010,847,830,830,fluttershy
1710096.png,https://derpicdn.net/img/view/2018/4/17/1710096.png,0,0.987040579,180,0,786,573,606,573,fluttershy
1711.png,https://derpicdn.net/img/view/2012/1/23/1711.png,0,0.975953281,21,0,1000,936,979,936,fluttershy
1713097.png,https://derpicdn.net/img/view/2018/4/20/1713097.png,0,0.99715066,1677,2,2365,690,688,688,fluttershy
1714564.png,https://derpicdn.net/img/view/2018/4/22/1714564.png,0,0.997470677,240,47,516,323,276,276,fluttershy
1715923.png,https://derpicdn.net/img/view/2018/4/24/1715923.png,0,0.98675853,302,0,932,584,630,584,fluttershy
1717868.png,https://derpicdn.net/img/view/2018/4/26/1717868.png,0,0.989979923,1601,344,2857,1600,1256,1256,fluttershy
1718032.png,https://derpicdn.net/img/view/2018/4/27/1718032.png,0,0.943360388,115,328,459,672,344,344,fluttershy
1718589.png,https://derpicdn.net/img/view/2018/4/27/1718589.png,0,0.934372425,888,0,4000,2290,3112,2290,fluttershy
1718826.png,https://derpicdn.net/img/view/2018/4/28/1718826.png,0,0.951690435,858,227,1364,733,506,506,fluttershy
1720822.png,https://derpicdn.net/img/view/2018/4/30/1720822.png,0,0.986669242,1017,0,1873,818,856,818,fluttershy
1720940.png,https://derpicdn.net/img/view/2018/4/30/1720940.png,0,0.977814913,82,0,1262,1127,1180,1127,fluttershy
1724588.png,https://derpicdn.net/img/view/2018/5/5/1724588.png,0,0.92343545,265,90,661,486,396,396,fluttershy
1725651.png,https://derpicdn.net/img/view/2018/5/6/1725651.png,0,0.90898025,0,0,665,713,665,713,fluttershy
1726062.png,https://derpicdn.net/img/view/2018/5/6/1726062.png,0,0.991749644,287,217,719,649,432,432,fluttershy
1727863.png,https://derpicdn.net/img/view/2018/5/8/1727863.png,0,0.994249523,4,0,902,861,898,861,fluttershy
1732379.png,https://derpicdn.net/img/view/2018/5/14/1732379.png,0,0.96160233,0,0,250,308,250,308,fluttershy
1732605.png,https://derpicdn.net/img/view/2018/5/14/1732605.png,0,0.94464463,239,0,3583,3193,3344,3193,fluttershy
1737284.png,https://derpicdn.net/img/view/2018/5/20/1737284.png,0,0.989421964,529,0,981,405,452,405,fluttershy
1738065.png,https://derpicdn.net/img/view/2018/5/21/1738065.png,0,0.988422453,187,54,1001,868,814,814,fluttershy
1740756.png,https://derpicdn.net/img/view/2018/5/25/1740756.png,0,0.995821655,1269,196,2469,1396,1200,1200,fluttershy
174147.png,https://derpicdn.net/img/view/2012/12/6/174147.png,0,0.932190895,257,272,489,504,232,232,fluttershy
1741476.png,https://derpicdn.net/img/view/2018/5/26/1741476.png,0,0.977498114,32,0,484,432,452,432,fluttershy
1745331.png,https://derpicdn.net/img/view/2018/5/30/1745331.png,0,0.996509016,487,0,945,458,458,458,fluttershy
1753947.png,https://derpicdn.net/img/view/2018/6/9/1753947.png,0,0.999112368,2005,437,3485,1917,1480,1480,fluttershy
1754581.png,https://derpicdn.net/img/view/2018/6/10/1754581.png,0,0.988376558,1852,0,3320,1176,1468,1176,fluttershy
1754581.png,https://derpicdn.net/img/view/2018/6/10/1754581.png,1,0.988111794,628,18,1492,882,864,864,fluttershy
1758413.png,https://derpicdn.net/img/view/2018/6/15/1758413.png,0,0.941167414,31,0,825,777,794,777,fluttershy
1759371.png,https://derpicdn.net/img/view/2018/6/16/1759371.png,0,0.995515108,203,85,463,345,260,260,fluttershy
1760012.png,https://derpicdn.net/img/view/2018/6/17/1760012.png,0,0.985286593,154,38,796,680,642,642,fluttershy
1762952.png,https://derpicdn.net/img/view/2018/6/21/1762952.png,0,0.945709288,323,341,855,873,532,532,fluttershy
1763471.png,https://derpicdn.net/img/view/2018/6/22/1763471.png,0,0.989659429,1060,181,2682,1803,1622,1622,fluttershy
1765698.png,https://derpicdn.net/img/view/2018/6/25/1765698.png,0,0.97735858,378,135,2720,2477,2342,2342,fluttershy
1766190.png,https://derpicdn.net/img/view/2018/6/26/1766190.png,0,0.981968224,170,77,734,641,564,564,fluttershy
1767715.png,https://derpicdn.net/img/view/2018/6/28/1767715.png,0,0.998171806,409,59,671,321,262,262,fluttershy
1768591.png,https://derpicdn.net/img/view/2018/6/29/1768591.png,0,0.994946837,250,0,1088,817,838,817,fluttershy
1770035.png,https://derpicdn.net/img/view/2018/7/1/1770035.png,0,0.985633969,95,38,599,542,504,504,fluttershy
1776318.png,https://derpicdn.net/img/view/2018/7/8/1776318.png,0,0.9969275,93,0,537,437,444,437,fluttershy
1780402.png,https://derpicdn.net/img/view/2018/7/13/1780402.png,0,0.993313968,229,0,937,577,708,577,fluttershy
1787064.png,https://derpicdn.net/img/view/2018/7/22/1787064.png,0,0.998243868,89,0,717,581,628,581,fluttershy
1789299.png,https://derpicdn.net/img/view/2018/7/25/1789299.png,0,0.993843377,377,17,929,569,552,552,fluttershy
1796905.png,https://derpicdn.net/img/view/2018/8/3/1796905.png,0,0.978551626,488,17,1324,853,836,836,fluttershy
1797680.png,https://derpicdn.net/img/view/2018/8/4/1797680.png,0,0.993431568,698,0,1514,807,816,807,fluttershy
1800908.png,https://derpicdn.net/img/view/2018/8/7/1800908.png,0,0.987683237,165,13,499,347,334,334,fluttershy
1801584.png,https://derpicdn.net/img/view/2018/8/8/1801584.png,0,0.968753457,0,444,644,1100,644,656,fluttershy
1806781.png,https://derpicdn.net/img/view/2018/8/14/1806781.png,0,0.993426919,1985,254,2611,880,626,626,fluttershy
1807086.png,https://derpicdn.net/img/view/2018/8/15/1807086.png,0,0.913728833,214,0,1354,1085,1140,1085,fluttershy
1807100.png,https://derpicdn.net/img/view/2018/8/15/1807100.png,0,0.975557923,457,125,949,617,492,492,fluttershy
1807675.png,https://derpicdn.net/img/view/2018/8/15/1807675.png,0,0.989386737,61,0,783,602,722,602,fluttershy
1811646.png,https://derpicdn.net/img/view/2018/8/20/1811646.png,0,0.987359881,452,394,960,902,508,508,fluttershy
1817068.png,https://derpicdn.net/img/view/2018/8/26/1817068.png,0,0.998799622,170,0,538,359,368,359,fluttershy
1818296.png,https://derpicdn.net/img/view/2018/8/28/1818296.png,0,0.999408722,313,293,1403,1383,1090,1090,fluttershy
1820976.png,https://derpicdn.net/img/view/2018/8/31/1820976.png,0,0.971909225,649,572,1085,1008,436,436,fluttershy
1821967.png,https://derpicdn.net/img/view/2018/9/1/1821967.png,0,0.976967633,55,0,415,349,360,349,fluttershy
1826203.png,https://derpicdn.net/img/view/2018/9/6/1826203.png,0,0.998866916,625,66,1475,916,850,850,fluttershy
1827906.png,https://derpicdn.net/img/view/2018/9/8/1827906.png,0,0.905052125,1236,560,3350,2674,2114,2114,fluttershy
1828427.png,https://derpicdn.net/img/view/2018/9/9/1828427.png,0,0.927855194,325,226,651,552,326,326,fluttershy
1832885.png,https://derpicdn.net/img/view/2018/9/15/1832885.png,0,0.928282797,591,535,901,845,310,310,fluttershy
1834498.png,https://derpicdn.net/img/view/2018/9/17/1834498.png,0,0.959004581,514,169,1198,853,684,684,fluttershy
1835083.png,https://derpicdn.net/img/view/2018/9/17/1835083.png,0,0.983702183,354,493,1842,1981,1488,1488,fluttershy
1838467.png,https://derpicdn.net/img/view/2018/9/22/1838467.png,0,0.978645325,324,111,776,563,452,452,fluttershy
1839286.png,https://derpicdn.net/img/view/2018/9/23/1839286.png,0,0.983235419,28,0,1181,1339,1153,1339,fluttershy
1842022.png,https://derpicdn.net/img/view/2018/9/26/1842022.png,0,0.961119354,3544,3012,6090,5558,2546,2546,fluttershy
1846757.png,https://derpicdn.net/img/view/2018/10/3/1846757.png,0,0.951872706,579,0,3205,2566,2626,2566,fluttershy
1847042.png,https://derpicdn.net/img/view/2018/10/3/1847042.png,0,0.914046168,0,0,2334,2603,2334,2603,fluttershy
1847974.png,https://derpicdn.net/img/view/2018/10/4/1847974.png,0,0.922858894,132,0,718,583,586,583,fluttershy
1848440.png,https://derpicdn.net/img/view/2018/10/5/1848440.png,0,0.980831623,25,0,989,919,964,919,fluttershy
1849420.png,https://derpicdn.net/img/view/2018/10/6/1849420.png,0,0.999613047,556,82,974,500,418,418,fluttershy
185107.png,https://derpicdn.net/img/view/2012/12/17/185107.png,0,0.927304149,284,0,2000,1619,1716,1619,fluttershy
1851522.png,https://derpicdn.net/img/view/2018/10/8/1851522.png,0,0.938674927,455,274,900,722,445,448,fluttershy
1851656.png,https://derpicdn.net/img/view/2018/10/8/1851656.png,0,0.99406296,111,0,795,628,684,628,fluttershy
1853288.png,https://derpicdn.net/img/view/2018/10/10/1853288.png,0,0.993676186,61,69,577,585,516,516,fluttershy
18621.png,https://derpicdn.net/img/view/2012/6/24/18621.png,0,0.988521755,152,0,718,540,566,540,fluttershy
1865055.png,https://derpicdn.net/img/view/2018/10/24/1865055.png,0,0.98110348,1164,430,1644,910,480,480,fluttershy
1866999.png,https://derpicdn.net/img/view/2018/10/27/1866999.png,0,0.976924896,34,0,884,777,850,777,fluttershy
1869829.png,https://derpicdn.net/img/view/2018/10/29/1869829.png,0,0.997107565,1278,88,2918,1728,1640,1640,fluttershy
18706.jpg,https://derpicdn.net/img/view/2012/6/24/18706.jpg,0,0.997948885,148,137,808,797,660,660,fluttershy
1876849.png,https://derpicdn.net/img/view/2018/11/7/1876849.png,0,0.997452855,233,0,663,423,430,423,fluttershy
1877524.png,https://derpicdn.net/img/view/2018/11/8/1877524.png,0,0.905750513,226,0,606,303,380,303,fluttershy
1877744.png,https://derpicdn.net/img/view/2018/11/8/1877744.png,0,0.957999766,290,176,2300,2186,2010,2010,fluttershy
1878420.png,https://derpicdn.net/img/view/2018/11/9/1878420.png,0,0.947859526,180,0,854,575,674,575,fluttershy
1879853.png,https://derpicdn.net/img/view/2018/11/11/1879853.png,0,0.975007713,0,40,3000,3306,3000,3266,fluttershy
1884630.png,https://derpicdn.net/img/view/2018/11/17/1884630.png,0,0.977452993,371,0,1033,592,662,592,fluttershy
1889811.png,https://derpicdn.net/img/view/2018/11/24/1889811.png,0,0.940317214,42,19,522,499,480,480,fluttershy
1890533.png,https://derpicdn.net/img/view/2018/11/25/1890533.png,0,0.966776013,41,0,387,325,346,325,fluttershy
1890817.png,https://derpicdn.net/img/view/2018/11/25/1890817.png,0,0.953413129,20,0,360,329,340,329,fluttershy
1894784.png,https://derpicdn.net/img/view/2018/11/30/1894784.png,0,0.998074055,601,179,1195,773,594,594,fluttershy
1895566.png,https://derpicdn.net/img/view/2018/12/1/1895566.png,0,0.972854078,0,0,602,611,602,611,fluttershy
1898007.png,https://derpicdn.net/img/view/2018/12/4/1898007.png,0,0.996125698,170,0,506,308,336,308,fluttershy
1898477.png,https://derpicdn.net/img/view/2018/12/4/1898477.png,0,0.991610289,178,10,1180,1012,1002,1002,fluttershy
1906462.png,https://derpicdn.net/img/view/2018/12/12/1906462.png,0,0.997645974,498,0,876,376,378,376,fluttershy
1908932.png,https://derpicdn.net/img/view/2018/12/15/1908932.png,0,0.946722388,261,6,900,672,639,666,fluttershy
1910882.png,https://derpicdn.net/img/view/2018/12/17/1910882.png,0,0.992959857,130,103,570,543,440,440,fluttershy
1913576.png,https://derpicdn.net/img/view/2018/12/20/1913576.png,0,0.998702526,0,0,2916,2700,2916,2700,fluttershy
1915657.png,https://derpicdn.net/img/view/2018/12/22/1915657.png,0,0.983165264,69,0,445,351,376,351,fluttershy
1919829.png,https://derpicdn.net/img/view/2018/12/27/1919829.png,0,0.988180935,246,32,666,452,420,420,fluttershy
1921109.png,https://derpicdn.net/img/view/2018/12/28/1921109.png,0,0.961431444,1149,0,4428,3245,3279,3245,fluttershy
1921817.png,https://derpicdn.net/img/view/2018/12/30/1921817.png,0,0.985668004,392,0,3406,2589,3014,2589,fluttershy
1923181.png,https://derpicdn.net/img/view/2018/12/31/1923181.png,0,0.944607079,287,234,637,584,350,350,fluttershy
1925486.png,https://derpicdn.net/img/view/2019/1/3/1925486.png,0,0.986143827,120,0,1088,947,968,947,fluttershy
1926050.png,https://derpicdn.net/img/view/2019/1/4/1926050.png,0,0.995413065,160,21,552,413,392,392,fluttershy
1926910.png,https://derpicdn.net/img/view/2019/1/5/1926910.png,0,0.998457134,269,0,601,330,332,330,fluttershy
1926910.png,https://derpicdn.net/img/view/2019/1/5/1926910.png,1,0.943108022,9,21,233,245,224,224,fluttershy
1927456.png,https://derpicdn.net/img/view/2019/1/5/1927456.png,0,0.959088266,1636,355,2856,1575,1220,1220,fluttershy
1928183.png,https://derpicdn.net/img/view/2019/1/6/1928183.png,0,0.987370789,1221,1172,3491,3442,2270,2270,fluttershy
1928784.png,https://derpicdn.net/img/view/2019/1/7/1928784.png,0,0.918785095,77,115,1637,1675,1560,1560,fluttershy
1928977.png,https://derpicdn.net/img/view/2019/1/7/1928977.png,0,0.92329669,154,0,1158,966,1004,966,fluttershy
1928979.png,https://derpicdn.net/img/view/2019/1/7/1928979.png,0,0.92329067,154,0,1158,966,1004,966,fluttershy
1928980.png,https://derpicdn.net/img/view/2019/1/7/1928980.png,0,0.923339486,154,0,1158,966,1004,966,fluttershy
19312.jpg,https://derpicdn.net/img/view/2012/6/24/19312.jpg,0,0.959555209,35,0,617,480,582,480,fluttershy
1937564.png,https://derpicdn.net/img/view/2019/1/17/1937564.png,0,0.965497792,93,0,1131,1030,1038,1030,fluttershy
1938416.png,https://derpicdn.net/img/view/2019/1/18/1938416.png,0,0.995777845,41,4,349,312,308,308,fluttershy
1938778.png,https://derpicdn.net/img/view/2019/1/19/1938778.png,0,0.995944083,1259,236,2603,1580,1344,1344,fluttershy
1939979.png,https://derpicdn.net/img/view/2019/1/20/1939979.png,0,0.986496091,95,86,933,924,838,838,fluttershy
1942434.png,https://derpicdn.net/img/view/2019/1/23/1942434.png,0,0.993953049,519,137,929,547,410,410,fluttershy
1943583.png,https://derpicdn.net/img/view/2019/1/24/1943583.png,0,0.999851465,483,4,1313,834,830,830,fluttershy
1946125.png,https://derpicdn.net/img/view/2019/1/27/1946125.png,0,0.978496134,143,113,1500,1500,1357,1387,fluttershy
1947099.png,https://derpicdn.net/img/view/2019/1/28/1947099.png,0,0.982120812,251,49,967,765,716,716,fluttershy
1947405.png,https://derpicdn.net/img/view/2019/1/29/1947405.png,0,0.981595755,200,64,684,548,484,484,fluttershy
1952886.png,https://derpicdn.net/img/view/2019/2/4/1952886.png,0,0.977114975,454,0,1450,886,996,886,fluttershy
1954354.png,https://derpicdn.net/img/view/2019/2/5/1954354.png,0,0.99726975,539,314,1273,1048,734,734,fluttershy
1956204.png,https://derpicdn.net/img/view/2019/2/7/1956204.png,0,0.926211953,396,1718,2322,3644,1926,1926,fluttershy
1957256.png,https://derpicdn.net/img/view/2019/2/9/1957256.png,0,0.972519755,0,37,210,257,210,220,fluttershy
1958218.png,https://derpicdn.net/img/view/2019/2/10/1958218.png,0,0.982797623,265,0,763,418,498,418,fluttershy
1960298.png,https://derpicdn.net/img/view/2019/2/12/1960298.png,0,0.93738097,0,0,1502,1487,1502,1487,fluttershy
1962536.png,https://derpicdn.net/img/view/2019/2/15/1962536.png,0,0.997718871,497,251,1467,1221,970,970,fluttershy
1965332.png,https://derpicdn.net/img/view/2019/2/18/1965332.png,0,0.987319648,178,190,2802,2814,2624,2624,fluttershy
1967016.png,https://derpicdn.net/img/view/2019/2/20/1967016.png,0,0.995758295,1368,415,2586,1633,1218,1218,fluttershy
1971440.png,https://derpicdn.net/img/view/2019/2/25/1971440.png,0,0.988161683,129,25,1435,1331,1306,1306,fluttershy
1972282.png,https://derpicdn.net/img/view/2019/2/26/1972282.png,0,0.990587413,196,0,1502,1304,1306,1304,fluttershy
1974285.png,https://derpicdn.net/img/view/2019/3/1/1974285.png,0,0.995491683,297,0,1115,798,818,798,fluttershy
1977315.png,https://derpicdn.net/img/view/2019/3/4/1977315.png,0,0.993996322,355,0,2597,2200,2242,2200,fluttershy
1984901.png,https://derpicdn.net/img/view/2019/3/14/1984901.png,0,0.963179171,548,0,2572,1932,2024,1932,fluttershy
1985178.png,https://derpicdn.net/img/view/2019/3/14/1985178.png,0,0.999309182,2450,0,4034,1574,1584,1574,fluttershy
1985799.png,https://derpicdn.net/img/view/2019/3/15/1985799.png,0,0.984615207,163,3,961,801,798,798,fluttershy
1987533.png,https://derpicdn.net/img/view/2019/3/16/1987533.png,0,0.985659778,398,0,906,476,508,476,fluttershy
1993068.png,https://derpicdn.net/img/view/2019/3/23/1993068.png,0,0.994401753,163,0,875,622,712,622,fluttershy
1993068.png,https://derpicdn.net/img/view/2019/3/23/1993068.png,1,0.991143465,429,546,709,826,280,280,fluttershy
1993823.png,https://derpicdn.net/img/view/2019/3/24/1993823.png,0,0.995216489,0,16,665,704,665,688,fluttershy
1996998.png,https://derpicdn.net/img/view/2019/3/28/1996998.png,0,0.9915573,204,0,564,302,360,302,fluttershy
1998556.png,https://derpicdn.net/img/view/2019/3/30/1998556.png,0,0.998304963,289,0,779,480,490,480,fluttershy
1998601.png,https://derpicdn.net/img/view/2019/3/30/1998601.png,0,0.997703612,100,0,628,448,528,448,fluttershy
1998629.png,https://derpicdn.net/img/view/2019/3/30/1998629.png,0,0.992047846,0,0,1553,1592,1553,1592,fluttershy
1999907.png,https://derpicdn.net/img/view/2019/4/1/1999907.png,0,0.95113951,582,112,1322,852,740,740,fluttershy
2002095.png,https://derpicdn.net/img/view/2019/4/3/2002095.png,0,0.963401079,76,70,854,848,778,778,fluttershy
2003076.png,https://derpicdn.net/img/view/2019/4/4/2003076.png,0,0.978575468,0,0,386,384,386,384,fluttershy
2007164.png,https://derpicdn.net/img/view/2019/4/9/2007164.png,0,0.919993043,5,0,405,374,400,374,fluttershy
2010333.png,https://derpicdn.net/img/view/2019/4/13/2010333.png,0,0.994586289,2331,0,4737,2314,2406,2314,fluttershy
2012227.png,https://derpicdn.net/img/view/2019/4/14/2012227.png,0,0.988016665,79,0,571,482,492,482,fluttershy
2015464.png,https://derpicdn.net/img/view/2019/4/18/2015464.png,0,0.989686787,72,0,340,261,268,261,fluttershy
2015629.png,https://derpicdn.net/img/view/2019/4/18/2015629.png,0,0.957053423,0,0,4615,5372,4615,5372,fluttershy
2018771.png,https://derpicdn.net/img/view/2019/4/21/2018771.png,0,0.951146841,262,0,1200,928,938,928,fluttershy
2019702.png,https://derpicdn.net/img/view/2019/4/22/2019702.png,0,0.992233455,0,6,491,502,491,496,fluttershy
2020896.png,https://derpicdn.net/img/view/2019/4/23/2020896.png,0,0.985474586,0,0,1132,1101,1132,1101,fluttershy
2023749.png,https://derpicdn.net/img/view/2019/4/27/2023749.png,0,0.995984077,1017,469,1729,1181,712,712,fluttershy
2024461.png,https://derpicdn.net/img/view/2019/4/27/2024461.png,0,0.986660182,818,0,1090,240,272,240,fluttershy
2025934.png,https://derpicdn.net/img/view/2019/4/28/2025934.png,0,0.950685084,619,371,1447,1199,828,828,fluttershy
2027606.png,https://derpicdn.net/img/view/2019/4/30/2027606.png,0,0.997864246,384,0,744,358,360,358,fluttershy
2027914.png,https://derpicdn.net/img/view/2019/5/1/2027914.png,0,0.993018866,561,0,965,390,404,390,fluttershy
2030165.png,https://derpicdn.net/img/view/2019/5/4/2030165.png,0,0.924711645,832,321,2700,2307,1868,1986,fluttershy
2030786.png,https://derpicdn.net/img/view/2019/5/4/2030786.png,0,0.997467995,1233,0,2613,1326,1380,1326,fluttershy
2035965.png,https://derpicdn.net/img/view/2019/5/11/2035965.png,0,0.99918592,267,164,1213,1110,946,946,fluttershy
2038611.png,https://derpicdn.net/img/view/2019/5/14/2038611.png,0,0.957979083,34,2,1134,1080,1100,1078,fluttershy
2042675.png,https://derpicdn.net/img/view/2019/5/18/2042675.png,0,0.992848933,13,0,1163,920,1150,920,fluttershy
2042748.png,https://derpicdn.net/img/view/2019/5/19/2042748.png,0,0.965906739,154,0,1392,1026,1238,1026,fluttershy
2045166.png,https://derpicdn.net/img/view/2019/5/21/2045166.png,0,0.993034661,340,58,682,400,342,342,fluttershy
2051986.png,https://derpicdn.net/img/view/2019/5/28/2051986.png,0,0.944838166,0,0,682,736,682,736,fluttershy
2056044.png,https://derpicdn.net/img/view/2019/6/2/2056044.png,0,0.985697865,412,36,1168,792,756,756,fluttershy
2056061.png,https://derpicdn.net/img/view/2019/6/2/2056061.png,0,0.986939847,7,0,389,364,382,364,fluttershy
2056592.png,https://derpicdn.net/img/view/2019/6/3/2056592.png,0,0.943815887,224,9,1918,1703,1694,1694,fluttershy
2057173.png,https://derpicdn.net/img/view/2019/6/3/2057173.png,0,0.998550951,290,23,764,497,474,474,fluttershy
2059114.png,https://derpicdn.net/img/view/2019/6/6/2059114.png,0,0.970343828,110,0,796,672,686,672,fluttershy
2061991.png,https://derpicdn.net/img/view/2019/6/10/2061991.png,0,0.997140169,96,0,1080,929,984,929,fluttershy
2063883.png,https://derpicdn.net/img/view/2019/6/12/2063883.png,0,0.99819988,71,0,799,642,728,642,fluttershy
2064121.png,https://derpicdn.net/img/view/2019/6/13/2064121.png,0,0.975092292,18,139,580,701,562,562,fluttershy
2064121.png,https://derpicdn.net/img/view/2019/6/13/2064121.png,3,0.964271188,1797,96,2461,760,664,664,fluttershy
206558.png,https://derpicdn.net/img/view/2013/1/8/206558.png,0,0.996957839,49,0,475,408,426,408,fluttershy
2066369.png,https://derpicdn.net/img/view/2019/6/15/2066369.png,0,0.950520992,117,42,681,606,564,564,fluttershy
2068442.png,https://derpicdn.net/img/view/2019/6/18/2068442.png,0,0.974242926,636,0,1898,1241,1262,1241,fluttershy
2070885.png,https://derpicdn.net/img/view/2019/6/20/2070885.png,0,0.994482279,76,342,1146,1412,1070,1070,fluttershy
2075136.png,https://derpicdn.net/img/view/2019/6/25/2075136.png,0,0.98275882,120,0,436,276,316,276,fluttershy
2075372.png,https://derpicdn.net/img/view/2019/6/26/2075372.png,0,0.917613149,165,0,1157,958,992,958,fluttershy
2075574.png,https://derpicdn.net/img/view/2019/6/26/2075574.png,0,0.963464797,430,0,1388,790,958,790,fluttershy
2077953.png,https://derpicdn.net/img/view/2019/6/28/2077953.png,0,0.980623543,380,239,1010,869,630,630,fluttershy
2078189.png,https://derpicdn.net/img/view/2019/6/29/2078189.png,0,0.900894344,346,110,842,606,496,496,fluttershy
2082229.png,https://derpicdn.net/img/view/2019/7/3/2082229.png,0,0.977222443,347,304,613,570,266,266,fluttershy
2086848.png,https://derpicdn.net/img/view/2019/7/9/2086848.png,0,0.918477774,81,0,501,402,420,402,fluttershy
2095115.png,https://derpicdn.net/img/view/2019/7/18/2095115.png,0,0.954227269,818,735,1434,1351,616,616,fluttershy
2096228.png,https://derpicdn.net/img/view/2019/7/19/2096228.png,0,0.97908479,46,0,1732,1573,1686,1573,fluttershy
2098137.png,https://derpicdn.net/img/view/2019/7/22/2098137.png,0,0.982507408,441,23,1021,603,580,580,fluttershy
2099787.png,https://derpicdn.net/img/view/2019/7/24/2099787.png,0,0.980534673,978,254,2072,1348,1094,1094,fluttershy
2101142.png,https://derpicdn.net/img/view/2019/7/25/2101142.png,0,0.93900913,443,393,757,707,314,314,fluttershy
2103597.png,https://derpicdn.net/img/view/2019/7/29/2103597.png,0,0.939334393,184,0,1040,850,856,850,fluttershy
2105533.png,https://derpicdn.net/img/view/2019/7/31/2105533.png,0,0.99550283,3,0,889,781,886,781,fluttershy
2106280.png,https://derpicdn.net/img/view/2019/8/1/2106280.png,0,0.989093125,183,0,1401,1160,1218,1160,fluttershy
2108209.png,https://derpicdn.net/img/view/2019/8/3/2108209.png,0,0.991491497,331,0,1305,934,974,934,fluttershy
2112890.png,https://derpicdn.net/img/view/2019/8/9/2112890.png,0,0.985281646,202,4,800,602,598,598,fluttershy
2117029.png,https://derpicdn.net/img/view/2019/8/13/2117029.png,0,0.996302009,352,66,814,528,462,462,fluttershy
211726.png,https://derpicdn.net/img/view/2013/1/13/211726.png,0,0.988187134,484,117,850,483,366,366,fluttershy
2117881.png,https://derpicdn.net/img/view/2019/8/14/2117881.png,0,0.9525792,143,53,853,763,710,710,fluttershy
2119417.png,https://derpicdn.net/img/view/2019/8/16/2119417.png,0,0.994362891,343,48,713,418,370,370,fluttershy
2119907.png,https://derpicdn.net/img/view/2019/8/16/2119907.png,0,0.972558856,382,179,702,499,320,320,fluttershy
2120605.png,https://derpicdn.net/img/view/2019/8/17/2120605.png,0,0.94008112,424,0,1718,1060,1294,1060,fluttershy
2121539.png,https://derpicdn.net/img/view/2019/8/18/2121539.png,0,0.996465564,58,0,1878,1754,1820,1754,fluttershy
2121548.png,https://derpicdn.net/img/view/2019/8/18/2121548.png,0,0.97254777,261,0,1407,1103,1146,1103,fluttershy
2122858.png,https://derpicdn.net/img/view/2019/8/20/2122858.png,0,0.992183268,0,16,1994,2128,1994,2112,fluttershy
2123037.png,https://derpicdn.net/img/view/2019/8/20/2123037.png,0,0.958142102,735,41,1081,387,346,346,fluttershy
2123790.png,https://derpicdn.net/img/view/2019/8/21/2123790.png,0,0.976418316,0,0,1278,1257,1278,1257,fluttershy
2125143.png,https://derpicdn.net/img/view/2019/8/23/2125143.png,0,0.997304976,644,221,2920,2497,2276,2276,fluttershy
2126533.png,https://derpicdn.net/img/view/2019/8/24/2126533.png,0,0.991912603,62,0,674,570,612,570,fluttershy
2130575.png,https://derpicdn.net/img/view/2019/8/29/2130575.png,0,0.996463716,459,113,1203,857,744,744,fluttershy
2131360.png,https://derpicdn.net/img/view/2019/8/30/2131360.png,0,0.99765867,66,0,670,583,604,583,fluttershy
2133207.png,https://derpicdn.net/img/view/2019/9/1/2133207.png,0,0.984616041,35,0,603,564,568,564,fluttershy
2135613.png,https://derpicdn.net/img/view/2019/9/3/2135613.png,0,0.974952102,1541,0,2825,1224,1284,1224,fluttershy
2137127.png,https://derpicdn.net/img/view/2019/9/5/2137127.png,0,0.999778092,211,59,821,669,610,610,fluttershy
2140590.png,https://derpicdn.net/img/view/2019/9/10/2140590.png,0,0.997547686,1505,387,2757,1639,1252,1252,fluttershy
21421.png,https://derpicdn.net/img/view/2012/6/26/21421.png,0,0.979155779,34,64,830,860,796,796,fluttershy
2142496.png,https://derpicdn.net/img/view/2019/9/12/2142496.png,0,0.996415138,165,23,555,413,390,390,fluttershy
2144217.png,https://derpicdn.net/img/view/2019/9/14/2144217.png,0,0.989484012,79,26,661,608,582,582,fluttershy
2144697.png,https://derpicdn.net/img/view/2019/9/15/2144697.png,0,0.914698184,898,0,1562,557,664,557,fluttershy
2147878.png,https://derpicdn.net/img/view/2019/9/19/2147878.png,0,0.988921642,251,0,1024,778,773,778,fluttershy
2147883.png,https://derpicdn.net/img/view/2019/9/19/2147883.png,0,0.904135644,178,0,798,577,620,577,fluttershy
2148359.png,https://derpicdn.net/img/view/2019/9/20/2148359.png,0,0.956960917,439,515,1113,1189,674,674,fluttershy
2148842.png,https://derpicdn.net/img/view/2019/9/20/2148842.png,0,0.985132873,582,146,1466,1030,884,884,fluttershy
2152644.png,https://derpicdn.net/img/view/2019/9/25/2152644.png,0,0.999657094,461,230,1515,1284,1054,1054,fluttershy
2154639.png,https://derpicdn.net/img/view/2019/9/28/2154639.png,0,0.947930813,135,95,411,371,276,276,fluttershy
2156062.png,https://derpicdn.net/img/view/2019/9/29/2156062.png,0,0.965844512,339,13,727,401,388,388,fluttershy
2156062.png,https://derpicdn.net/img/view/2019/9/29/2156062.png,1,0.955790579,918,36,1118,236,200,200,fluttershy
2157089.png,https://derpicdn.net/img/view/2019/9/30/2157089.png,0,0.955807626,36,0,660,608,624,608,fluttershy
2161982.png,https://derpicdn.net/img/view/2019/10/6/2161982.png,0,0.933412969,1609,8,2637,1036,1028,1028,fluttershy
2163526.png,https://derpicdn.net/img/view/2019/10/8/2163526.png,0,0.993434668,589,40,943,394,354,354,fluttershy
2164770.png,https://derpicdn.net/img/view/2019/10/10/2164770.png,0,0.97181803,132,21,1192,1167,1060,1146,fluttershy
2165030.png,https://derpicdn.net/img/view/2019/10/10/2165030.png,0,0.99841851,245,5,1239,999,994,994,fluttershy
2166760.png,https://derpicdn.net/img/view/2019/10/12/2166760.png,0,0.998895645,4171,2174,6123,4126,1952,1952,fluttershy
2166760.png,https://derpicdn.net/img/view/2019/10/12/2166760.png,1,0.979017377,1393,641,2891,2139,1498,1498,fluttershy
2166760.png,https://derpicdn.net/img/view/2019/10/12/2166760.png,2,0.932673812,2981,146,4777,1942,1796,1796,fluttershy
2168914.png,https://derpicdn.net/img/view/2019/10/14/2168914.png,0,0.990753651,933,438,2941,2446,2008,2008,fluttershy
2170059.png,https://derpicdn.net/img/view/2019/10/15/2170059.png,0,0.957341731,335,235,733,633,398,398,fluttershy
2173128.png,https://derpicdn.net/img/view/2019/10/18/2173128.png,0,0.997250378,0,16,675,712,675,696,fluttershy
2173268.png,https://derpicdn.net/img/view/2019/10/19/2173268.png,0,0.961613834,341,0,2048,1536,1707,1536,fluttershy
2180328.png,https://derpicdn.net/img/view/2019/10/27/2180328.png,0,0.992544889,458,58,1452,1052,994,994,fluttershy
2180361.png,https://derpicdn.net/img/view/2019/10/27/2180361.png,0,0.950547934,2289,504,2895,1110,606,606,fluttershy
2182973.png,https://derpicdn.net/img/view/2019/10/30/2182973.png,0,0.995925069,172,17,770,615,598,598,fluttershy
2185009.png,https://derpicdn.net/img/view/2019/11/1/2185009.png,0,0.992035627,596,0,1352,682,756,682,fluttershy
2186314.png,https://derpicdn.net/img/view/2019/11/3/2186314.png,0,0.991350293,17,0,237,209,220,209,fluttershy
2186640.png,https://derpicdn.net/img/view/2019/11/3/2186640.png,0,0.984860659,763,81,3111,2429,2348,2348,fluttershy
2187164.png,https://derpicdn.net/img/view/2019/11/4/2187164.png,0,0.995463073,0,0,1973,1785,1973,1785,fluttershy
2187164.png,https://derpicdn.net/img/view/2019/11/4/2187164.png,1,0.986651003,1329,0,3300,1839,1971,1839,fluttershy
2189838.png,https://derpicdn.net/img/view/2019/11/7/2189838.png,0,0.982991993,158,0,1822,1339,1664,1339,fluttershy
2193203.png,https://derpicdn.net/img/view/2019/11/11/2193203.png,0,0.995984912,470,243,948,721,478,478,fluttershy
2193781.png,https://derpicdn.net/img/view/2019/11/12/2193781.png,0,0.994573712,336,53,636,353,300,300,fluttershy
2194928.png,https://derpicdn.net/img/view/2019/11/13/2194928.png,0,0.945357978,221,231,595,605,374,374,fluttershy
2196328.png,https://derpicdn.net/img/view/2019/11/15/2196328.png,0,0.998347998,503,419,1301,1217,798,798,fluttershy
2196922.png,https://derpicdn.net/img/view/2019/11/15/2196922.png,0,0.998619914,6,0,398,355,392,355,fluttershy
2196943.png,https://derpicdn.net/img/view/2019/11/15/2196943.png,0,0.936736226,248,0,1166,900,918,900,fluttershy
2197528.png,https://derpicdn.net/img/view/2019/11/16/2197528.png,0,0.987674117,0,3,705,715,705,712,fluttershy
2199032.png,https://derpicdn.net/img/view/2019/11/17/2199032.png,0,0.985024035,422,54,950,582,528,528,fluttershy
2201388.png,https://derpicdn.net/img/view/2019/11/21/2201388.png,0,0.987769663,0,11,347,371,347,360,fluttershy
2203232.png,https://derpicdn.net/img/view/2019/11/23/2203232.png,0,0.96237278,0,36,435,474,435,438,fluttershy
2204414.png,https://derpicdn.net/img/view/2019/11/24/2204414.png,0,0.975340664,0,0,847,885,847,885,fluttershy
2206605.png,https://derpicdn.net/img/view/2019/11/27/2206605.png,0,0.962021828,30,0,792,677,762,677,fluttershy
220710.png,https://derpicdn.net/img/view/2013/1/22/220710.png,0,0.998121202,655,77,1113,535,458,458,fluttershy
2208220.png,https://derpicdn.net/img/view/2019/11/29/2208220.png,0,0.957145035,0,0,2876,2947,2876,2947,fluttershy
2208900.png,https://derpicdn.net/img/view/2019/11/30/2208900.png,0,0.996211469,339,0,1519,1140,1180,1140,fluttershy
2208944.png,https://derpicdn.net/img/view/2019/11/30/2208944.png,0,0.998665452,1045,14,1755,724,710,710,fluttershy
22090.jpg,https://derpicdn.net/img/view/2012/6/26/22090.jpg,0,0.991903543,123,184,335,396,212,212,fluttershy
2213632.png,https://derpicdn.net/img/view/2019/12/6/2213632.png,0,0.976015151,784,0,1724,902,940,902,fluttershy
2213742.png,https://derpicdn.net/img/view/2019/12/6/2213742.png,0,0.976735771,346,0,640,289,294,289,fluttershy
2225264.jpg,https://derpicdn.net/img/view/2019/12/20/2225264.jpg,0,0.96744293,515,0,1920,1262,1405,1262,fluttershy
2225893.png,https://derpicdn.net/img/view/2019/12/21/2225893.png,0,0.996847868,0,165,1637,1987,1637,1822,fluttershy
2226563.png,https://derpicdn.net/img/view/2019/12/21/2226563.png,0,0.987336934,494,0,1144,638,650,638,fluttershy
2226584.png,https://derpicdn.net/img/view/2019/12/22/2226584.png,0,0.921587825,828,0,2070,1209,1242,1209,fluttershy
2227069.png,https://derpicdn.net/img/view/2019/12/22/2227069.png,0,0.997793317,745,0,2351,1532,1606,1532,fluttershy
222853.png,https://derpicdn.net/img/view/2013/1/25/222853.png,0,0.998364091,296,4,824,532,528,528,fluttershy
2229949.png,https://derpicdn.net/img/view/2019/12/25/2229949.png,0,0.991514862,938,0,1640,653,702,653,fluttershy
2230761.jpg,https://derpicdn.net/img/view/2019/12/26/2230761.jpg,0,0.99532181,190,40,920,770,730,730,fluttershy
2230821.jpg,https://derpicdn.net/img/view/2019/12/26/2230821.jpg,0,0.963906705,103,38,567,502,464,464,fluttershy
2231509.png,https://derpicdn.net/img/view/2019/12/27/2231509.png,0,0.975647092,383,14,919,550,536,536,fluttershy
2235104.png,https://derpicdn.net/img/view/2019/12/31/2235104.png,0,0.996255755,65,0,439,359,374,359,fluttershy
2235500.png,https://derpicdn.net/img/view/2020/1/1/2235500.png,0,0.999282062,1942,0,4000,1920,2058,1920,fluttershy
2237907.png,https://derpicdn.net/img/view/2020/1/3/2237907.png,0,0.994280338,61,0,575,511,514,511,fluttershy
2240948.png,https://derpicdn.net/img/view/2020/1/7/2240948.png,0,0.963824689,821,1536,1967,2682,1146,1146,fluttershy
2245778.png,https://derpicdn.net/img/view/2020/1/12/2245778.png,0,0.99764508,130,48,536,454,406,406,fluttershy
2246081.png,https://derpicdn.net/img/view/2020/1/13/2246081.png,0,0.997935176,311,1,1997,1687,1686,1686,fluttershy
2246892.png,https://derpicdn.net/img/view/2020/1/14/2246892.png,0,0.997158527,96,0,914,756,818,756,fluttershy
2247026.png,https://derpicdn.net/img/view/2020/1/14/2247026.png,0,0.986446738,8,0,462,434,454,434,fluttershy
2247370.png,https://derpicdn.net/img/view/2020/1/14/2247370.png,0,0.99567616,217,4,1600,1478,1383,1474,fluttershy
2247502.jpg,https://derpicdn.net/img/view/2020/1/14/2247502.jpg,0,0.944186032,115,0,1485,1332,1370,1332,fluttershy
2248666.png,https://derpicdn.net/img/view/2020/1/16/2248666.png,0,0.968022287,479,17,2417,1955,1938,1938,fluttershy
2251177.png,https://derpicdn.net/img/view/2020/1/19/2251177.png,0,0.993112385,168,64,778,674,610,610,fluttershy
2254766.jpg,https://derpicdn.net/img/view/2020/1/23/2254766.jpg,0,0.988939047,0,0,1537,1200,1537,1200,fluttershy
2254768.jpg,https://derpicdn.net/img/view/2020/1/23/2254768.jpg,0,0.982254207,0,0,1033,1023,1033,1023,fluttershy
2256771.png,https://derpicdn.net/img/view/2020/1/25/2256771.png,0,0.972165585,85,0,905,752,820,752,fluttershy
2261915.png,https://derpicdn.net/img/view/2020/1/31/2261915.png,0,0.986196041,803,0,3940,3527,3137,3527,fluttershy
2263085.png,https://derpicdn.net/img/view/2020/2/1/2263085.png,0,0.998794436,259,214,719,674,460,460,fluttershy
2263609.jpg,https://derpicdn.net/img/view/2020/2/2/2263609.jpg,0,0.954418242,149,49,2115,2015,1966,1966,fluttershy
2265084.png,https://derpicdn.net/img/view/2020/2/3/2265084.png,0,0.938706517,17,0,612,571,595,571,fluttershy
2266088.png,https://derpicdn.net/img/view/2020/2/5/2266088.png,0,0.953701675,333,23,913,643,580,620,fluttershy
2269037.png,https://derpicdn.net/img/view/2020/2/8/2269037.png,0,0.978228629,0,102,2142,2346,2142,2244,fluttershy
2270125.png,https://derpicdn.net/img/view/2020/2/9/2270125.png,0,0.914413452,0,119,984,1287,984,1168,fluttershy
2270151.png,https://derpicdn.net/img/view/2020/2/9/2270151.png,0,0.995465457,43,9,615,581,572,572,fluttershy
2270973.jpg,https://derpicdn.net/img/view/2020/2/11/2270973.jpg,0,0.996958077,217,11,749,543,532,532,fluttershy
2270982.jpg,https://derpicdn.net/img/view/2020/2/11/2270982.jpg,0,0.998480499,96,0,718,534,622,534,fluttershy
2272274.jpg,https://derpicdn.net/img/view/2020/2/12/2272274.jpg,0,0.993373275,499,14,975,490,476,476,fluttershy
2273996.jpg,https://derpicdn.net/img/view/2020/2/14/2273996.jpg,0,0.999471843,448,0,1142,663,694,663,fluttershy
2274109.jpg,https://derpicdn.net/img/view/2020/2/14/2274109.jpg,0,0.987285793,138,0,762,614,624,614,fluttershy
2274110.jpg,https://derpicdn.net/img/view/2020/2/14/2274110.jpg,0,0.941114068,158,18,734,594,576,576,fluttershy
2274116.png,https://derpicdn.net/img/view/2020/2/14/2274116.png,0,0.99358952,0,0,214,211,214,211,fluttershy
2274192.jpg,https://derpicdn.net/img/view/2020/2/14/2274192.jpg,0,0.950294495,470,0,1446,868,976,868,fluttershy
2274966.png,https://derpicdn.net/img/view/2020/2/15/2274966.png,0,0.979801774,0,0,587,610,587,610,fluttershy
2275672.png,https://derpicdn.net/img/view/2020/2/16/2275672.png,0,0.937772453,0,0,755,726,755,726,fluttershy
2278816.jpg,https://derpicdn.net/img/view/2020/2/20/2278816.jpg,0,0.901023328,1350,0,2472,967,1122,967,fluttershy
2280360.jpg,https://derpicdn.net/img/view/2020/2/21/2280360.jpg,0,0.988095582,327,0,1197,845,870,845,fluttershy
2281884.jpg,https://derpicdn.net/img/view/2020/2/23/2281884.jpg,0,0.930391431,174,0,1250,1064,1076,1064,fluttershy
2282054.png,https://derpicdn.net/img/view/2020/2/23/2282054.png,0,0.994683981,907,318,1465,876,558,558,fluttershy
2283188.png,https://derpicdn.net/img/view/2020/2/25/2283188.png,0,0.983079851,125,0,891,719,766,719,fluttershy
2283188.png,https://derpicdn.net/img/view/2020/2/25/2283188.png,1,0.943655491,747,878,1047,1178,300,300,fluttershy
2284517.png,https://derpicdn.net/img/view/2020/2/27/2284517.png,0,0.984787643,0,36,701,868,701,832,fluttershy
2285813.png,https://derpicdn.net/img/view/2020/2/29/2285813.png,0,0.979301572,0,0,471,457,471,457,fluttershy
2286410.png,https://derpicdn.net/img/view/2020/2/29/2286410.png,0,0.99650681,51,0,309,258,258,258,fluttershy
2290423.jpg,https://derpicdn.net/img/view/2020/3/5/2290423.jpg,0,0.990627646,82,118,898,934,816,816,fluttershy
2292832.jpg,https://derpicdn.net/img/view/2020/3/8/2292832.jpg,0,0.94413656,348,0,1452,1079,1104,1079,fluttershy
2293658.png,https://derpicdn.net/img/view/2020/3/9/2293658.png,0,0.913526237,849,133,1951,1235,1102,1102,fluttershy
2300474.png,https://derpicdn.net/img/view/2020/3/18/2300474.png,0,0.9835186,394,0,1348,865,954,865,fluttershy
2300980.jpg,https://derpicdn.net/img/view/2020/3/19/2300980.jpg,0,0.953998268,816,475,2446,2105,1630,1630,fluttershy
2301243.jpg,https://derpicdn.net/img/view/2020/3/19/2301243.jpg,0,0.996181488,30,0,626,564,596,564,fluttershy
2301423.jpg,https://derpicdn.net/img/view/2020/3/19/2301423.jpg,0,0.962786794,920,0,1734,718,814,718,fluttershy
2302108.png,https://derpicdn.net/img/view/2020/3/20/2302108.png,0,0.980519831,28,0,1280,1229,1252,1229,fluttershy
2303768.jpg,https://derpicdn.net/img/view/2020/3/22/2303768.jpg,0,0.997865975,216,18,552,354,336,336,fluttershy
2305130.png,https://derpicdn.net/img/view/2020/3/24/2305130.png,0,0.99898839,141,46,561,466,420,420,fluttershy
23054.jpg,https://derpicdn.net/img/view/2012/6/27/23054.jpg,0,0.99827373,183,211,427,455,244,244,fluttershy
2305927.png,https://derpicdn.net/img/view/2020/3/25/2305927.png,0,0.994960189,1609,0,3145,1434,1536,1434,fluttershy
2306301.jpg,https://derpicdn.net/img/view/2020/3/26/2306301.jpg,0,0.97665745,353,81,959,687,606,606,fluttershy
2308360.jpg,https://derpicdn.net/img/view/2020/3/28/2308360.jpg,0,0.992973804,353,4,969,620,616,616,fluttershy
2310145.png,https://derpicdn.net/img/view/2020/3/30/2310145.png,0,0.981147766,77,0,1227,1083,1150,1083,fluttershy
2311088.png,https://derpicdn.net/img/view/2020/4/1/2311088.png,0,0.989115477,301,0,953,624,652,624,fluttershy
2312322.jpg,https://derpicdn.net/img/view/2020/4/2/2312322.jpg,0,0.977460325,248,19,634,405,386,386,fluttershy
2312420.jpg,https://derpicdn.net/img/view/2020/4/2/2312420.jpg,0,0.987158358,163,12,531,380,368,368,fluttershy
2314924.jpg,https://derpicdn.net/img/view/2020/4/5/2314924.jpg,0,0.953201473,83,0,561,449,478,449,fluttershy
231695.png,https://derpicdn.net/img/view/2013/2/2/231695.png,0,0.910082519,89,25,317,253,228,228,fluttershy
2319117.png,https://derpicdn.net/img/view/2020/4/10/2319117.png,0,0.96666187,310,1,442,133,132,132,fluttershy
23222.png,https://derpicdn.net/img/view/2012/6/27/23222.png,0,0.976225138,232,0,516,241,284,241,fluttershy
2326724.jpg,https://derpicdn.net/img/view/2020/4/20/2326724.jpg,0,0.992100179,524,0,1272,728,748,728,fluttershy
2327558.jpg,https://derpicdn.net/img/view/2020/4/21/2327558.jpg,0,0.997234523,328,21,1176,869,848,848,fluttershy
2329655.png,https://derpicdn.net/img/view/2020/4/23/2329655.png,0,0.998470843,455,0,1889,1386,1434,1386,fluttershy
2329688.png,https://derpicdn.net/img/view/2020/4/23/2329688.png,0,0.994248331,617,608,1131,1122,514,514,fluttershy
2329951.jpg,https://derpicdn.net/img/view/2020/4/23/2329951.jpg,0,0.988888204,1380,1299,1898,1817,518,518,fluttershy
2330287.jpg,https://derpicdn.net/img/view/2020/4/24/2330287.jpg,0,0.98390007,0,0,1606,1641,1606,1641,fluttershy
2330965.jpg,https://derpicdn.net/img/view/2020/4/25/2330965.jpg,0,0.992280781,69,0,1659,1441,1590,1441,fluttershy
2332416.jpg,https://derpicdn.net/img/view/2020/4/26/2332416.jpg,0,0.981237829,169,0,411,232,242,232,fluttershy
2332877.jpg,https://derpicdn.net/img/view/2020/4/27/2332877.jpg,0,0.982276499,231,87,1365,1221,1134,1134,fluttershy
2333909.png,https://derpicdn.net/img/view/2020/4/28/2333909.png,0,0.996719003,1026,0,1894,828,868,828,fluttershy
2334017.jpg,https://derpicdn.net/img/view/2020/4/28/2334017.jpg,0,0.99076879,257,137,835,715,578,578,fluttershy
2334532.png,https://derpicdn.net/img/view/2020/4/29/2334532.png,0,0.930467308,3318,1818,4984,3484,1666,1666,fluttershy
2334562.png,https://derpicdn.net/img/view/2020/4/29/2334562.png,0,0.960216343,0,14,609,650,609,636,fluttershy
2335024.png,https://derpicdn.net/img/view/2020/4/29/2335024.png,0,0.978557467,251,0,1949,1412,1698,1412,fluttershy
2335356.png,https://derpicdn.net/img/view/2020/4/30/2335356.png,0,0.982049108,6,0,680,588,674,588,fluttershy
2337218.jpg,https://derpicdn.net/img/view/2020/5/2/2337218.jpg,0,0.997676015,183,28,699,544,516,516,fluttershy
2338884.png,https://derpicdn.net/img/view/2020/5/4/2338884.png,0,0.980602801,0,0,396,417,396,417,fluttershy
2340885.jpg,https://derpicdn.net/img/view/2020/5/6/2340885.jpg,0,0.917227507,1083,267,1647,831,564,564,fluttershy
2341182.jpg,https://derpicdn.net/img/view/2020/5/6/2341182.jpg,0,0.981301129,121,0,701,555,580,555,fluttershy
2343361.png,https://derpicdn.net/img/view/2020/5/9/2343361.png,0,0.990737557,0,293,1035,1471,1035,1178,fluttershy
2343585.png,https://derpicdn.net/img/view/2020/5/9/2343585.png,0,0.998265684,2636,0,5094,2411,2458,2411,fluttershy
2347453.jpg,https://derpicdn.net/img/view/2020/5/13/2347453.jpg,0,0.960717976,32,0,764,723,732,723,fluttershy
234780.jpg,https://derpicdn.net/img/view/2013/2/6/234780.jpg,0,0.991974831,403,189,641,427,238,238,fluttershy
2348056.png,https://derpicdn.net/img/view/2020/5/14/2348056.png,0,0.994027019,182,0,938,718,756,718,fluttershy
2353288.png,https://derpicdn.net/img/view/2020/5/20/2353288.png,0,0.9888345,189,0,1497,1308,1308,1308,fluttershy
2354613.jpg,https://derpicdn.net/img/view/2020/5/21/2354613.jpg,0,0.964862168,4,0,480,493,476,493,fluttershy
2355897.png,https://derpicdn.net/img/view/2020/5/23/2355897.png,0,0.999286532,278,0,824,533,546,533,fluttershy
2355898.png,https://derpicdn.net/img/view/2020/5/23/2355898.png,0,0.999580324,287,0,825,522,538,522,fluttershy
2355977.png,https://derpicdn.net/img/view/2020/5/23/2355977.png,0,0.990146101,0,0,1329,1133,1329,1133,fluttershy
246720.png,https://derpicdn.net/img/view/2013/2/17/246720.png,0,0.945643067,75,0,479,402,404,402,fluttershy
251465.png,https://derpicdn.net/img/view/2013/2/22/251465.png,0,0.982153058,0,97,2074,2451,2074,2354,fluttershy
2521.png,https://derpicdn.net/img/view/2012/1/28/2521.png,0,0.996974885,518,950,1076,1508,558,558,fluttershy
252458.png,https://derpicdn.net/img/view/2013/2/23/252458.png,0,0.999095082,648,169,1022,543,374,374,fluttershy
252458.png,https://derpicdn.net/img/view/2013/2/23/252458.png,1,0.921954513,608,465,1008,865,400,400,fluttershy
254355.png,https://derpicdn.net/img/view/2013/2/24/254355.png,0,0.981178105,76,0,838,685,762,685,fluttershy
25908.jpg,https://derpicdn.net/img/view/2012/6/30/25908.jpg,0,0.906565726,263,0,818,461,555,461,fluttershy
277851.png,https://derpicdn.net/img/view/2013/3/23/277851.png,0,0.982305944,91,0,783,772,692,772,fluttershy
285232.png,https://derpicdn.net/img/view/2013/4/1/285232.png,0,0.999094605,391,0,689,288,298,288,fluttershy
2903.png,https://derpicdn.net/img/view/2012/2/2/2903.png,0,0.971363842,270,0,692,384,422,384,fluttershy
2924.png,https://derpicdn.net/img/view/2012/2/2/2924.png,0,0.990337729,385,0,909,522,524,522,fluttershy
30905.jpg,https://derpicdn.net/img/view/2012/7/4/30905.jpg,0,0.993398607,214,398,424,608,210,210,fluttershy
30905.jpg,https://derpicdn.net/img/view/2012/7/4/30905.jpg,1,0.903967142,574,210,790,426,216,216,fluttershy
312711.png,https://derpicdn.net/img/view/2013/4/30/312711.png,0,0.991532028,207,35,427,255,220,220,fluttershy
31718.jpg,https://derpicdn.net/img/view/2012/7/4/31718.jpg,0,0.961507201,311,93,555,337,244,244,fluttershy
324815.jpg,https://derpicdn.net/img/view/2013/5/14/324815.jpg,0,0.996067047,512,80,1628,1196,1116,1116,fluttershy
325396.png,https://derpicdn.net/img/view/2013/5/15/325396.png,0,0.996741831,199,88,733,622,534,534,fluttershy
32808.png,https://derpicdn.net/img/view/2012/7/5/32808.png,0,0.987462997,6,0,296,281,290,281,fluttershy
338428.png,https://derpicdn.net/img/view/2013/6/1/338428.png,0,0.994635344,496,207,866,577,370,370,fluttershy
365128.png,https://derpicdn.net/img/view/2013/7/5/365128.png,0,0.983374774,638,148,2176,1686,1538,1538,fluttershy
375273.png,https://derpicdn.net/img/view/2013/7/16/375273.png,0,0.970639527,830,191,1402,763,572,572,fluttershy
379075.png,https://derpicdn.net/img/view/2013/7/20/379075.png,0,0.974641383,178,88,766,676,588,588,fluttershy
379235.png,https://derpicdn.net/img/view/2013/7/20/379235.png,0,0.993690073,522,115,2002,1595,1480,1480,fluttershy
406996.png,https://derpicdn.net/img/view/2013/8/22/406996.png,0,0.925037742,75,302,725,952,650,650,fluttershy
41397.png,https://derpicdn.net/img/view/2012/7/12/41397.png,0,0.999178648,56,66,322,332,266,266,fluttershy
42006.png,https://derpicdn.net/img/view/2012/7/12/42006.png,0,0.998632371,117,0,429,294,312,294,fluttershy
430934.png,https://derpicdn.net/img/view/2013/9/19/430934.png,0,0.991156816,104,0,482,360,378,360,fluttershy
435261.png,https://derpicdn.net/img/view/2013/9/26/435261.png,0,0.98734194,334,76,854,596,520,520,fluttershy
437041.png,https://derpicdn.net/img/view/2013/9/28/437041.png,0,0.988855779,0,0,241,220,241,220,fluttershy
437660.png,https://derpicdn.net/img/view/2013/9/29/437660.png,0,0.923730135,8,0,588,568,580,568,fluttershy
441793.png,https://derpicdn.net/img/view/2013/10/5/441793.png,0,0.942960083,0,3,438,473,438,470,fluttershy
442103.jpg,https://derpicdn.net/img/view/2013/10/5/442103.jpg,0,0.98789221,449,77,887,515,438,438,fluttershy
442145.png,https://derpicdn.net/img/view/2013/10/5/442145.png,0,0.950507402,207,175,1129,1097,922,922,fluttershy
44694.png,https://derpicdn.net/img/view/2012/7/15/44694.png,0,0.985722899,413,66,725,378,312,312,fluttershy
451023.png,https://derpicdn.net/img/view/2013/10/18/451023.png,0,0.996448576,159,34,1029,904,870,870,fluttershy
46246.png,https://derpicdn.net/img/view/2012/7/16/46246.png,0,0.921282947,413,137,867,591,454,454,fluttershy
470232.png,https://derpicdn.net/img/view/2013/11/11/470232.png,0,0.922558486,339,120,603,384,264,264,fluttershy
472845.png,https://derpicdn.net/img/view/2013/11/15/472845.png,0,0.979681969,357,30,729,402,372,372,fluttershy
473599.png,https://derpicdn.net/img/view/2013/11/16/473599.png,0,0.984573424,78,0,628,535,550,535,fluttershy
477520.png,https://derpicdn.net/img/view/2013/11/21/477520.png,0,0.991098285,132,0,1804,1658,1672,1658,fluttershy
486841.png,https://derpicdn.net/img/view/2013/12/1/486841.png,0,0.982540131,9,0,473,444,464,444,fluttershy
490165.png,https://derpicdn.net/img/view/2013/12/5/490165.png,0,0.98109585,416,39,988,611,572,572,fluttershy
49048.jpg,https://derpicdn.net/img/view/2012/7/19/49048.jpg,0,0.997943938,78,0,378,291,300,291,fluttershy
495720.png,https://derpicdn.net/img/view/2013/12/13/495720.png,0,0.917850792,775,107,4489,3821,3714,3714,fluttershy
497477.png,https://derpicdn.net/img/view/2013/12/15/497477.png,0,0.996993303,1368,156,3394,2182,2026,2026,fluttershy
506756.png,https://derpicdn.net/img/view/2013/12/26/506756.png,0,0.984531403,1673,83,2421,831,748,748,fluttershy
507330.png,https://derpicdn.net/img/view/2013/12/27/507330.png,0,0.998325109,15,0,375,338,360,338,fluttershy
508348.png,https://derpicdn.net/img/view/2013/12/28/508348.png,0,0.993554711,0,0,949,952,949,952,fluttershy
508470.jpg,https://derpicdn.net/img/view/2013/12/28/508470.jpg,0,0.988692582,308,0,764,398,456,398,fluttershy
509011.png,https://derpicdn.net/img/view/2013/12/29/509011.png,0,0.988131046,0,65,264,333,264,268,fluttershy
509115.png,https://derpicdn.net/img/view/2013/12/29/509115.png,0,0.992720783,0,0,232,246,232,246,fluttershy
509375.png,https://derpicdn.net/img/view/2013/12/29/509375.png,0,0.991957843,83,0,937,828,854,828,fluttershy
509497.png,https://derpicdn.net/img/view/2013/12/29/509497.png,0,0.942553282,190,0,1038,777,848,777,fluttershy
511055.png,https://derpicdn.net/img/view/2013/12/31/511055.png,0,0.946426511,4,0,292,288,288,288,fluttershy
511283.png,https://derpicdn.net/img/view/2013/12/31/511283.png,0,0.992688239,229,133,1093,997,864,864,fluttershy
512456.jpg,https://derpicdn.net/img/view/2014/1/2/512456.jpg,0,0.98645848,0,0,650,799,650,799,fluttershy
513120.jpg,https://derpicdn.net/img/view/2014/1/2/513120.jpg,0,0.979478955,153,130,463,440,310,310,fluttershy
513653.png,https://derpicdn.net/img/view/2014/1/3/513653.png,0,0.956298351,606,545,1160,1099,554,554,fluttershy
515735.png,https://derpicdn.net/img/view/2014/1/5/515735.png,0,0.900208533,1102,0,1734,515,632,515,fluttershy
515758.png,https://derpicdn.net/img/view/2014/1/5/515758.png,0,0.981399417,229,0,575,343,346,343,fluttershy
515825.png,https://derpicdn.net/img/view/2014/1/5/515825.png,0,0.994173706,228,10,652,434,424,424,fluttershy
515857.png,https://derpicdn.net/img/view/2014/1/5/515857.png,0,0.996984422,0,0,287,287,287,287,fluttershy
518183.png,https://derpicdn.net/img/view/2014/1/7/518183.png,0,0.942619979,509,0,987,443,478,443,fluttershy
519475.png,https://derpicdn.net/img/view/2014/1/9/519475.png,0,0.99649179,549,14,1067,532,518,518,fluttershy
519929.png,https://derpicdn.net/img/view/2014/1/9/519929.png,0,0.969091356,142,0,890,662,748,662,fluttershy
525888.jpg,https://derpicdn.net/img/view/2014/1/16/525888.jpg,0,0.973851085,20,0,621,602,601,602,fluttershy
525950.png,https://derpicdn.net/img/view/2014/1/16/525950.png,0,0.914608717,156,43,1076,963,920,920,fluttershy
526051.png,https://derpicdn.net/img/view/2014/1/16/526051.png,0,0.936103642,0,13,296,315,296,302,fluttershy
526117.png,https://derpicdn.net/img/view/2014/1/16/526117.png,0,0.988737702,21,0,301,242,280,242,fluttershy
529444.png,https://derpicdn.net/img/view/2014/1/20/529444.png,0,0.96257782,437,0,1000,592,563,592,fluttershy
530439.jpg,https://derpicdn.net/img/view/2014/1/21/530439.jpg,0,0.987052739,361,23,1027,689,666,666,fluttershy
533161.png,https://derpicdn.net/img/view/2014/1/24/533161.png,0,0.996518373,1129,0,2631,1467,1502,1467,fluttershy
533545.png,https://derpicdn.net/img/view/2014/1/25/533545.png,0,0.976560712,0,1,174,193,174,192,fluttershy
533658.png,https://derpicdn.net/img/view/2014/1/25/533658.png,0,0.966550529,469,76,1399,1006,930,930,fluttershy
533943.png,https://derpicdn.net/img/view/2014/1/25/533943.png,0,0.990368605,135,53,601,519,466,466,fluttershy
537945.jpg,https://derpicdn.net/img/view/2014/1/29/537945.jpg,0,0.92519176,546,0,1494,753,948,753,fluttershy
539214.png,https://derpicdn.net/img/view/2014/1/31/539214.png,0,0.94376266,0,1,257,277,257,276,fluttershy
543415.jpg,https://derpicdn.net/img/view/2014/2/4/543415.jpg,0,0.912047982,237,117,600,489,363,372,fluttershy
556157.png,https://derpicdn.net/img/view/2014/2/19/556157.png,0,0.99631089,187,11,517,341,330,330,fluttershy
581486.png,https://derpicdn.net/img/view/2014/3/22/581486.png,0,0.994170129,885,335,1641,1091,756,756,fluttershy
5913.jpg,https://derpicdn.net/img/view/2012/6/18/5913.jpg,0,0.957908571,77,21,491,435,414,414,fluttershy
595862.jpg,https://derpicdn.net/img/view/2014/4/8/595862.jpg,0,0.953475296,523,311,821,609,298,298,fluttershy
599466.png,https://derpicdn.net/img/view/2014/4/13/599466.png,0,0.950454414,277,1707,3021,4451,2744,2744,fluttershy
600182.png,https://derpicdn.net/img/view/2014/4/14/600182.png,0,0.934212625,313,105,681,473,368,368,fluttershy
605693.png,https://derpicdn.net/img/view/2014/4/20/605693.png,0,0.98911649,64,0,600,585,536,585,fluttershy
607611.png,https://derpicdn.net/img/view/2014/4/23/607611.png,0,0.956674993,0,0,1339,804,1339,804,fluttershy
61729.png,https://derpicdn.net/img/view/2012/7/30/61729.png,0,0.984966576,149,169,341,361,192,192,fluttershy
617946.png,https://derpicdn.net/img/view/2014/5/5/617946.png,0,0.919359982,205,59,495,349,290,290,fluttershy
619956.png,https://derpicdn.net/img/view/2014/5/7/619956.png,0,0.990521908,223,0,777,549,554,549,fluttershy
627088.png,https://derpicdn.net/img/view/2014/5/15/627088.png,0,0.999250531,179,5,621,447,442,442,fluttershy
628382.jpg,https://derpicdn.net/img/view/2014/5/16/628382.jpg,0,0.997762322,0,0,535,487,535,487,fluttershy
643720.png,https://derpicdn.net/img/view/2014/6/3/643720.png,0,0.999577105,16,0,702,672,686,672,fluttershy
644821.jpg,https://derpicdn.net/img/view/2014/6/4/644821.jpg,0,0.993269384,82,0,494,411,412,411,fluttershy
656715.jpg,https://derpicdn.net/img/view/2014/6/19/656715.jpg,0,0.98441565,95,0,367,272,272,272,fluttershy
656921.png,https://derpicdn.net/img/view/2014/6/19/656921.png,0,0.996932626,561,75,921,435,360,360,fluttershy
656921.png,https://derpicdn.net/img/view/2014/6/19/656921.png,1,0.95098722,214,49,608,443,394,394,fluttershy
669537.png,https://derpicdn.net/img/view/2014/7/7/669537.png,0,0.939474821,57,14,345,302,288,288,fluttershy
670289.png,https://derpicdn.net/img/view/2014/7/8/670289.png,0,0.994631231,183,236,441,494,258,258,fluttershy
671608.png,https://derpicdn.net/img/view/2014/7/10/671608.png,0,0.982193351,391,16,1933,1558,1542,1542,fluttershy
676657.jpg,https://derpicdn.net/img/view/2014/7/17/676657.jpg,0,0.975655198,78,0,452,374,374,374,fluttershy
67885.jpg,https://derpicdn.net/img/view/2012/8/6/67885.jpg,0,0.985244572,48,1,464,417,416,416,fluttershy
6810.png,https://derpicdn.net/img/view/2012/6/18/6810.png,0,0.984821439,221,16,511,306,290,290,fluttershy
683.png,https://derpicdn.net/img/view/2012/1/17/683.png,0,0.994159162,288,0,784,465,496,465,fluttershy
691900.jpg,https://derpicdn.net/img/view/2014/8/5/691900.jpg,0,0.984246075,229,15,825,611,596,596,fluttershy
692732.png,https://derpicdn.net/img/view/2014/8/6/692732.png,0,0.959667742,1178,479,2164,1465,986,986,fluttershy
692762.png,https://derpicdn.net/img/view/2014/8/6/692762.png,0,0.988966227,320,14,842,536,522,522,fluttershy
695554.png,https://derpicdn.net/img/view/2014/8/9/695554.png,0,0.992547274,717,1,919,203,202,202,fluttershy
697150.png,https://derpicdn.net/img/view/2014/8/11/697150.png,0,0.98495245,0,0,298,312,298,312,fluttershy
697244.png,https://derpicdn.net/img/view/2014/8/11/697244.png,0,0.927616,249,75,877,703,628,628,fluttershy
704763.png,https://derpicdn.net/img/view/2014/8/21/704763.png,0,0.966163039,301,17,551,267,250,250,fluttershy
704900.png,https://derpicdn.net/img/view/2014/8/21/704900.png,0,0.971554637,1328,0,3326,1962,1998,1962,fluttershy
705294.png,https://derpicdn.net/img/view/2014/8/22/705294.png,0,0.954483807,12,0,280,255,268,255,fluttershy
707604.png,https://derpicdn.net/img/view/2014/8/25/707604.png,0,0.935205996,144,0,1986,1323,1842,1323,fluttershy
707608.jpg,https://derpicdn.net/img/view/2014/8/25/707608.jpg,0,0.986698389,459,0,1043,574,584,574,fluttershy
708562.jpg,https://derpicdn.net/img/view/2014/8/26/708562.jpg,0,0.917504907,1450,48,3988,2586,2538,2538,fluttershy
712899.png,https://derpicdn.net/img/view/2014/9/1/712899.png,0,0.981319129,44,0,422,363,378,363,fluttershy
719814.png,https://derpicdn.net/img/view/2014/9/11/719814.png,0,0.990819693,0,35,409,489,409,454,fluttershy
720697.jpg,https://derpicdn.net/img/view/2014/9/12/720697.jpg,0,0.987179101,0,0,371,297,371,297,fluttershy
722144.png,https://derpicdn.net/img/view/2014/9/14/722144.png,0,0.922022164,346,0,666,317,320,317,fluttershy
726278.png,https://derpicdn.net/img/view/2014/9/21/726278.png,1,0.985283017,11,170,2761,2920,2750,2750,fluttershy
730075.jpg,https://derpicdn.net/img/view/2014/9/26/730075.jpg,0,0.995202363,1060,687,2142,1769,1082,1082,fluttershy
740218.png,https://derpicdn.net/img/view/2014/10/10/740218.png,0,0.958157122,346,157,922,733,576,576,fluttershy
740611.jpg,https://derpicdn.net/img/view/2014/10/11/740611.jpg,1,0.957899749,297,0,695,375,398,375,fluttershy
746729.png,https://derpicdn.net/img/view/2014/10/20/746729.png,0,0.948003471,246,20,582,356,336,336,fluttershy
747842.png,https://derpicdn.net/img/view/2014/10/22/747842.png,0,0.98121655,343,0,825,461,482,461,fluttershy
748736.png,https://derpicdn.net/img/view/2014/10/23/748736.png,0,0.97000277,295,0,887,567,592,567,fluttershy
749971.png,https://derpicdn.net/img/view/2014/10/25/749971.png,0,0.96674335,334,65,1132,863,798,798,fluttershy
757248.png,https://derpicdn.net/img/view/2014/11/3/757248.png,0,0.992230773,0,0,675,703,675,703,fluttershy
760089.png,https://derpicdn.net/img/view/2014/11/7/760089.png,0,0.922010064,647,508,983,844,336,336,fluttershy
76407.jpg,https://derpicdn.net/img/view/2012/8/17/76407.jpg,0,0.955159903,183,0,675,425,492,425,fluttershy
765213.jpg,https://derpicdn.net/img/view/2014/11/15/765213.jpg,0,0.991085529,41,17,291,267,250,250,fluttershy
772760.jpg,https://derpicdn.net/img/view/2014/11/27/772760.jpg,0,0.994501352,160,0,366,203,206,203,fluttershy
772928.png,https://derpicdn.net/img/view/2014/11/27/772928.png,0,0.997338176,562,0,2068,1438,1506,1438,fluttershy
773406.png,https://derpicdn.net/img/view/2014/11/28/773406.png,0,0.991800427,263,0,727,422,464,422,fluttershy
774690.png,https://derpicdn.net/img/view/2014/11/30/774690.png,0,0.994138598,79,0,647,566,568,566,fluttershy
775794.png,https://derpicdn.net/img/view/2014/12/1/775794.png,0,0.998039782,136,0,440,291,304,291,fluttershy
776249.png,https://derpicdn.net/img/view/2014/12/2/776249.png,0,0.936980784,419,5,795,381,376,376,fluttershy
7803.jpg,https://derpicdn.net/img/view/2012/6/18/7803.jpg,1,0.926427245,79,86,457,464,378,378,fluttershy
782269.png,https://derpicdn.net/img/view/2014/12/10/782269.png,0,0.99432528,88,25,600,537,512,512,fluttershy
788012.png,https://derpicdn.net/img/view/2014/12/19/788012.png,0,0.992571831,742,246,1446,950,704,704,fluttershy
799631.png,https://derpicdn.net/img/view/2015/1/4/799631.png,0,0.998491585,1297,0,2265,917,968,917,fluttershy
800321.png,https://derpicdn.net/img/view/2015/1/5/800321.png,0,0.996204317,234,55,590,411,356,356,fluttershy
801413.jpg,https://derpicdn.net/img/view/2015/1/7/801413.jpg,0,0.96631825,8,0,672,650,664,650,fluttershy
802120.jpg,https://derpicdn.net/img/view/2015/1/8/802120.jpg,0,0.991334856,99,0,957,762,858,762,fluttershy
8054.png,https://derpicdn.net/img/view/2012/6/18/8054.png,0,0.919953167,326,26,598,298,272,272,fluttershy
806579.jpg,https://derpicdn.net/img/view/2015/1/14/806579.jpg,0,0.990619779,159,9,735,585,576,576,fluttershy
809172.png,https://derpicdn.net/img/view/2015/1/18/809172.png,0,0.998098373,449,26,829,406,380,380,fluttershy
813987.png,https://derpicdn.net/img/view/2015/1/25/813987.png,0,0.993113458,1367,106,2293,1032,926,926,fluttershy
815347.jpg,https://derpicdn.net/img/view/2015/1/26/815347.jpg,0,0.998579264,392,0,910,515,518,515,fluttershy
815731.png,https://derpicdn.net/img/view/2015/1/27/815731.png,0,0.98957926,1636,1095,3200,2659,1564,1564,fluttershy
819454.jpg,https://derpicdn.net/img/view/2015/2/1/819454.jpg,0,0.975542367,0,0,411,448,411,448,fluttershy
826709.jpg,https://derpicdn.net/img/view/2015/2/12/826709.jpg,0,0.998541713,431,11,1115,695,684,684,fluttershy
82689.png,https://derpicdn.net/img/view/2012/8/25/82689.png,0,0.926778793,17,37,315,335,298,298,fluttershy
8295.jpg,https://derpicdn.net/img/view/2012/6/18/8295.jpg,0,0.939592004,67,0,591,522,524,522,fluttershy
839380.png,https://derpicdn.net/img/view/2015/2/28/839380.png,0,0.992757201,184,5,662,483,478,478,fluttershy
845350.png,https://derpicdn.net/img/view/2015/3/8/845350.png,0,0.98945421,112,0,402,287,290,287,fluttershy
845353.png,https://derpicdn.net/img/view/2015/3/8/845353.png,0,0.988835275,112,0,400,285,288,285,fluttershy
855625.png,https://derpicdn.net/img/view/2015/3/23/855625.png,0,0.919925392,134,162,382,410,248,248,fluttershy
8599.jpg,https://derpicdn.net/img/view/2012/6/18/8599.jpg,0,0.992052257,766,521,1048,803,282,282,fluttershy
864983.png,https://derpicdn.net/img/view/2015/4/4/864983.png,0,0.99776113,490,78,768,356,278,278,fluttershy
866649.png,https://derpicdn.net/img/view/2015/4/6/866649.png,0,0.998714745,432,0,992,558,560,558,fluttershy
866750.png,https://derpicdn.net/img/view/2015/4/6/866750.png,0,0.994475961,369,0,777,390,408,390,fluttershy
869341.png,https://derpicdn.net/img/view/2015/4/9/869341.png,0,0.992290318,125,0,1461,1294,1336,1294,fluttershy
870504.png,https://derpicdn.net/img/view/2015/4/10/870504.png,0,0.99428463,146,97,722,673,576,576,fluttershy
873360.png,https://derpicdn.net/img/view/2015/4/13/873360.png,0,0.98321408,0,0,1076,1050,1076,1050,fluttershy
875427.png,https://derpicdn.net/img/view/2015/4/16/875427.png,0,0.975579977,160,43,510,393,350,350,fluttershy
878705.jpg,https://derpicdn.net/img/view/2015/4/20/878705.jpg,0,0.990655363,240,0,522,268,282,268,fluttershy
879033.png,https://derpicdn.net/img/view/2015/4/20/879033.png,0,0.995183587,324,210,988,874,664,664,fluttershy
893780.jpg,https://derpicdn.net/img/view/2015/5/11/893780.jpg,0,0.986270547,189,86,439,336,250,250,fluttershy
894398.png,https://derpicdn.net/img/view/2015/5/12/894398.png,0,0.928012848,118,1,494,377,376,376,fluttershy
899209.png,https://derpicdn.net/img/view/2015/5/18/899209.png,0,0.969394922,0,0,1262,1347,1262,1347,fluttershy
901758.png,https://derpicdn.net/img/view/2015/5/22/901758.png,0,0.998395503,118,0,872,565,754,565,fluttershy
902417.png,https://derpicdn.net/img/view/2015/5/23/902417.png,0,0.940617681,130,20,1058,948,928,928,fluttershy
904658.png,https://derpicdn.net/img/view/2015/5/26/904658.png,0,0.955287158,99,10,739,650,640,640,fluttershy
904659.png,https://derpicdn.net/img/view/2015/5/26/904659.png,0,0.994441271,81,44,637,600,556,556,fluttershy
911757.png,https://derpicdn.net/img/view/2015/6/6/911757.png,0,0.998857081,203,52,619,468,416,416,fluttershy
927662.jpg,https://derpicdn.net/img/view/2015/7/1/927662.jpg,0,0.986128628,830,0,1496,637,666,637,fluttershy
928120.png,https://derpicdn.net/img/view/2015/7/2/928120.png,0,0.996718645,598,125,1430,957,832,832,fluttershy
940272.png,https://derpicdn.net/img/view/2015/7/20/940272.png,0,0.994677365,215,173,707,665,492,492,fluttershy
942914.jpg,https://derpicdn.net/img/view/2015/7/24/942914.jpg,0,0.983972311,492,7,1326,841,834,834,fluttershy
943100.png,https://derpicdn.net/img/view/2015/7/24/943100.png,0,0.992370248,142,144,710,712,568,568,fluttershy
945726.jpg,https://derpicdn.net/img/view/2015/7/28/945726.jpg,0,0.99927938,404,0,788,383,384,383,fluttershy
945933.jpg,https://derpicdn.net/img/view/2015/7/28/945933.jpg,0,0.982497513,53,229,305,481,252,252,fluttershy
945933.jpg,https://derpicdn.net/img/view/2015/7/28/945933.jpg,1,0.981436133,244,215,478,449,234,234,fluttershy
952145.jpg,https://derpicdn.net/img/view/2015/8/6/952145.jpg,0,0.999170363,267,38,521,292,254,254,fluttershy
956541.jpg,https://derpicdn.net/img/view/2015/8/13/956541.jpg,0,0.993741333,536,339,1314,1117,778,778,fluttershy
959073.png,https://derpicdn.net/img/view/2015/8/16/959073.png,0,0.986305594,0,0,230,230,230,230,fluttershy
959576.png,https://derpicdn.net/img/view/2015/8/17/959576.png,0,0.99870348,236,185,618,567,382,382,fluttershy
961694.png,https://derpicdn.net/img/view/2015/8/20/961694.png,0,0.902143955,239,523,2287,2571,2048,2048,fluttershy
961710.png,https://derpicdn.net/img/view/2015/8/20/961710.png,0,0.994217277,1110,1222,2144,2256,1034,1034,fluttershy
966167.png,https://derpicdn.net/img/view/2015/8/26/966167.png,0,0.960998595,473,0,1355,868,882,868,fluttershy
968242.png,https://derpicdn.net/img/view/2015/8/29/968242.png,0,0.967280507,369,0,1024,701,655,701,fluttershy
977405.png,https://derpicdn.net/img/view/2015/9/11/977405.png,0,0.993974209,116,60,288,232,172,172,fluttershy
978981.png,https://derpicdn.net/img/view/2015/9/13/978981.png,0,0.919898093,622,0,2474,1729,1852,1729,fluttershy
983535.png,https://derpicdn.net/img/view/2015/9/20/983535.png,0,0.997342288,413,28,727,342,314,314,fluttershy
984211.png,https://derpicdn.net/img/view/2015/9/21/984211.png,0,0.99896121,213,167,693,647,480,480,fluttershy
985005.png,https://derpicdn.net/img/view/2015/9/22/985005.png,0,0.998942673,369,156,2313,2100,1944,1944,fluttershy
98522.png,https://derpicdn.net/img/view/2012/9/15/98522.png,0,0.955871761,116,0,1846,1571,1730,1571,fluttershy
988433.png,https://derpicdn.net/img/view/2015/9/26/988433.png,0,0.974672794,2,0,514,442,512,442,fluttershy
996725.png,https://derpicdn.net/img/view/2015/10/7/996725.png,0,0.989965737,326,17,994,685,668,668,fluttershy
9971.png,https://derpicdn.net/img/view/2012/6/19/9971.png,0,0.983854532,0,0,531,473,531,473,fluttershy
999875.png,https://derpicdn.net/img/view/2015/10/11/999875.png,0,0.964108169,17,0,769,743,752,743,fluttershy
1005255.jpg,https://derpicdn.net/img/view/2015/10/18/1005255.jpg,0,0.944877982,306,32,654,380,348,348,fluttershy
1005709.png,https://derpicdn.net/img/view/2015/10/19/1005709.png,0,0.974583387,356,23,724,391,368,368,fluttershy
1010702.png,https://derpicdn.net/img/view/2015/10/28/1010702.png,0,0.979352772,1279,153,2243,1117,964,964,fluttershy
1010702.png,https://derpicdn.net/img/view/2015/10/28/1010702.png,1,0.959882438,805,375,1323,893,518,518,fluttershy
1010718.png,https://derpicdn.net/img/view/2015/10/28/1010718.png,0,0.963075817,199,97,945,843,746,746,fluttershy
1012556.jpg,https://derpicdn.net/img/view/2015/10/30/1012556.jpg,0,0.919013858,984,50,1768,834,784,784,fluttershy
1012705.png,https://derpicdn.net/img/view/2015/10/30/1012705.png,0,0.997731507,315,0,2379,2036,2064,2036,fluttershy
1013055.jpg,https://derpicdn.net/img/view/2015/10/31/1013055.jpg,0,0.997709513,1321,0,2059,695,738,695,fluttershy
1014123.png,https://derpicdn.net/img/view/2015/11/1/1014123.png,0,0.943959057,352,54,770,472,418,418,fluttershy
1014251.jpg,https://derpicdn.net/img/view/2015/11/1/1014251.jpg,0,0.989236236,285,45,717,477,432,432,fluttershy
1020940.jpg,https://derpicdn.net/img/view/2015/11/11/1020940.jpg,0,0.943138957,178,22,534,378,356,356,fluttershy
1021760.png,https://derpicdn.net/img/view/2015/11/12/1021760.png,0,0.99147296,217,8,417,208,200,200,fluttershy
104139.png,https://derpicdn.net/img/view/2012/9/22/104139.png,0,0.941702127,0,280,8026,8410,8026,8130,fluttershy
104609.jpg,https://derpicdn.net/img/view/2012/9/23/104609.jpg,0,0.981665373,167,0,1055,821,888,821,fluttershy
1055041.png,https://derpicdn.net/img/view/2015/12/29/1055041.png,0,0.999487281,185,502,1017,1334,832,832,fluttershy
1056598.jpg,https://derpicdn.net/img/view/2015/12/31/1056598.jpg,0,0.961950958,111,0,399,279,288,279,fluttershy
1061445.png,https://derpicdn.net/img/view/2016/1/7/1061445.png,0,0.983437061,148,17,514,383,366,366,fluttershy
106366.png,https://derpicdn.net/img/view/2012/9/25/106366.png,0,0.928099453,150,471,452,773,302,302,fluttershy
1065205.png,https://derpicdn.net/img/view/2016/1/12/1065205.png,0,0.943390787,193,47,589,443,396,396,fluttershy
1065850.png,https://derpicdn.net/img/view/2016/1/13/1065850.png,0,0.986531258,326,0,3500,3338,3174,3338,fluttershy
1066846.png,https://derpicdn.net/img/view/2016/1/15/1066846.png,0,0.996008396,1052,0,2346,1175,1294,1175,fluttershy
1078955.png,https://derpicdn.net/img/view/2016/2/2/1078955.png,0,0.916751981,185,0,1869,1671,1684,1671,fluttershy
1085537.png,https://derpicdn.net/img/view/2016/2/11/1085537.png,0,0.98973453,0,0,144,134,144,134,fluttershy
1085570.png,https://derpicdn.net/img/view/2016/2/11/1085570.png,0,0.941830635,0,0,650,716,650,716,fluttershy
1091306.jpg,https://derpicdn.net/img/view/2016/2/18/1091306.jpg,0,0.996055782,709,29,1915,1235,1206,1206,fluttershy
1102795.png,https://derpicdn.net/img/view/2016/3/6/1102795.png,0,0.981037796,788,987,1370,1569,582,582,fluttershy
11028.png,https://derpicdn.net/img/view/2012/6/20/11028.png,0,0.963991284,409,0,851,440,442,440,fluttershy
1106416.png,https://derpicdn.net/img/view/2016/3/11/1106416.png,0,0.996119797,1322,0,2250,872,928,872,fluttershy
110953.png,https://derpicdn.net/img/view/2012/10/1/110953.png,0,0.99243021,0,1,270,275,270,274,fluttershy
1112041.png,https://derpicdn.net/img/view/2016/3/19/1112041.png,0,0.983007312,511,72,987,548,476,476,fluttershy
1112041.png,https://derpicdn.net/img/view/2016/3/19/1112041.png,1,0.960791171,270,145,712,587,442,442,fluttershy
1113733.png,https://derpicdn.net/img/view/2016/3/21/1113733.png,0,0.989700675,258,27,514,283,256,256,fluttershy
111799.png,https://derpicdn.net/img/view/2012/10/2/111799.png,0,0.998653412,2339,0,4669,2232,2330,2232,fluttershy
1118226.png,https://derpicdn.net/img/view/2016/3/27/1118226.png,0,0.99723959,355,12,1083,740,728,728,fluttershy
1118895.png,https://derpicdn.net/img/view/2016/3/28/1118895.png,0,0.962972939,0,0,558,568,558,568,fluttershy
1132153.png,https://derpicdn.net/img/view/2016/4/15/1132153.png,0,0.967639267,879,33,1739,893,860,860,fluttershy
1133030.png,https://derpicdn.net/img/view/2016/4/16/1133030.png,0,0.997307003,207,0,2665,2314,2458,2314,fluttershy
1133142.png,https://derpicdn.net/img/view/2016/4/16/1133142.png,0,0.966774106,22,74,1000,1000,978,926,fluttershy
1135529.jpg,https://derpicdn.net/img/view/2016/4/19/1135529.jpg,0,0.966178358,67,0,1111,997,1044,997,fluttershy
1141548.png,https://derpicdn.net/img/view/2016/4/28/1141548.png,0,0.990745246,308,0,652,330,344,330,fluttershy
1142754.png,https://derpicdn.net/img/view/2016/4/30/1142754.png,0,0.997322261,31,115,451,535,420,420,fluttershy
115377.png,https://derpicdn.net/img/view/2012/10/6/115377.png,0,0.995468855,167,0,963,766,796,766,fluttershy
1155448.png,https://derpicdn.net/img/view/2016/5/16/1155448.png,0,0.997572899,89,0,583,477,494,477,fluttershy
1169398.png,https://derpicdn.net/img/view/2016/6/3/1169398.png,0,0.972903013,402,24,970,592,568,568,fluttershy
1169990.png,https://derpicdn.net/img/view/2016/6/4/1169990.png,0,0.962112963,249,0,1737,1080,1488,1080,fluttershy
1170190.png,https://derpicdn.net/img/view/2016/6/4/1170190.png,0,0.977830946,235,0,1549,900,1314,900,fluttershy
1170193.png,https://derpicdn.net/img/view/2016/6/4/1170193.png,0,0.974906027,61,39,397,389,336,350,fluttershy
1170209.png,https://derpicdn.net/img/view/2016/6/4/1170209.png,0,0.979398727,3,4,351,386,348,382,fluttershy
1170223.png,https://derpicdn.net/img/view/2016/6/4/1170223.png,0,0.993487418,0,44,417,470,417,426,fluttershy
1171778.png,https://derpicdn.net/img/view/2016/6/6/1171778.png,0,0.92784816,203,0,1227,720,1024,720,fluttershy
1179010.png,https://derpicdn.net/img/view/2016/6/15/1179010.png,0,0.948838115,429,89,875,535,446,446,fluttershy
1179243.png,https://derpicdn.net/img/view/2016/6/15/1179243.png,0,0.99150908,144,0,1166,976,1022,976,fluttershy
1183588.png,https://derpicdn.net/img/view/2016/6/21/1183588.png,0,0.997359157,1797,614,3783,2600,1986,1986,fluttershy
1187497.jpg,https://derpicdn.net/img/view/2016/6/26/1187497.jpg,0,0.986551762,2426,111,4244,1929,1818,1818,fluttershy
1187950.png,https://derpicdn.net/img/view/2016/6/27/1187950.png,0,0.990743518,1203,509,2783,2089,1580,1580,fluttershy
118854.png,https://derpicdn.net/img/view/2012/10/10/118854.png,0,0.997826576,52,374,1366,1688,1314,1314,fluttershy
1191054.png,https://derpicdn.net/img/view/2016/7/1/1191054.png,0,0.986601532,1,0,487,479,486,479,fluttershy
1193447.png,https://derpicdn.net/img/view/2016/7/4/1193447.png,2,0.974772036,622,326,938,642,316,316,fluttershy
1213639.png,https://derpicdn.net/img/view/2016/7/31/1213639.png,0,0.994711578,68,22,952,906,884,884,fluttershy
1232316.png,https://derpicdn.net/img/view/2016/8/23/1232316.png,0,0.997278094,97,94,629,626,532,532,fluttershy
1234311.png,https://derpicdn.net/img/view/2016/8/26/1234311.png,0,0.964349151,31,84,533,586,502,502,fluttershy
1241723.png,https://derpicdn.net/img/view/2016/9/4/1241723.png,0,0.950018406,55,0,1177,720,1122,720,fluttershy
1247036.png,https://derpicdn.net/img/view/2016/9/11/1247036.png,0,0.956769764,155,55,894,865,739,810,fluttershy
1251573.png,https://derpicdn.net/img/view/2016/9/17/1251573.png,0,0.981999397,29,96,759,826,730,730,fluttershy
1255680.png,https://derpicdn.net/img/view/2016/9/22/1255680.png,0,0.991716385,92,79,880,867,788,788,fluttershy
1267369.png,https://derpicdn.net/img/view/2016/10/7/1267369.png,0,0.969157398,362,0,942,574,580,574,fluttershy
1271964.png,https://derpicdn.net/img/view/2016/10/13/1271964.png,0,0.966061175,649,25,2247,1623,1598,1598,fluttershy
1272545.png,https://derpicdn.net/img/view/2016/10/14/1272545.png,0,0.997451603,165,0,2749,2492,2584,2492,fluttershy
1284748.png,https://derpicdn.net/img/view/2016/10/30/1284748.png,0,0.965740681,0,89,415,511,415,422,fluttershy
1297139.png,https://derpicdn.net/img/view/2016/11/16/1297139.png,0,0.998853028,330,18,800,488,470,470,fluttershy
1298661.png,https://derpicdn.net/img/view/2016/11/19/1298661.png,0,0.954637051,232,249,546,563,314,314,fluttershy
1299982.png,https://derpicdn.net/img/view/2016/11/20/1299982.png,0,0.997772992,452,2,1260,810,808,808,fluttershy
1300641.png,https://derpicdn.net/img/view/2016/11/21/1300641.png,0,0.998683453,414,2,784,372,370,370,fluttershy
1302581.png,https://derpicdn.net/img/view/2016/11/24/1302581.png,0,0.980650008,969,0,1923,706,954,706,fluttershy
1309589.png,https://derpicdn.net/img/view/2016/12/4/1309589.png,0,0.998412907,300,0,612,311,312,311,fluttershy
1318992.png,https://derpicdn.net/img/view/2016/12/16/1318992.png,0,0.994272232,181,42,793,654,612,612,fluttershy
1329080.png,https://derpicdn.net/img/view/2016/12/31/1329080.png,0,0.937942028,317,0,643,318,326,318,fluttershy
1331684.png,https://derpicdn.net/img/view/2017/1/4/1331684.png,0,0.979198754,297,173,1257,1133,960,960,fluttershy
13333.png,https://derpicdn.net/img/view/2012/6/21/13333.png,0,0.995131612,411,59,821,469,410,410,fluttershy
1334722.png,https://derpicdn.net/img/view/2017/1/8/1334722.png,0,0.957940042,173,174,863,864,690,690,fluttershy
1343619.png,https://derpicdn.net/img/view/2017/1/20/1343619.png,0,0.989746869,233,0,653,392,420,392,fluttershy
1349515.png,https://derpicdn.net/img/view/2017/1/28/1349515.png,0,0.995952368,50,0,564,505,514,505,fluttershy
1350350.png,https://derpicdn.net/img/view/2017/1/29/1350350.png,0,0.975528896,181,0,805,596,624,596,fluttershy
1354115.png,https://derpicdn.net/img/view/2017/2/3/1354115.png,0,0.982504785,129,0,823,645,694,645,fluttershy
1354118.png,https://derpicdn.net/img/view/2017/2/3/1354118.png,0,0.990158319,1024,646,1856,1478,832,832,fluttershy
1354122.png,https://derpicdn.net/img/view/2017/2/3/1354122.png,0,0.990158319,1024,646,1856,1478,832,832,fluttershy
1354254.png,https://derpicdn.net/img/view/2017/2/3/1354254.png,0,0.995002329,332,0,1484,995,1152,995,fluttershy
1357476.png,https://derpicdn.net/img/view/2017/2/7/1357476.png,0,0.901795924,1452,259,2514,1321,1062,1062,fluttershy
1357958.png,https://derpicdn.net/img/view/2017/2/8/1357958.png,0,0.998292446,195,170,1693,1668,1498,1498,fluttershy
1360470.png,https://derpicdn.net/img/view/2017/2/11/1360470.png,0,0.950932384,0,0,1425,1080,1425,1080,fluttershy
1362209.png,https://derpicdn.net/img/view/2017/2/13/1362209.png,0,0.999522865,1458,0,2792,1146,1334,1146,fluttershy
1362544.png,https://derpicdn.net/img/view/2017/2/14/1362544.png,0,0.998185158,675,630,977,932,302,302,fluttershy
1372660.png,https://derpicdn.net/img/view/2017/2/25/1372660.png,0,0.991940677,310,100,588,378,278,278,fluttershy
1384386.png,https://derpicdn.net/img/view/2017/3/11/1384386.png,0,0.981908381,135,0,713,564,578,564,fluttershy
1390546.png,https://derpicdn.net/img/view/2017/3/18/1390546.png,0,0.99933964,225,0,897,669,672,669,fluttershy
1396152.png,https://derpicdn.net/img/view/2017/3/25/1396152.png,0,0.985411465,166,0,1184,960,1018,960,fluttershy
1402280.png,https://derpicdn.net/img/view/2017/4/2/1402280.png,0,0.980683565,203,0,935,722,732,722,fluttershy
1403163.png,https://derpicdn.net/img/view/2017/4/3/1403163.png,0,0.978490889,78,0,1234,1122,1156,1122,fluttershy
1403842.png,https://derpicdn.net/img/view/2017/4/4/1403842.png,0,0.99913764,1085,408,1717,1040,632,632,fluttershy
1406721.png,https://derpicdn.net/img/view/2017/4/8/1406721.png,0,0.951328576,155,0,904,787,749,787,fluttershy
1407814.png,https://derpicdn.net/img/view/2017/4/9/1407814.png,0,0.985745549,117,33,345,261,228,228,fluttershy
1409912.png,https://derpicdn.net/img/view/2017/4/12/1409912.png,0,0.980234802,39,0,531,475,492,475,fluttershy
1410304.png,https://derpicdn.net/img/view/2017/4/13/1410304.png,0,0.949444652,298,0,1930,1549,1632,1549,fluttershy
1410539.png,https://derpicdn.net/img/view/2017/4/13/1410539.png,0,0.995979071,0,0,1238,1273,1238,1273,fluttershy
1410545.png,https://derpicdn.net/img/view/2017/4/13/1410545.png,0,0.989600599,117,30,549,462,432,432,fluttershy
1415816.png,https://derpicdn.net/img/view/2017/4/19/1415816.png,0,0.993237853,1686,822,3742,2878,2056,2056,fluttershy
1417393.png,https://derpicdn.net/img/view/2017/4/21/1417393.png,0,0.944232404,234,30,1082,878,848,848,fluttershy
1422931.png,https://derpicdn.net/img/view/2017/4/27/1422931.png,0,0.995928049,702,0,1996,1288,1294,1288,fluttershy
1424339.png,https://derpicdn.net/img/view/2017/4/29/1424339.png,0,0.992075086,41,0,689,616,648,616,fluttershy
1426167.png,https://derpicdn.net/img/view/2017/5/1/1426167.png,0,0.977413595,350,243,630,523,280,280,fluttershy
1426599.png,https://derpicdn.net/img/view/2017/5/1/1426599.png,0,0.902939558,105,0,1789,1665,1684,1665,fluttershy
1426781.png,https://derpicdn.net/img/view/2017/5/2/1426781.png,0,0.937789857,445,0,2789,2304,2344,2304,fluttershy
1429118.png,https://derpicdn.net/img/view/2017/5/5/1429118.png,0,0.999147058,1195,823,2105,1733,910,910,fluttershy
1429405.png,https://derpicdn.net/img/view/2017/5/5/1429405.png,0,0.998226702,254,0,786,516,532,516,fluttershy
1431990.png,https://derpicdn.net/img/view/2017/5/8/1431990.png,0,0.981551528,110,78,722,690,612,612,fluttershy
1432360.png,https://derpicdn.net/img/view/2017/5/9/1432360.png,0,0.943378806,1302,0,3396,1999,2094,1999,fluttershy
1432375.png,https://derpicdn.net/img/view/2017/5/9/1432375.png,0,0.989738941,329,509,3445,3119,3116,2610,fluttershy
1433504.png,https://derpicdn.net/img/view/2017/5/10/1433504.png,0,0.994860709,639,13,1449,823,810,810,fluttershy
1434682.png,https://derpicdn.net/img/view/2017/5/12/1434682.png,0,0.989641607,367,268,2527,2308,2160,2040,fluttershy
1434708.png,https://derpicdn.net/img/view/2017/5/12/1434708.png,0,0.965187907,1051,359,1975,1283,924,924,fluttershy
1434899.png,https://derpicdn.net/img/view/2017/5/12/1434899.png,0,0.998751342,175,0,749,531,574,531,fluttershy
1442408.png,https://derpicdn.net/img/view/2017/5/21/1442408.png,0,0.988625765,323,78,1013,768,690,690,fluttershy
1442841.png,https://derpicdn.net/img/view/2017/5/22/1442841.png,0,0.958521545,173,0,1024,804,851,804,fluttershy
1444563.png,https://derpicdn.net/img/view/2017/5/24/1444563.png,0,0.998442948,190,140,522,472,332,332,fluttershy
1454189.png,https://derpicdn.net/img/view/2017/6/4/1454189.png,0,0.950799584,28,0,354,311,326,311,fluttershy
1457554.png,https://derpicdn.net/img/view/2017/6/9/1457554.png,0,0.961138725,780,0,4238,3377,3458,3377,fluttershy
1458467.png,https://derpicdn.net/img/view/2017/6/10/1458467.png,0,0.988457978,256,0,638,372,382,372,fluttershy
1461421.png,https://derpicdn.net/img/view/2017/6/14/1461421.png,0,0.99738282,963,0,3413,2123,2450,2123,fluttershy
1461496.png,https://derpicdn.net/img/view/2017/6/14/1461496.png,0,0.91407156,39,0,377,335,338,335,fluttershy
1463014.png,https://derpicdn.net/img/view/2017/6/16/1463014.png,0,0.945166528,506,0,1094,546,588,546,fluttershy
1463758.png,https://derpicdn.net/img/view/2017/6/17/1463758.png,0,0.981682003,8,0,250,213,242,213,fluttershy
1464408.png,https://derpicdn.net/img/view/2017/6/18/1464408.png,0,0.968337476,246,0,2684,2322,2438,2322,fluttershy
1465190.png,https://derpicdn.net/img/view/2017/6/18/1465190.png,0,0.991863906,0,0,829,900,829,900,fluttershy
146647.jpg,https://derpicdn.net/img/view/2012/11/9/146647.jpg,0,0.948457301,371,88,831,548,460,460,fluttershy
1466473.png,https://derpicdn.net/img/view/2017/6/20/1466473.png,0,0.980687737,114,0,2550,1440,2436,1440,fluttershy
1466848.png,https://derpicdn.net/img/view/2017/6/20/1466848.png,0,0.921326518,286,0,2560,1440,2274,1440,fluttershy
1477761.png,https://derpicdn.net/img/view/2017/7/3/1477761.png,0,0.99139899,719,162,2817,2260,2098,2098,fluttershy
1479675.png,https://derpicdn.net/img/view/2017/7/6/1479675.png,0,0.997603953,375,66,743,434,368,368,fluttershy
1479804.png,https://derpicdn.net/img/view/2017/7/6/1479804.png,0,0.906262636,11,0,821,787,810,787,fluttershy
1484868.png,https://derpicdn.net/img/view/2017/7/12/1484868.png,0,0.926856935,520,269,892,641,372,372,fluttershy
1489629.png,https://derpicdn.net/img/view/2017/7/19/1489629.png,1,0.941126704,0,337,523,911,523,574,fluttershy
1491745.png,https://derpicdn.net/img/view/2017/7/21/1491745.png,0,0.979691386,70,0,678,584,608,584,fluttershy
1494007.png,https://derpicdn.net/img/view/2017/7/24/1494007.png,0,0.955710232,2328,0,5106,2660,2778,2660,fluttershy
1495912.png,https://derpicdn.net/img/view/2017/7/27/1495912.png,0,0.992179513,348,0,1506,1148,1158,1148,fluttershy
1498219.png,https://derpicdn.net/img/view/2017/7/30/1498219.png,0,0.996772468,460,221,936,697,476,476,fluttershy
1499004.png,https://derpicdn.net/img/view/2017/7/31/1499004.png,0,0.963236272,109,0,945,774,836,774,fluttershy
1506966.png,https://derpicdn.net/img/view/2017/8/10/1506966.png,1,0.954201341,634,363,868,597,234,234,fluttershy
1508412.png,https://derpicdn.net/img/view/2017/8/11/1508412.png,0,0.985168874,89,71,499,481,410,410,fluttershy
1510904.png,https://derpicdn.net/img/view/2017/8/14/1510904.png,0,0.994062543,177,0,1365,1186,1188,1186,fluttershy
1511349.png,https://derpicdn.net/img/view/2017/8/15/1511349.png,0,0.981087387,0,123,921,1115,921,992,fluttershy
1513773.png,https://derpicdn.net/img/view/2017/8/18/1513773.png,0,0.980138063,89,148,975,1034,886,886,fluttershy
1513784.png,https://derpicdn.net/img/view/2017/8/18/1513784.png,0,0.911704302,110,35,684,609,574,574,fluttershy
15166.png,https://derpicdn.net/img/view/2012/6/22/15166.png,0,0.969114125,185,46,493,354,308,308,fluttershy
1521454.png,https://derpicdn.net/img/view/2017/8/27/1521454.png,0,0.987779498,484,179,984,679,500,500,fluttershy
1525338.png,https://derpicdn.net/img/view/2017/9/1/1525338.png,0,0.983716488,64,4,554,494,490,490,fluttershy
1527130.png,https://derpicdn.net/img/view/2017/9/3/1527130.png,0,0.997721612,371,224,853,706,482,482,fluttershy
1527815.png,https://derpicdn.net/img/view/2017/9/4/1527815.png,0,0.997263849,800,0,1880,1044,1080,1044,fluttershy
1528003.png,https://derpicdn.net/img/view/2017/9/4/1528003.png,0,0.951659322,220,32,630,442,410,410,fluttershy
1528717.png,https://derpicdn.net/img/view/2017/9/5/1528717.png,0,0.908276558,182,384,1142,1344,960,960,fluttershy
1529873.png,https://derpicdn.net/img/view/2017/9/7/1529873.png,0,0.953529418,203,14,865,676,662,662,fluttershy
1533233.png,https://derpicdn.net/img/view/2017/9/11/1533233.png,0,0.996769607,2168,2088,3500,3452,1332,1364,fluttershy
1533233.png,https://derpicdn.net/img/view/2017/9/11/1533233.png,1,0.996367455,2592,0,3410,802,818,802,fluttershy
1533233.png,https://derpicdn.net/img/view/2017/9/11/1533233.png,2,0.946034908,635,181,1287,833,652,652,fluttershy
1537579.png,https://derpicdn.net/img/view/2017/9/17/1537579.png,0,0.977558553,247,8,547,334,300,326,fluttershy
1538691.png,https://derpicdn.net/img/view/2017/9/18/1538691.png,0,0.9678123,0,0,633,470,633,470,fluttershy
1538709.png,https://derpicdn.net/img/view/2017/9/18/1538709.png,0,0.985378385,20,20,438,438,418,418,fluttershy
1540260.png,https://derpicdn.net/img/view/2017/9/20/1540260.png,0,0.979987621,213,145,587,519,374,374,fluttershy
1543278.png,https://derpicdn.net/img/view/2017/9/24/1543278.png,0,0.971598983,174,74,918,818,744,744,fluttershy
1548970.png,https://derpicdn.net/img/view/2017/10/1/1548970.png,0,0.994512439,708,79,1214,585,506,506,fluttershy
1549394.png,https://derpicdn.net/img/view/2017/10/1/1549394.png,0,0.903946459,0,428,1088,1604,1088,1176,fluttershy
1556.png,https://derpicdn.net/img/view/2012/1/23/1556.png,0,0.997724831,358,66,598,306,240,240,fluttershy
1564129.png,https://derpicdn.net/img/view/2017/10/18/1564129.png,0,0.989570558,61,432,759,1130,698,698,fluttershy
1565456.png,https://derpicdn.net/img/view/2017/10/19/1565456.png,0,0.989492476,187,0,1315,1125,1128,1125,fluttershy
1570195.png,https://derpicdn.net/img/view/2017/10/25/1570195.png,0,0.938417196,0,0,1505,1730,1505,1730,fluttershy
1571750.png,https://derpicdn.net/img/view/2017/10/28/1571750.png,0,0.996705055,238,0,1804,1495,1566,1495,fluttershy
1572631.png,https://derpicdn.net/img/view/2017/10/29/1572631.png,0,0.911158025,115,0,1129,948,1014,948,fluttershy
1579478.png,https://derpicdn.net/img/view/2017/11/6/1579478.png,0,0.937483013,158,131,1810,1783,1652,1652,fluttershy
1581300.png,https://derpicdn.net/img/view/2017/11/8/1581300.png,0,0.950879633,0,0,1976,1941,1976,1941,fluttershy
1590689.png,https://derpicdn.net/img/view/2017/11/20/1590689.png,0,0.968593001,211,105,539,433,328,328,fluttershy
15914.png,https://derpicdn.net/img/view/2012/6/22/15914.png,0,0.998283267,275,10,511,246,236,236,fluttershy
1594115.png,https://derpicdn.net/img/view/2017/11/25/1594115.png,0,0.998383582,380,0,900,512,520,512,fluttershy
1594861.png,https://derpicdn.net/img/view/2017/11/26/1594861.png,0,0.983049691,256,0,1155,925,899,925,fluttershy
1597859.png,https://derpicdn.net/img/view/2017/12/1/1597859.png,0,0.987962186,1983,0,3651,1486,1668,1486,fluttershy
1599436.png,https://derpicdn.net/img/view/2017/12/3/1599436.png,0,0.997571409,150,0,516,364,366,364,fluttershy
1600492.png,https://derpicdn.net/img/view/2017/12/4/1600492.png,0,0.98990643,28,0,954,724,926,724,fluttershy
1609710.png,https://derpicdn.net/img/view/2017/12/17/1609710.png,0,0.987019539,712,0,1436,715,724,715,fluttershy
1612812.png,https://derpicdn.net/img/view/2017/12/21/1612812.png,0,0.944846153,0,8,800,890,800,882,fluttershy
1612907.png,https://derpicdn.net/img/view/2017/12/21/1612907.png,0,0.910022438,896,870,2172,2146,1276,1276,fluttershy
1614807.png,https://derpicdn.net/img/view/2017/12/24/1614807.png,0,0.990147233,317,0,907,573,590,573,fluttershy
1616619.png,https://derpicdn.net/img/view/2017/12/26/1616619.png,0,0.996089995,149,30,1083,964,934,934,fluttershy
1617849.png,https://derpicdn.net/img/view/2017/12/28/1617849.png,0,0.98377794,380,534,968,1122,588,588,fluttershy
1623408.png,https://derpicdn.net/img/view/2018/1/3/1623408.png,0,0.932559729,1904,0,4340,2236,2436,2236,fluttershy
1625489.png,https://derpicdn.net/img/view/2018/1/6/1625489.png,0,0.996959329,215,25,697,507,482,482,fluttershy
1634828.png,https://derpicdn.net/img/view/2018/1/18/1634828.png,0,0.963184416,200,32,2382,2214,2182,2182,fluttershy
1638910.png,https://derpicdn.net/img/view/2018/1/23/1638910.png,0,0.992393672,155,166,471,482,316,316,fluttershy
1639479.png,https://derpicdn.net/img/view/2018/1/24/1639479.png,0,0.949141145,211,0,961,702,750,702,fluttershy
1642781.png,https://derpicdn.net/img/view/2018/1/28/1642781.png,0,0.961462736,632,105,988,461,356,356,fluttershy
1643159.png,https://derpicdn.net/img/view/2018/1/28/1643159.png,0,0.998577833,437,1611,1353,2527,916,916,fluttershy
1643597.png,https://derpicdn.net/img/view/2018/1/29/1643597.png,0,0.993874609,319,60,599,340,280,280,fluttershy
165416.jpg,https://derpicdn.net/img/view/2012/11/27/165416.jpg,0,0.998571157,101,0,711,581,610,581,fluttershy
1664446.png,https://derpicdn.net/img/view/2018/2/24/1664446.png,0,0.998849511,0,0,264,259,264,259,fluttershy
1667550.png,https://derpicdn.net/img/view/2018/2/27/1667550.png,0,0.993839324,304,74,738,508,434,434,fluttershy
1668700.png,https://derpicdn.net/img/view/2018/3/1/1668700.png,0,0.998170733,183,116,721,654,538,538,fluttershy
1669987.png,https://derpicdn.net/img/view/2018/3/2/1669987.png,0,0.98533237,10,0,584,562,574,562,fluttershy
1671318.png,https://derpicdn.net/img/view/2018/3/4/1671318.png,0,0.999098718,251,0,1213,923,962,923,fluttershy
1672941.png,https://derpicdn.net/img/view/2018/3/6/1672941.png,0,0.980405807,89,353,403,667,314,314,fluttershy
1681396.png,https://derpicdn.net/img/view/2018/3/15/1681396.png,0,0.995369554,195,0,797,588,602,588,fluttershy
1682075.png,https://derpicdn.net/img/view/2018/3/16/1682075.png,0,0.993213356,244,418,822,996,578,578,fluttershy
1688750.png,https://derpicdn.net/img/view/2018/3/24/1688750.png,0,0.958577275,1117,158,1735,776,618,618,fluttershy
1688804.png,https://derpicdn.net/img/view/2018/3/24/1688804.png,0,0.995965183,75,0,467,341,392,341,fluttershy
1690213.png,https://derpicdn.net/img/view/2018/3/25/1690213.png,0,0.94285512,192,0,544,336,352,336,fluttershy
1690309.png,https://derpicdn.net/img/view/2018/3/25/1690309.png,0,0.996207595,1661,538,4245,3122,2584,2584,fluttershy
1690414.png,https://derpicdn.net/img/view/2018/3/25/1690414.png,0,0.996669769,744,56,1140,452,396,396,fluttershy
1698831.png,https://derpicdn.net/img/view/2018/4/4/1698831.png,0,0.978940368,193,51,881,739,688,688,fluttershy
1702578.png,https://derpicdn.net/img/view/2018/4/8/1702578.png,0,0.984496653,33,13,603,579,570,566,fluttershy
1706316.png,https://derpicdn.net/img/view/2018/4/13/1706316.png,0,0.995323479,581,35,1015,469,434,434,fluttershy
1706316.png,https://derpicdn.net/img/view/2018/4/13/1706316.png,1,0.949143171,159,5,633,479,474,474,fluttershy
1706404.png,https://derpicdn.net/img/view/2018/4/13/1706404.png,0,0.953591347,24,0,2588,2431,2564,2431,fluttershy
1707689.png,https://derpicdn.net/img/view/2018/4/14/1707689.png,0,0.970570207,345,0,1739,1266,1394,1266,fluttershy
1708491.png,https://derpicdn.net/img/view/2018/4/15/1708491.png,0,0.983567834,171,0,465,279,294,279,fluttershy
1712462.png,https://derpicdn.net/img/view/2018/4/20/1712462.png,0,0.986721814,45,0,1629,1080,1584,1080,fluttershy
1712468.png,https://derpicdn.net/img/view/2018/4/20/1712468.png,0,0.935791612,6,0,1556,1080,1550,1080,fluttershy
1718337.png,https://derpicdn.net/img/view/2018/4/27/1718337.png,1,0.909152746,304,0,570,249,266,249,fluttershy
1720109.png,https://derpicdn.net/img/view/2018/4/29/1720109.png,0,0.966673374,85,57,569,541,484,484,fluttershy
1720165.png,https://derpicdn.net/img/view/2018/4/29/1720165.png,0,0.998026907,385,364,811,790,426,426,fluttershy
1722301.png,https://derpicdn.net/img/view/2018/5/2/1722301.png,0,0.982740521,27,0,361,314,334,314,fluttershy
1724718.png,https://derpicdn.net/img/view/2018/5/5/1724718.png,0,0.984675467,0,34,1729,1844,1729,1810,fluttershy
1727.jpg,https://derpicdn.net/img/view/2012/1/23/1727.jpg,0,0.951842487,11,40,289,318,278,278,fluttershy
1728132.png,https://derpicdn.net/img/view/2018/5/9/1728132.png,0,0.964277864,465,259,3361,3155,2896,2896,fluttershy
1730723.png,https://derpicdn.net/img/view/2018/5/12/1730723.png,0,0.999032974,406,0,832,376,426,376,fluttershy
1730847.png,https://derpicdn.net/img/view/2018/5/12/1730847.png,0,0.936679006,0,0,613,605,613,605,fluttershy
1730997.png,https://derpicdn.net/img/view/2018/5/12/1730997.png,0,0.960780025,0,27,497,581,497,554,fluttershy
1731853.png,https://derpicdn.net/img/view/2018/5/13/1731853.png,0,0.943536282,129,0,445,312,316,312,fluttershy
1732155.png,https://derpicdn.net/img/view/2018/5/13/1732155.png,0,0.973489821,24,173,1391,1677,1367,1504,fluttershy
1734272.png,https://derpicdn.net/img/view/2018/5/16/1734272.png,0,0.949395835,0,0,1916,1865,1916,1865,fluttershy
1738055.png,https://derpicdn.net/img/view/2018/5/21/1738055.png,0,0.998238742,1879,18,3541,1680,1662,1662,fluttershy
1741010.png,https://derpicdn.net/img/view/2018/5/25/1741010.png,0,0.905382514,26,0,404,356,378,356,fluttershy
1742151.png,https://derpicdn.net/img/view/2018/5/26/1742151.png,0,0.99224788,618,148,1064,594,446,446,fluttershy
1745315.png,https://derpicdn.net/img/view/2018/5/30/1745315.png,0,0.966062665,486,0,818,327,332,327,fluttershy
1745972.png,https://derpicdn.net/img/view/2018/5/31/1745972.png,0,0.980131447,385,53,689,357,304,304,fluttershy
1756.jpg,https://derpicdn.net/img/view/2012/1/23/1756.jpg,0,0.984527647,73,0,537,427,464,427,fluttershy
1756802.png,https://derpicdn.net/img/view/2018/6/13/1756802.png,0,0.972874105,1022,47,1822,847,800,800,fluttershy
1758669.png,https://derpicdn.net/img/view/2018/6/16/1758669.png,0,0.987043262,69,0,469,380,400,380,fluttershy
1759814.png,https://derpicdn.net/img/view/2018/6/17/1759814.png,0,0.973193705,616,481,1191,1113,575,632,fluttershy
1767381.png,https://derpicdn.net/img/view/2018/6/27/1767381.png,0,0.996241033,81,119,919,957,838,838,fluttershy
1767642.png,https://derpicdn.net/img/view/2018/6/27/1767642.png,0,0.974177539,1994,325,4214,2545,2220,2220,fluttershy
1778420.png,https://derpicdn.net/img/view/2018/7/11/1778420.png,0,0.986580491,121,16,1267,1162,1146,1146,fluttershy
1778528.png,https://derpicdn.net/img/view/2018/7/11/1778528.png,0,0.987110198,56,0,908,831,852,831,fluttershy
1780623.png,https://derpicdn.net/img/view/2018/7/14/1780623.png,0,0.988283336,0,0,405,481,405,481,fluttershy
1783476.png,https://derpicdn.net/img/view/2018/7/17/1783476.png,0,0.98821944,621,0,1133,467,512,467,fluttershy
1785251.png,https://derpicdn.net/img/view/2018/7/20/1785251.png,0,0.930594027,224,184,960,920,736,736,fluttershy
1787337.png,https://derpicdn.net/img/view/2018/7/22/1787337.png,0,0.999295712,192,64,550,422,358,358,fluttershy
1788224.png,https://derpicdn.net/img/view/2018/7/24/1788224.png,0,0.941620946,237,22,773,558,536,536,fluttershy
1795788.png,https://derpicdn.net/img/view/2018/8/2/1795788.png,0,0.983174622,8,85,434,549,426,464,fluttershy
1797446.png,https://derpicdn.net/img/view/2018/8/4/1797446.png,0,0.997793078,24,26,428,430,404,404,fluttershy
1798028.png,https://derpicdn.net/img/view/2018/8/4/1798028.png,0,0.953644037,1036,0,2886,1838,1850,1838,fluttershy
1800111.png,https://derpicdn.net/img/view/2018/8/6/1800111.png,0,0.998635888,231,17,689,475,458,458,fluttershy
1804125.png,https://derpicdn.net/img/view/2018/8/11/1804125.png,0,0.997503281,1554,0,2808,1091,1254,1091,fluttershy
1804299.png,https://derpicdn.net/img/view/2018/8/11/1804299.png,0,0.995927215,112,0,612,437,500,437,fluttershy
1805220.png,https://derpicdn.net/img/view/2018/8/12/1805220.png,0,0.985383272,366,60,694,388,328,328,fluttershy
1805221.png,https://derpicdn.net/img/view/2018/8/12/1805221.png,0,0.984503031,368,61,692,385,324,324,fluttershy
1808652.png,https://derpicdn.net/img/view/2018/8/16/1808652.png,0,0.951931238,585,95,2587,2097,2002,2002,fluttershy
1808918.png,https://derpicdn.net/img/view/2018/8/17/1808918.png,0,0.963734448,632,151,4018,4171,3386,4020,fluttershy
1809202.png,https://derpicdn.net/img/view/2018/8/17/1809202.png,0,0.968178749,0,0,365,409,365,409,fluttershy
1812304.png,https://derpicdn.net/img/view/2018/8/21/1812304.png,0,0.991368413,389,0,1259,833,870,833,fluttershy
1812454.png,https://derpicdn.net/img/view/2018/8/21/1812454.png,0,0.979067385,84,2,664,582,580,580,fluttershy
1816632.png,https://derpicdn.net/img/view/2018/8/26/1816632.png,0,0.97476387,508,0,794,231,286,231,fluttershy
1816884.png,https://derpicdn.net/img/view/2018/8/26/1816884.png,0,0.985266685,110,0,1309,1310,1199,1310,fluttershy
1818984.png,https://derpicdn.net/img/view/2018/8/28/1818984.png,0,0.995651364,393,23,1127,757,734,734,fluttershy
1826559.png,https://derpicdn.net/img/view/2018/9/6/1826559.png,0,0.95304203,40,0,800,759,760,759,fluttershy
1826977.png,https://derpicdn.net/img/view/2018/9/7/1826977.png,0,0.98644501,540,0,1206,637,666,637,fluttershy
1828828.png,https://derpicdn.net/img/view/2018/9/9/1828828.png,0,0.91685766,108,58,1256,1206,1148,1148,fluttershy
1831147.png,https://derpicdn.net/img/view/2018/9/12/1831147.png,0,0.966780961,0,0,482,526,482,526,fluttershy
1837589.png,https://derpicdn.net/img/view/2018/9/21/1837589.png,0,0.983546019,132,0,1212,1064,1080,1064,fluttershy
1838636.png,https://derpicdn.net/img/view/2018/9/22/1838636.png,1,0.956947088,89,370,803,1084,714,714,fluttershy
1839057.png,https://derpicdn.net/img/view/2018/9/23/1839057.png,0,0.99725318,857,0,2247,1363,1390,1363,fluttershy
1841152.png,https://derpicdn.net/img/view/2018/9/25/1841152.png,0,0.978343248,23,0,583,527,560,527,fluttershy
1843129.png,https://derpicdn.net/img/view/2018/9/28/1843129.png,0,0.995374739,0,0,615,570,615,570,fluttershy
1843408.png,https://derpicdn.net/img/view/2018/9/28/1843408.png,0,0.984879076,0,0,758,768,758,768,fluttershy
1844012.png,https://derpicdn.net/img/view/2018/9/29/1844012.png,0,0.992847204,294,43,928,677,634,634,fluttershy
1852388.png,https://derpicdn.net/img/view/2018/10/9/1852388.png,0,0.973536849,224,251,888,915,664,664,fluttershy
1853753.png,https://derpicdn.net/img/view/2018/10/11/1853753.png,0,0.943774939,166,11,574,419,408,408,fluttershy
1854531.png,https://derpicdn.net/img/view/2018/10/12/1854531.png,0,0.93319869,1572,307,2612,1347,1040,1040,fluttershy
1855422.png,https://derpicdn.net/img/view/2018/10/13/1855422.png,0,0.969685137,66,0,1214,1101,1148,1101,fluttershy
1860023.png,https://derpicdn.net/img/view/2018/10/18/1860023.png,0,0.991104186,93,0,1857,1691,1764,1691,fluttershy
1861474.png,https://derpicdn.net/img/view/2018/10/20/1861474.png,0,0.998737514,105,0,551,411,446,411,fluttershy
1861724.png,https://derpicdn.net/img/view/2018/10/20/1861724.png,0,0.997611403,736,241,1050,555,314,314,fluttershy
18618.png,https://derpicdn.net/img/view/2012/6/24/18618.png,0,0.982899368,85,51,445,411,360,360,fluttershy
1863422.png,https://derpicdn.net/img/view/2018/10/22/1863422.png,0,0.997924805,309,171,1849,1711,1540,1540,fluttershy
1865105.png,https://derpicdn.net/img/view/2018/10/24/1865105.png,0,0.996172845,171,0,1855,1527,1684,1527,fluttershy
1865716.png,https://derpicdn.net/img/view/2018/10/25/1865716.png,0,0.984265924,57,34,508,522,451,488,fluttershy
1865716.png,https://derpicdn.net/img/view/2018/10/25/1865716.png,1,0.950818956,0,118,408,540,408,422,fluttershy
1868739.png,https://derpicdn.net/img/view/2018/10/28/1868739.png,0,0.998874068,176,0,598,384,422,384,fluttershy
1869471.png,https://derpicdn.net/img/view/2018/10/29/1869471.png,0,0.92710495,1674,0,4700,2717,3026,2717,fluttershy
1874431.png,https://derpicdn.net/img/view/2018/11/4/1874431.png,0,0.970198154,233,0,540,301,307,301,fluttershy
1875136.png,https://derpicdn.net/img/view/2018/11/4/1875136.png,0,0.996165872,706,0,2140,1369,1434,1369,fluttershy
1889682.png,https://derpicdn.net/img/view/2018/11/24/1889682.png,0,0.984325171,455,13,1227,785,772,772,fluttershy
1890988.png,https://derpicdn.net/img/view/2018/11/26/1890988.png,0,0.997643948,33,0,837,783,804,783,fluttershy
1893369.png,https://derpicdn.net/img/view/2018/11/29/1893369.png,0,0.969463766,653,173,1313,833,660,660,fluttershy
1894789.png,https://derpicdn.net/img/view/2018/11/30/1894789.png,0,0.94768858,627,215,1235,823,608,608,fluttershy
1895750.png,https://derpicdn.net/img/view/2018/12/1/1895750.png,0,0.990711391,320,192,976,848,656,656,fluttershy
1896288.png,https://derpicdn.net/img/view/2018/12/2/1896288.png,0,0.963947058,456,110,774,428,318,318,fluttershy
1896491.png,https://derpicdn.net/img/view/2018/12/2/1896491.png,0,0.903917432,1369,894,2865,2390,1496,1496,fluttershy
1897251.png,https://derpicdn.net/img/view/2018/12/3/1897251.png,0,0.952778995,275,558,2799,3082,2524,2524,fluttershy
1897326.png,https://derpicdn.net/img/view/2018/12/3/1897326.png,0,0.991643727,121,0,697,543,576,543,fluttershy
1897713.png,https://derpicdn.net/img/view/2018/12/4/1897713.png,0,0.997078598,233,0,1547,1237,1314,1237,fluttershy
1898480.png,https://derpicdn.net/img/view/2018/12/4/1898480.png,0,0.997033358,624,0,1964,1152,1340,1152,fluttershy
1903105.png,https://derpicdn.net/img/view/2018/12/9/1903105.png,0,0.974016249,455,257,3719,3521,3264,3264,fluttershy
1903271.png,https://derpicdn.net/img/view/2018/12/9/1903271.png,0,0.909953654,186,2,716,532,530,530,fluttershy
1906357.png,https://derpicdn.net/img/view/2018/12/12/1906357.png,0,0.928121328,0,0,795,743,795,743,fluttershy
1907217.png,https://derpicdn.net/img/view/2018/12/13/1907217.png,0,0.937915027,0,596,2986,3312,2986,2716,fluttershy
1909852.png,https://derpicdn.net/img/view/2018/12/16/1909852.png,0,0.991042554,12,0,1000,932,988,932,fluttershy
1912496.png,https://derpicdn.net/img/view/2018/12/19/1912496.png,0,0.935577393,300,66,710,476,410,410,fluttershy
1914386.png,https://derpicdn.net/img/view/2018/12/21/1914386.png,0,0.955913961,46,224,1764,1942,1718,1718,fluttershy
1918117.png,https://derpicdn.net/img/view/2018/12/25/1918117.png,0,0.990717053,792,0,2562,1695,1770,1695,fluttershy
1920953.png,https://derpicdn.net/img/view/2018/12/28/1920953.png,0,0.979762673,177,151,409,383,232,232,fluttershy
1923173.png,https://derpicdn.net/img/view/2018/12/31/1923173.png,0,0.97919625,34,0,1390,1337,1356,1337,fluttershy
1925194.png,https://derpicdn.net/img/view/2019/1/2/1925194.png,0,0.983924091,116,196,486,566,370,370,fluttershy
1928550.png,https://derpicdn.net/img/view/2019/1/6/1928550.png,0,0.96681124,53,20,859,826,806,806,fluttershy
1930015.png,https://derpicdn.net/img/view/2019/1/8/1930015.png,0,0.991933107,891,0,4000,3000,3109,3000,fluttershy
1932767.png,https://derpicdn.net/img/view/2019/1/12/1932767.png,0,0.997469664,30,0,322,269,292,269,fluttershy
1934774.png,https://derpicdn.net/img/view/2019/1/14/1934774.png,0,0.937407434,84,90,300,300,216,210,fluttershy
1935265.png,https://derpicdn.net/img/view/2019/1/14/1935265.png,0,0.990814805,203,0,713,458,510,458,fluttershy
1935445.png,https://derpicdn.net/img/view/2019/1/14/1935445.png,0,0.993075907,1,0,489,479,488,479,fluttershy
1935577.png,https://derpicdn.net/img/view/2019/1/14/1935577.png,0,0.989330709,363,0,3391,2922,3028,2922,fluttershy
1936611.png,https://derpicdn.net/img/view/2019/1/16/1936611.png,0,0.9892115,92,0,2060,2010,1968,2010,fluttershy
1936625.png,https://derpicdn.net/img/view/2019/1/16/1936625.png,0,0.99429816,149,0,639,478,490,478,fluttershy
1940326.png,https://derpicdn.net/img/view/2019/1/20/1940326.png,0,0.998090446,467,0,1233,711,766,711,fluttershy
1944416.png,https://derpicdn.net/img/view/2019/1/25/1944416.png,0,0.989054024,2402,0,3116,682,714,682,fluttershy
1946719.png,https://derpicdn.net/img/view/2019/1/28/1946719.png,0,0.927853167,0,120,694,800,694,680,fluttershy
1948978.png,https://derpicdn.net/img/view/2019/1/30/1948978.png,0,0.99695009,28,0,942,784,914,784,fluttershy
1949585.png,https://derpicdn.net/img/view/2019/1/31/1949585.png,0,0.987459779,1943,0,10921,8121,8978,8121,fluttershy
1951155.png,https://derpicdn.net/img/view/2019/2/2/1951155.png,0,0.945947886,0,431,1618,2107,1618,1676,fluttershy
1951449.png,https://derpicdn.net/img/view/2019/2/2/1951449.png,0,0.983932257,1105,133,2307,1335,1202,1202,fluttershy
1954823.png,https://derpicdn.net/img/view/2019/2/6/1954823.png,0,0.989178717,3,14,139,150,136,136,fluttershy
1955973.png,https://derpicdn.net/img/view/2019/2/7/1955973.png,0,0.996121824,316,0,1160,785,844,785,fluttershy
1957300.png,https://derpicdn.net/img/view/2019/2/9/1957300.png,0,0.988666952,130,0,936,787,806,787,fluttershy
1957505.png,https://derpicdn.net/img/view/2019/2/9/1957505.png,0,0.977444708,0,0,603,568,603,568,fluttershy
1959482.png,https://derpicdn.net/img/view/2019/2/11/1959482.png,0,0.97328943,625,0,2637,1845,2012,1845,fluttershy
1959884.png,https://derpicdn.net/img/view/2019/2/12/1959884.png,0,0.989431679,2893,1742,3515,2364,622,622,fluttershy
1960616.png,https://derpicdn.net/img/view/2019/2/13/1960616.png,0,0.966155648,42,0,698,631,656,631,fluttershy
1963533.png,https://derpicdn.net/img/view/2019/2/16/1963533.png,0,0.920436978,0,0,395,410,395,410,fluttershy
1963534.png,https://derpicdn.net/img/view/2019/2/16/1963534.png,0,0.946572244,38,0,442,402,404,402,fluttershy
1964999.png,https://derpicdn.net/img/view/2019/2/18/1964999.png,0,0.905369282,759,849,3765,3855,3006,3006,fluttershy
1965810.png,https://derpicdn.net/img/view/2019/2/19/1965810.png,0,0.967051268,105,0,1075,867,970,867,fluttershy
1966544.png,https://derpicdn.net/img/view/2019/2/19/1966544.png,0,0.977331161,181,62,551,432,370,370,fluttershy
1968499.png,https://derpicdn.net/img/view/2019/2/22/1968499.png,0,0.914488971,0,0,597,558,597,558,fluttershy
1969441.png,https://derpicdn.net/img/view/2019/2/23/1969441.png,0,0.939007282,428,159,890,621,462,462,fluttershy
1970527.png,https://derpicdn.net/img/view/2019/2/24/1970527.png,0,0.97376287,0,0,1792,1889,1792,1889,fluttershy
1972968.png,https://derpicdn.net/img/view/2019/2/27/1972968.png,0,0.97588861,483,0,1479,962,996,962,fluttershy
1975781.png,https://derpicdn.net/img/view/2019/3/2/1975781.png,0,0.969278634,501,33,1107,639,606,606,fluttershy
1975781.png,https://derpicdn.net/img/view/2019/3/2/1975781.png,1,0.931348503,1101,135,1391,425,290,290,fluttershy
1977963.png,https://derpicdn.net/img/view/2019/3/5/1977963.png,0,0.970010817,0,8,881,890,881,882,fluttershy
1979810.png,https://derpicdn.net/img/view/2019/3/7/1979810.png,0,0.995474756,7,165,417,575,410,410,fluttershy
1980840.png,https://derpicdn.net/img/view/2019/3/8/1980840.png,0,0.958693027,49,0,531,478,482,478,fluttershy
1985137.png,https://derpicdn.net/img/view/2019/3/14/1985137.png,0,0.998620689,343,293,1249,1199,906,906,fluttershy
1986271.png,https://derpicdn.net/img/view/2019/3/15/1986271.png,0,0.937563837,189,0,1009,787,820,787,fluttershy
1992232.png,https://derpicdn.net/img/view/2019/3/22/1992232.png,0,0.989486814,252,82,818,648,566,566,fluttershy
1992233.png,https://derpicdn.net/img/view/2019/3/22/1992233.png,0,0.998658419,172,124,586,538,414,414,fluttershy
1993819.png,https://derpicdn.net/img/view/2019/3/24/1993819.png,0,0.980320573,10,86,868,939,858,853,fluttershy
1995283.png,https://derpicdn.net/img/view/2019/3/26/1995283.png,0,0.949359596,699,0,4000,3075,3301,3075,fluttershy
1995669.png,https://derpicdn.net/img/view/2019/3/26/1995669.png,0,0.985543847,81,27,911,861,830,834,fluttershy
1996008.png,https://derpicdn.net/img/view/2019/3/27/1996008.png,0,0.982292771,81,0,770,726,689,726,fluttershy
1996427.png,https://derpicdn.net/img/view/2019/3/28/1996427.png,0,0.996860564,556,115,1406,965,850,850,fluttershy
1998795.png,https://derpicdn.net/img/view/2019/3/31/1998795.png,0,0.971847177,527,560,2009,2042,1482,1482,fluttershy
2000007.png,https://derpicdn.net/img/view/2019/4/1/2000007.png,0,0.982875407,174,0,1506,1114,1332,1114,fluttershy
2000127.png,https://derpicdn.net/img/view/2019/4/1/2000127.png,0,0.972203195,26,0,1624,1513,1598,1513,fluttershy
2000827.png,https://derpicdn.net/img/view/2019/4/2/2000827.png,0,0.995472908,70,0,408,328,338,328,fluttershy
2005668.png,https://derpicdn.net/img/view/2019/4/7/2005668.png,0,0.985880136,426,213,800,587,374,374,fluttershy
2005987.png,https://derpicdn.net/img/view/2019/4/7/2005987.png,0,0.971303284,0,394,1439,1876,1439,1482,fluttershy
2007526.png,https://derpicdn.net/img/view/2019/4/9/2007526.png,0,0.999380112,24,0,848,765,824,765,fluttershy
2008993.png,https://derpicdn.net/img/view/2019/4/11/2008993.png,0,0.947290182,0,0,697,685,697,685,fluttershy
2009280.png,https://derpicdn.net/img/view/2019/4/11/2009280.png,0,0.946813107,186,0,656,464,470,464,fluttershy
2009343.png,https://derpicdn.net/img/view/2019/4/11/2009343.png,0,0.994106531,2140,283,5662,3805,3522,3522,fluttershy
201030.png,https://derpicdn.net/img/view/2013/1/3/201030.png,0,0.914237797,1038,0,2582,1361,1544,1361,fluttershy
2011340.png,https://derpicdn.net/img/view/2019/4/13/2011340.png,0,0.970144391,353,113,1337,1097,984,984,fluttershy
2012485.png,https://derpicdn.net/img/view/2019/4/14/2012485.png,0,0.939903438,62,0,802,706,740,706,fluttershy
2012624.png,https://derpicdn.net/img/view/2019/4/14/2012624.png,0,0.984383702,1483,1208,3477,3202,1994,1994,fluttershy
2014811.png,https://derpicdn.net/img/view/2019/4/17/2014811.png,0,0.986601412,10,0,468,341,458,341,fluttershy
2015300.png,https://derpicdn.net/img/view/2019/4/17/2015300.png,0,0.952378809,115,0,1356,1175,1241,1175,fluttershy
2016319.png,https://derpicdn.net/img/view/2019/4/19/2016319.png,0,0.940483332,729,0,3273,2428,2544,2428,fluttershy
2016433.png,https://derpicdn.net/img/view/2019/4/19/2016433.png,0,0.98410517,130,0,374,223,244,223,fluttershy
2017511.png,https://derpicdn.net/img/view/2019/4/20/2017511.png,0,0.958112061,166,0,748,486,582,486,fluttershy
2019413.png,https://derpicdn.net/img/view/2019/4/22/2019413.png,0,0.992659748,296,0,873,624,577,624,fluttershy
2021448.png,https://derpicdn.net/img/view/2019/4/24/2021448.png,0,0.970464706,0,0,1992,2239,1992,2239,fluttershy
2022759.jpg,https://derpicdn.net/img/view/2019/4/25/2022759.jpg,0,0.998721659,513,0,739,197,226,197,fluttershy
2022832.png,https://derpicdn.net/img/view/2019/4/25/2022832.png,0,0.923269391,0,0,972,1048,972,1048,fluttershy
2022834.png,https://derpicdn.net/img/view/2019/4/25/2022834.png,0,0.990384459,421,133,1127,839,706,706,fluttershy
2025193.png,https://derpicdn.net/img/view/2019/4/28/2025193.png,0,0.987865269,395,245,1967,1817,1572,1572,fluttershy
2027306.png,https://derpicdn.net/img/view/2019/4/30/2027306.png,0,0.996573031,68,15,600,547,532,532,fluttershy
2028074.png,https://derpicdn.net/img/view/2019/5/1/2028074.png,0,0.913351119,1379,149,1957,727,578,578,fluttershy
2029302.png,https://derpicdn.net/img/view/2019/5/2/2029302.png,0,0.981236458,259,114,1187,1042,928,928,fluttershy
2030082.png,https://derpicdn.net/img/view/2019/5/3/2030082.png,0,0.985228896,0,0,3029,2722,3029,2722,fluttershy
2030696.png,https://derpicdn.net/img/view/2019/5/4/2030696.png,0,0.97187978,28,319,1078,1369,1050,1050,fluttershy
2032528.png,https://derpicdn.net/img/view/2019/5/6/2032528.png,0,0.996375918,26,55,380,409,354,354,fluttershy
2033016.png,https://derpicdn.net/img/view/2019/5/7/2033016.png,0,0.999038756,58,558,702,1202,644,644,fluttershy
2034558.png,https://derpicdn.net/img/view/2019/5/9/2034558.png,0,0.985382318,0,0,684,717,684,717,fluttershy
20362.jpg,https://derpicdn.net/img/view/2012/6/25/20362.jpg,0,0.916644037,251,24,545,318,294,294,fluttershy
2037172.png,https://derpicdn.net/img/view/2019/5/12/2037172.png,0,0.99736613,1234,279,2278,1323,1044,1044,fluttershy
2037511.png,https://derpicdn.net/img/view/2019/5/12/2037511.png,0,0.999085009,1021,0,3797,2470,2776,2470,fluttershy
2037650.png,https://derpicdn.net/img/view/2019/5/13/2037650.png,0,0.990113258,796,0,3866,2963,3070,2963,fluttershy
2039369.png,https://derpicdn.net/img/view/2019/5/15/2039369.png,0,0.985793591,336,0,784,445,448,445,fluttershy
2040815.png,https://derpicdn.net/img/view/2019/5/16/2040815.png,0,0.999397755,355,17,767,429,412,412,fluttershy
2045365.png,https://derpicdn.net/img/view/2019/5/21/2045365.png,0,0.982073128,128,0,528,396,400,396,fluttershy
2047229.png,https://derpicdn.net/img/view/2019/5/23/2047229.png,0,0.985901654,2851,0,6702,4115,3851,4115,fluttershy
2048916.png,https://derpicdn.net/img/view/2019/5/25/2048916.png,0,0.980491638,4,0,1228,1002,1224,1002,fluttershy
2051987.png,https://derpicdn.net/img/view/2019/5/28/2051987.png,0,0.992603004,61,95,789,823,728,728,fluttershy
2054232.png,https://derpicdn.net/img/view/2019/5/31/2054232.png,0,0.993990541,1514,0,3370,1788,1856,1788,fluttershy
2060339.png,https://derpicdn.net/img/view/2019/6/8/2060339.png,0,0.967105448,77,0,1047,855,970,855,fluttershy
206057.jpg,https://derpicdn.net/img/view/2013/1/8/206057.jpg,0,0.995102763,382,380,584,582,202,202,fluttershy
206057.jpg,https://derpicdn.net/img/view/2013/1/8/206057.jpg,1,0.99184525,0,171,229,431,229,260,fluttershy
206057.jpg,https://derpicdn.net/img/view/2013/1/8/206057.jpg,2,0.965576708,177,404,345,572,168,168,fluttershy
2063239.png,https://derpicdn.net/img/view/2019/6/11/2063239.png,0,0.999549448,229,140,1495,1406,1266,1266,fluttershy
2063664.png,https://derpicdn.net/img/view/2019/6/12/2063664.png,0,0.981576145,11,0,285,256,274,256,fluttershy
2064349.png,https://derpicdn.net/img/view/2019/6/13/2064349.png,0,0.993064404,725,23,1605,903,880,880,fluttershy
2067673.png,https://derpicdn.net/img/view/2019/6/17/2067673.png,0,0.952588081,93,6,413,326,320,320,fluttershy
2070995.png,https://derpicdn.net/img/view/2019/6/21/2070995.png,0,0.96940738,265,0,1975,1626,1710,1626,fluttershy
2071154.png,https://derpicdn.net/img/view/2019/6/21/2071154.png,0,0.995446265,93,0,371,272,278,272,fluttershy
2073225.png,https://derpicdn.net/img/view/2019/6/23/2073225.png,0,0.999128878,284,12,896,624,612,612,fluttershy
2077310.png,https://derpicdn.net/img/view/2019/6/28/2077310.png,0,0.911345959,0,0,2948,2899,2948,2899,fluttershy
2077341.png,https://derpicdn.net/img/view/2019/6/28/2077341.png,0,0.985112369,59,0,383,310,324,310,fluttershy
2078752.png,https://derpicdn.net/img/view/2019/6/29/2078752.png,0,0.977028787,28,3,438,410,410,407,fluttershy
2083270.png,https://derpicdn.net/img/view/2019/7/5/2083270.png,0,0.992714286,70,0,704,580,634,580,fluttershy
208511.png,https://derpicdn.net/img/view/2013/1/10/208511.png,1,0.953503013,169,24,425,280,256,256,fluttershy
2086864.png,https://derpicdn.net/img/view/2019/7/9/2086864.png,0,0.97457248,0,0,1057,1055,1057,1055,fluttershy
2089719.png,https://derpicdn.net/img/view/2019/7/12/2089719.png,0,0.997808754,610,836,1536,1762,926,926,fluttershy
2091156.png,https://derpicdn.net/img/view/2019/7/14/2091156.png,0,0.965994537,40,0,1810,1372,1770,1372,fluttershy
2091363.png,https://derpicdn.net/img/view/2019/7/14/2091363.png,0,0.947863698,1066,261,1962,1157,896,896,fluttershy
2091516.png,https://derpicdn.net/img/view/2019/7/14/2091516.png,0,0.939152241,202,0,1122,721,920,721,fluttershy
2091583.png,https://derpicdn.net/img/view/2019/7/14/2091583.png,0,0.913836718,452,112,2010,1670,1558,1558,fluttershy
2091968.png,https://derpicdn.net/img/view/2019/7/14/2091968.png,0,0.988055289,0,0,714,746,714,746,fluttershy
2093175.png,https://derpicdn.net/img/view/2019/7/16/2093175.png,0,0.931931078,77,52,1024,1024,947,972,fluttershy
2093639.png,https://derpicdn.net/img/view/2019/7/16/2093639.png,0,0.999651134,0,24,933,994,933,970,fluttershy
2096940.png,https://derpicdn.net/img/view/2019/7/20/2096940.png,0,0.982398272,823,0,2533,1669,1710,1669,fluttershy
2097944.png,https://derpicdn.net/img/view/2019/7/21/2097944.png,0,0.986542523,337,34,1145,842,808,808,fluttershy
2098010.png,https://derpicdn.net/img/view/2019/7/21/2098010.png,0,0.992164791,456,375,1298,1217,842,842,fluttershy
2102210.png,https://derpicdn.net/img/view/2019/7/27/2102210.png,0,0.992675662,76,86,692,702,616,616,fluttershy
2102558.png,https://derpicdn.net/img/view/2019/7/27/2102558.png,0,0.989272237,151,0,1133,886,982,886,fluttershy
2107715.png,https://derpicdn.net/img/view/2019/8/3/2107715.png,0,0.99834305,270,0,678,397,408,397,fluttershy
2113277.png,https://derpicdn.net/img/view/2019/8/9/2113277.png,0,0.919029355,1035,102,2605,1672,1570,1570,fluttershy
2113777.png,https://derpicdn.net/img/view/2019/8/10/2113777.png,0,0.959898233,0,0,1363,1273,1363,1273,fluttershy
2116550.png,https://derpicdn.net/img/view/2019/8/12/2116550.png,0,0.990203023,634,45,1404,815,770,770,fluttershy
2117448.png,https://derpicdn.net/img/view/2019/8/13/2117448.png,0,0.993498385,607,40,1037,470,430,430,fluttershy
2117448.png,https://derpicdn.net/img/view/2019/8/13/2117448.png,1,0.955188572,255,108,707,560,452,452,fluttershy
2120343.png,https://derpicdn.net/img/view/2019/8/17/2120343.png,0,0.999243915,63,0,473,401,410,401,fluttershy
2122543.png,https://derpicdn.net/img/view/2019/8/19/2122543.png,0,0.978074074,63,0,1651,897,1588,897,fluttershy
2123910.png,https://derpicdn.net/img/view/2019/8/21/2123910.png,0,0.961948216,0,0,1275,1038,1275,1038,fluttershy
2127025.png,https://derpicdn.net/img/view/2019/8/25/2127025.png,0,0.994199634,825,137,1475,787,650,650,fluttershy
2129391.png,https://derpicdn.net/img/view/2019/8/27/2129391.png,0,0.971877396,314,0,1158,802,844,802,fluttershy
2129579.png,https://derpicdn.net/img/view/2019/8/28/2129579.png,0,0.965842485,552,0,1352,789,800,789,fluttershy
2133638.png,https://derpicdn.net/img/view/2019/9/1/2133638.png,0,0.989432573,510,0,2326,1741,1816,1741,fluttershy
2134477.png,https://derpicdn.net/img/view/2019/9/2/2134477.png,0,0.935971975,166,174,2522,2818,2356,2644,fluttershy
2134732.png,https://derpicdn.net/img/view/2019/9/2/2134732.png,0,0.995467067,1074,787,2816,2529,1742,1742,fluttershy
2137299.png,https://derpicdn.net/img/view/2019/9/5/2137299.png,0,0.999541819,256,0,528,260,272,260,fluttershy
21383.png,https://derpicdn.net/img/view/2012/6/26/21383.png,0,0.995855689,187,144,563,520,376,376,fluttershy
2140655.png,https://derpicdn.net/img/view/2019/9/10/2140655.png,0,0.988614917,511,39,841,369,330,330,fluttershy
2144420.png,https://derpicdn.net/img/view/2019/9/15/2144420.png,0,0.946860969,53,289,2579,2815,2526,2526,fluttershy
2144936.png,https://derpicdn.net/img/view/2019/9/15/2144936.png,0,0.981094539,703,0,1485,759,782,759,fluttershy
2148235.png,https://derpicdn.net/img/view/2019/9/20/2148235.png,0,0.971938074,178,146,438,406,260,260,fluttershy
2149492.png,https://derpicdn.net/img/view/2019/9/21/2149492.png,0,0.973312795,0,0,535,497,535,497,fluttershy
2149496.png,https://derpicdn.net/img/view/2019/9/21/2149496.png,0,0.966587961,0,25,808,703,808,678,fluttershy
2150654.png,https://derpicdn.net/img/view/2019/9/22/2150654.png,0,0.989040315,117,0,897,709,780,709,fluttershy
2151786.png,https://derpicdn.net/img/view/2019/9/24/2151786.png,0,0.986462414,0,0,480,461,480,461,fluttershy
2154583.png,https://derpicdn.net/img/view/2019/9/28/2154583.png,0,0.992586076,273,34,1089,850,816,816,fluttershy
2157711.png,https://derpicdn.net/img/view/2019/10/1/2157711.png,0,0.952581167,212,0,1778,1363,1566,1363,fluttershy
2166675.png,https://derpicdn.net/img/view/2019/10/12/2166675.png,0,0.992515147,4,0,1834,1451,1830,1451,fluttershy
2169272.png,https://derpicdn.net/img/view/2019/10/15/2169272.png,0,0.957096338,0,0,1321,1280,1321,1280,fluttershy
2170098.png,https://derpicdn.net/img/view/2019/10/16/2170098.png,0,0.97623384,0,0,743,768,743,768,fluttershy
2170098.png,https://derpicdn.net/img/view/2019/10/16/2170098.png,1,0.927531779,82,43,1014,989,932,946,fluttershy
2174127.png,https://derpicdn.net/img/view/2019/10/20/2174127.png,0,0.971255183,457,0,6000,5550,5543,5550,fluttershy
2175764.png,https://derpicdn.net/img/view/2019/10/22/2175764.png,0,0.997061849,161,39,733,611,572,572,fluttershy
2178938.png,https://derpicdn.net/img/view/2019/10/25/2178938.png,0,0.990983903,228,0,906,539,678,539,fluttershy
2185533.png,https://derpicdn.net/img/view/2019/11/2/2185533.png,0,0.992436886,882,0,1760,848,878,848,fluttershy
2188219.png,https://derpicdn.net/img/view/2019/11/5/2188219.png,0,0.990404665,43,0,789,691,746,691,fluttershy
2191897.png,https://derpicdn.net/img/view/2019/11/10/2191897.png,0,0.996579289,73,0,1621,1348,1548,1348,fluttershy
2193687.png,https://derpicdn.net/img/view/2019/11/12/2193687.png,1,0.983654201,92,189,342,439,250,250,fluttershy
2193687.png,https://derpicdn.net/img/view/2019/11/12/2193687.png,3,0.955361009,275,66,960,848,685,782,fluttershy
2193687.png,https://derpicdn.net/img/view/2019/11/12/2193687.png,4,0.921476007,683,969,960,1285,277,316,fluttershy
2196529.png,https://derpicdn.net/img/view/2019/11/15/2196529.png,0,0.948441267,212,14,395,204,183,190,fluttershy
2197824.png,https://derpicdn.net/img/view/2019/11/16/2197824.png,0,0.983857155,18,0,886,820,868,820,fluttershy
2202916.png,https://derpicdn.net/img/view/2019/11/22/2202916.png,0,0.985837221,223,93,966,871,743,778,fluttershy
2202916.png,https://derpicdn.net/img/view/2019/11/22/2202916.png,1,0.928264499,0,82,726,878,726,796,fluttershy
2203604.png,https://derpicdn.net/img/view/2019/11/23/2203604.png,0,0.966545999,476,0,3000,2527,2524,2527,fluttershy
2203936.png,https://derpicdn.net/img/view/2019/11/23/2203936.png,0,0.948565841,0,0,3313,3002,3313,3002,fluttershy
2208621.png,https://derpicdn.net/img/view/2019/11/29/2208621.png,0,0.998098791,1460,369,3300,2209,1840,1840,fluttershy
220902.png,https://derpicdn.net/img/view/2013/1/22/220902.png,0,0.943913102,109,41,363,295,254,254,fluttershy
2212017.png,https://derpicdn.net/img/view/2019/12/4/2212017.png,0,0.989016593,225,0,1955,1539,1730,1539,fluttershy
22138.png,https://derpicdn.net/img/view/2012/6/26/22138.png,0,0.997898936,25,266,203,444,178,178,fluttershy
2215166.png,https://derpicdn.net/img/view/2019/12/7/2215166.png,0,0.996781528,103,0,347,234,244,234,fluttershy
2216249.png,https://derpicdn.net/img/view/2019/12/9/2216249.png,0,0.982039094,18,14,216,212,198,198,fluttershy
2218934.png,https://derpicdn.net/img/view/2019/12/12/2218934.png,0,0.999425709,184,0,528,323,344,323,fluttershy
2220009.png,https://derpicdn.net/img/view/2019/12/14/2220009.png,0,0.982942462,59,0,291,215,232,215,fluttershy
2221735.png,https://derpicdn.net/img/view/2019/12/16/2221735.png,0,0.976133704,0,0,481,541,481,541,fluttershy
2223243.png,https://derpicdn.net/img/view/2019/12/17/2223243.png,0,0.985889018,0,0,1087,1062,1087,1062,fluttershy
2227921.jpg,https://derpicdn.net/img/view/2019/12/23/2227921.jpg,0,0.997379065,334,626,1116,1408,782,782,fluttershy
2228031.jpg,https://derpicdn.net/img/view/2019/12/23/2228031.jpg,0,0.995391786,1438,224,2864,1650,1426,1426,fluttershy
2229023.png,https://derpicdn.net/img/view/2019/12/24/2229023.png,0,0.998631001,91,37,477,423,386,386,fluttershy
2230757.jpg,https://derpicdn.net/img/view/2019/12/26/2230757.jpg,0,0.959111869,655,484,1119,948,464,464,fluttershy
2234462.png,https://derpicdn.net/img/view/2019/12/31/2234462.png,0,0.982722402,4,17,816,849,812,832,fluttershy
2235485.png,https://derpicdn.net/img/view/2020/1/1/2235485.png,0,0.95478344,488,62,1606,1180,1118,1118,fluttershy
2235781.jpg,https://derpicdn.net/img/view/2020/1/1/2235781.jpg,0,0.945657432,352,0,1202,684,850,684,fluttershy
22359.png,https://derpicdn.net/img/view/2012/6/27/22359.png,0,0.912528574,479,142,1901,1564,1422,1422,fluttershy
2236378.png,https://derpicdn.net/img/view/2020/1/2/2236378.png,0,0.995340109,179,63,627,511,448,448,fluttershy
2239523.jpg,https://derpicdn.net/img/view/2020/1/5/2239523.jpg,0,0.990714431,109,0,1235,1076,1126,1076,fluttershy
2244493.png,https://derpicdn.net/img/view/2020/1/11/2244493.png,0,0.972685993,0,0,386,366,386,366,fluttershy
2247014.png,https://derpicdn.net/img/view/2020/1/14/2247014.png,0,0.955796003,164,15,630,481,466,466,fluttershy
2247442.png,https://derpicdn.net/img/view/2020/1/14/2247442.png,0,0.98304379,29,26,451,448,422,422,fluttershy
2248714.jpg,https://derpicdn.net/img/view/2020/1/16/2248714.jpg,0,0.908023059,87,0,1037,907,950,907,fluttershy
2251521.png,https://derpicdn.net/img/view/2020/1/19/2251521.png,0,0.965932906,550,0,2334,1754,1784,1754,fluttershy
2252926.png,https://derpicdn.net/img/view/2020/1/21/2252926.png,0,0.99895376,1108,116,1852,860,744,744,fluttershy
2253670.jpg,https://derpicdn.net/img/view/2020/1/22/2253670.jpg,0,0.952699661,802,0,1094,269,292,269,fluttershy
2254551.jpg,https://derpicdn.net/img/view/2020/1/23/2254551.jpg,0,0.98723197,161,10,837,686,676,676,fluttershy
2257606.jpg,https://derpicdn.net/img/view/2020/1/26/2257606.jpg,0,0.943246663,129,29,445,345,316,316,fluttershy
2258337.png,https://derpicdn.net/img/view/2020/1/27/2258337.png,0,0.97046721,172,135,1598,1561,1426,1426,fluttershy
2259756.png,https://derpicdn.net/img/view/2020/1/28/2259756.png,0,0.983819127,0,80,536,698,536,618,fluttershy
2259758.png,https://derpicdn.net/img/view/2020/1/28/2259758.png,0,0.990812004,0,182,729,932,729,750,fluttershy
2260405.png,https://derpicdn.net/img/view/2020/1/29/2260405.png,1,0.914776564,34,107,396,469,362,362,fluttershy
2262838.jpg,https://derpicdn.net/img/view/2020/2/1/2262838.jpg,0,0.994791806,423,446,723,746,300,300,fluttershy
2264432.png,https://derpicdn.net/img/view/2020/2/3/2264432.png,0,0.995738924,2232,110,4082,1960,1850,1850,fluttershy
2266077.png,https://derpicdn.net/img/view/2020/2/5/2266077.png,0,0.959996641,0,0,504,581,504,581,fluttershy
2266078.png,https://derpicdn.net/img/view/2020/2/5/2266078.png,0,0.986604095,0,0,512,596,512,596,fluttershy
2266084.png,https://derpicdn.net/img/view/2020/2/5/2266084.png,0,0.962598085,244,32,877,704,633,672,fluttershy
2266091.png,https://derpicdn.net/img/view/2020/2/5/2266091.png,0,0.989470303,39,0,729,660,690,660,fluttershy
2266097.png,https://derpicdn.net/img/view/2020/2/5/2266097.png,0,0.960822225,166,0,1068,859,902,859,fluttershy
2274054.png,https://derpicdn.net/img/view/2020/2/14/2274054.png,0,0.927765608,86,0,922,828,836,828,fluttershy
2274056.png,https://derpicdn.net/img/view/2020/2/14/2274056.png,0,0.978877127,430,0,1174,658,744,658,fluttershy
2274883.png,https://derpicdn.net/img/view/2020/2/15/2274883.png,0,0.988661706,703,117,1941,1355,1238,1238,fluttershy
2275141.png,https://derpicdn.net/img/view/2020/2/15/2275141.png,0,0.998720706,453,0,1637,1168,1184,1168,fluttershy
2278020.png,https://derpicdn.net/img/view/2020/2/19/2278020.png,0,0.998135984,156,0,1476,1295,1320,1295,fluttershy
2278210.jpg,https://derpicdn.net/img/view/2020/2/19/2278210.jpg,0,0.998960018,679,15,1361,697,682,682,fluttershy
2279218.png,https://derpicdn.net/img/view/2020/2/20/2279218.png,0,0.978625596,0,0,687,898,687,898,fluttershy
2280620.jpg,https://derpicdn.net/img/view/2020/2/22/2280620.jpg,0,0.991904914,485,124,1471,1110,986,986,fluttershy
2282081.png,https://derpicdn.net/img/view/2020/2/23/2282081.png,0,0.998417199,46,3,284,241,238,238,fluttershy
2282110.png,https://derpicdn.net/img/view/2020/2/23/2282110.png,0,0.994419038,525,0,1631,1088,1106,1088,fluttershy
2284508.png,https://derpicdn.net/img/view/2020/2/27/2284508.png,0,0.988978982,212,0,1380,941,1168,941,fluttershy
2284525.png,https://derpicdn.net/img/view/2020/2/27/2284525.png,0,0.988791883,0,6,701,718,701,712,fluttershy
2284528.png,https://derpicdn.net/img/view/2020/2/27/2284528.png,0,0.985465884,201,51,1119,938,918,887,fluttershy
2288858.jpg,https://derpicdn.net/img/view/2020/3/3/2288858.jpg,0,0.998772681,316,39,608,331,292,292,fluttershy
2288868.jpg,https://derpicdn.net/img/view/2020/3/3/2288868.jpg,0,0.975398302,384,172,544,332,160,160,fluttershy
2291847.png,https://derpicdn.net/img/view/2020/3/7/2291847.png,0,0.99373436,866,80,1890,1104,1024,1024,fluttershy
2292726.png,https://derpicdn.net/img/view/2020/3/8/2292726.png,0,0.961977065,374,0,1426,972,1052,972,fluttershy
2294449.png,https://derpicdn.net/img/view/2020/3/10/2294449.png,0,0.95049572,128,69,1346,1287,1218,1218,fluttershy
2306875.jpg,https://derpicdn.net/img/view/2020/3/26/2306875.jpg,0,0.97164923,99,3,873,777,774,774,fluttershy
2307132.png,https://derpicdn.net/img/view/2020/3/27/2307132.png,0,0.98030293,61,0,779,718,718,718,fluttershy
2307464.png,https://derpicdn.net/img/view/2020/3/27/2307464.png,0,0.989872396,204,5,2480,2575,2276,2570,fluttershy
2309871.png,https://derpicdn.net/img/view/2020/3/30/2309871.png,0,0.976987958,412,0,1368,804,956,804,fluttershy
2312288.jpg,https://derpicdn.net/img/view/2020/4/2/2312288.jpg,0,0.979399621,161,12,531,382,370,370,fluttershy
2312474.jpg,https://derpicdn.net/img/view/2020/4/2/2312474.jpg,0,0.959676206,375,0,995,504,620,504,fluttershy
2314418.jpg,https://derpicdn.net/img/view/2020/4/5/2314418.jpg,0,0.995773733,231,215,551,535,320,320,fluttershy
2322401.jpg,https://derpicdn.net/img/view/2020/4/14/2322401.jpg,0,0.967462122,98,469,540,911,442,442,fluttershy
2322601.jpg,https://derpicdn.net/img/view/2020/4/14/2322601.jpg,0,0.926098526,135,0,641,418,506,418,fluttershy
2327113.png,https://derpicdn.net/img/view/2020/4/20/2327113.png,0,0.991281271,15,0,977,877,962,877,fluttershy
2330963.jpg,https://derpicdn.net/img/view/2020/4/25/2330963.jpg,0,0.995437622,125,76,947,898,822,822,fluttershy
2330968.png,https://derpicdn.net/img/view/2020/4/25/2330968.png,0,0.998393953,426,74,794,442,368,368,fluttershy
2332571.png,https://derpicdn.net/img/view/2020/4/26/2332571.png,0,0.99792403,169,4,605,440,436,436,fluttershy
2332712.png,https://derpicdn.net/img/view/2020/4/27/2332712.png,0,0.999347329,444,32,824,412,380,380,fluttershy
2336488.png,https://derpicdn.net/img/view/2020/5/1/2336488.png,0,0.992531955,0,0,1775,1778,1775,1778,fluttershy
2341516.png,https://derpicdn.net/img/view/2020/5/7/2341516.png,0,0.954726696,1658,376,2250,968,592,592,fluttershy
2343189.jpg,https://derpicdn.net/img/view/2020/5/8/2343189.jpg,0,0.971192062,38,193,450,605,412,412,fluttershy
2344873.png,https://derpicdn.net/img/view/2020/5/10/2344873.png,0,0.977432907,31,0,389,347,358,347,fluttershy
2347648.jpg,https://derpicdn.net/img/view/2020/5/13/2347648.jpg,0,0.984045267,78,0,500,422,422,422,fluttershy
2348862.png,https://derpicdn.net/img/view/2020/5/14/2348862.png,0,0.994475186,64,36,570,542,506,506,fluttershy
2351025.jpg,https://derpicdn.net/img/view/2020/5/17/2351025.jpg,0,0.996039927,434,617,788,983,354,366,fluttershy
2351025.jpg,https://derpicdn.net/img/view/2020/5/17/2351025.jpg,1,0.975601196,195,88,461,354,266,266,fluttershy
2352519.jpg,https://derpicdn.net/img/view/2020/5/19/2352519.jpg,0,0.993745148,475,14,807,346,332,332,fluttershy
2353222.jpg,https://derpicdn.net/img/view/2020/5/20/2353222.jpg,0,0.99239254,351,1,835,485,484,484,fluttershy
2354891.png,https://derpicdn.net/img/view/2020/5/22/2354891.png,0,0.983062744,21,0,425,355,404,355,fluttershy
2355896.png,https://derpicdn.net/img/view/2020/5/23/2355896.png,0,0.999599338,289,0,819,519,530,519,fluttershy
23702.png,https://derpicdn.net/img/view/2012/6/28/23702.png,0,0.924302578,345,0,1651,1252,1306,1252,fluttershy
239211.png,https://derpicdn.net/img/view/2013/2/10/239211.png,0,0.986362517,377,291,653,567,276,276,fluttershy
242063.png,https://derpicdn.net/img/view/2013/2/13/242063.png,0,0.933059037,127,0,787,642,660,642,fluttershy
242115.png,https://derpicdn.net/img/view/2013/2/13/242115.png,0,0.91617167,140,220,1076,1156,936,936,fluttershy
254217.jpg,https://derpicdn.net/img/view/2013/2/24/254217.jpg,0,0.979098558,62,0,945,833,883,833,fluttershy
254240.png,https://derpicdn.net/img/view/2013/2/24/254240.png,0,0.980813324,97,0,945,895,848,895,fluttershy
271023.png,https://derpicdn.net/img/view/2013/3/15/271023.png,0,0.958264589,773,271,1171,669,398,398,fluttershy
272686.png,https://derpicdn.net/img/view/2013/3/17/272686.png,0,0.959438205,169,31,657,519,488,488,fluttershy
280800.png,https://derpicdn.net/img/view/2013/3/27/280800.png,0,0.977425575,222,7,964,749,742,742,fluttershy
282997.png,https://derpicdn.net/img/view/2013/3/30/282997.png,0,0.966983438,6,0,222,213,216,213,fluttershy
294643.png,https://derpicdn.net/img/view/2013/4/11/294643.png,0,0.993641555,419,56,915,552,496,496,fluttershy
298064.png,https://derpicdn.net/img/view/2013/4/14/298064.png,0,0.983225942,1158,117,2198,1157,1040,1040,fluttershy
314752.jpg,https://derpicdn.net/img/view/2013/5/2/314752.jpg,0,0.994577825,142,49,348,255,206,206,fluttershy
318103.jpg,https://derpicdn.net/img/view/2013/5/6/318103.jpg,0,0.994905472,77,14,653,590,576,576,fluttershy
319283.png,https://derpicdn.net/img/view/2013/5/7/319283.png,0,0.934467494,84,0,580,486,496,486,fluttershy
324911.png,https://derpicdn.net/img/view/2013/5/14/324911.png,0,0.997922778,83,120,295,332,212,212,fluttershy
331861.jpg,https://derpicdn.net/img/view/2013/5/23/331861.jpg,0,0.972767115,1495,0,3112,1530,1617,1530,fluttershy
336543.png,https://derpicdn.net/img/view/2013/5/30/336543.png,0,0.999449492,279,0,605,317,326,317,fluttershy
340939.png,https://derpicdn.net/img/view/2013/6/5/340939.png,0,0.996528745,250,35,1776,1561,1526,1526,fluttershy
345970.png,https://derpicdn.net/img/view/2013/6/11/345970.png,0,0.998050809,473,24,1821,1372,1348,1348,fluttershy
348137.png,https://derpicdn.net/img/view/2013/6/14/348137.png,0,0.938723266,64,0,838,607,774,607,fluttershy
348138.png,https://derpicdn.net/img/view/2013/6/14/348138.png,0,0.988613904,42,0,934,852,892,852,fluttershy
348268.png,https://derpicdn.net/img/view/2013/6/14/348268.png,0,0.997400463,254,306,678,730,424,424,fluttershy
351350.png,https://derpicdn.net/img/view/2013/6/18/351350.png,0,0.999507666,391,252,903,764,512,512,fluttershy
355647.jpg,https://derpicdn.net/img/view/2013/6/24/355647.jpg,0,0.984495163,722,0,1916,1188,1194,1188,fluttershy
355736.png,https://derpicdn.net/img/view/2013/6/24/355736.png,0,0.986027777,1151,329,1735,913,584,584,fluttershy
367647.png,https://derpicdn.net/img/view/2013/7/8/367647.png,0,0.988117516,7,0,459,412,452,412,fluttershy
372561.jpg,https://derpicdn.net/img/view/2013/7/13/372561.jpg,0,0.963618517,511,107,1739,1335,1228,1228,fluttershy
372563.jpg,https://derpicdn.net/img/view/2013/7/13/372563.jpg,0,0.972129285,227,133,655,561,428,428,fluttershy
374812.png,https://derpicdn.net/img/view/2013/7/15/374812.png,0,0.991373539,235,0,969,684,734,684,fluttershy
3793.png,https://derpicdn.net/img/view/2012/3/21/3793.png,0,0.976226091,1983,0,3171,991,1188,991,fluttershy
384479.png,https://derpicdn.net/img/view/2013/7/29/384479.png,0,0.998794317,333,161,559,387,226,226,fluttershy
390041.png,https://derpicdn.net/img/view/2013/8/3/390041.png,0,0.988137126,0,0,963,829,963,829,fluttershy
401296.png,https://derpicdn.net/img/view/2013/8/15/401296.png,0,0.902721703,146,0,1056,901,910,901,fluttershy
412535.png,https://derpicdn.net/img/view/2013/8/27/412535.png,0,0.992909074,269,0,943,621,674,621,fluttershy
416976.png,https://derpicdn.net/img/view/2013/9/2/416976.png,0,0.992802203,986,152,1778,944,792,792,fluttershy
417991.png,https://derpicdn.net/img/view/2013/9/3/417991.png,0,0.98585397,126,0,400,258,274,258,fluttershy
419655.png,https://derpicdn.net/img/view/2013/9/5/419655.png,0,0.976042926,0,39,795,748,795,709,fluttershy
420928.png,https://derpicdn.net/img/view/2013/9/6/420928.png,0,0.942327142,160,0,1875,1762,1715,1762,fluttershy
424902.png,https://derpicdn.net/img/view/2013/9/11/424902.png,0,0.989097595,212,0,566,334,354,334,fluttershy
43434.png,https://derpicdn.net/img/view/2012/7/14/43434.png,0,0.963274837,89,0,653,510,564,510,fluttershy
4366.jpg,https://derpicdn.net/img/view/2012/6/6/4366.jpg,0,0.950442374,1423,495,2295,1367,872,872,fluttershy
438450.png,https://derpicdn.net/img/view/2013/9/30/438450.png,0,0.955749691,602,0,1098,483,496,483,fluttershy
443779.png,https://derpicdn.net/img/view/2013/10/7/443779.png,1,0.983537257,774,1119,1270,1615,496,496,fluttershy
448893.png,https://derpicdn.net/img/view/2013/10/14/448893.png,0,0.996628463,58,0,394,327,336,327,fluttershy
454164.png,https://derpicdn.net/img/view/2013/10/22/454164.png,0,0.995945275,84,3,384,303,300,300,fluttershy
473554.png,https://derpicdn.net/img/view/2013/11/16/473554.png,0,0.999370217,32,0,830,738,798,738,fluttershy
481341.png,https://derpicdn.net/img/view/2013/11/25/481341.png,0,0.998882771,548,53,1232,737,684,684,fluttershy
493150.png,https://derpicdn.net/img/view/2013/12/8/493150.png,0,0.998393476,97,16,655,574,558,558,fluttershy
495066.png,https://derpicdn.net/img/view/2013/12/12/495066.png,0,0.990121603,124,24,374,274,250,250,fluttershy
499476.png,https://derpicdn.net/img/view/2013/12/17/499476.png,0,0.994181752,29,0,411,363,382,363,fluttershy
5084.png,https://derpicdn.net/img/view/2012/6/17/5084.png,0,0.995330989,120,0,480,346,360,346,fluttershy
508642.png,https://derpicdn.net/img/view/2013/12/28/508642.png,0,0.972696543,53,0,570,307,517,307,fluttershy
508688.png,https://derpicdn.net/img/view/2013/12/28/508688.png,0,0.97079736,1713,88,4451,2826,2738,2738,fluttershy
509489.png,https://derpicdn.net/img/view/2013/12/29/509489.png,0,0.997347772,953,144,1565,756,612,612,fluttershy
510022.png,https://derpicdn.net/img/view/2013/12/30/510022.png,0,0.962777138,598,0,1028,412,430,412,fluttershy
510022.png,https://derpicdn.net/img/view/2013/12/30/510022.png,1,0.930166602,86,19,478,411,392,392,fluttershy
510192.png,https://derpicdn.net/img/view/2013/12/30/510192.png,0,0.940727711,189,0,1273,1061,1084,1061,fluttershy
511093.png,https://derpicdn.net/img/view/2013/12/31/511093.png,0,0.959820509,77,0,1801,1703,1724,1703,fluttershy
511096.jpg,https://derpicdn.net/img/view/2013/12/31/511096.jpg,0,0.976136804,0,15,1509,1747,1509,1732,fluttershy
511175.png,https://derpicdn.net/img/view/2013/12/31/511175.png,0,0.963433027,1160,506,1904,1250,744,744,fluttershy
511568.png,https://derpicdn.net/img/view/2014/1/1/511568.png,0,0.987493813,633,0,1900,1081,1267,1081,fluttershy
513502.png,https://derpicdn.net/img/view/2014/1/3/513502.png,0,0.991173685,379,46,1083,750,704,704,fluttershy
515217.jpg,https://derpicdn.net/img/view/2014/1/4/515217.jpg,0,0.958653271,645,1228,937,1520,292,292,fluttershy
517617.png,https://derpicdn.net/img/view/2014/1/7/517617.png,0,0.979947388,1148,0,2674,1307,1526,1307,fluttershy
520795.png,https://derpicdn.net/img/view/2014/1/11/520795.png,0,0.9352355,89,0,745,607,656,607,fluttershy
524176.jpg,https://derpicdn.net/img/view/2014/1/14/524176.jpg,0,0.984780371,110,31,344,265,234,234,fluttershy
528018.jpg,https://derpicdn.net/img/view/2014/1/18/528018.jpg,0,0.998764336,301,1233,685,1617,384,384,fluttershy
528018.jpg,https://derpicdn.net/img/view/2014/1/18/528018.jpg,1,0.993393421,1039,1023,1523,1507,484,484,fluttershy
528018.jpg,https://derpicdn.net/img/view/2014/1/18/528018.jpg,2,0.977242589,624,722,1102,1200,478,478,fluttershy
528411.png,https://derpicdn.net/img/view/2014/1/19/528411.png,0,0.981377304,180,336,578,734,398,398,fluttershy
529561.jpg,https://derpicdn.net/img/view/2014/1/20/529561.jpg,0,0.984665036,351,104,899,652,548,548,fluttershy
542895.jpg,https://derpicdn.net/img/view/2014/2/4/542895.jpg,0,0.982610106,80,0,1206,750,1126,750,fluttershy
545396.png,https://derpicdn.net/img/view/2014/2/7/545396.png,0,0.998108864,167,68,579,480,412,412,fluttershy
546268.png,https://derpicdn.net/img/view/2014/2/8/546268.png,0,0.997990251,553,421,1723,1591,1170,1170,fluttershy
547711.png,https://derpicdn.net/img/view/2014/2/9/547711.png,0,0.931462228,112,0,882,736,770,736,fluttershy
548044.png,https://derpicdn.net/img/view/2014/2/9/548044.png,0,0.999643683,426,569,850,993,424,424,fluttershy
552749.png,https://derpicdn.net/img/view/2014/2/15/552749.png,0,0.963316441,685,15,853,183,168,168,fluttershy
561230.png,https://derpicdn.net/img/view/2014/2/25/561230.png,0,0.990984499,216,7,414,205,198,198,fluttershy
564391.png,https://derpicdn.net/img/view/2014/3/1/564391.png,0,0.99256891,133,16,685,568,552,552,fluttershy
568584.png,https://derpicdn.net/img/view/2014/3/7/568584.png,0,0.949541688,401,221,607,427,206,206,fluttershy
577173.png,https://derpicdn.net/img/view/2014/3/16/577173.png,0,0.998763025,103,0,425,286,322,286,fluttershy
578058.png,https://derpicdn.net/img/view/2014/3/17/578058.png,0,0.980871379,1923,0,4747,2711,2824,2711,fluttershy
592374.png,https://derpicdn.net/img/view/2014/4/4/592374.png,0,0.968950093,0,0,768,789,768,789,fluttershy
593155.png,https://derpicdn.net/img/view/2014/4/5/593155.png,0,0.999111831,507,0,1053,534,546,534,fluttershy
601224.png,https://derpicdn.net/img/view/2014/4/15/601224.png,0,0.989148617,66,0,494,409,428,409,fluttershy
602093.png,https://derpicdn.net/img/view/2014/4/16/602093.png,0,0.919582427,1219,0,3331,1696,2112,1696,fluttershy
606880.png,https://derpicdn.net/img/view/2014/4/22/606880.png,0,0.995461643,154,0,690,520,536,520,fluttershy
607867.jpg,https://derpicdn.net/img/view/2014/4/23/607867.jpg,0,0.955664635,343,0,711,317,368,317,fluttershy
612160.png,https://derpicdn.net/img/view/2014/4/28/612160.png,0,0.988803804,0,0,756,722,756,722,fluttershy
613718.jpg,https://derpicdn.net/img/view/2014/4/30/613718.jpg,0,0.965549946,33,0,849,636,816,636,fluttershy
618495.png,https://derpicdn.net/img/view/2014/5/5/618495.png,0,0.92966038,0,174,1608,2084,1608,1910,fluttershy
6337.jpg,https://derpicdn.net/img/view/2012/6/18/6337.jpg,0,0.959708989,130,0,716,548,586,548,fluttershy
649766.png,https://derpicdn.net/img/view/2014/6/10/649766.png,0,0.998480558,6,0,650,617,644,617,fluttershy
661363.png,https://derpicdn.net/img/view/2014/6/25/661363.png,0,0.98719728,170,133,414,377,244,244,fluttershy
661752.jpg,https://derpicdn.net/img/view/2014/6/26/661752.jpg,0,0.988377094,665,107,1657,1099,992,992,fluttershy
662568.png,https://derpicdn.net/img/view/2014/6/27/662568.png,0,0.956554294,111,0,360,250,249,250,fluttershy
667344.png,https://derpicdn.net/img/view/2014/7/4/667344.png,0,0.917831063,690,39,1422,771,732,732,fluttershy
669.png,https://derpicdn.net/img/view/2012/1/17/669.png,0,0.996722341,28,0,286,241,258,241,fluttershy
669599.png,https://derpicdn.net/img/view/2014/7/7/669599.png,0,0.928894579,0,6,354,366,354,360,fluttershy
671743.png,https://derpicdn.net/img/view/2014/7/10/671743.png,0,0.997877657,323,40,837,554,514,514,fluttershy
674695.png,https://derpicdn.net/img/view/2014/7/14/674695.png,0,0.981718183,753,0,2113,1201,1360,1201,fluttershy
677784.png,https://derpicdn.net/img/view/2014/7/18/677784.png,0,0.99787873,272,40,830,598,558,558,fluttershy
678784.png,https://derpicdn.net/img/view/2014/7/20/678784.png,0,0.982979834,85,0,533,372,448,372,fluttershy
680140.png,https://derpicdn.net/img/view/2014/7/21/680140.png,0,0.969494402,93,0,500,411,407,411,fluttershy
681599.png,https://derpicdn.net/img/view/2014/7/23/681599.png,0,0.99406451,299,6,547,254,248,248,fluttershy
684166.jpg,https://derpicdn.net/img/view/2014/7/26/684166.jpg,0,0.998450696,278,30,898,650,620,620,fluttershy
689958.png,https://derpicdn.net/img/view/2014/8/3/689958.png,0,0.994648874,345,0,943,578,598,578,fluttershy
690597.png,https://derpicdn.net/img/view/2014/8/3/690597.png,0,0.996749759,98,93,782,777,684,684,fluttershy
701839.jpg,https://derpicdn.net/img/view/2014/8/17/701839.jpg,0,0.998079181,119,65,513,459,394,394,fluttershy
70380.png,https://derpicdn.net/img/view/2012/8/9/70380.png,0,0.956684291,35,0,407,371,372,371,fluttershy
704903.jpg,https://derpicdn.net/img/view/2014/8/21/704903.jpg,0,0.999108255,326,117,554,345,228,228,fluttershy
705008.png,https://derpicdn.net/img/view/2014/8/21/705008.png,0,0.968247354,40,0,1130,1034,1090,1034,fluttershy
707192.jpg,https://derpicdn.net/img/view/2014/8/24/707192.jpg,0,0.969446301,125,0,787,604,662,604,fluttershy
710916.png,https://derpicdn.net/img/view/2014/8/30/710916.png,0,0.995795965,597,119,1127,649,530,530,fluttershy
713733.png,https://derpicdn.net/img/view/2014/9/2/713733.png,0,0.946313143,187,0,1677,1460,1490,1460,fluttershy
713824.png,https://derpicdn.net/img/view/2014/9/2/713824.png,0,0.989431441,0,69,972,1041,972,972,fluttershy
714254.png,https://derpicdn.net/img/view/2014/9/3/714254.png,0,0.929989994,344,13,960,629,616,616,fluttershy
714872.jpg,https://derpicdn.net/img/view/2014/9/4/714872.jpg,0,0.98930347,1229,0,1981,740,752,740,fluttershy
719449.jpg,https://derpicdn.net/img/view/2014/9/10/719449.jpg,0,0.994649053,179,1,365,187,186,186,fluttershy
725795.png,https://derpicdn.net/img/view/2014/9/20/725795.png,0,0.991062641,101,1,339,239,238,238,fluttershy
732154.png,https://derpicdn.net/img/view/2014/9/29/732154.png,0,0.997787356,215,27,631,443,416,416,fluttershy
733810.png,https://derpicdn.net/img/view/2014/10/2/733810.png,0,0.999189019,577,231,1571,1225,994,994,fluttershy
73538.jpg,https://derpicdn.net/img/view/2012/8/13/73538.jpg,0,0.950098515,219,0,539,300,320,300,fluttershy
750390.png,https://derpicdn.net/img/view/2014/10/25/750390.png,0,0.920394778,544,209,1336,1001,792,792,fluttershy
752317.png,https://derpicdn.net/img/view/2014/10/28/752317.png,0,0.991977692,211,5,567,361,356,356,fluttershy
761569.png,https://derpicdn.net/img/view/2014/11/10/761569.png,0,0.99896735,269,34,797,562,528,528,fluttershy
771772.jpg,https://derpicdn.net/img/view/2014/11/25/771772.jpg,0,0.996807218,149,0,557,390,408,390,fluttershy
772585.png,https://derpicdn.net/img/view/2014/11/27/772585.png,0,0.960358143,90,5,332,247,242,242,fluttershy
772588.png,https://derpicdn.net/img/view/2014/11/27/772588.png,0,0.994219363,208,11,550,353,342,342,fluttershy
781190.png,https://derpicdn.net/img/view/2014/12/9/781190.png,0,0.935454428,2059,1155,3307,2403,1248,1248,fluttershy
787260.png,https://derpicdn.net/img/view/2014/12/18/787260.png,0,0.950574398,0,0,1364,1338,1364,1338,fluttershy
791972.png,https://derpicdn.net/img/view/2014/12/24/791972.png,0,0.983368993,319,0,2987,2560,2668,2560,fluttershy
793650.jpg,https://derpicdn.net/img/view/2014/12/27/793650.jpg,0,0.990867019,667,0,1739,1063,1072,1063,fluttershy
795914.png,https://derpicdn.net/img/view/2014/12/30/795914.png,0,0.910918593,0,60,1036,1202,1036,1142,fluttershy
796507.jpg,https://derpicdn.net/img/view/2014/12/31/796507.jpg,0,0.982706189,0,7,564,575,564,568,fluttershy
796661.png,https://derpicdn.net/img/view/2014/12/31/796661.png,0,0.996618271,54,0,428,360,374,360,fluttershy
800725.jpg,https://derpicdn.net/img/view/2015/1/6/800725.jpg,0,0.989255309,606,40,2588,2022,1982,1982,fluttershy
800992.png,https://derpicdn.net/img/view/2015/1/6/800992.png,0,0.995699108,219,29,903,713,684,684,fluttershy
803035.png,https://derpicdn.net/img/view/2015/1/10/803035.png,0,0.982069671,476,221,934,679,458,458,fluttershy
809070.png,https://derpicdn.net/img/view/2015/1/18/809070.png,0,0.999258935,290,19,914,643,624,624,fluttershy
809070.png,https://derpicdn.net/img/view/2015/1/18/809070.png,1,0.997753441,1320,0,2012,676,692,676,fluttershy
81318.jpg,https://derpicdn.net/img/view/2012/8/24/81318.jpg,0,0.971129298,189,0,1335,1069,1146,1069,fluttershy
813454.png,https://derpicdn.net/img/view/2015/1/24/813454.png,0,0.999006927,234,18,480,264,246,246,fluttershy
815730.png,https://derpicdn.net/img/view/2015/1/27/815730.png,0,0.988823473,1636,1095,3200,2659,1564,1564,fluttershy
817332.jpg,https://derpicdn.net/img/view/2015/1/29/817332.jpg,0,0.9962098,129,90,945,906,816,816,fluttershy
821952.png,https://derpicdn.net/img/view/2015/2/5/821952.png,0,0.996419072,503,600,949,1046,446,446,fluttershy
8300.jpg,https://derpicdn.net/img/view/2012/6/18/8300.jpg,0,0.970981479,219,52,561,394,342,342,fluttershy
838268.png,https://derpicdn.net/img/view/2015/2/27/838268.png,0,0.907578349,0,40,509,572,509,532,fluttershy
839388.jpg,https://derpicdn.net/img/view/2015/2/28/839388.jpg,0,0.992908418,134,0,390,252,256,252,fluttershy
841315.png,https://derpicdn.net/img/view/2015/3/3/841315.png,0,0.996905565,70,12,348,290,278,278,fluttershy
842998.png,https://derpicdn.net/img/view/2015/3/5/842998.png,0,0.930136025,433,75,1543,1185,1110,1110,fluttershy
843336.jpg,https://derpicdn.net/img/view/2015/3/6/843336.jpg,0,0.918313742,59,229,1695,1865,1636,1636,fluttershy
845345.png,https://derpicdn.net/img/view/2015/3/8/845345.png,0,0.987533152,129,0,465,332,336,332,fluttershy
845864.jpg,https://derpicdn.net/img/view/2015/3/9/845864.jpg,0,0.998366117,379,173,659,453,280,280,fluttershy
860745.png,https://derpicdn.net/img/view/2015/3/30/860745.png,0,0.997730315,297,54,755,512,458,458,fluttershy
862450.png,https://derpicdn.net/img/view/2015/4/1/862450.png,0,0.996766388,695,65,1047,417,352,352,fluttershy
865695.png,https://derpicdn.net/img/view/2015/4/5/865695.png,0,0.994894922,213,0,745,529,532,529,fluttershy
870356.png,https://derpicdn.net/img/view/2015/4/10/870356.png,0,0.991611421,364,34,1094,764,730,730,fluttershy
872871.png,https://derpicdn.net/img/view/2015/4/13/872871.png,0,0.990019321,0,0,650,550,650,550,fluttershy
874087.png,https://derpicdn.net/img/view/2015/4/14/874087.png,0,0.969811082,316,46,796,526,480,480,fluttershy
877781.png,https://derpicdn.net/img/view/2015/4/19/877781.png,0,0.989869237,11,26,459,474,448,448,fluttershy
878645.png,https://derpicdn.net/img/view/2015/4/20/878645.png,0,0.987105906,46,7,316,277,270,270,fluttershy
893804.png,https://derpicdn.net/img/view/2015/5/11/893804.png,0,0.988667369,332,7,708,383,376,376,fluttershy
894166.png,https://derpicdn.net/img/view/2015/5/11/894166.png,0,0.997884572,520,106,872,458,352,352,fluttershy
897404.png,https://derpicdn.net/img/view/2015/5/16/897404.png,0,0.984010339,9,0,1107,1005,1098,1005,fluttershy
897522.png,https://derpicdn.net/img/view/2015/5/16/897522.png,0,0.963642836,67,98,739,776,672,678,fluttershy
897901.png,https://derpicdn.net/img/view/2015/5/17/897901.png,0,0.963276267,19,31,365,348,346,317,fluttershy
906458.png,https://derpicdn.net/img/view/2015/5/29/906458.png,0,0.99289757,870,161,1494,785,624,624,fluttershy
910886.png,https://derpicdn.net/img/view/2015/6/5/910886.png,0,0.921336889,97,0,443,335,346,335,fluttershy
917815.jpg,https://derpicdn.net/img/view/2015/6/15/917815.jpg,0,0.953738749,347,205,2153,2011,1806,1806,fluttershy
918316.jpg,https://derpicdn.net/img/view/2015/6/16/918316.jpg,0,0.914819062,244,0,590,336,346,336,fluttershy
930736.png,https://derpicdn.net/img/view/2015/7/5/930736.png,0,0.989168823,1432,123,2494,1185,1062,1062,fluttershy
933174.png,https://derpicdn.net/img/view/2015/7/9/933174.png,0,0.972220719,95,0,361,240,266,240,fluttershy
953144.png,https://derpicdn.net/img/view/2015/8/7/953144.png,0,0.951510072,704,0,2194,1323,1490,1323,fluttershy
963255.png,https://derpicdn.net/img/view/2015/8/22/963255.png,0,0.988246143,589,0,3033,2141,2444,2141,fluttershy
972977.png,https://derpicdn.net/img/view/2015/9/5/972977.png,0,0.996345639,37,0,837,682,800,682,fluttershy
980459.png,https://derpicdn.net/img/view/2015/9/15/980459.png,0,0.976608396,361,25,793,457,432,432,fluttershy
981207.png,https://derpicdn.net/img/view/2015/9/16/981207.png,0,0.985450745,60,34,448,422,388,388,fluttershy
981207.png,https://derpicdn.net/img/view/2015/9/16/981207.png,1,0.946326256,757,680,1017,940,260,260,fluttershy
981775.png,https://derpicdn.net/img/view/2015/9/17/981775.png,0,0.990584373,17,0,401,359,384,359,fluttershy
985559.jpg,https://derpicdn.net/img/view/2015/9/22/985559.jpg,0,0.973021984,254,73,634,453,380,380,fluttershy
986602.png,https://derpicdn.net/img/view/2015/9/24/986602.png,0,0.99056226,594,0,1206,537,612,537,fluttershy
989438.png,https://derpicdn.net/img/view/2015/9/27/989438.png,0,0.969968259,1528,0,3040,1302,1512,1302,fluttershy
992991.png,https://derpicdn.net/img/view/2015/10/2/992991.png,0,0.997770071,101,34,453,386,352,352,fluttershy
993332.png,https://derpicdn.net/img/view/2015/10/3/993332.png,0,0.991746962,94,0,768,772,674,772,fluttershy
994459.png,https://derpicdn.net/img/view/2015/10/4/994459.png,0,0.946804225,80,215,2010,2145,1930,1930,fluttershy
1009249.png,https://derpicdn.net/img/view/2015/10/24/1009249.png,0,0.986973822,247,34,745,532,498,498,fluttershy
1011244.jpg,https://derpicdn.net/img/view/2015/10/28/1011244.jpg,0,0.974364698,415,98,741,424,326,326,fluttershy
1012274.png,https://derpicdn.net/img/view/2015/10/30/1012274.png,0,0.947461128,646,315,1778,1447,1132,1132,fluttershy
1017228.jpg,https://derpicdn.net/img/view/2015/11/6/1017228.jpg,0,0.992690742,726,16,1016,306,290,290,fluttershy
1032458.png,https://derpicdn.net/img/view/2015/11/29/1032458.png,0,0.951990247,138,0,330,182,192,182,fluttershy
1036173.png,https://derpicdn.net/img/view/2015/12/3/1036173.png,0,0.996375978,1147,258,1567,678,420,420,fluttershy
10379.jpg,https://derpicdn.net/img/view/2012/6/19/10379.jpg,0,0.949507713,953,760,2003,1810,1050,1050,fluttershy
1041526.jpg,https://derpicdn.net/img/view/2015/12/11/1041526.jpg,0,0.975503922,1952,317,2646,1011,694,694,fluttershy
1041950.png,https://derpicdn.net/img/view/2015/12/11/1041950.png,0,0.905661464,564,687,2742,2865,2178,2178,fluttershy
108738.png,https://derpicdn.net/img/view/2012/9/28/108738.png,0,0.991065145,186,4,708,526,522,522,fluttershy
1087526.png,https://derpicdn.net/img/view/2016/2/14/1087526.png,0,0.972540617,84,26,364,306,280,280,fluttershy
1091742.jpg,https://derpicdn.net/img/view/2016/2/19/1091742.jpg,0,0.990306437,360,105,1002,747,642,642,fluttershy
1091959.jpg,https://derpicdn.net/img/view/2016/2/19/1091959.jpg,0,0.967916667,817,0,2131,1287,1314,1287,fluttershy
1098938.jpg,https://derpicdn.net/img/view/2016/2/28/1098938.jpg,0,0.987110436,442,176,1316,1050,874,874,fluttershy
11013.png,https://derpicdn.net/img/view/2012/6/20/11013.png,0,0.990122736,28,9,700,685,672,676,fluttershy
11037.png,https://derpicdn.net/img/view/2012/6/20/11037.png,0,0.991082668,4,0,446,407,442,407,fluttershy
1104759.png,https://derpicdn.net/img/view/2016/3/8/1104759.png,0,0.995789766,714,99,1302,687,588,588,fluttershy
1106024.png,https://derpicdn.net/img/view/2016/3/10/1106024.png,0,0.999566972,251,45,719,513,468,468,fluttershy
1119253.png,https://derpicdn.net/img/view/2016/3/28/1119253.png,0,0.9886958,95,0,609,508,514,508,fluttershy
1141528.png,https://derpicdn.net/img/view/2016/4/28/1141528.png,0,0.998004496,207,0,521,275,314,275,fluttershy
1145572.png,https://derpicdn.net/img/view/2016/5/3/1145572.png,1,0.931652904,2117,592,2841,1316,724,724,fluttershy
1157379.jpg,https://derpicdn.net/img/view/2016/5/19/1157379.jpg,0,0.997558475,150,0,410,256,260,256,fluttershy
1163681.jpg,https://derpicdn.net/img/view/2016/5/26/1163681.jpg,0,0.90857774,841,187,2757,2103,1916,1916,fluttershy
1168417.png,https://derpicdn.net/img/view/2016/6/2/1168417.png,0,0.967467308,1965,448,3121,1604,1156,1156,fluttershy
1170215.png,https://derpicdn.net/img/view/2016/6/4/1170215.png,0,0.971629679,0,7,284,329,284,322,fluttershy
1171299.png,https://derpicdn.net/img/view/2016/6/5/1171299.png,0,0.998039842,861,301,1433,873,572,572,fluttershy
1171983.png,https://derpicdn.net/img/view/2016/6/6/1171983.png,0,0.982354879,0,0,3109,3180,3109,3180,fluttershy
1171990.jpg,https://derpicdn.net/img/view/2016/6/6/1171990.jpg,0,0.997471035,2332,238,2718,624,386,386,fluttershy
1171990.jpg,https://derpicdn.net/img/view/2016/6/6/1171990.jpg,1,0.995983541,1451,317,1903,769,452,452,fluttershy
1171990.jpg,https://derpicdn.net/img/view/2016/6/6/1171990.jpg,2,0.966388404,2775,72,3283,580,508,508,fluttershy
1171990.jpg,https://derpicdn.net/img/view/2016/6/6/1171990.jpg,3,0.959664047,440,612,844,1016,404,404,fluttershy
117502.png,https://derpicdn.net/img/view/2012/10/8/117502.png,0,0.976821005,276,2,574,300,298,298,fluttershy
1183822.png,https://derpicdn.net/img/view/2016/6/21/1183822.png,0,0.965965092,384,1428,842,1886,458,458,fluttershy
1184500.png,https://derpicdn.net/img/view/2016/6/22/1184500.png,0,0.927197933,785,9,3000,2413,2215,2404,fluttershy
1194166.png,https://derpicdn.net/img/view/2016/7/5/1194166.png,0,0.99756968,669,0,1067,375,398,375,fluttershy
1199441.png,https://derpicdn.net/img/view/2016/7/13/1199441.png,0,0.979967833,1165,21,5425,4281,4260,4260,fluttershy
1212083.png,https://derpicdn.net/img/view/2016/7/29/1212083.png,0,0.988586843,0,0,1027,1079,1027,1079,fluttershy
1224293.png,https://derpicdn.net/img/view/2016/8/13/1224293.png,0,0.985067606,0,0,358,355,358,355,fluttershy
1225774.png,https://derpicdn.net/img/view/2016/8/15/1225774.png,0,0.98821795,0,242,2481,2898,2481,2656,fluttershy
122708.png,https://derpicdn.net/img/view/2012/10/14/122708.png,0,0.995420575,390,0,890,425,500,425,fluttershy
1231093.png,https://derpicdn.net/img/view/2016/8/22/1231093.png,0,0.9927634,125,0,539,398,414,398,fluttershy
12339.png,https://derpicdn.net/img/view/2012/6/20/12339.png,0,0.911333799,441,121,719,399,278,278,fluttershy
1234986.png,https://derpicdn.net/img/view/2016/8/27/1234986.png,0,0.967883945,30,27,396,403,366,376,fluttershy
1236631.png,https://derpicdn.net/img/view/2016/8/29/1236631.png,0,0.991541028,659,0,1613,911,954,911,fluttershy
1238730.png,https://derpicdn.net/img/view/2016/8/31/1238730.png,0,0.949543357,319,481,847,1009,528,528,fluttershy
1240750.png,https://derpicdn.net/img/view/2016/9/3/1240750.png,0,0.965485036,184,0,2185,1423,2001,1423,fluttershy
1240804.png,https://derpicdn.net/img/view/2016/9/3/1240804.png,0,0.937569678,0,0,822,597,822,597,fluttershy
1262747.png,https://derpicdn.net/img/view/2016/10/1/1262747.png,0,0.986125827,0,0,2398,2572,2398,2572,fluttershy
126382.jpg,https://derpicdn.net/img/view/2012/10/19/126382.jpg,0,0.988371968,232,0,794,456,562,456,fluttershy
1265.jpg,https://derpicdn.net/img/view/2012/1/22/1265.jpg,0,0.980306923,155,81,640,577,485,496,fluttershy
127843.jpg,https://derpicdn.net/img/view/2012/10/20/127843.jpg,0,0.963483632,80,0,854,741,774,741,fluttershy
1278516.png,https://derpicdn.net/img/view/2016/10/22/1278516.png,0,0.989198864,128,0,680,486,552,486,fluttershy
1279751.png,https://derpicdn.net/img/view/2016/10/23/1279751.png,0,0.936483026,688,540,1530,1382,842,842,fluttershy
1279894.png,https://derpicdn.net/img/view/2016/10/23/1279894.png,0,0.986527741,154,0,708,533,554,533,fluttershy
1291.jpg,https://derpicdn.net/img/view/2012/1/22/1291.jpg,0,0.998523235,566,398,792,624,226,226,fluttershy
1291507.png,https://derpicdn.net/img/view/2016/11/8/1291507.png,0,0.996416271,275,62,777,564,502,502,fluttershy
1298925.png,https://derpicdn.net/img/view/2016/11/19/1298925.png,0,0.918335021,186,81,2050,1945,1864,1864,fluttershy
1299971.png,https://derpicdn.net/img/view/2016/11/20/1299971.png,0,0.998961389,478,0,1490,1012,1012,1012,fluttershy
1311157.png,https://derpicdn.net/img/view/2016/12/6/1311157.png,0,0.989579439,264,43,754,533,490,490,fluttershy
1317933.png,https://derpicdn.net/img/view/2016/12/15/1317933.png,0,0.991837084,196,0,510,308,314,308,fluttershy
1319520.png,https://derpicdn.net/img/view/2016/12/17/1319520.png,0,0.953423738,90,98,1498,1506,1408,1408,fluttershy
1326920.png,https://derpicdn.net/img/view/2016/12/28/1326920.png,0,0.924583137,89,29,1349,1289,1260,1260,fluttershy
1339737.png,https://derpicdn.net/img/view/2017/1/15/1339737.png,0,0.972404838,617,0,2425,1690,1808,1690,fluttershy
134436.png,https://derpicdn.net/img/view/2012/10/28/134436.png,0,0.990918934,289,419,559,689,270,270,fluttershy
1345404.png,https://derpicdn.net/img/view/2017/1/22/1345404.png,0,0.978627086,221,36,775,590,554,554,fluttershy
1346948.png,https://derpicdn.net/img/view/2017/1/24/1346948.png,0,0.97894448,185,0,613,416,428,416,fluttershy
1348378.png,https://derpicdn.net/img/view/2017/1/26/1348378.png,0,0.985827386,0,10,298,308,298,298,fluttershy
1349727.png,https://derpicdn.net/img/view/2017/1/28/1349727.png,0,0.907646179,177,306,473,602,296,296,fluttershy
1350703.png,https://derpicdn.net/img/view/2017/1/29/1350703.png,0,0.998369038,469,0,1371,806,902,806,fluttershy
1351212.png,https://derpicdn.net/img/view/2017/1/30/1351212.png,0,0.98655951,52,3,518,469,466,466,fluttershy
1357600.png,https://derpicdn.net/img/view/2017/2/7/1357600.png,0,0.992101312,1631,77,2861,1307,1230,1230,fluttershy
1363939.png,https://derpicdn.net/img/view/2017/2/15/1363939.png,0,0.962067425,0,0,517,537,517,537,fluttershy
1367073.png,https://derpicdn.net/img/view/2017/2/19/1367073.png,0,0.946562409,8,193,786,971,778,778,fluttershy
1373462.png,https://derpicdn.net/img/view/2017/2/26/1373462.png,0,0.904451311,81,58,621,598,540,540,fluttershy
1378760.png,https://derpicdn.net/img/view/2017/3/4/1378760.png,0,0.993453205,69,0,1165,1003,1096,1003,fluttershy
1380592.png,https://derpicdn.net/img/view/2017/3/6/1380592.png,0,0.990014017,346,0,826,443,480,443,fluttershy
1388167.png,https://derpicdn.net/img/view/2017/3/16/1388167.png,0,0.998728216,28,34,860,866,832,832,fluttershy
1393762.png,https://derpicdn.net/img/view/2017/3/22/1393762.png,0,0.981676161,1164,0,3454,1872,2290,1872,fluttershy
1398871.png,https://derpicdn.net/img/view/2017/3/29/1398871.png,0,0.985130668,0,0,1249,1212,1249,1212,fluttershy
1400307.png,https://derpicdn.net/img/view/2017/3/31/1400307.png,0,0.976092696,200,70,1410,1280,1210,1210,fluttershy
1404882.png,https://derpicdn.net/img/view/2017/4/5/1404882.png,0,0.955953896,41,23,445,427,404,404,fluttershy
1406775.png,https://derpicdn.net/img/view/2017/4/8/1406775.png,0,0.995645583,250,0,998,728,748,728,fluttershy
1407193.png,https://derpicdn.net/img/view/2017/4/9/1407193.png,0,0.994718015,896,334,1804,1242,908,908,fluttershy
1407193.png,https://derpicdn.net/img/view/2017/4/9/1407193.png,1,0.956724167,615,1180,1921,2486,1306,1306,fluttershy
1408150.png,https://derpicdn.net/img/view/2017/4/10/1408150.png,0,0.910280585,885,0,2487,1278,1602,1278,fluttershy
1408629.png,https://derpicdn.net/img/view/2017/4/11/1408629.png,0,0.997739255,520,128,1296,904,776,776,fluttershy
1412079.png,https://derpicdn.net/img/view/2017/4/15/1412079.png,0,0.967442751,297,104,737,544,440,440,fluttershy
1413481.png,https://derpicdn.net/img/view/2017/4/16/1413481.png,0,0.996371388,42,13,432,403,390,390,fluttershy
1414609.png,https://derpicdn.net/img/view/2017/4/18/1414609.png,0,0.996815383,108,0,2704,2527,2596,2527,fluttershy
1415057.png,https://derpicdn.net/img/view/2017/4/18/1415057.png,0,0.948600709,0,0,806,848,806,848,fluttershy
1418044.png,https://derpicdn.net/img/view/2017/4/22/1418044.png,0,0.993764162,216,0,636,398,420,398,fluttershy
1423514.png,https://derpicdn.net/img/view/2017/4/28/1423514.png,0,0.972580492,1022,0,1894,709,872,709,fluttershy
1425743.png,https://derpicdn.net/img/view/2017/4/30/1425743.png,0,0.995211959,121,0,1801,1564,1680,1564,fluttershy
1426509.png,https://derpicdn.net/img/view/2017/5/1/1426509.png,0,0.996635258,854,0,2190,1218,1336,1218,fluttershy
1428224.png,https://derpicdn.net/img/view/2017/5/4/1428224.png,0,0.984487414,927,75,2807,1955,1880,1880,fluttershy
1431270.png,https://derpicdn.net/img/view/2017/5/7/1431270.png,0,0.967904627,1335,0,2905,1490,1570,1490,fluttershy
1435198.png,https://derpicdn.net/img/view/2017/5/13/1435198.png,0,0.956065059,17,4,607,594,590,590,fluttershy
1436599.png,https://derpicdn.net/img/view/2017/5/14/1436599.png,0,0.992711723,457,132,695,370,238,238,fluttershy
1442627.png,https://derpicdn.net/img/view/2017/5/21/1442627.png,0,0.986070514,368,0,1260,863,892,863,fluttershy
1447530.png,https://derpicdn.net/img/view/2017/5/27/1447530.png,0,0.998343527,527,58,1777,1308,1250,1250,fluttershy
1451595.png,https://derpicdn.net/img/view/2017/6/1/1451595.png,0,0.995561302,952,0,2258,1255,1306,1255,fluttershy
1462913.png,https://derpicdn.net/img/view/2017/6/16/1462913.png,0,0.987730503,318,342,992,1016,674,674,fluttershy
1463747.png,https://derpicdn.net/img/view/2017/6/17/1463747.png,0,0.934222341,70,0,412,280,342,280,fluttershy
1464211.png,https://derpicdn.net/img/view/2017/6/17/1464211.png,0,0.909015954,572,28,1759,1242,1187,1214,fluttershy
1465077.png,https://derpicdn.net/img/view/2017/6/18/1465077.png,0,0.993234217,148,0,592,438,444,438,fluttershy
1466216.png,https://derpicdn.net/img/view/2017/6/20/1466216.png,0,0.986756325,112,102,1362,1352,1250,1250,fluttershy
1466847.png,https://derpicdn.net/img/view/2017/6/20/1466847.png,0,0.954436898,220,0,2436,1440,2216,1440,fluttershy
1470315.png,https://derpicdn.net/img/view/2017/6/24/1470315.png,0,0.977209449,180,373,2520,2713,2340,2340,fluttershy
1471247.png,https://derpicdn.net/img/view/2017/6/25/1471247.png,0,0.992925048,94,490,4028,4150,3934,3660,fluttershy
1471248.png,https://derpicdn.net/img/view/2017/6/25/1471248.png,0,0.982465208,60,562,3808,4140,3748,3578,fluttershy
14740.png,https://derpicdn.net/img/view/2012/6/22/14740.png,0,0.978215754,74,52,302,280,228,228,fluttershy
1476241.png,https://derpicdn.net/img/view/2017/7/1/1476241.png,0,0.987594366,3203,637,5857,3291,2654,2654,fluttershy
1479811.png,https://derpicdn.net/img/view/2017/7/6/1479811.png,0,0.977693737,132,10,1104,982,972,972,fluttershy
1480183.png,https://derpicdn.net/img/view/2017/7/6/1480183.png,1,0.999421775,41,681,421,1061,380,380,fluttershy
1480183.png,https://derpicdn.net/img/view/2017/7/6/1480183.png,2,0.955979884,322,744,592,1014,270,270,fluttershy
1482463.png,https://derpicdn.net/img/view/2017/7/9/1482463.png,0,0.916077077,21,0,2115,1853,2094,1853,fluttershy
1486503.png,https://derpicdn.net/img/view/2017/7/15/1486503.png,0,0.998713136,1492,570,2936,2014,1444,1444,fluttershy
1488215.png,https://derpicdn.net/img/view/2017/7/17/1488215.png,0,0.989618003,22,0,1832,1554,1810,1554,fluttershy
1491973.png,https://derpicdn.net/img/view/2017/7/22/1491973.png,0,0.998391032,372,87,966,681,594,594,fluttershy
1492127.png,https://derpicdn.net/img/view/2017/7/22/1492127.png,0,0.998869121,107,22,409,324,302,302,fluttershy
1492127.png,https://derpicdn.net/img/view/2017/7/22/1492127.png,1,0.994415164,559,27,847,315,288,288,fluttershy
1495066.png,https://derpicdn.net/img/view/2017/7/26/1495066.png,0,0.92882967,497,86,953,542,456,456,fluttershy
1495563.png,https://derpicdn.net/img/view/2017/7/26/1495563.png,0,0.938310444,325,0,1425,1066,1100,1066,fluttershy
149821.jpg,https://derpicdn.net/img/view/2012/11/12/149821.jpg,0,0.966104865,927,265,1485,823,558,558,fluttershy
1509958.png,https://derpicdn.net/img/view/2017/8/13/1509958.png,0,0.976630926,85,91,861,867,776,776,fluttershy
1510830.png,https://derpicdn.net/img/view/2017/8/14/1510830.png,0,0.983513713,0,0,1102,1269,1102,1269,fluttershy
1510901.png,https://derpicdn.net/img/view/2017/8/14/1510901.png,0,0.987683356,246,0,1558,1307,1312,1307,fluttershy
1511285.png,https://derpicdn.net/img/view/2017/8/15/1511285.png,0,0.986580491,1535,0,4103,2353,2568,2353,fluttershy
1513785.png,https://derpicdn.net/img/view/2017/8/18/1513785.png,0,0.940795362,104,4,698,598,594,594,fluttershy
1516639.png,https://derpicdn.net/img/view/2017/8/21/1516639.png,0,0.910716951,250,0,1000,731,750,731,fluttershy
1517424.png,https://derpicdn.net/img/view/2017/8/22/1517424.png,0,0.997695386,353,48,1159,854,806,806,fluttershy
1517424.png,https://derpicdn.net/img/view/2017/8/22/1517424.png,1,0.941899002,943,111,1725,893,782,782,fluttershy
1522464.png,https://derpicdn.net/img/view/2017/8/29/1522464.png,0,0.967082679,112,0,768,679,656,679,fluttershy
1523135.png,https://derpicdn.net/img/view/2017/8/30/1523135.png,0,0.99783057,227,30,663,466,436,436,fluttershy
15239.png,https://derpicdn.net/img/view/2012/6/22/15239.png,0,0.977900743,2046,534,2890,1378,844,844,fluttershy
1532167.png,https://derpicdn.net/img/view/2017/9/10/1532167.png,0,0.955796182,613,226,1371,984,758,758,fluttershy
15326.png,https://derpicdn.net/img/view/2012/6/22/15326.png,0,0.936550617,0,0,396,384,396,384,fluttershy
1538712.png,https://derpicdn.net/img/view/2017/9/18/1538712.png,0,0.942727804,83,14,493,430,410,416,fluttershy
1538712.png,https://derpicdn.net/img/view/2017/9/18/1538712.png,1,0.908986866,0,79,360,441,360,362,fluttershy
1540803.png,https://derpicdn.net/img/view/2017/9/21/1540803.png,0,0.987428188,546,0,1174,552,628,552,fluttershy
1541224.png,https://derpicdn.net/img/view/2017/9/21/1541224.png,0,0.981151223,159,5,665,511,506,506,fluttershy
1541936.png,https://derpicdn.net/img/view/2017/9/22/1541936.png,0,0.917247236,26,0,1648,1597,1622,1597,fluttershy
1542553.png,https://derpicdn.net/img/view/2017/9/23/1542553.png,0,0.995841146,7,0,953,913,946,913,fluttershy
1543239.png,https://derpicdn.net/img/view/2017/9/24/1543239.png,0,0.938267589,182,0,1246,720,1064,720,fluttershy
1548341.png,https://derpicdn.net/img/view/2017/9/30/1548341.png,0,0.985866129,150,38,982,870,832,832,fluttershy
1554709.png,https://derpicdn.net/img/view/2017/10/7/1554709.png,0,0.921888888,79,12,659,592,580,580,fluttershy
1561246.png,https://derpicdn.net/img/view/2017/10/14/1561246.png,0,0.957537413,98,0,968,833,870,833,fluttershy
156307.png,https://derpicdn.net/img/view/2012/11/18/156307.png,0,0.992799342,48,95,600,647,552,552,fluttershy
1565211.png,https://derpicdn.net/img/view/2017/10/19/1565211.png,0,0.996265531,718,0,1078,325,360,325,fluttershy
1567446.png,https://derpicdn.net/img/view/2017/10/22/1567446.png,0,0.974134982,0,160,851,1284,851,1124,fluttershy
1569084.png,https://derpicdn.net/img/view/2017/10/24/1569084.png,0,0.99739337,1573,0,3059,1455,1486,1455,fluttershy
1571387.png,https://derpicdn.net/img/view/2017/10/27/1571387.png,0,0.996636331,149,0,533,372,384,372,fluttershy
1571478.png,https://derpicdn.net/img/view/2017/10/27/1571478.png,0,0.984184265,114,0,556,414,442,414,fluttershy
1575450.png,https://derpicdn.net/img/view/2017/11/1/1575450.png,0,0.935132265,28,114,632,718,604,604,fluttershy
1575792.png,https://derpicdn.net/img/view/2017/11/1/1575792.png,0,0.943761647,110,0,1280,1160,1170,1160,fluttershy
1575838.png,https://derpicdn.net/img/view/2017/11/1/1575838.png,0,0.959921837,47,105,1263,1409,1216,1304,fluttershy
1578448.png,https://derpicdn.net/img/view/2017/11/5/1578448.png,0,0.975276589,0,0,621,611,621,611,fluttershy
1582070.png,https://derpicdn.net/img/view/2017/11/9/1582070.png,0,0.94060421,1033,25,2645,1637,1612,1612,fluttershy
1588069.png,https://derpicdn.net/img/view/2017/11/17/1588069.png,0,0.964658082,26,0,700,644,674,644,fluttershy
1590814.png,https://derpicdn.net/img/view/2017/11/20/1590814.png,0,0.970932722,688,284,2802,2398,2114,2114,fluttershy
1593792.png,https://derpicdn.net/img/view/2017/11/25/1593792.png,0,0.99309665,124,0,630,494,506,494,fluttershy
1594589.png,https://derpicdn.net/img/view/2017/11/26/1594589.png,0,0.993721783,272,0,2092,1500,1820,1500,fluttershy
1598842.png,https://derpicdn.net/img/view/2017/12/2/1598842.png,0,0.946837664,30,109,418,479,388,370,fluttershy
1599695.png,https://derpicdn.net/img/view/2017/12/3/1599695.png,0,0.998475969,401,0,1039,627,638,627,fluttershy
1601346.png,https://derpicdn.net/img/view/2017/12/5/1601346.png,1,0.998391509,69,405,279,615,210,210,fluttershy
1601346.png,https://derpicdn.net/img/view/2017/12/5/1601346.png,2,0.997774959,170,0,364,183,194,183,fluttershy
1601346.png,https://derpicdn.net/img/view/2017/12/5/1601346.png,3,0.99728173,473,0,711,192,238,192,fluttershy
1602604.png,https://derpicdn.net/img/view/2017/12/7/1602604.png,0,0.998179674,184,0,736,519,552,519,fluttershy
1608336.png,https://derpicdn.net/img/view/2017/12/15/1608336.png,0,0.936885417,0,14,1380,1596,1380,1582,fluttershy
1612295.png,https://derpicdn.net/img/view/2017/12/20/1612295.png,0,0.990171313,66,40,700,674,634,634,fluttershy
1616329.png,https://derpicdn.net/img/view/2017/12/26/1616329.png,0,0.93945986,463,254,2491,2282,2028,2028,fluttershy
1616565.png,https://derpicdn.net/img/view/2017/12/26/1616565.png,0,0.987301409,120,0,952,745,832,745,fluttershy
1617174.png,https://derpicdn.net/img/view/2017/12/27/1617174.png,0,0.977855563,484,71,2620,2207,2136,2136,fluttershy
1618422.png,https://derpicdn.net/img/view/2017/12/28/1618422.png,0,0.953930378,58,41,988,971,930,930,fluttershy
1618884.png,https://derpicdn.net/img/view/2017/12/29/1618884.png,0,0.996328771,503,689,1027,1213,524,524,fluttershy
1623125.png,https://derpicdn.net/img/view/2018/1/3/1623125.png,0,0.927031159,165,0,1333,1145,1168,1145,fluttershy
1626794.png,https://derpicdn.net/img/view/2018/1/7/1626794.png,0,0.911337614,372,0,934,530,562,530,fluttershy
1628211.png,https://derpicdn.net/img/view/2018/1/9/1628211.png,0,0.930785716,2575,0,6849,3600,4274,3600,fluttershy
1629442.png,https://derpicdn.net/img/view/2018/1/11/1629442.png,0,0.966804445,308,47,816,555,508,508,fluttershy
1629981.png,https://derpicdn.net/img/view/2018/1/11/1629981.png,0,0.998209536,203,49,589,435,386,386,fluttershy
1630117.png,https://derpicdn.net/img/view/2018/1/12/1630117.png,0,0.9531129,395,157,807,569,412,412,fluttershy
1633578.png,https://derpicdn.net/img/view/2018/1/16/1633578.png,0,0.991218507,245,64,1095,914,850,850,fluttershy
1634966.png,https://derpicdn.net/img/view/2018/1/18/1634966.png,0,0.99525553,5,318,325,638,320,320,fluttershy
1634966.png,https://derpicdn.net/img/view/2018/1/18/1634966.png,1,0.983429611,251,0,813,521,562,521,fluttershy
1638583.png,https://derpicdn.net/img/view/2018/1/22/1638583.png,0,0.937090814,102,0,1118,720,1016,720,fluttershy
1638931.png,https://derpicdn.net/img/view/2018/1/23/1638931.png,0,0.955038369,838,145,1490,797,652,652,fluttershy
1648614.png,https://derpicdn.net/img/view/2018/2/4/1648614.png,0,0.950551927,144,0,442,282,298,282,fluttershy
1650627.png,https://derpicdn.net/img/view/2018/2/7/1650627.png,0,0.975135505,785,60,1521,796,736,736,fluttershy
1650729.png,https://derpicdn.net/img/view/2018/2/7/1650729.png,0,0.984109342,64,0,1060,720,996,720,fluttershy
1652025.png,https://derpicdn.net/img/view/2018/2/9/1652025.png,0,0.967012107,269,119,643,493,374,374,fluttershy
1653102.png,https://derpicdn.net/img/view/2018/2/11/1653102.png,0,0.978669703,156,42,484,370,328,328,fluttershy
1654339.png,https://derpicdn.net/img/view/2018/2/12/1654339.png,0,0.997513652,163,70,741,648,578,578,fluttershy
1656262.png,https://derpicdn.net/img/view/2018/2/14/1656262.png,0,0.991694152,26,188,246,408,220,220,fluttershy
1661060.png,https://derpicdn.net/img/view/2018/2/20/1661060.png,0,0.994392812,600,0,2574,1891,1974,1891,fluttershy
1661061.png,https://derpicdn.net/img/view/2018/2/20/1661061.png,0,0.933952987,412,0,1396,983,984,983,fluttershy
1661556.png,https://derpicdn.net/img/view/2018/2/20/1661556.png,0,0.98529464,66,28,830,792,764,764,fluttershy
1663864.png,https://derpicdn.net/img/view/2018/2/23/1663864.png,0,0.960521936,444,130,1244,930,800,800,fluttershy
1666755.png,https://derpicdn.net/img/view/2018/2/26/1666755.png,0,0.967499554,104,0,1128,720,1024,720,fluttershy
1671124.png,https://derpicdn.net/img/view/2018/3/4/1671124.png,0,0.96222055,240,445,834,1039,594,594,fluttershy
1672945.png,https://derpicdn.net/img/view/2018/3/6/1672945.png,0,0.996806264,262,0,912,624,650,624,fluttershy
1675948.png,https://derpicdn.net/img/view/2018/3/10/1675948.png,0,0.9935444,61,0,761,680,700,680,fluttershy
1677499.png,https://derpicdn.net/img/view/2018/3/11/1677499.png,0,0.994046867,93,0,821,643,728,643,fluttershy
1682924.png,https://derpicdn.net/img/view/2018/3/17/1682924.png,0,0.998376071,133,231,901,999,768,768,fluttershy
1684247.png,https://derpicdn.net/img/view/2018/3/18/1684247.png,0,0.941584647,677,0,1576,867,899,867,fluttershy
1686753.png,https://derpicdn.net/img/view/2018/3/21/1686753.png,0,0.99741596,200,0,670,410,470,410,fluttershy
1688903.png,https://derpicdn.net/img/view/2018/3/24/1688903.png,0,0.995301902,9,0,219,210,210,210,fluttershy
1692465.png,https://derpicdn.net/img/view/2018/3/27/1692465.png,0,0.999450147,401,18,651,268,250,250,fluttershy
1694100.png,https://derpicdn.net/img/view/2018/3/29/1694100.png,0,0.949479043,142,192,1404,1454,1262,1262,fluttershy
1694698.png,https://derpicdn.net/img/view/2018/3/30/1694698.png,0,0.945046842,18,0,450,419,432,419,fluttershy
1695666.png,https://derpicdn.net/img/view/2018/3/31/1695666.png,0,0.997759521,2216,86,3498,1368,1282,1282,fluttershy
1700760.png,https://derpicdn.net/img/view/2018/4/6/1700760.png,0,0.981667042,320,0,622,274,302,274,fluttershy
1701798.png,https://derpicdn.net/img/view/2018/4/7/1701798.png,0,0.977858007,679,0,1109,422,430,422,fluttershy
1702561.png,https://derpicdn.net/img/view/2018/4/8/1702561.png,0,0.993478537,265,0,2033,1491,1768,1491,fluttershy
1703842.png,https://derpicdn.net/img/view/2018/4/9/1703842.png,0,0.99741888,332,44,804,516,472,472,fluttershy
1704716.png,https://derpicdn.net/img/view/2018/4/11/1704716.png,0,0.995624423,17,134,871,988,854,854,fluttershy
1707254.png,https://derpicdn.net/img/view/2018/4/14/1707254.png,0,0.982133508,155,0,1641,1338,1486,1338,fluttershy
1709800.png,https://derpicdn.net/img/view/2018/4/16/1709800.png,0,0.945314229,174,0,770,568,596,568,fluttershy
1712404.png,https://derpicdn.net/img/view/2018/4/20/1712404.png,0,0.988240778,446,95,882,531,436,436,fluttershy
1713561.png,https://derpicdn.net/img/view/2018/4/21/1713561.png,0,0.990837932,140,1,1074,935,934,934,fluttershy
1713717.png,https://derpicdn.net/img/view/2018/4/21/1713717.png,0,0.997468948,16,98,314,396,298,298,fluttershy
1713717.png,https://derpicdn.net/img/view/2018/4/21/1713717.png,1,0.971653223,508,0,840,308,332,308,fluttershy
1714365.png,https://derpicdn.net/img/view/2018/4/22/1714365.png,0,0.984911442,444,0,4200,3547,3756,3547,fluttershy
1718383.png,https://derpicdn.net/img/view/2018/4/27/1718383.png,0,0.99757421,283,0,759,400,476,400,fluttershy
1718585.png,https://derpicdn.net/img/view/2018/4/27/1718585.png,0,0.996484518,752,361,2866,2475,2114,2114,fluttershy
1723094.png,https://derpicdn.net/img/view/2018/5/3/1723094.png,0,0.990409613,0,0,850,788,850,788,fluttershy
1725.png,https://derpicdn.net/img/view/2012/1/23/1725.png,0,0.98871094,56,0,976,862,920,862,fluttershy
1728515.png,https://derpicdn.net/img/view/2018/5/9/1728515.png,0,0.961748242,20,0,956,576,936,576,fluttershy
1728515.png,https://derpicdn.net/img/view/2018/5/9/1728515.png,1,0.903695226,28,0,806,576,778,576,fluttershy
1728825.png,https://derpicdn.net/img/view/2018/5/10/1728825.png,0,0.992568195,218,5,928,715,710,710,fluttershy
1729764.png,https://derpicdn.net/img/view/2018/5/11/1729764.png,0,0.923587859,3,0,1981,1889,1978,1889,fluttershy
1730690.png,https://derpicdn.net/img/view/2018/5/12/1730690.png,0,0.992035747,277,322,591,636,314,314,fluttershy
1731216.png,https://derpicdn.net/img/view/2018/5/12/1731216.png,0,0.926560104,181,0,1035,849,854,849,fluttershy
1732149.png,https://derpicdn.net/img/view/2018/5/13/1732149.png,0,0.972606003,17,100,1391,1608,1374,1508,fluttershy
1732149.png,https://derpicdn.net/img/view/2018/5/13/1732149.png,1,0.915744007,0,376,1268,1800,1268,1424,fluttershy
1732151.png,https://derpicdn.net/img/view/2018/5/13/1732151.png,0,0.971026063,18,100,1391,1606,1373,1506,fluttershy
1732156.png,https://derpicdn.net/img/view/2018/5/13/1732156.png,0,0.98007983,0,42,1391,1674,1391,1632,fluttershy
1732156.png,https://derpicdn.net/img/view/2018/5/13/1732156.png,1,0.954957604,0,378,1271,1800,1271,1422,fluttershy
1734695.png,https://derpicdn.net/img/view/2018/5/17/1734695.png,0,0.984977484,368,0,1500,1003,1132,1003,fluttershy
1740185.png,https://derpicdn.net/img/view/2018/5/24/1740185.png,0,0.996660411,218,150,904,836,686,686,fluttershy
1740345.png,https://derpicdn.net/img/view/2018/5/24/1740345.png,0,0.996454298,257,181,1081,1005,824,824,fluttershy
1745875.png,https://derpicdn.net/img/view/2018/5/31/1745875.png,0,0.998295248,402,25,1034,657,632,632,fluttershy
1747661.png,https://derpicdn.net/img/view/2018/6/2/1747661.png,0,0.916974783,0,0,259,253,259,253,fluttershy
1748981.png,https://derpicdn.net/img/view/2018/6/3/1748981.png,0,0.995948792,176,12,676,512,500,500,fluttershy
1754134.png,https://derpicdn.net/img/view/2018/6/10/1754134.png,0,0.968695164,0,0,2951,3134,2951,3134,fluttershy
175539.png,https://derpicdn.net/img/view/2012/12/7/175539.png,0,0.990332782,180,6,498,324,318,318,fluttershy
1755408.png,https://derpicdn.net/img/view/2018/6/11/1755408.png,0,0.914698958,64,0,738,622,674,622,fluttershy
1761269.png,https://derpicdn.net/img/view/2018/6/19/1761269.png,0,0.993096232,378,1,1022,645,644,644,fluttershy
1764146.png,https://derpicdn.net/img/view/2018/6/23/1764146.png,0,0.998481035,212,31,912,731,700,700,fluttershy
1767063.png,https://derpicdn.net/img/view/2018/6/27/1767063.png,0,0.99893254,102,27,424,349,322,322,fluttershy
1767063.png,https://derpicdn.net/img/view/2018/6/27/1767063.png,1,0.991312087,558,266,884,592,326,326,fluttershy
1767320.png,https://derpicdn.net/img/view/2018/6/27/1767320.png,0,0.978073895,35,0,439,375,404,375,fluttershy
1767596.png,https://derpicdn.net/img/view/2018/6/27/1767596.png,0,0.998261034,148,54,688,594,540,540,fluttershy
1780400.png,https://derpicdn.net/img/view/2018/7/13/1780400.png,0,0.9968431,135,0,533,376,398,376,fluttershy
1780969.png,https://derpicdn.net/img/view/2018/7/14/1780969.png,0,0.996445715,186,55,956,825,770,770,fluttershy
1782011.png,https://derpicdn.net/img/view/2018/7/16/1782011.png,0,0.933124185,443,0,1583,1012,1140,1012,fluttershy
17855.png,https://derpicdn.net/img/view/2012/6/23/17855.png,0,0.950561702,26,0,456,390,430,390,fluttershy
1790706.png,https://derpicdn.net/img/view/2018/7/27/1790706.png,0,0.949666798,63,232,517,686,454,454,fluttershy
1798040.png,https://derpicdn.net/img/view/2018/8/4/1798040.png,0,0.989073396,1311,599,1933,1221,622,622,fluttershy
1798040.png,https://derpicdn.net/img/view/2018/8/4/1798040.png,1,0.965683103,856,625,1502,1271,646,646,fluttershy
1801176.png,https://derpicdn.net/img/view/2018/8/8/1801176.png,0,0.993981838,135,151,625,641,490,490,fluttershy
1806900.png,https://derpicdn.net/img/view/2018/8/15/1806900.png,0,0.988021255,86,378,824,1116,738,738,fluttershy
1806900.png,https://derpicdn.net/img/view/2018/8/15/1806900.png,1,0.986375332,897,0,2215,1260,1318,1260,fluttershy
1807729.png,https://derpicdn.net/img/view/2018/8/15/1807729.png,0,0.985413671,879,0,2201,1266,1322,1266,fluttershy
1807729.png,https://derpicdn.net/img/view/2018/8/15/1807729.png,1,0.974901259,79,384,817,1122,738,738,fluttershy
1809946.png,https://derpicdn.net/img/view/2018/8/18/1809946.png,0,0.988111615,0,0,475,479,475,479,fluttershy
1816521.png,https://derpicdn.net/img/view/2018/8/26/1816521.png,0,0.994242609,206,1536,2158,3488,1952,1952,fluttershy
1816521.png,https://derpicdn.net/img/view/2018/8/26/1816521.png,1,0.987647951,2936,1100,4804,2968,1868,1868,fluttershy
1817144.png,https://derpicdn.net/img/view/2018/8/26/1817144.png,0,0.956604004,242,0,1786,1518,1544,1518,fluttershy
1821660.png,https://derpicdn.net/img/view/2018/9/1/1821660.png,0,0.99688226,715,117,1003,405,288,288,fluttershy
1823351.png,https://derpicdn.net/img/view/2018/9/2/1823351.png,0,0.984068394,16,2,362,348,346,346,fluttershy
1826443.png,https://derpicdn.net/img/view/2018/9/6/1826443.png,0,0.9310835,284,36,1052,804,768,768,fluttershy
1828422.png,https://derpicdn.net/img/view/2018/9/9/1828422.png,0,0.995773971,102,47,578,523,476,476,fluttershy
1828428.png,https://derpicdn.net/img/view/2018/9/9/1828428.png,0,0.996709347,126,7,564,445,438,438,fluttershy
1830695.png,https://derpicdn.net/img/view/2018/9/12/1830695.png,0,0.97434777,0,0,424,463,424,463,fluttershy
18339.png,https://derpicdn.net/img/view/2012/6/24/18339.png,0,0.985307336,169,0,845,633,676,633,fluttershy
1835600.png,https://derpicdn.net/img/view/2018/9/18/1835600.png,0,0.937991679,267,0,1617,1230,1350,1230,fluttershy
1841361.png,https://derpicdn.net/img/view/2018/9/25/1841361.png,0,0.962094665,53,99,389,435,336,336,fluttershy
1855583.png,https://derpicdn.net/img/view/2018/10/13/1855583.png,0,0.999048769,902,56,2270,1424,1368,1368,fluttershy
1858383.png,https://derpicdn.net/img/view/2018/10/16/1858383.png,0,0.974867105,24,0,2276,2178,2252,2178,fluttershy
1860375.png,https://derpicdn.net/img/view/2018/10/19/1860375.png,0,0.978608131,2288,31,4408,2151,2120,2120,fluttershy
1864361.png,https://derpicdn.net/img/view/2018/10/23/1864361.png,0,0.924537778,88,0,908,710,820,710,fluttershy
1866756.png,https://derpicdn.net/img/view/2018/10/26/1866756.png,0,0.944401741,675,0,1063,331,388,331,fluttershy
1873815.png,https://derpicdn.net/img/view/2018/11/3/1873815.png,0,0.986756146,362,84,704,426,342,342,fluttershy
1876844.png,https://derpicdn.net/img/view/2018/11/7/1876844.png,0,0.992604911,0,52,629,786,629,734,fluttershy
1877915.png,https://derpicdn.net/img/view/2018/11/8/1877915.png,0,0.997044086,492,61,1140,709,648,648,fluttershy
1879428.png,https://derpicdn.net/img/view/2018/11/10/1879428.png,0,0.998582721,196,2,2432,2238,2236,2236,fluttershy
1889922.png,https://derpicdn.net/img/view/2018/11/24/1889922.png,0,0.999560058,173,0,355,158,182,158,fluttershy
1890987.png,https://derpicdn.net/img/view/2018/11/26/1890987.png,0,0.997643948,33,0,837,783,804,783,fluttershy
1895553.png,https://derpicdn.net/img/view/2018/12/1/1895553.png,0,0.957995236,0,0,5561,5416,5561,5416,fluttershy
1896921.png,https://derpicdn.net/img/view/2018/12/3/1896921.png,0,0.95049727,1512,310,2502,1300,990,990,fluttershy
1899636.png,https://derpicdn.net/img/view/2018/12/5/1899636.png,0,0.99716717,308,0,1392,859,1084,859,fluttershy
1901307.png,https://derpicdn.net/img/view/2018/12/7/1901307.png,0,0.999860883,341,0,1421,1019,1080,1019,fluttershy
1910106.png,https://derpicdn.net/img/view/2018/12/16/1910106.png,0,0.96688062,139,55,505,421,366,366,fluttershy
1915942.png,https://derpicdn.net/img/view/2018/12/23/1915942.png,0,0.977558553,100,9,654,563,554,554,fluttershy
1921829.png,https://derpicdn.net/img/view/2018/12/30/1921829.png,0,0.958294809,66,0,928,824,862,824,fluttershy
1924182.png,https://derpicdn.net/img/view/2019/1/1/1924182.png,0,0.995887637,311,0,599,282,288,282,fluttershy
1925829.png,https://derpicdn.net/img/view/2019/1/3/1925829.png,0,0.992939115,1169,139,3389,2359,2220,2220,fluttershy
1926373.png,https://derpicdn.net/img/view/2019/1/4/1926373.png,0,0.989489019,86,0,614,455,528,455,fluttershy
1936019.png,https://derpicdn.net/img/view/2019/1/15/1936019.png,0,0.989735842,303,0,4613,4033,4310,4033,fluttershy
1937647.png,https://derpicdn.net/img/view/2019/1/17/1937647.png,0,0.984292448,79,0,454,353,375,353,fluttershy
1945497.png,https://derpicdn.net/img/view/2019/1/26/1945497.png,0,0.975458264,207,0,993,703,786,703,fluttershy
1948131.png,https://derpicdn.net/img/view/2019/1/29/1948131.png,0,0.950827241,0,0,1754,1692,1754,1692,fluttershy
1949654.png,https://derpicdn.net/img/view/2019/1/31/1949654.png,0,0.993157387,584,427,1776,1619,1192,1192,fluttershy
1955941.png,https://derpicdn.net/img/view/2019/2/7/1955941.png,0,0.973118067,110,115,2458,2463,2348,2348,fluttershy
1957538.png,https://derpicdn.net/img/view/2019/2/9/1957538.png,0,0.986670196,35,0,747,618,712,618,fluttershy
1961525.png,https://derpicdn.net/img/view/2019/2/14/1961525.png,0,0.961827159,370,0,2762,2361,2392,2361,fluttershy
1962094.png,https://derpicdn.net/img/view/2019/2/14/1962094.png,1,0.912681162,2533,848,4095,2410,1562,1562,fluttershy
1962420.png,https://derpicdn.net/img/view/2019/2/15/1962420.png,0,0.94657886,0,0,1244,1206,1244,1206,fluttershy
1963894.png,https://derpicdn.net/img/view/2019/2/16/1963894.png,0,0.939199269,462,2,726,266,264,264,fluttershy
1964014.png,https://derpicdn.net/img/view/2019/2/17/1964014.png,0,0.990028501,59,59,611,611,552,552,fluttershy
1964998.png,https://derpicdn.net/img/view/2019/2/18/1964998.png,0,0.960257232,339,527,3025,3213,2686,2686,fluttershy
1965175.png,https://derpicdn.net/img/view/2019/2/18/1965175.png,0,0.985111475,171,0,795,546,624,546,fluttershy
1966997.png,https://derpicdn.net/img/view/2019/2/20/1966997.png,0,0.992125273,15,5,599,589,584,584,fluttershy
1967597.png,https://derpicdn.net/img/view/2019/2/21/1967597.png,0,0.979228675,0,36,1051,1196,1051,1160,fluttershy
1970297.png,https://derpicdn.net/img/view/2019/2/24/1970297.png,0,0.999098957,594,79,1034,519,440,440,fluttershy
1971036.png,https://derpicdn.net/img/view/2019/2/25/1971036.png,1,0.961609483,530,288,2132,1890,1602,1602,fluttershy
1972462.png,https://derpicdn.net/img/view/2019/2/26/1972462.png,0,0.990456283,269,211,1327,1269,1058,1058,fluttershy
1979840.png,https://derpicdn.net/img/view/2019/3/7/1979840.png,0,0.996333838,754,0,1472,633,718,633,fluttershy
1979840.png,https://derpicdn.net/img/view/2019/3/7/1979840.png,1,0.963970304,137,71,811,745,674,674,fluttershy
1986266.png,https://derpicdn.net/img/view/2019/3/15/1986266.png,0,0.922873139,0,0,735,751,735,751,fluttershy
1988279.png,https://derpicdn.net/img/view/2019/3/17/1988279.png,0,0.990882933,107,0,835,728,728,728,fluttershy
1991819.png,https://derpicdn.net/img/view/2019/3/22/1991819.png,0,0.970324934,160,10,470,320,310,310,fluttershy
1993820.png,https://derpicdn.net/img/view/2019/3/24/1993820.png,0,0.972888172,78,0,984,852,906,852,fluttershy
1993824.png,https://derpicdn.net/img/view/2019/3/24/1993824.png,0,0.986010194,0,12,640,740,640,728,fluttershy
1993826.png,https://derpicdn.net/img/view/2019/3/24/1993826.png,0,0.976071656,137,0,1305,939,1168,939,fluttershy
1995305.png,https://derpicdn.net/img/view/2019/3/26/1995305.png,0,0.98093164,139,0,581,451,442,451,fluttershy
1996172.png,https://derpicdn.net/img/view/2019/3/27/1996172.png,0,0.986531675,896,502,1996,1602,1100,1100,fluttershy
1998285.png,https://derpicdn.net/img/view/2019/3/30/1998285.png,0,0.995733738,64,25,3164,3125,3100,3100,fluttershy
1998552.png,https://derpicdn.net/img/view/2019/3/30/1998552.png,0,0.987277269,467,62,909,504,442,442,fluttershy
2001486.png,https://derpicdn.net/img/view/2019/4/3/2001486.png,0,0.994307518,295,247,1025,977,730,730,fluttershy
2011299.png,https://derpicdn.net/img/view/2019/4/13/2011299.png,0,0.958686471,404,136,752,484,348,348,fluttershy
2011730.png,https://derpicdn.net/img/view/2019/4/14/2011730.png,0,0.981800854,120,52,494,451,374,399,fluttershy
2012495.png,https://derpicdn.net/img/view/2019/4/14/2012495.png,0,0.967413068,0,0,2024,1992,2024,1992,fluttershy
2012860.png,https://derpicdn.net/img/view/2019/4/15/2012860.png,0,0.922078311,26,0,892,769,866,769,fluttershy
2014893.png,https://derpicdn.net/img/view/2019/4/17/2014893.png,0,0.994890034,586,3,1592,1009,1006,1006,fluttershy
2015321.png,https://derpicdn.net/img/view/2019/4/17/2015321.png,0,0.952070415,0,4,900,1126,900,1122,fluttershy
2016474.png,https://derpicdn.net/img/view/2019/4/19/2016474.png,0,0.959112346,536,0,1454,880,918,880,fluttershy
2022083.png,https://derpicdn.net/img/view/2019/4/24/2022083.png,0,0.987230182,80,17,348,285,268,268,fluttershy
2023128.png,https://derpicdn.net/img/view/2019/4/26/2023128.png,0,0.990710974,1557,226,2705,1374,1148,1148,fluttershy
2023942.png,https://derpicdn.net/img/view/2019/4/27/2023942.png,0,0.989664793,125,0,2149,1881,2024,1881,fluttershy
2025736.png,https://derpicdn.net/img/view/2019/4/28/2025736.png,0,0.98127836,1612,372,2404,1164,792,792,fluttershy
2025902.png,https://derpicdn.net/img/view/2019/4/28/2025902.png,0,0.987937927,2480,96,5210,2870,2730,2774,fluttershy
2027446.png,https://derpicdn.net/img/view/2019/4/30/2027446.png,0,0.999726593,1283,63,2093,873,810,810,fluttershy
2036427.png,https://derpicdn.net/img/view/2019/5/11/2036427.png,0,0.928264439,46,0,1082,720,1036,720,fluttershy
2041541.png,https://derpicdn.net/img/view/2019/5/17/2041541.png,0,0.995129049,512,386,908,782,396,396,fluttershy
2042458.png,https://derpicdn.net/img/view/2019/5/18/2042458.png,0,0.96098125,159,0,1385,1021,1226,1021,fluttershy
2042631.png,https://derpicdn.net/img/view/2019/5/18/2042631.png,0,0.975914121,636,240,2762,2366,2126,2126,fluttershy
2047326.png,https://derpicdn.net/img/view/2019/5/24/2047326.png,0,0.951543987,419,118,973,672,554,554,fluttershy
2048333.png,https://derpicdn.net/img/view/2019/5/25/2048333.png,0,0.999328256,699,116,1671,1088,972,972,fluttershy
2048829.png,https://derpicdn.net/img/view/2019/5/25/2048829.png,0,0.979144335,46,0,402,348,356,348,fluttershy
2049172.png,https://derpicdn.net/img/view/2019/5/26/2049172.png,0,0.914507806,677,0,1187,395,510,395,fluttershy
2051209.png,https://derpicdn.net/img/view/2019/5/28/2051209.png,0,0.969546199,216,0,607,309,391,309,fluttershy
2051988.png,https://derpicdn.net/img/view/2019/5/28/2051988.png,0,0.993669391,220,21,868,729,648,708,fluttershy
2052004.png,https://derpicdn.net/img/view/2019/5/28/2052004.png,0,0.991374612,210,0,1330,940,1120,940,fluttershy
2054874.png,https://derpicdn.net/img/view/2019/6/1/2054874.png,0,0.986192048,44,0,928,861,884,861,fluttershy
2054875.png,https://derpicdn.net/img/view/2019/6/1/2054875.png,0,0.933098972,42,0,542,426,500,426,fluttershy
2054941.png,https://derpicdn.net/img/view/2019/6/1/2054941.png,0,0.987123251,1429,1969,1759,2272,330,303,fluttershy
2056435.png,https://derpicdn.net/img/view/2019/6/2/2056435.png,0,0.985506654,123,0,1280,1127,1157,1127,fluttershy
2059714.png,https://derpicdn.net/img/view/2019/6/7/2059714.png,0,0.988891661,0,0,699,726,699,726,fluttershy
2060530.png,https://derpicdn.net/img/view/2019/6/8/2060530.png,0,0.997247279,770,65,1750,1045,980,980,fluttershy
2063347.png,https://derpicdn.net/img/view/2019/6/12/2063347.png,0,0.994933844,2097,81,3601,1585,1504,1504,fluttershy
2065841.png,https://derpicdn.net/img/view/2019/6/15/2065841.png,0,0.962627113,412,66,736,390,324,324,fluttershy
2065970.png,https://derpicdn.net/img/view/2019/6/15/2065970.png,0,0.996378481,247,0,881,568,634,568,fluttershy
2068721.png,https://derpicdn.net/img/view/2019/6/18/2068721.png,0,0.933647156,55,3,443,467,388,464,fluttershy
207442.png,https://derpicdn.net/img/view/2013/1/9/207442.png,0,0.954895973,116,344,306,534,190,190,fluttershy
2079516.png,https://derpicdn.net/img/view/2019/6/30/2079516.png,0,0.975643635,194,3,602,411,408,408,fluttershy
2079809.png,https://derpicdn.net/img/view/2019/6/30/2079809.png,0,0.997558594,751,674,1269,1192,518,518,fluttershy
2079810.png,https://derpicdn.net/img/view/2019/6/30/2079810.png,0,0.991226375,764,669,1278,1183,514,514,fluttershy
2079992.png,https://derpicdn.net/img/view/2019/7/1/2079992.png,0,0.98108834,186,0,1380,1196,1194,1196,fluttershy
2080528.png,https://derpicdn.net/img/view/2019/7/1/2080528.png,0,0.952756047,444,0,1422,890,978,890,fluttershy
2084491.png,https://derpicdn.net/img/view/2019/7/6/2084491.png,0,0.988241613,171,0,909,736,738,736,fluttershy
2085334.png,https://derpicdn.net/img/view/2019/7/7/2085334.png,0,0.933617473,552,286,1688,1422,1136,1136,fluttershy
2086700.png,https://derpicdn.net/img/view/2019/7/8/2086700.png,0,0.98200345,69,0,355,283,286,283,fluttershy
2088206.png,https://derpicdn.net/img/view/2019/7/10/2088206.png,0,0.998299003,1373,1996,1859,2482,486,486,fluttershy
2088206.png,https://derpicdn.net/img/view/2019/7/10/2088206.png,1,0.98648876,1246,1012,1826,1592,580,580,fluttershy
2088206.png,https://derpicdn.net/img/view/2019/7/10/2088206.png,2,0.985721707,1326,425,1718,817,392,392,fluttershy
2088206.png,https://derpicdn.net/img/view/2019/7/10/2088206.png,3,0.968095839,294,454,614,774,320,320,fluttershy
2088206.png,https://derpicdn.net/img/view/2019/7/10/2088206.png,4,0.917732298,83,1151,661,1729,578,578,fluttershy
2092021.png,https://derpicdn.net/img/view/2019/7/15/2092021.png,0,0.990464509,69,0,609,521,540,521,fluttershy
2092093.png,https://derpicdn.net/img/view/2019/7/15/2092093.png,0,0.995642245,143,25,987,869,844,844,fluttershy
2093962.png,https://derpicdn.net/img/view/2019/7/17/2093962.png,0,0.998215795,10,1,362,353,352,352,fluttershy
2099484.png,https://derpicdn.net/img/view/2019/7/23/2099484.png,0,0.991381168,145,38,991,884,846,846,fluttershy
2099764.png,https://derpicdn.net/img/view/2019/7/24/2099764.png,0,0.963166475,0,0,745,779,745,779,fluttershy
2100822.png,https://derpicdn.net/img/view/2019/7/25/2100822.png,0,0.996117294,458,0,1098,554,640,554,fluttershy
2105130.png,https://derpicdn.net/img/view/2019/7/30/2105130.png,0,0.999396324,480,0,810,318,330,318,fluttershy
2105634.png,https://derpicdn.net/img/view/2019/7/31/2105634.png,0,0.954230487,109,6,453,350,344,344,fluttershy
2106596.png,https://derpicdn.net/img/view/2019/8/1/2106596.png,0,0.933797479,61,455,581,975,520,520,fluttershy
2111802.png,https://derpicdn.net/img/view/2019/8/8/2111802.png,0,0.998793602,323,36,845,558,522,522,fluttershy
211575.png,https://derpicdn.net/img/view/2013/1/13/211575.png,0,0.950030029,344,0,906,552,562,552,fluttershy
2122776.png,https://derpicdn.net/img/view/2019/8/20/2122776.png,0,0.983350933,492,102,988,598,496,496,fluttershy
2124602.png,https://derpicdn.net/img/view/2019/8/22/2124602.png,0,0.985754728,558,0,2422,1766,1864,1766,fluttershy
2130775.png,https://derpicdn.net/img/view/2019/8/29/2130775.png,0,0.965619445,528,357,802,631,274,274,fluttershy
2130775.png,https://derpicdn.net/img/view/2019/8/29/2130775.png,1,0.918607652,47,36,375,364,328,328,fluttershy
2146852.png,https://derpicdn.net/img/view/2019/9/18/2146852.png,0,0.982182503,66,0,784,631,718,631,fluttershy
2149607.png,https://derpicdn.net/img/view/2019/9/21/2149607.png,0,0.903946638,175,99,499,423,324,324,fluttershy
2150408.png,https://derpicdn.net/img/view/2019/9/22/2150408.png,0,0.991068959,133,0,903,711,770,711,fluttershy
2151017.png,https://derpicdn.net/img/view/2019/9/23/2151017.png,0,0.989357769,0,126,911,1074,911,948,fluttershy
2153200.png,https://derpicdn.net/img/view/2019/9/26/2153200.png,0,0.980106652,0,0,411,417,411,417,fluttershy
2154545.png,https://derpicdn.net/img/view/2019/9/27/2154545.png,0,0.988346756,0,59,852,955,852,896,fluttershy
2156175.png,https://derpicdn.net/img/view/2019/9/29/2156175.png,0,0.938866258,1036,522,1450,936,414,414,fluttershy
2161160.png,https://derpicdn.net/img/view/2019/10/5/2161160.png,0,0.977321267,123,39,1080,1057,957,1018,fluttershy
2161231.png,https://derpicdn.net/img/view/2019/10/6/2161231.png,0,0.972076774,90,0,898,798,808,798,fluttershy
2177536.png,https://derpicdn.net/img/view/2019/10/24/2177536.png,0,0.965854347,29,15,297,283,268,268,fluttershy
2178094.png,https://derpicdn.net/img/view/2019/10/24/2178094.png,0,0.98636955,13,0,519,501,506,501,fluttershy
2178642.png,https://derpicdn.net/img/view/2019/10/25/2178642.png,0,0.986157835,749,0,2789,2001,2040,2001,fluttershy
2178735.png,https://derpicdn.net/img/view/2019/10/25/2178735.png,0,0.980554044,6,0,352,311,346,311,fluttershy
2178877.png,https://derpicdn.net/img/view/2019/10/25/2178877.png,0,0.923900366,104,0,440,306,336,306,fluttershy
2181961.png,https://derpicdn.net/img/view/2019/10/29/2181961.png,0,0.962988079,584,0,1136,547,552,547,fluttershy
2182643.png,https://derpicdn.net/img/view/2019/10/30/2182643.png,0,0.954935849,0,380,1579,1920,1579,1540,fluttershy
2186386.png,https://derpicdn.net/img/view/2019/11/3/2186386.png,0,0.998161316,120,0,1840,1583,1720,1583,fluttershy
2191862.png,https://derpicdn.net/img/view/2019/11/10/2191862.png,0,0.948443472,1775,0,6525,4026,4750,4026,fluttershy
2193612.png,https://derpicdn.net/img/view/2019/11/11/2193612.png,0,0.993678331,536,607,824,895,288,288,fluttershy
2193612.png,https://derpicdn.net/img/view/2019/11/11/2193612.png,1,0.976032615,579,63,831,315,252,252,fluttershy
2193612.png,https://derpicdn.net/img/view/2019/11/11/2193612.png,2,0.941467166,278,715,554,991,276,276,fluttershy
2193673.png,https://derpicdn.net/img/view/2019/11/12/2193673.png,1,0.946470618,604,600,958,954,354,354,fluttershy
2198577.png,https://derpicdn.net/img/view/2019/11/17/2198577.png,0,0.98930186,73,0,657,535,584,535,fluttershy
2199693.png,https://derpicdn.net/img/view/2019/11/18/2199693.png,0,0.99228555,390,665,760,1035,370,370,fluttershy
2199778.png,https://derpicdn.net/img/view/2019/11/19/2199778.png,0,0.99394393,0,0,722,794,722,794,fluttershy
2200067.png,https://derpicdn.net/img/view/2019/11/19/2200067.png,0,0.986022234,50,0,518,403,468,403,fluttershy
2201179.png,https://derpicdn.net/img/view/2019/11/20/2201179.png,0,0.950053394,906,317,4634,4045,3728,3728,fluttershy
2202198.png,https://derpicdn.net/img/view/2019/11/21/2202198.png,0,0.990098059,35,0,361,316,326,316,fluttershy
2205743.png,https://derpicdn.net/img/view/2019/11/25/2205743.png,0,0.99118048,3286,0,3848,437,562,437,fluttershy
2206212.png,https://derpicdn.net/img/view/2019/11/26/2206212.png,0,0.984079003,63,0,1135,939,1072,939,fluttershy
2206215.png,https://derpicdn.net/img/view/2019/11/26/2206215.png,0,0.995643795,123,0,621,488,498,488,fluttershy
2207229.png,https://derpicdn.net/img/view/2019/11/27/2207229.png,0,0.988928437,142,0,564,385,422,385,fluttershy
2212232.png,https://derpicdn.net/img/view/2019/12/4/2212232.png,0,0.993558168,692,45,2134,1487,1442,1442,fluttershy
2214903.png,https://derpicdn.net/img/view/2019/12/7/2214903.png,0,0.942004383,313,0,1623,1301,1310,1301,fluttershy
2220530.png,https://derpicdn.net/img/view/2019/12/14/2220530.png,0,0.961419344,84,12,576,504,492,492,fluttershy
2220817.png,https://derpicdn.net/img/view/2019/12/14/2220817.png,0,0.988094628,580,227,3088,2735,2508,2508,fluttershy
2220912.png,https://derpicdn.net/img/view/2019/12/15/2220912.png,0,0.991734266,8,0,796,717,788,717,fluttershy
2221733.png,https://derpicdn.net/img/view/2019/12/16/2221733.png,0,0.930480838,0,0,486,604,486,604,fluttershy
2222503.png,https://derpicdn.net/img/view/2019/12/16/2222503.png,0,0.985999763,11,28,816,904,805,876,fluttershy
2223884.png,https://derpicdn.net/img/view/2019/12/18/2223884.png,0,0.990072191,39,0,774,732,735,732,fluttershy
2224085.png,https://derpicdn.net/img/view/2019/12/19/2224085.png,0,0.974235952,49,28,307,286,258,258,fluttershy
2228022.png,https://derpicdn.net/img/view/2019/12/23/2228022.png,0,0.979124546,0,0,1377,1461,1377,1461,fluttershy
2234557.jpg,https://derpicdn.net/img/view/2019/12/31/2234557.jpg,0,0.999698579,2328,71,3286,1029,958,958,fluttershy
2237131.png,https://derpicdn.net/img/view/2020/1/3/2237131.png,0,0.937604606,105,0,789,653,684,653,fluttershy
2237131.png,https://derpicdn.net/img/view/2020/1/3/2237131.png,1,0.92664665,0,87,635,809,635,722,fluttershy
2238071.png,https://derpicdn.net/img/view/2020/1/4/2238071.png,0,0.974075675,252,0,1238,825,986,825,fluttershy
2238831.png,https://derpicdn.net/img/view/2020/1/4/2238831.png,0,0.996365666,471,99,839,467,368,368,fluttershy
2239099.png,https://derpicdn.net/img/view/2020/1/5/2239099.png,0,0.941735923,115,64,335,284,220,220,fluttershy
2241442.png,https://derpicdn.net/img/view/2020/1/7/2241442.png,0,0.986314058,255,906,629,1280,374,374,fluttershy
2241442.png,https://derpicdn.net/img/view/2020/1/7/2241442.png,1,0.984856188,729,334,1137,742,408,408,fluttershy
2241791.png,https://derpicdn.net/img/view/2020/1/8/2241791.png,0,0.964298368,493,13,875,395,382,382,fluttershy
2242918.png,https://derpicdn.net/img/view/2020/1/9/2242918.png,0,0.98936373,156,189,1080,1080,924,891,fluttershy
2245747.png,https://derpicdn.net/img/view/2020/1/12/2245747.png,0,0.989510775,446,187,1986,1727,1540,1540,fluttershy
224666.png,https://derpicdn.net/img/view/2013/1/26/224666.png,0,0.951194525,1021,124,1539,642,518,518,fluttershy
2248479.jpg,https://derpicdn.net/img/view/2020/1/15/2248479.jpg,0,0.999595523,210,9,764,563,554,554,fluttershy
2250097.png,https://derpicdn.net/img/view/2020/1/18/2250097.png,0,0.987521589,0,0,726,730,726,730,fluttershy
2250656.jpg,https://derpicdn.net/img/view/2020/1/18/2250656.jpg,0,0.992830873,542,0,1720,1106,1178,1106,fluttershy
2253531.jpg,https://derpicdn.net/img/view/2020/1/21/2253531.jpg,0,0.999202251,329,272,707,650,378,378,fluttershy
2257141.jpg,https://derpicdn.net/img/view/2020/1/26/2257141.jpg,0,0.959635377,33,20,501,488,468,468,fluttershy
2257548.jpg,https://derpicdn.net/img/view/2020/1/26/2257548.jpg,0,0.977829456,125,0,1397,1119,1272,1119,fluttershy
2257907.png,https://derpicdn.net/img/view/2020/1/26/2257907.png,0,0.99958533,157,270,585,698,428,428,fluttershy
2258807.png,https://derpicdn.net/img/view/2020/1/27/2258807.png,0,0.976414979,197,38,635,476,438,438,fluttershy
2259748.png,https://derpicdn.net/img/view/2020/1/28/2259748.png,0,0.972040176,216,0,1312,937,1096,937,fluttershy
2259753.png,https://derpicdn.net/img/view/2020/1/28/2259753.png,0,0.986148655,208,0,1401,938,1193,938,fluttershy
2264576.png,https://derpicdn.net/img/view/2020/2/3/2264576.png,0,0.986833394,359,0,1365,899,1006,899,fluttershy
2266080.png,https://derpicdn.net/img/view/2020/2/5/2266080.png,0,0.992246747,85,0,720,722,635,722,fluttershy
2266089.png,https://derpicdn.net/img/view/2020/2/5/2266089.png,0,0.992532551,5,0,717,697,712,697,fluttershy
2266096.png,https://derpicdn.net/img/view/2020/2/5/2266096.png,0,0.976242244,226,4,883,748,657,744,fluttershy
2272516.png,https://derpicdn.net/img/view/2020/2/12/2272516.png,0,0.978292763,191,9,633,451,442,442,fluttershy
2272826.jpg,https://derpicdn.net/img/view/2020/2/13/2272826.jpg,0,0.99964875,160,0,528,343,368,343,fluttershy
2274683.png,https://derpicdn.net/img/view/2020/2/15/2274683.png,0,0.981957674,725,87,1507,869,782,782,fluttershy
2275031.png,https://derpicdn.net/img/view/2020/2/15/2275031.png,0,0.972210169,153,0,1017,852,864,852,fluttershy
2276265.png,https://derpicdn.net/img/view/2020/2/16/2276265.png,0,0.950473368,478,28,902,452,424,424,fluttershy
2279214.png,https://derpicdn.net/img/view/2020/2/20/2279214.png,0,0.988542795,53,57,759,763,706,706,fluttershy
2279216.png,https://derpicdn.net/img/view/2020/2/20/2279216.png,0,0.995292842,16,0,872,841,856,841,fluttershy
2279217.png,https://derpicdn.net/img/view/2020/2/20/2279217.png,0,0.987557113,48,49,698,699,650,650,fluttershy
2282018.png,https://derpicdn.net/img/view/2020/2/23/2282018.png,0,0.992213905,135,0,853,686,718,686,fluttershy
2282823.png,https://derpicdn.net/img/view/2020/2/24/2282823.png,0,0.964443564,308,25,1376,1093,1068,1068,fluttershy
2284507.png,https://derpicdn.net/img/view/2020/2/27/2284507.png,0,0.977826357,187,0,1269,941,1082,941,fluttershy
2284513.png,https://derpicdn.net/img/view/2020/2/27/2284513.png,0,0.949573219,190,1,1150,939,960,938,fluttershy
2284524.png,https://derpicdn.net/img/view/2020/2/27/2284524.png,0,0.987969518,300,45,879,643,579,598,fluttershy
2292132.jpg,https://derpicdn.net/img/view/2020/3/7/2292132.jpg,0,0.981179416,413,0,1280,899,867,899,fluttershy
2292166.png,https://derpicdn.net/img/view/2020/3/7/2292166.png,0,0.990313649,0,0,1993,1950,1993,1950,fluttershy
2293004.png,https://derpicdn.net/img/view/2020/3/8/2293004.png,0,0.986470282,881,336,1895,1350,1014,1014,fluttershy
2297014.png,https://derpicdn.net/img/view/2020/3/14/2297014.png,0,0.961171687,157,75,1005,923,848,848,fluttershy
2299686.png,https://derpicdn.net/img/view/2020/3/17/2299686.png,0,0.981127262,277,0,1051,751,774,751,fluttershy
2305670.png,https://derpicdn.net/img/view/2020/3/25/2305670.png,0,0.973466039,0,7,523,587,523,580,fluttershy
2310102.png,https://derpicdn.net/img/view/2020/3/30/2310102.png,0,0.996039391,268,0,848,520,580,520,fluttershy
2310482.png,https://derpicdn.net/img/view/2020/3/31/2310482.png,0,0.990032792,696,79,1488,871,792,792,fluttershy
2313823.jpg,https://derpicdn.net/img/view/2020/4/4/2313823.jpg,0,0.96818614,623,317,899,593,276,276,fluttershy
2315348.jpg,https://derpicdn.net/img/view/2020/4/6/2315348.jpg,0,0.997315586,148,0,1250,944,1102,944,fluttershy
2315820.png,https://derpicdn.net/img/view/2020/4/6/2315820.png,0,0.980772436,193,0,1200,800,1007,800,fluttershy
2317136.jpg,https://derpicdn.net/img/view/2020/4/8/2317136.jpg,0,0.950041711,207,11,575,379,368,368,fluttershy
2319007.jpg,https://derpicdn.net/img/view/2020/4/10/2319007.jpg,0,0.968151927,293,52,1353,1112,1060,1060,fluttershy
2320666.png,https://derpicdn.net/img/view/2020/4/12/2320666.png,0,0.998612702,169,10,961,802,792,792,fluttershy
2321687.png,https://derpicdn.net/img/view/2020/4/13/2321687.png,0,0.974907219,136,0,1258,1079,1122,1079,fluttershy
2325951.png,https://derpicdn.net/img/view/2020/4/19/2325951.png,0,0.992889047,61,8,441,388,380,380,fluttershy
2326049.png,https://derpicdn.net/img/view/2020/4/19/2326049.png,0,0.99800086,0,0,527,460,527,460,fluttershy
2327025.png,https://derpicdn.net/img/view/2020/4/20/2327025.png,0,0.976070762,843,227,2243,1627,1400,1400,fluttershy
2327876.png,https://derpicdn.net/img/view/2020/4/21/2327876.png,0,0.959814787,291,85,4179,3327,3888,3242,fluttershy
2329915.png,https://derpicdn.net/img/view/2020/4/23/2329915.png,0,0.997660458,5,0,659,637,654,637,fluttershy
2330023.jpg,https://derpicdn.net/img/view/2020/4/24/2330023.jpg,0,0.977435231,525,0,1023,440,498,440,fluttershy
2331852.png,https://derpicdn.net/img/view/2020/4/26/2331852.png,0,0.960711539,23,0,1367,1331,1344,1331,fluttershy
2334309.jpg,https://derpicdn.net/img/view/2020/4/29/2334309.jpg,0,0.99788177,368,40,996,668,628,628,fluttershy
2338933.png,https://derpicdn.net/img/view/2020/5/4/2338933.png,0,0.980674803,160,18,500,372,340,354,fluttershy
2339499.png,https://derpicdn.net/img/view/2020/5/4/2339499.png,0,0.990650058,145,0,567,406,422,406,fluttershy
2342164.png,https://derpicdn.net/img/view/2020/5/7/2342164.png,0,0.933239639,14,109,642,737,628,628,fluttershy
2342242.jpg,https://derpicdn.net/img/view/2020/5/7/2342242.jpg,0,0.926731646,17,0,379,356,362,356,fluttershy
23441.png,https://derpicdn.net/img/view/2012/6/28/23441.png,0,0.975640893,0,36,425,467,425,431,fluttershy
2345832.png,https://derpicdn.net/img/view/2020/5/11/2345832.png,0,0.981314242,62,27,370,335,308,308,fluttershy
2349706.png,https://derpicdn.net/img/view/2020/5/15/2349706.png,0,0.995414376,525,153,813,441,288,288,fluttershy
2351380.png,https://derpicdn.net/img/view/2020/5/17/2351380.png,1,0.938765585,665,0,1419,688,754,688,fluttershy
2354547.jpg,https://derpicdn.net/img/view/2020/5/21/2354547.jpg,0,0.971199811,84,0,860,741,776,741,fluttershy
2354817.jpg,https://derpicdn.net/img/view/2020/5/22/2354817.jpg,0,0.995145082,279,0,565,268,286,268,fluttershy
2354956.jpg,https://derpicdn.net/img/view/2020/5/22/2354956.jpg,0,0.990380943,111,49,443,381,332,332,fluttershy
2355734.png,https://derpicdn.net/img/view/2020/5/23/2355734.png,0,0.961712122,0,0,960,1011,960,1011,fluttershy
2381.png,https://derpicdn.net/img/view/2012/1/25/2381.png,0,0.994474769,90,0,412,313,322,313,fluttershy
2381.png,https://derpicdn.net/img/view/2012/1/25/2381.png,1,0.990534604,326,0,628,298,302,298,fluttershy
241324.png,https://derpicdn.net/img/view/2013/2/12/241324.png,0,0.946042359,580,0,2974,2149,2394,2149,fluttershy
246542.png,https://derpicdn.net/img/view/2013/2/17/246542.png,0,0.993206739,0,86,816,1000,816,914,fluttershy
247558.png,https://derpicdn.net/img/view/2013/2/18/247558.png,0,0.996258497,526,0,872,335,346,335,fluttershy
249823.jpg,https://derpicdn.net/img/view/2013/2/20/249823.jpg,0,0.96059835,77,0,421,339,344,339,fluttershy
249824.jpg,https://derpicdn.net/img/view/2013/2/20/249824.jpg,0,0.990343511,202,180,660,638,458,458,fluttershy
250016.png,https://derpicdn.net/img/view/2013/2/20/250016.png,0,0.933858275,324,111,670,457,346,346,fluttershy
260102.png,https://derpicdn.net/img/view/2013/3/2/260102.png,0,0.993601978,0,113,744,931,744,818,fluttershy
2631.png,https://derpicdn.net/img/view/2012/1/29/2631.png,0,0.987894058,43,13,443,413,400,400,fluttershy
272948.png,https://derpicdn.net/img/view/2013/3/17/272948.png,0,0.985049069,64,0,602,531,538,531,fluttershy
276798.png,https://derpicdn.net/img/view/2013/3/22/276798.png,0,0.988135159,207,0,1727,1472,1520,1472,fluttershy
278266.png,https://derpicdn.net/img/view/2013/3/24/278266.png,0,0.944839239,19,0,345,318,326,318,fluttershy
278884.png,https://derpicdn.net/img/view/2013/3/25/278884.png,0,0.992353022,124,0,552,420,428,420,fluttershy
283695.png,https://derpicdn.net/img/view/2013/3/30/283695.png,0,0.909530163,576,115,1066,605,490,490,fluttershy
288999.png,https://derpicdn.net/img/view/2013/4/5/288999.png,0,0.964403093,55,0,375,317,320,317,fluttershy
300696.png,https://derpicdn.net/img/view/2013/4/17/300696.png,0,0.997485459,130,31,498,399,368,368,fluttershy
3241.png,https://derpicdn.net/img/view/2012/2/17/3241.png,0,0.987255514,30,0,496,431,466,431,fluttershy
324287.jpg,https://derpicdn.net/img/view/2013/5/13/324287.jpg,0,0.993543565,16,0,442,385,426,385,fluttershy
3310.png,https://derpicdn.net/img/view/2012/2/20/3310.png,0,0.986352146,0,175,2610,2811,2610,2636,fluttershy
335216.png,https://derpicdn.net/img/view/2013/5/28/335216.png,0,0.991204321,365,134,765,534,400,400,fluttershy
337782.jpg,https://derpicdn.net/img/view/2013/5/31/337782.jpg,0,0.993368447,49,0,817,734,768,734,fluttershy
34205.jpg,https://derpicdn.net/img/view/2012/7/6/34205.jpg,1,0.907735825,316,584,530,798,214,214,fluttershy
353769.png,https://derpicdn.net/img/view/2013/6/21/353769.png,0,0.996080518,903,129,1929,1155,1026,1026,fluttershy
355312.jpg,https://derpicdn.net/img/view/2013/6/23/355312.jpg,0,0.997733176,515,0,2149,1515,1634,1515,fluttershy
360390.png,https://derpicdn.net/img/view/2013/6/30/360390.png,0,0.998756528,488,0,3200,2684,2712,2684,fluttershy
374209.png,https://derpicdn.net/img/view/2013/7/14/374209.png,0,0.998680174,120,0,406,279,286,279,fluttershy
374209.png,https://derpicdn.net/img/view/2013/7/14/374209.png,1,0.991804719,551,0,863,286,312,286,fluttershy
376354.png,https://derpicdn.net/img/view/2013/7/17/376354.png,0,0.978874266,2674,203,4700,2229,2026,2026,fluttershy
383906.png,https://derpicdn.net/img/view/2013/7/29/383906.png,0,0.994197726,265,47,563,345,298,298,fluttershy
390159.png,https://derpicdn.net/img/view/2013/8/3/390159.png,0,0.979031026,10,0,730,539,720,539,fluttershy
395700.png,https://derpicdn.net/img/view/2013/8/9/395700.png,0,0.93928355,3686,1075,6586,3975,2900,2900,fluttershy
426042.png,https://derpicdn.net/img/view/2013/9/12/426042.png,0,0.995407462,357,0,769,397,412,397,fluttershy
434517.png,https://derpicdn.net/img/view/2013/9/25/434517.png,0,0.964286208,465,9,897,441,432,432,fluttershy
435448.png,https://derpicdn.net/img/view/2013/9/26/435448.png,0,0.927670479,14,8,468,462,454,454,fluttershy
4432.png,https://derpicdn.net/img/view/2012/6/6/4432.png,0,0.951519132,408,190,946,728,538,538,fluttershy
451973.png,https://derpicdn.net/img/view/2013/10/19/451973.png,0,0.976748109,342,87,702,447,360,360,fluttershy
452922.png,https://derpicdn.net/img/view/2013/10/20/452922.png,0,0.99564451,154,45,404,295,250,250,fluttershy
473633.png,https://derpicdn.net/img/view/2013/11/16/473633.png,0,0.992819548,155,0,669,492,514,492,fluttershy
489491.png,https://derpicdn.net/img/view/2013/12/4/489491.png,0,0.999661803,78,0,456,355,378,355,fluttershy
489637.png,https://derpicdn.net/img/view/2013/12/4/489637.png,0,0.997381985,18,2,394,378,376,376,fluttershy
490731.jpg,https://derpicdn.net/img/view/2013/12/6/490731.jpg,0,0.998085737,126,426,924,1224,798,798,fluttershy
496046.jpg,https://derpicdn.net/img/view/2013/12/13/496046.jpg,0,0.978796542,165,15,489,339,324,324,fluttershy
498801.jpg,https://derpicdn.net/img/view/2013/12/16/498801.jpg,0,0.961728096,615,993,1487,1865,872,872,fluttershy
504363.jpg,https://derpicdn.net/img/view/2013/12/23/504363.jpg,0,0.972128093,1065,162,2699,1796,1634,1634,fluttershy
508323.jpg,https://derpicdn.net/img/view/2013/12/28/508323.jpg,0,0.999552667,257,354,939,1036,682,682,fluttershy
508613.png,https://derpicdn.net/img/view/2013/12/28/508613.png,0,0.993263245,0,1,751,761,751,760,fluttershy
508817.png,https://derpicdn.net/img/view/2013/12/29/508817.png,0,0.909676731,1493,971,2645,2123,1152,1152,fluttershy
509516.png,https://derpicdn.net/img/view/2013/12/29/509516.png,0,0.998455405,990,188,1518,716,528,528,fluttershy
511613.png,https://derpicdn.net/img/view/2014/1/1/511613.png,0,0.992183208,509,0,1803,1261,1294,1261,fluttershy
512348.jpg,https://derpicdn.net/img/view/2014/1/2/512348.jpg,0,0.999067903,619,51,1271,703,652,652,fluttershy
513077.png,https://derpicdn.net/img/view/2014/1/2/513077.png,0,0.951660097,341,0,1551,1175,1210,1175,fluttershy
515709.png,https://derpicdn.net/img/view/2014/1/5/515709.png,0,0.900516689,0,148,973,1162,973,1014,fluttershy
527585.png,https://derpicdn.net/img/view/2014/1/18/527585.png,0,0.997601688,511,41,1397,927,886,886,fluttershy
537099.png,https://derpicdn.net/img/view/2014/1/28/537099.png,0,0.998826802,85,1,563,479,478,478,fluttershy
537421.png,https://derpicdn.net/img/view/2014/1/29/537421.png,0,0.983216524,210,0,840,625,630,625,fluttershy
54225.jpg,https://derpicdn.net/img/view/2012/7/24/54225.jpg,0,0.973074138,32,0,744,708,712,708,fluttershy
544563.png,https://derpicdn.net/img/view/2014/2/6/544563.png,0,0.956915677,168,109,720,711,552,602,fluttershy
545883.png,https://derpicdn.net/img/view/2014/2/7/545883.png,0,0.989967942,18,0,552,520,534,520,fluttershy
549535.jpg,https://derpicdn.net/img/view/2014/2/11/549535.jpg,0,0.981509089,732,17,1158,443,426,426,fluttershy
575609.jpg,https://derpicdn.net/img/view/2014/3/15/575609.jpg,0,0.991160572,139,100,559,520,420,420,fluttershy
580392.jpg,https://derpicdn.net/img/view/2014/3/20/580392.jpg,0,0.955346704,111,33,1200,1137,1089,1104,fluttershy
586797.png,https://derpicdn.net/img/view/2014/3/28/586797.png,0,0.995006084,434,0,1102,597,668,597,fluttershy
591610.jpg,https://derpicdn.net/img/view/2014/4/3/591610.jpg,0,0.999390721,369,135,1583,1349,1214,1214,fluttershy
593212.png,https://derpicdn.net/img/view/2014/4/5/593212.png,0,0.998992324,30,0,496,426,466,426,fluttershy
594489.png,https://derpicdn.net/img/view/2014/4/6/594489.png,0,0.917979836,41,0,625,514,584,514,fluttershy
595915.png,https://derpicdn.net/img/view/2014/4/8/595915.png,0,0.944124222,546,24,836,314,290,290,fluttershy
604070.jpg,https://derpicdn.net/img/view/2014/4/18/604070.jpg,0,0.918061435,901,983,1280,1280,379,297,fluttershy
604282.png,https://derpicdn.net/img/view/2014/4/19/604282.png,0,0.989908218,1012,91,1466,545,454,454,fluttershy
619215.png,https://derpicdn.net/img/view/2014/5/6/619215.png,0,0.942877293,1745,616,2501,1372,756,756,fluttershy
620075.png,https://derpicdn.net/img/view/2014/5/7/620075.png,0,0.998768151,312,15,742,445,430,430,fluttershy
6393.png,https://derpicdn.net/img/view/2012/6/18/6393.png,0,0.9963153,8,0,294,283,286,283,fluttershy
640232.png,https://derpicdn.net/img/view/2014/5/29/640232.png,0,0.994494796,69,14,381,326,312,312,fluttershy
645396.png,https://derpicdn.net/img/view/2014/6/5/645396.png,0,0.962085903,315,0,799,477,484,477,fluttershy
6553.png,https://derpicdn.net/img/view/2012/6/18/6553.png,0,0.993997693,224,48,548,372,324,324,fluttershy
670330.jpg,https://derpicdn.net/img/view/2014/7/8/670330.jpg,1,0.987508476,1003,1103,1581,1681,578,578,fluttershy
672495.png,https://derpicdn.net/img/view/2014/7/11/672495.png,0,0.973557949,151,54,543,446,392,392,fluttershy
676202.jpg,https://derpicdn.net/img/view/2014/7/16/676202.jpg,0,0.937637091,114,317,1618,1821,1504,1504,fluttershy
676842.png,https://derpicdn.net/img/view/2014/7/17/676842.png,0,0.926238298,599,170,1131,702,532,532,fluttershy
682981.png,https://derpicdn.net/img/view/2014/7/25/682981.png,0,0.993214786,3,0,451,390,448,390,fluttershy
690073.png,https://derpicdn.net/img/view/2014/8/3/690073.png,0,0.968080878,90,39,410,359,320,320,fluttershy
692708.png,https://derpicdn.net/img/view/2014/8/6/692708.png,0,0.986545742,583,73,1885,1375,1302,1302,fluttershy
695570.png,https://derpicdn.net/img/view/2014/8/9/695570.png,0,0.982616961,288,0,866,555,578,555,fluttershy
700944.png,https://derpicdn.net/img/view/2014/8/16/700944.png,0,0.997906923,630,0,1706,901,1076,901,fluttershy
710461.png,https://derpicdn.net/img/view/2014/8/29/710461.png,0,0.981757224,7,0,703,564,696,564,fluttershy
712963.png,https://derpicdn.net/img/view/2014/9/1/712963.png,0,0.928609431,397,75,745,423,348,348,fluttershy
723806.jpg,https://derpicdn.net/img/view/2014/9/17/723806.jpg,0,0.988209724,24,0,502,457,478,457,fluttershy
730006.png,https://derpicdn.net/img/view/2014/9/26/730006.png,0,0.997711778,143,39,579,475,436,436,fluttershy
731406.png,https://derpicdn.net/img/view/2014/9/28/731406.png,0,0.994220853,0,0,647,554,647,554,fluttershy
734425.jpg,https://derpicdn.net/img/view/2014/10/3/734425.jpg,0,0.957850158,1161,295,1427,561,266,266,fluttershy
735666.png,https://derpicdn.net/img/view/2014/10/4/735666.png,0,0.997882426,145,0,711,544,566,544,fluttershy
736007.png,https://derpicdn.net/img/view/2014/10/5/736007.png,0,0.971304536,223,138,497,412,274,274,fluttershy
743907.png,https://derpicdn.net/img/view/2014/10/16/743907.png,0,0.943707228,393,78,1099,784,706,706,fluttershy
747898.png,https://derpicdn.net/img/view/2014/10/22/747898.png,0,0.958525598,388,264,720,672,332,408,fluttershy
752109.jpg,https://derpicdn.net/img/view/2014/10/28/752109.jpg,0,0.998335123,168,37,588,457,420,420,fluttershy
7524.jpg,https://derpicdn.net/img/view/2012/6/18/7524.jpg,0,0.982115567,0,0,779,766,779,766,fluttershy
7550.png,https://derpicdn.net/img/view/2012/6/18/7550.png,0,0.916908205,205,50,631,476,426,426,fluttershy
763155.png,https://derpicdn.net/img/view/2014/11/12/763155.png,0,0.988113523,50,0,534,470,484,470,fluttershy
766342.png,https://derpicdn.net/img/view/2014/11/17/766342.png,0,0.985263526,403,158,1275,1030,872,872,fluttershy
766343.png,https://derpicdn.net/img/view/2014/11/17/766343.png,0,0.997896433,223,50,769,596,546,546,fluttershy
768422.png,https://derpicdn.net/img/view/2014/11/20/768422.png,0,0.999874353,860,184,1336,660,476,476,fluttershy
768423.png,https://derpicdn.net/img/view/2014/11/20/768423.png,0,0.99988997,860,186,1334,660,474,474,fluttershy
768423.png,https://derpicdn.net/img/view/2014/11/20/768423.png,1,0.980332494,792,766,1288,1262,496,496,fluttershy
770375.jpg,https://derpicdn.net/img/view/2014/11/23/770375.jpg,0,0.941906571,205,80,617,492,412,412,fluttershy
771567.png,https://derpicdn.net/img/view/2014/11/25/771567.png,0,0.998725533,112,25,558,471,446,446,fluttershy
776002.png,https://derpicdn.net/img/view/2014/12/1/776002.png,0,0.949188054,444,112,1226,894,782,782,fluttershy
786725.png,https://derpicdn.net/img/view/2014/12/17/786725.png,0,0.999361515,0,0,340,338,340,338,fluttershy
787354.jpg,https://derpicdn.net/img/view/2014/12/18/787354.jpg,0,0.963625014,81,104,800,892,719,788,fluttershy
792099.png,https://derpicdn.net/img/view/2014/12/24/792099.png,0,0.989836633,788,207,1338,757,550,550,fluttershy
795025.jpg,https://derpicdn.net/img/view/2014/12/29/795025.jpg,0,0.976000607,117,0,811,649,694,649,fluttershy
799876.png,https://derpicdn.net/img/view/2015/1/5/799876.png,0,0.946500421,373,181,931,739,558,558,fluttershy
801755.jpg,https://derpicdn.net/img/view/2015/1/8/801755.jpg,0,0.98680383,239,326,641,728,402,402,fluttershy
823695.png,https://derpicdn.net/img/view/2015/2/7/823695.png,0,0.991899014,765,0,1887,1107,1122,1107,fluttershy
828461.png,https://derpicdn.net/img/view/2015/2/14/828461.png,0,0.969209492,252,50,462,260,210,210,fluttershy
832548.png,https://derpicdn.net/img/view/2015/2/19/832548.png,0,0.996263504,185,0,673,470,488,470,fluttershy
835118.jpg,https://derpicdn.net/img/view/2015/2/22/835118.jpg,0,0.994247377,171,0,957,746,786,746,fluttershy
8385.jpg,https://derpicdn.net/img/view/2012/6/18/8385.jpg,0,0.972270966,55,91,303,339,248,248,fluttershy
8385.jpg,https://derpicdn.net/img/view/2012/6/18/8385.jpg,1,0.960566163,286,0,532,244,246,244,fluttershy
840249.png,https://derpicdn.net/img/view/2015/3/1/840249.png,0,0.95781219,314,114,732,532,418,418,fluttershy
843296.png,https://derpicdn.net/img/view/2015/3/6/843296.png,0,0.976077855,293,61,595,363,302,302,fluttershy
844888.png,https://derpicdn.net/img/view/2015/3/8/844888.png,0,0.996392906,320,0,802,474,482,474,fluttershy
845385.png,https://derpicdn.net/img/view/2015/3/8/845385.png,0,0.907819033,145,234,1341,1430,1196,1196,fluttershy
848406.png,https://derpicdn.net/img/view/2015/3/13/848406.png,0,0.91535598,22,0,382,339,360,339,fluttershy
848997.png,https://derpicdn.net/img/view/2015/3/14/848997.png,0,0.997534275,376,57,886,567,510,510,fluttershy
856034.png,https://derpicdn.net/img/view/2015/3/24/856034.png,0,0.98699975,2966,0,4058,1043,1092,1043,fluttershy
856241.png,https://derpicdn.net/img/view/2015/3/24/856241.png,0,0.98819536,3796,2140,5694,4094,1898,1954,fluttershy
858133.jpg,https://derpicdn.net/img/view/2015/3/27/858133.jpg,0,0.994501352,160,0,366,203,206,203,fluttershy
86455.jpg,https://derpicdn.net/img/view/2012/8/30/86455.jpg,0,0.993141055,377,326,789,738,412,412,fluttershy
877037.png,https://derpicdn.net/img/view/2015/4/18/877037.png,0,0.908438265,177,76,561,460,384,384,fluttershy
878319.jpg,https://derpicdn.net/img/view/2015/4/19/878319.jpg,0,0.948925734,57,0,555,476,498,476,fluttershy
878326.png,https://derpicdn.net/img/view/2015/4/19/878326.png,0,0.998005986,302,0,798,493,496,493,fluttershy
883878.png,https://derpicdn.net/img/view/2015/4/27/883878.png,0,0.978925347,293,0,767,414,474,414,fluttershy
884971.png,https://derpicdn.net/img/view/2015/4/28/884971.png,0,0.909774303,61,0,411,348,350,348,fluttershy
893925.png,https://derpicdn.net/img/view/2015/5/11/893925.png,0,0.998223007,335,0,923,575,588,575,fluttershy
895754.png,https://derpicdn.net/img/view/2015/5/14/895754.png,0,0.992365956,835,558,1569,1292,734,734,fluttershy
8980.png,https://derpicdn.net/img/view/2012/6/19/8980.png,0,0.9859249,263,0,5565,4638,5302,4638,fluttershy
901216.png,https://derpicdn.net/img/view/2015/5/21/901216.png,0,0.927823424,554,63,992,501,438,438,fluttershy
915588.png,https://derpicdn.net/img/view/2015/6/13/915588.png,0,0.921737254,331,24,717,410,386,386,fluttershy
922860.png,https://derpicdn.net/img/view/2015/6/24/922860.png,0,0.997147858,369,0,651,278,282,278,fluttershy
924611.png,https://derpicdn.net/img/view/2015/6/27/924611.png,0,0.950477481,74,0,1162,1031,1088,1031,fluttershy
927399.png,https://derpicdn.net/img/view/2015/7/1/927399.png,0,0.958884656,259,211,1961,1913,1702,1702,fluttershy
932532.png,https://derpicdn.net/img/view/2015/7/8/932532.png,0,0.994452238,34,0,316,251,282,251,fluttershy
934975.png,https://derpicdn.net/img/view/2015/7/11/934975.png,0,0.950907946,66,0,400,294,334,294,fluttershy
964819.png,https://derpicdn.net/img/view/2015/8/24/964819.png,0,0.985976934,928,0,2942,1715,2014,1715,fluttershy
976247.png,https://derpicdn.net/img/view/2015/9/9/976247.png,0,0.997881949,107,0,741,600,634,600,fluttershy
981380.png,https://derpicdn.net/img/view/2015/9/17/981380.png,0,0.999061882,431,0,729,296,298,296,fluttershy
989448.jpg,https://derpicdn.net/img/view/2015/9/27/989448.jpg,0,0.97319001,752,0,2366,1562,1614,1562,fluttershy
1000183.jpeg,https://derpicdn.net/img/view/2015/10/12/1000183.jpeg,0,0.924127817,28,0,916,804,888,804,fluttershy
1000546.jpeg,https://derpicdn.net/img/view/2015/10/12/1000546.jpeg,0,0.935850203,99,0,583,470,484,470,fluttershy
1006330.jpeg,https://derpicdn.net/img/view/2015/10/20/1006330.jpeg,0,0.992084444,93,0,503,394,410,394,fluttershy
1007099.jpeg,https://derpicdn.net/img/view/2015/10/21/1007099.jpeg,0,0.99611026,250,18,802,570,552,552,fluttershy
1007732.jpeg,https://derpicdn.net/img/view/2015/10/22/1007732.jpeg,0,0.973624706,163,101,663,601,500,500,fluttershy
1008278.jpeg,https://derpicdn.net/img/view/2015/10/23/1008278.jpeg,0,0.995411754,343,0,2435,2060,2092,2060,fluttershy
1010810.jpeg,https://derpicdn.net/img/view/2015/10/28/1010810.jpeg,0,0.928985655,419,0,969,532,550,532,fluttershy
1014100.jpeg,https://derpicdn.net/img/view/2015/11/1/1014100.jpeg,0,0.998772442,77,4,609,536,532,532,fluttershy
1014877.jpeg,https://derpicdn.net/img/view/2015/11/2/1014877.jpeg,0,0.900903761,243,104,577,438,334,334,fluttershy
1017964.jpeg,https://derpicdn.net/img/view/2015/11/7/1017964.jpeg,0,0.986739576,163,219,355,411,192,192,fluttershy
1018916.jpeg,https://derpicdn.net/img/view/2015/11/8/1018916.jpeg,0,0.990196168,93,0,951,720,858,720,fluttershy
1019198.jpeg,https://derpicdn.net/img/view/2015/11/8/1019198.jpeg,0,0.948340297,81,51,1053,1023,972,972,fluttershy
1021327.jpeg,https://derpicdn.net/img/view/2015/11/12/1021327.jpeg,0,0.988991916,96,0,612,451,516,451,fluttershy
1021939.jpeg,https://derpicdn.net/img/view/2015/11/13/1021939.jpeg,0,0.926388562,518,228,768,478,250,250,fluttershy
1022106.jpeg,https://derpicdn.net/img/view/2015/11/13/1022106.jpeg,0,0.907636106,182,0,1738,1439,1556,1439,fluttershy
1022763.jpeg,https://derpicdn.net/img/view/2015/11/14/1022763.jpeg,0,0.942129254,731,177,3203,2649,2472,2472,fluttershy
1023639.jpeg,https://derpicdn.net/img/view/2015/11/15/1023639.jpeg,0,0.936965704,316,0,1342,1013,1026,1013,fluttershy
1025954.jpeg,https://derpicdn.net/img/view/2015/11/19/1025954.jpeg,0,0.901915193,0,165,963,1193,963,1028,fluttershy
1027750.jpeg,https://derpicdn.net/img/view/2015/11/22/1027750.jpeg,0,0.980817735,269,0,1967,1660,1698,1660,fluttershy
1031221.jpeg,https://derpicdn.net/img/view/2015/11/27/1031221.jpeg,0,0.991543174,353,39,869,555,516,516,fluttershy
1036357.jpeg,https://derpicdn.net/img/view/2015/12/4/1036357.jpeg,0,0.970578194,570,0,870,276,300,276,fluttershy
1043537.jpeg,https://derpicdn.net/img/view/2015/12/13/1043537.jpeg,0,0.989264071,1077,94,1519,536,442,442,fluttershy
1044044.jpeg,https://derpicdn.net/img/view/2015/12/14/1044044.jpeg,0,0.976969481,141,0,1485,1239,1344,1239,fluttershy
1045067.jpeg,https://derpicdn.net/img/view/2015/12/15/1045067.jpeg,0,0.980317652,368,64,738,434,370,370,fluttershy
1046358.jpeg,https://derpicdn.net/img/view/2015/12/17/1046358.jpeg,0,0.975478292,939,156,1915,1132,976,976,fluttershy
1047392.jpeg,https://derpicdn.net/img/view/2015/12/19/1047392.jpeg,0,0.996398509,249,6,543,300,294,294,fluttershy
1048804.jpeg,https://derpicdn.net/img/view/2015/12/20/1048804.jpeg,0,0.971219122,282,0,844,527,562,527,fluttershy
1053760.jpeg,https://derpicdn.net/img/view/2015/12/27/1053760.jpeg,0,0.907008767,49,93,899,943,850,850,fluttershy
1054271.jpeg,https://derpicdn.net/img/view/2015/12/28/1054271.jpeg,0,0.944173753,0,0,490,486,490,486,fluttershy
1061041.jpeg,https://derpicdn.net/img/view/2016/1/6/1061041.jpeg,0,0.991166711,100,0,672,563,572,563,fluttershy
1063622.jpeg,https://derpicdn.net/img/view/2016/1/10/1063622.jpeg,0,0.973010957,66,10,500,476,434,466,fluttershy
1065893.jpeg,https://derpicdn.net/img/view/2016/1/13/1065893.jpeg,0,0.985635161,234,0,2382,1955,2148,1955,fluttershy
1068153.jpeg,https://derpicdn.net/img/view/2016/1/17/1068153.jpeg,0,0.985294223,9,45,741,777,732,732,fluttershy
1072110.jpeg,https://derpicdn.net/img/view/2016/1/23/1072110.jpeg,0,0.995467663,215,40,605,430,390,390,fluttershy
1073328.jpeg,https://derpicdn.net/img/view/2016/1/25/1073328.jpeg,0,0.999733984,64,0,410,332,346,332,fluttershy
1075758.jpeg,https://derpicdn.net/img/view/2016/1/29/1075758.jpeg,0,0.913502991,238,6,747,516,509,510,fluttershy
1078056.jpeg,https://derpicdn.net/img/view/2016/2/1/1078056.jpeg,0,0.965238929,275,0,1049,714,774,714,fluttershy
1082746.jpeg,https://derpicdn.net/img/view/2016/2/7/1082746.jpeg,0,0.998665631,1768,67,4152,2451,2384,2384,fluttershy
1088375.jpeg,https://derpicdn.net/img/view/2016/2/15/1088375.jpeg,0,0.924643815,381,14,827,460,446,446,fluttershy
1094263.jpeg,https://derpicdn.net/img/view/2016/2/22/1094263.jpeg,0,0.993575394,294,22,982,710,688,688,fluttershy
1094446.jpeg,https://derpicdn.net/img/view/2016/2/22/1094446.jpeg,0,0.992540956,512,0,1504,989,992,989,fluttershy
1107854.jpeg,https://derpicdn.net/img/view/2016/3/13/1107854.jpeg,0,0.9826473,44,0,340,258,296,258,fluttershy
1107854.jpeg,https://derpicdn.net/img/view/2016/3/13/1107854.jpeg,1,0.922474504,680,171,896,387,216,216,fluttershy
1108939.jpeg,https://derpicdn.net/img/view/2016/3/14/1108939.jpeg,0,0.987817883,182,75,1184,1077,1002,1002,fluttershy
1111479.jpeg,https://derpicdn.net/img/view/2016/3/18/1111479.jpeg,0,0.994595647,495,0,1417,776,922,776,fluttershy
1113021.jpeg,https://derpicdn.net/img/view/2016/3/20/1113021.jpeg,0,0.981635332,824,709,1024,911,200,202,fluttershy
1115934.jpeg,https://derpicdn.net/img/view/2016/3/24/1115934.jpeg,0,0.998182714,15,0,393,356,378,356,fluttershy
1118511.jpeg,https://derpicdn.net/img/view/2016/3/27/1118511.jpeg,0,0.955996454,136,3,796,663,660,660,fluttershy
1125922.jpeg,https://derpicdn.net/img/view/2016/4/6/1125922.jpeg,0,0.964769542,203,0,1358,1218,1155,1218,fluttershy
1127316.jpeg,https://derpicdn.net/img/view/2016/4/8/1127316.jpeg,0,0.990702391,81,0,500,406,419,406,fluttershy
1127316.jpeg,https://derpicdn.net/img/view/2016/4/8/1127316.jpeg,1,0.925656915,0,40,420,472,420,432,fluttershy
1129006.jpeg,https://derpicdn.net/img/view/2016/4/10/1129006.jpeg,0,0.91055572,120,55,474,409,354,354,fluttershy
1129213.jpeg,https://derpicdn.net/img/view/2016/4/10/1129213.jpeg,0,0.901299894,0,18,400,474,400,456,fluttershy
1138300.jpeg,https://derpicdn.net/img/view/2016/4/23/1138300.jpeg,0,0.995672345,381,47,925,591,544,544,fluttershy
1138367.jpeg,https://derpicdn.net/img/view/2016/4/23/1138367.jpeg,0,0.94521606,235,45,829,639,594,594,fluttershy
1140137.jpeg,https://derpicdn.net/img/view/2016/4/26/1140137.jpeg,0,0.985886931,342,0,1008,666,666,666,fluttershy
1145499.jpeg,https://derpicdn.net/img/view/2016/5/3/1145499.jpeg,0,0.996442318,1184,235,1702,753,518,518,fluttershy
1147657.jpeg,https://derpicdn.net/img/view/2016/5/6/1147657.jpeg,0,0.957944751,56,0,1166,1037,1110,1037,fluttershy
1155458.jpeg,https://derpicdn.net/img/view/2016/5/16/1155458.jpeg,0,0.994847775,126,0,934,746,808,746,fluttershy
1162795.jpeg,https://derpicdn.net/img/view/2016/5/25/1162795.jpeg,0,0.996997595,739,0,1687,823,948,823,fluttershy
1168455.jpeg,https://derpicdn.net/img/view/2016/6/2/1168455.jpeg,0,0.983116031,228,0,758,493,530,493,fluttershy
1170144.jpeg,https://derpicdn.net/img/view/2016/6/4/1170144.jpeg,0,0.988740027,17,0,753,823,736,823,fluttershy
1170548.jpeg,https://derpicdn.net/img/view/2016/6/5/1170548.jpeg,0,0.997015774,149,1722,1601,3174,1452,1452,fluttershy
1171384.jpeg,https://derpicdn.net/img/view/2016/6/6/1171384.jpeg,0,0.993419468,826,420,1068,662,242,242,fluttershy
1171384.jpeg,https://derpicdn.net/img/view/2016/6/6/1171384.jpeg,1,0.956237912,1216,373,1590,747,374,374,fluttershy
1171384.jpeg,https://derpicdn.net/img/view/2016/6/6/1171384.jpeg,2,0.956177413,412,292,908,787,496,495,fluttershy
1173866.jpeg,https://derpicdn.net/img/view/2016/6/8/1173866.jpeg,0,0.990777969,81,0,437,352,356,352,fluttershy
1173866.jpeg,https://derpicdn.net/img/view/2016/6/8/1173866.jpeg,1,0.975385725,360,14,672,326,312,312,fluttershy
1174278.jpeg,https://derpicdn.net/img/view/2016/6/9/1174278.jpeg,0,0.993565738,701,243,1739,1281,1038,1038,fluttershy
1174278.jpeg,https://derpicdn.net/img/view/2016/6/9/1174278.jpeg,1,0.990980864,1128,0,2230,1099,1102,1099,fluttershy
1176241.jpeg,https://derpicdn.net/img/view/2016/6/11/1176241.jpeg,0,0.939863265,212,119,856,763,644,644,fluttershy
1178641.jpeg,https://derpicdn.net/img/view/2016/6/15/1178641.jpeg,0,0.99316442,741,22,1485,766,744,744,fluttershy
1183792.jpeg,https://derpicdn.net/img/view/2016/6/21/1183792.jpeg,0,0.998362899,818,134,1582,898,764,764,fluttershy
1192598.jpeg,https://derpicdn.net/img/view/2016/7/3/1192598.jpeg,0,0.931560338,417,124,597,304,180,180,fluttershy
1198648.jpeg,https://derpicdn.net/img/view/2016/7/11/1198648.jpeg,0,0.939134479,1757,262,3139,1644,1382,1382,fluttershy
1207490.jpeg,https://derpicdn.net/img/view/2016/7/23/1207490.jpeg,0,0.995165884,87,0,583,479,496,479,fluttershy
1209628.jpeg,https://derpicdn.net/img/view/2016/7/26/1209628.jpeg,0,0.998222411,470,186,722,438,252,252,fluttershy
1210510.jpeg,https://derpicdn.net/img/view/2016/7/27/1210510.jpeg,0,0.987617433,0,0,777,693,777,693,fluttershy
1212465.jpeg,https://derpicdn.net/img/view/2016/7/30/1212465.jpeg,0,0.955276966,460,0,984,489,524,489,fluttershy
1213005.jpeg,https://derpicdn.net/img/view/2016/7/31/1213005.jpeg,0,0.996031106,0,0,3080,3067,3080,3067,fluttershy
1213692.jpeg,https://derpicdn.net/img/view/2016/7/31/1213692.jpeg,0,0.990348756,225,18,489,282,264,264,fluttershy
1213958.jpeg,https://derpicdn.net/img/view/2016/7/31/1213958.jpeg,0,0.993485034,655,10,1407,762,752,752,fluttershy
1214094.jpeg,https://derpicdn.net/img/view/2016/8/1/1214094.jpeg,0,0.990750134,0,0,1580,1565,1580,1565,fluttershy
1218672.jpeg,https://derpicdn.net/img/view/2016/8/6/1218672.jpeg,0,0.977740049,1025,251,1389,615,364,364,fluttershy
1220640.jpeg,https://derpicdn.net/img/view/2016/8/9/1220640.jpeg,0,0.982171535,35,0,621,501,586,501,fluttershy
1221253.jpeg,https://derpicdn.net/img/view/2016/8/9/1221253.jpeg,0,0.984192014,0,0,640,843,640,843,fluttershy
1223263.jpeg,https://derpicdn.net/img/view/2016/8/12/1223263.jpeg,0,0.998426676,216,41,550,375,334,334,fluttershy
1224116.jpeg,https://derpicdn.net/img/view/2016/8/13/1224116.jpeg,0,0.907915533,0,10,367,404,367,394,fluttershy
1224940.jpeg,https://derpicdn.net/img/view/2016/8/14/1224940.jpeg,0,0.966545939,0,153,1272,1455,1272,1302,fluttershy
1226351.jpeg,https://derpicdn.net/img/view/2016/8/16/1226351.jpeg,0,0.996914744,22,52,536,566,514,514,fluttershy
1226767.jpeg,https://derpicdn.net/img/view/2016/8/16/1226767.jpeg,0,0.995369673,47,0,1203,1021,1156,1021,fluttershy
1237743.jpeg,https://derpicdn.net/img/view/2016/8/30/1237743.jpeg,0,0.975251853,84,12,272,200,188,188,fluttershy
1241158.jpeg,https://derpicdn.net/img/view/2016/9/3/1241158.jpeg,0,0.906374514,189,187,767,759,578,572,fluttershy
1242648.jpeg,https://derpicdn.net/img/view/2016/9/5/1242648.jpeg,0,0.983080506,981,532,3293,2844,2312,2312,fluttershy
1244505.jpeg,https://derpicdn.net/img/view/2016/9/8/1244505.jpeg,0,0.957874835,868,1412,1832,2376,964,964,fluttershy
1246739.jpeg,https://derpicdn.net/img/view/2016/9/11/1246739.jpeg,0,0.992205203,120,7,432,319,312,312,fluttershy
1250071.jpeg,https://derpicdn.net/img/view/2016/9/15/1250071.jpeg,0,0.99119103,138,0,1417,1259,1279,1259,fluttershy
1251000.jpeg,https://derpicdn.net/img/view/2016/9/17/1251000.jpeg,0,0.992981672,205,0,601,370,396,370,fluttershy
1251268.jpeg,https://derpicdn.net/img/view/2016/9/17/1251268.jpeg,0,0.922836006,21,36,872,920,851,884,fluttershy
1251289.jpeg,https://derpicdn.net/img/view/2016/9/17/1251289.jpeg,0,0.949335635,50,174,680,776,630,602,fluttershy
1253401.jpeg,https://derpicdn.net/img/view/2016/9/19/1253401.jpeg,0,0.994537055,106,0,678,499,572,499,fluttershy
1254111.jpeg,https://derpicdn.net/img/view/2016/9/20/1254111.jpeg,0,0.991328478,33,4,353,324,320,320,fluttershy
1256196.jpeg,https://derpicdn.net/img/view/2016/9/23/1256196.jpeg,0,0.986846983,81,1,391,311,310,310,fluttershy
1257484.jpeg,https://derpicdn.net/img/view/2016/9/24/1257484.jpeg,0,0.997505665,204,0,870,665,666,665,fluttershy
1259629.jpeg,https://derpicdn.net/img/view/2016/9/27/1259629.jpeg,0,0.969115198,203,42,773,612,570,570,fluttershy
1266845.jpeg,https://derpicdn.net/img/view/2016/10/7/1266845.jpeg,0,0.958385229,315,0,1778,1435,1463,1435,fluttershy
1269441.jpeg,https://derpicdn.net/img/view/2016/10/10/1269441.jpeg,0,0.98969835,312,4,996,688,684,684,fluttershy
1279013.jpeg,https://derpicdn.net/img/view/2016/10/22/1279013.jpeg,0,0.981897771,496,248,1004,756,508,508,fluttershy
1281479.jpeg,https://derpicdn.net/img/view/2016/10/25/1281479.jpeg,0,0.978628397,0,0,3457,3552,3457,3552,fluttershy
1282113.jpeg,https://derpicdn.net/img/view/2016/10/26/1282113.jpeg,0,0.985203743,1126,831,2812,2517,1686,1686,fluttershy
1282373.jpeg,https://derpicdn.net/img/view/2016/10/27/1282373.jpeg,0,0.989085853,283,0,1280,966,997,966,fluttershy
1283724.jpeg,https://derpicdn.net/img/view/2016/10/29/1283724.jpeg,0,0.962251127,212,0,940,719,728,719,fluttershy
1284193.jpeg,https://derpicdn.net/img/view/2016/10/29/1284193.jpeg,0,0.996711016,624,12,1262,650,638,638,fluttershy
1286430.jpeg,https://derpicdn.net/img/view/2016/11/1/1286430.jpeg,0,0.963700771,414,882,2000,3168,1586,2286,fluttershy
1288104.jpeg,https://derpicdn.net/img/view/2016/11/3/1288104.jpeg,0,0.992409348,233,68,487,322,254,254,fluttershy
1297256.jpeg,https://derpicdn.net/img/view/2016/11/16/1297256.jpeg,0,0.912038803,397,33,841,477,444,444,fluttershy
1298928.jpeg,https://derpicdn.net/img/view/2016/11/19/1298928.jpeg,0,0.97508651,229,0,749,520,520,520,fluttershy
1303424.jpeg,https://derpicdn.net/img/view/2016/11/25/1303424.jpeg,0,0.99019134,34,0,488,425,454,425,fluttershy
1305475.jpeg,https://derpicdn.net/img/view/2016/11/28/1305475.jpeg,0,0.998482645,360,85,1166,891,806,806,fluttershy
1305478.jpeg,https://derpicdn.net/img/view/2016/11/28/1305478.jpeg,0,0.995547175,2181,1884,4815,4518,2634,2634,fluttershy
1309266.jpeg,https://derpicdn.net/img/view/2016/12/3/1309266.jpeg,0,0.982458353,160,0,1236,1000,1076,1000,fluttershy
1310610.jpeg,https://derpicdn.net/img/view/2016/12/5/1310610.jpeg,0,0.980552614,244,0,952,624,708,624,fluttershy
1312210.jpeg,https://derpicdn.net/img/view/2016/12/7/1312210.jpeg,0,0.994258702,266,420,1348,1502,1082,1082,fluttershy
1312672.jpeg,https://derpicdn.net/img/view/2016/12/8/1312672.jpeg,0,0.974493921,52,0,434,366,382,366,fluttershy
1312678.jpeg,https://derpicdn.net/img/view/2016/12/8/1312678.jpeg,0,0.997725189,516,171,868,523,352,352,fluttershy
1316125.jpeg,https://derpicdn.net/img/view/2016/12/12/1316125.jpeg,0,0.996563494,402,140,742,480,340,340,fluttershy
1318503.jpeg,https://derpicdn.net/img/view/2016/12/16/1318503.jpeg,0,0.998903036,437,26,1459,1048,1022,1022,fluttershy
1322551.jpeg,https://derpicdn.net/img/view/2016/12/22/1322551.jpeg,0,0.991018772,1569,99,2593,1123,1024,1024,fluttershy
1325678.jpeg,https://derpicdn.net/img/view/2016/12/26/1325678.jpeg,0,0.986677051,998,125,1986,1113,988,988,fluttershy
1326357.jpeg,https://derpicdn.net/img/view/2016/12/27/1326357.jpeg,0,0.908029318,284,0,5132,4089,4848,4089,fluttershy
1328443.jpeg,https://derpicdn.net/img/view/2016/12/30/1328443.jpeg,0,0.998667121,225,717,1055,1547,830,830,fluttershy
1328862.jpeg,https://derpicdn.net/img/view/2016/12/31/1328862.jpeg,0,0.956132412,2436,578,3312,1454,876,876,fluttershy
1329333.jpeg,https://derpicdn.net/img/view/2016/12/31/1329333.jpeg,0,0.985996068,204,0,784,559,580,559,fluttershy
1330768.jpeg,https://derpicdn.net/img/view/2017/1/2/1330768.jpeg,0,0.929956496,515,232,1271,988,756,756,fluttershy
1331199.jpeg,https://derpicdn.net/img/view/2017/1/3/1331199.jpeg,0,0.97164911,282,40,664,422,382,382,fluttershy
1332155.jpeg,https://derpicdn.net/img/view/2017/1/4/1332155.jpeg,0,0.996590316,842,0,2584,1576,1742,1576,fluttershy
1332561.jpeg,https://derpicdn.net/img/view/2017/1/5/1332561.jpeg,0,0.97082603,1496,139,1880,523,384,384,fluttershy
1333268.jpeg,https://derpicdn.net/img/view/2017/1/6/1333268.jpeg,0,0.95272845,0,489,2641,3151,2641,2662,fluttershy
1337623.jpeg,https://derpicdn.net/img/view/2017/1/12/1337623.jpeg,0,0.990155101,56,0,754,635,698,635,fluttershy
1339238.jpeg,https://derpicdn.net/img/view/2017/1/14/1339238.jpeg,0,0.994474888,132,82,1490,1440,1358,1358,fluttershy
1342764.jpeg,https://derpicdn.net/img/view/2017/1/19/1342764.jpeg,0,0.987088144,2296,1088,3414,2206,1118,1118,fluttershy
1346460.jpeg,https://derpicdn.net/img/view/2017/1/23/1346460.jpeg,0,0.998506606,419,34,723,338,304,304,fluttershy
1347764.jpeg,https://derpicdn.net/img/view/2017/1/25/1347764.jpeg,0,0.997498751,285,2,971,688,686,686,fluttershy
1348155.jpeg,https://derpicdn.net/img/view/2017/1/26/1348155.jpeg,0,0.940422118,472,0,2350,1768,1878,1768,fluttershy
1349574.jpeg,https://derpicdn.net/img/view/2017/1/28/1349574.jpeg,0,0.985344529,380,13,750,433,370,420,fluttershy
1349865.jpeg,https://derpicdn.net/img/view/2017/1/28/1349865.jpeg,0,0.989274979,768,0,1964,1147,1196,1147,fluttershy
1350793.jpeg,https://derpicdn.net/img/view/2017/1/29/1350793.jpeg,0,0.940376461,442,419,962,939,520,520,fluttershy
1351148.jpeg,https://derpicdn.net/img/view/2017/1/30/1351148.jpeg,0,0.98173058,3392,277,4434,1319,1042,1042,fluttershy
1351148.jpeg,https://derpicdn.net/img/view/2017/1/30/1351148.jpeg,2,0.90227741,1893,187,3035,1329,1142,1142,fluttershy
1352296.jpeg,https://derpicdn.net/img/view/2017/1/31/1352296.jpeg,0,0.985496104,0,0,769,718,769,718,fluttershy
1352735.jpeg,https://derpicdn.net/img/view/2017/2/1/1352735.jpeg,0,0.926883698,284,46,1692,1454,1408,1408,fluttershy
1353854.jpeg,https://derpicdn.net/img/view/2017/2/3/1353854.jpeg,0,0.97032553,3,0,345,327,342,327,fluttershy
1354440.jpeg,https://derpicdn.net/img/view/2017/2/3/1354440.jpeg,0,0.963038623,236,82,566,412,330,330,fluttershy
1355409.jpeg,https://derpicdn.net/img/view/2017/2/5/1355409.jpeg,0,0.975725353,1620,116,2754,1250,1134,1134,fluttershy
1356326.jpeg,https://derpicdn.net/img/view/2017/2/6/1356326.jpeg,0,0.986941397,151,6,775,630,624,624,fluttershy
1356392.jpeg,https://derpicdn.net/img/view/2017/2/6/1356392.jpeg,0,0.984799504,222,0,1586,1212,1364,1212,fluttershy
1356893.jpeg,https://derpicdn.net/img/view/2017/2/6/1356893.jpeg,0,0.994232953,215,109,779,673,564,564,fluttershy
1357523.jpeg,https://derpicdn.net/img/view/2017/2/7/1357523.jpeg,0,0.980518401,295,14,1435,1154,1140,1140,fluttershy
1359208.jpeg,https://derpicdn.net/img/view/2017/2/10/1359208.jpeg,0,0.986683309,91,29,439,377,348,348,fluttershy
1362116.jpeg,https://derpicdn.net/img/view/2017/2/13/1362116.jpeg,0,0.974051118,79,0,700,512,621,512,fluttershy
1362379.jpeg,https://derpicdn.net/img/view/2017/2/14/1362379.jpeg,0,0.971831858,146,0,522,331,376,331,fluttershy
1362381.jpeg,https://derpicdn.net/img/view/2017/2/14/1362381.jpeg,0,0.972735286,329,289,2445,2405,2116,2116,fluttershy
1366808.jpeg,https://derpicdn.net/img/view/2017/2/18/1366808.jpeg,0,0.992578089,154,27,540,413,386,386,fluttershy
1374384.jpeg,https://derpicdn.net/img/view/2017/2/27/1374384.jpeg,0,0.994782627,210,341,592,723,382,382,fluttershy
1374384.jpeg,https://derpicdn.net/img/view/2017/2/27/1374384.jpeg,1,0.909594893,540,112,1016,588,476,476,fluttershy
1378991.jpeg,https://derpicdn.net/img/view/2017/3/4/1378991.jpeg,0,0.936270952,84,81,714,711,630,630,fluttershy
1379193.jpeg,https://derpicdn.net/img/view/2017/3/4/1379193.jpeg,0,0.992381632,554,209,1238,893,684,684,fluttershy
1379765.jpeg,https://derpicdn.net/img/view/2017/3/5/1379765.jpeg,0,0.990543485,4,0,1710,1536,1706,1536,fluttershy
1386648.jpeg,https://derpicdn.net/img/view/2017/3/14/1386648.jpeg,0,0.978567421,456,104,864,512,408,408,fluttershy
1387304.jpeg,https://derpicdn.net/img/view/2017/3/15/1387304.jpeg,0,0.974263489,76,176,900,1013,824,837,fluttershy
1392033.jpeg,https://derpicdn.net/img/view/2017/3/20/1392033.jpeg,0,0.995846152,4,0,688,621,684,621,fluttershy
1397096.jpeg,https://derpicdn.net/img/view/2017/3/26/1397096.jpeg,0,0.999062002,178,32,786,640,608,608,fluttershy
1398179.jpeg,https://derpicdn.net/img/view/2017/3/28/1398179.jpeg,0,0.978220165,331,28,857,554,526,526,fluttershy
1402218.jpeg,https://derpicdn.net/img/view/2017/4/2/1402218.jpeg,0,0.991416991,220,0,698,444,478,444,fluttershy
1402629.jpeg,https://derpicdn.net/img/view/2017/4/2/1402629.jpeg,0,0.957734764,566,415,1106,955,540,540,fluttershy
1402873.jpeg,https://derpicdn.net/img/view/2017/4/3/1402873.jpeg,0,0.992831051,332,0,878,512,546,512,fluttershy
1403609.jpeg,https://derpicdn.net/img/view/2017/4/4/1403609.jpeg,0,0.936051786,269,0,683,366,414,366,fluttershy
1403829.jpeg,https://derpicdn.net/img/view/2017/4/4/1403829.jpeg,0,0.996550918,334,0,792,437,458,437,fluttershy
1403830.jpeg,https://derpicdn.net/img/view/2017/4/4/1403830.jpeg,0,0.905622125,60,0,968,821,908,821,fluttershy
1404667.jpeg,https://derpicdn.net/img/view/2017/4/5/1404667.jpeg,0,0.934479415,156,126,2052,2022,1896,1896,fluttershy
1405997.jpeg,https://derpicdn.net/img/view/2017/4/7/1405997.jpeg,0,0.993922412,263,0,645,363,382,363,fluttershy
1407395.jpeg,https://derpicdn.net/img/view/2017/4/9/1407395.jpeg,0,0.990464866,142,0,598,452,456,452,fluttershy
1407603.jpeg,https://derpicdn.net/img/view/2017/4/9/1407603.jpeg,0,0.998750925,3,0,187,165,184,165,fluttershy
1407603.jpeg,https://derpicdn.net/img/view/2017/4/9/1407603.jpeg,1,0.997110605,260,0,444,168,184,168,fluttershy
1408389.jpeg,https://derpicdn.net/img/view/2017/4/10/1408389.jpeg,0,0.960746288,603,6,1227,630,624,624,fluttershy
1411931.jpeg,https://derpicdn.net/img/view/2017/4/15/1411931.jpeg,0,0.976923108,98,0,736,576,638,576,fluttershy
1416002.jpeg,https://derpicdn.net/img/view/2017/4/19/1416002.jpeg,0,0.92051369,1089,104,4505,3520,3416,3416,fluttershy
1416867.jpeg,https://derpicdn.net/img/view/2017/4/20/1416867.jpeg,0,0.996675491,713,2,1341,630,628,628,fluttershy
1417879.jpeg,https://derpicdn.net/img/view/2017/4/21/1417879.jpeg,0,0.960480571,331,164,1161,1050,830,886,fluttershy
1421313.jpeg,https://derpicdn.net/img/view/2017/4/25/1421313.jpeg,0,0.973272979,50,0,748,685,698,685,fluttershy
1423027.jpeg,https://derpicdn.net/img/view/2017/4/27/1423027.jpeg,0,0.923727274,13,21,777,785,764,764,fluttershy
1424946.jpeg,https://derpicdn.net/img/view/2017/4/29/1424946.jpeg,0,0.979331255,495,0,1021,523,526,523,fluttershy
1425390.jpeg,https://derpicdn.net/img/view/2017/4/30/1425390.jpeg,0,0.98552382,1351,56,2607,1312,1256,1256,fluttershy
1427699.jpeg,https://derpicdn.net/img/view/2017/5/3/1427699.jpeg,0,0.984317422,159,0,1643,1456,1484,1456,fluttershy
1428884.jpeg,https://derpicdn.net/img/view/2017/5/5/1428884.jpeg,0,0.998999655,103,4,503,404,400,400,fluttershy
1430784.jpeg,https://derpicdn.net/img/view/2017/5/7/1430784.jpeg,0,0.99373877,470,71,2328,1929,1858,1858,fluttershy
1431402.jpeg,https://derpicdn.net/img/view/2017/5/8/1431402.jpeg,0,0.949535549,1245,603,2169,1527,924,924,fluttershy
1431934.jpeg,https://derpicdn.net/img/view/2017/5/8/1431934.jpeg,0,0.902362585,124,51,538,465,414,414,fluttershy
1434312.jpeg,https://derpicdn.net/img/view/2017/5/11/1434312.jpeg,0,0.99591136,100,0,426,288,326,288,fluttershy
1434312.jpeg,https://derpicdn.net/img/view/2017/5/11/1434312.jpeg,1,0.990629017,466,0,824,301,358,301,fluttershy
1434376.jpeg,https://derpicdn.net/img/view/2017/5/11/1434376.jpeg,0,0.955076635,40,62,380,402,340,340,fluttershy
1434573.jpeg,https://derpicdn.net/img/view/2017/5/12/1434573.jpeg,0,0.922883332,40,57,392,409,352,352,fluttershy
1434770.jpeg,https://derpicdn.net/img/view/2017/5/12/1434770.jpeg,0,0.942721605,32,19,530,517,498,498,fluttershy
1434909.jpeg,https://derpicdn.net/img/view/2017/5/12/1434909.jpeg,0,0.995567203,432,124,1130,822,698,698,fluttershy
1437813.jpeg,https://derpicdn.net/img/view/2017/5/16/1437813.jpeg,0,0.998144865,271,222,589,540,318,318,fluttershy
1442914.jpeg,https://derpicdn.net/img/view/2017/5/22/1442914.jpeg,0,0.996377468,241,121,711,591,470,470,fluttershy
1443843.jpeg,https://derpicdn.net/img/view/2017/5/23/1443843.jpeg,0,0.985029042,443,71,1125,753,682,682,fluttershy
1444192.jpeg,https://derpicdn.net/img/view/2017/5/23/1444192.jpeg,0,0.98639226,11,20,277,286,266,266,fluttershy
1444770.jpeg,https://derpicdn.net/img/view/2017/5/24/1444770.jpeg,0,0.961636424,429,39,1161,771,732,732,fluttershy
1448987.jpeg,https://derpicdn.net/img/view/2017/5/29/1448987.jpeg,0,0.950803697,268,0,1350,998,1082,998,fluttershy
1449936.jpeg,https://derpicdn.net/img/view/2017/5/30/1449936.jpeg,0,0.954654336,211,0,1665,1080,1454,1080,fluttershy
1452336.jpeg,https://derpicdn.net/img/view/2017/6/2/1452336.jpeg,0,0.909161925,223,13,847,637,624,624,fluttershy
1452842.jpeg,https://derpicdn.net/img/view/2017/6/3/1452842.jpeg,0,0.934200048,37,0,720,804,683,804,fluttershy
1455705.jpeg,https://derpicdn.net/img/view/2017/6/6/1455705.jpeg,1,0.924585342,439,202,659,422,220,220,fluttershy
1456722.jpeg,https://derpicdn.net/img/view/2017/6/8/1456722.jpeg,0,0.909311593,299,0,1279,944,980,944,fluttershy
1459144.jpeg,https://derpicdn.net/img/view/2017/6/11/1459144.jpeg,0,0.98709166,156,137,394,375,238,238,fluttershy
1462102.jpeg,https://derpicdn.net/img/view/2017/6/15/1462102.jpeg,0,0.996936619,72,125,614,667,542,542,fluttershy
1462466.jpeg,https://derpicdn.net/img/view/2017/6/15/1462466.jpeg,0,0.986595511,325,0,1277,916,952,916,fluttershy
1463566.jpeg,https://derpicdn.net/img/view/2017/6/17/1463566.jpeg,0,0.994823098,1459,195,2683,1419,1224,1224,fluttershy
1464233.jpeg,https://derpicdn.net/img/view/2017/6/17/1464233.jpeg,0,0.996494353,756,0,2118,1260,1362,1260,fluttershy
1465306.jpeg,https://derpicdn.net/img/view/2017/6/18/1465306.jpeg,0,0.988809168,124,0,766,625,642,625,fluttershy
1467882.jpeg,https://derpicdn.net/img/view/2017/6/21/1467882.jpeg,0,0.949173629,124,6,692,574,568,568,fluttershy
1468414.jpeg,https://derpicdn.net/img/view/2017/6/21/1468414.jpeg,0,0.982030749,482,8,1196,722,714,714,fluttershy
1468653.jpeg,https://derpicdn.net/img/view/2017/6/22/1468653.jpeg,0,0.969962656,158,0,712,501,554,501,fluttershy
1470637.jpeg,https://derpicdn.net/img/view/2017/6/24/1470637.jpeg,0,0.9591102,296,180,1792,1676,1496,1496,fluttershy
1470751.jpeg,https://derpicdn.net/img/view/2017/6/24/1470751.jpeg,0,0.997559845,228,0,768,531,540,531,fluttershy
1471334.jpeg,https://derpicdn.net/img/view/2017/6/25/1471334.jpeg,0,0.989988446,186,70,626,510,440,440,fluttershy
1472086.jpeg,https://derpicdn.net/img/view/2017/6/26/1472086.jpeg,0,0.986401379,844,415,1280,851,436,436,fluttershy
1474598.jpeg,https://derpicdn.net/img/view/2017/6/29/1474598.jpeg,0,0.93945986,117,362,391,636,274,274,fluttershy
1477073.jpeg,https://derpicdn.net/img/view/2017/7/2/1477073.jpeg,0,0.987817883,182,75,1184,1077,1002,1002,fluttershy
1478213.jpeg,https://derpicdn.net/img/view/2017/7/4/1478213.jpeg,0,0.991667509,299,0,821,499,522,499,fluttershy
1478306.jpeg,https://derpicdn.net/img/view/2017/7/4/1478306.jpeg,0,0.993666947,740,211,1472,943,732,732,fluttershy
1480837.jpeg,https://derpicdn.net/img/view/2017/7/7/1480837.jpeg,0,0.977618575,73,115,867,909,794,794,fluttershy
1481475.jpeg,https://derpicdn.net/img/view/2017/7/8/1481475.jpeg,0,0.96892339,1148,2553,2040,3445,892,892,fluttershy
1481748.jpeg,https://derpicdn.net/img/view/2017/7/8/1481748.jpeg,0,0.97822392,415,40,675,300,260,260,fluttershy
1483963.jpeg,https://derpicdn.net/img/view/2017/7/11/1483963.jpeg,0,0.921576262,1073,268,2305,1500,1232,1232,fluttershy
1485549.jpeg,https://derpicdn.net/img/view/2017/7/13/1485549.jpeg,0,0.98565799,166,447,1778,2059,1612,1612,fluttershy
1487232.jpeg,https://derpicdn.net/img/view/2017/7/16/1487232.jpeg,0,0.939862549,37,64,1091,1350,1054,1286,fluttershy
1488273.jpeg,https://derpicdn.net/img/view/2017/7/17/1488273.jpeg,0,0.997358859,369,0,1181,719,812,719,fluttershy
1494530.jpeg,https://derpicdn.net/img/view/2017/7/25/1494530.jpeg,0,0.979140282,597,1365,1499,2267,902,902,fluttershy
1495179.jpeg,https://derpicdn.net/img/view/2017/7/26/1495179.jpeg,0,0.993275583,636,377,1356,1097,720,720,fluttershy
1496292.jpeg,https://derpicdn.net/img/view/2017/7/27/1496292.jpeg,0,0.923996687,25,110,882,1094,857,984,fluttershy
1496787.jpeg,https://derpicdn.net/img/view/2017/7/28/1496787.jpeg,0,0.965736151,260,0,1748,1080,1488,1080,fluttershy
1497368.jpeg,https://derpicdn.net/img/view/2017/7/29/1497368.jpeg,0,0.938696504,152,25,434,307,282,282,fluttershy
1499999.jpeg,https://derpicdn.net/img/view/2017/8/1/1499999.jpeg,0,0.998141289,967,279,1773,1085,806,806,fluttershy
1500425.jpeg,https://derpicdn.net/img/view/2017/8/1/1500425.jpeg,0,0.958477497,9,0,567,522,558,522,fluttershy
1500835.jpeg,https://derpicdn.net/img/view/2017/8/2/1500835.jpeg,0,0.941380084,399,97,1000,725,601,628,fluttershy
1501600.jpeg,https://derpicdn.net/img/view/2017/8/3/1501600.jpeg,0,0.922568262,259,46,549,336,290,290,fluttershy
1503335.jpeg,https://derpicdn.net/img/view/2017/8/5/1503335.jpeg,0,0.99927336,679,95,1255,671,576,576,fluttershy
1504342.jpeg,https://derpicdn.net/img/view/2017/8/6/1504342.jpeg,0,0.980335653,932,25,1658,751,726,726,fluttershy
1504639.jpeg,https://derpicdn.net/img/view/2017/8/6/1504639.jpeg,0,0.998103678,948,982,1390,1424,442,442,fluttershy
1504639.jpeg,https://derpicdn.net/img/view/2017/8/6/1504639.jpeg,1,0.949747562,239,1131,595,1487,356,356,fluttershy
1505084.jpeg,https://derpicdn.net/img/view/2017/8/7/1505084.jpeg,0,0.999427855,92,20,604,532,512,512,fluttershy
1506377.jpeg,https://derpicdn.net/img/view/2017/8/9/1506377.jpeg,0,0.961666167,262,377,2564,2679,2302,2302,fluttershy
1508066.jpeg,https://derpicdn.net/img/view/2017/8/11/1508066.jpeg,0,0.99317944,85,0,475,374,390,374,fluttershy
1508118.jpeg,https://derpicdn.net/img/view/2017/8/11/1508118.jpeg,0,0.993468523,295,0,1907,1611,1612,1611,fluttershy
1508595.jpeg,https://derpicdn.net/img/view/2017/8/12/1508595.jpeg,0,0.992441058,2027,734,3241,1948,1214,1214,fluttershy
1510058.jpeg,https://derpicdn.net/img/view/2017/8/13/1510058.jpeg,0,0.938907921,1363,360,1943,940,580,580,fluttershy
1510761.jpeg,https://derpicdn.net/img/view/2017/8/14/1510761.jpeg,0,0.970104992,770,148,1456,834,686,686,fluttershy
1519430.jpeg,https://derpicdn.net/img/view/2017/8/25/1519430.jpeg,0,0.996953905,478,30,1200,752,722,722,fluttershy
1520525.jpeg,https://derpicdn.net/img/view/2017/8/26/1520525.jpeg,0,0.979650617,0,0,511,507,511,507,fluttershy
1520781.jpeg,https://derpicdn.net/img/view/2017/8/27/1520781.jpeg,0,0.911948264,461,0,2853,2220,2392,2220,fluttershy
1521437.jpeg,https://derpicdn.net/img/view/2017/8/27/1521437.jpeg,0,0.99772352,567,32,1609,1074,1042,1042,fluttershy
1521728.jpeg,https://derpicdn.net/img/view/2017/8/28/1521728.jpeg,0,0.994124055,445,259,967,781,522,522,fluttershy
1523639.jpeg,https://derpicdn.net/img/view/2017/8/30/1523639.jpeg,0,0.996482909,174,21,344,191,170,170,fluttershy
1524416.jpeg,https://derpicdn.net/img/view/2017/8/31/1524416.jpeg,0,0.999800563,532,9,3118,2595,2586,2586,fluttershy
1525333.jpeg,https://derpicdn.net/img/view/2017/9/1/1525333.jpeg,0,0.999066293,396,177,936,717,540,540,fluttershy
1525333.jpeg,https://derpicdn.net/img/view/2017/9/1/1525333.jpeg,1,0.978289783,801,273,1219,691,418,418,fluttershy
1525917.jpeg,https://derpicdn.net/img/view/2017/9/2/1525917.jpeg,0,0.998703301,701,224,1469,992,768,768,fluttershy
1526974.jpeg,https://derpicdn.net/img/view/2017/9/3/1526974.jpeg,0,0.929099441,569,137,1505,1073,936,936,fluttershy
1527824.jpeg,https://derpicdn.net/img/view/2017/9/4/1527824.jpeg,0,0.978113294,1220,0,2772,1525,1552,1525,fluttershy
1528009.jpeg,https://derpicdn.net/img/view/2017/9/4/1528009.jpeg,0,0.944697738,0,33,1068,1275,1068,1242,fluttershy
1528748.jpeg,https://derpicdn.net/img/view/2017/9/5/1528748.jpeg,0,0.965414345,124,112,316,304,192,192,fluttershy
1529970.jpeg,https://derpicdn.net/img/view/2017/9/7/1529970.jpeg,0,0.995113611,150,36,452,338,302,302,fluttershy
1531980.jpeg,https://derpicdn.net/img/view/2017/9/10/1531980.jpeg,0,0.994849503,1212,0,1626,409,414,409,fluttershy
1537602.jpeg,https://derpicdn.net/img/view/2017/9/17/1537602.jpeg,0,0.995662928,409,0,787,367,378,367,fluttershy
1541073.jpeg,https://derpicdn.net/img/view/2017/9/21/1541073.jpeg,0,0.901560903,199,0,557,328,358,328,fluttershy
1543842.jpeg,https://derpicdn.net/img/view/2017/9/24/1543842.jpeg,0,0.978877485,0,22,787,856,787,834,fluttershy
1544861.jpeg,https://derpicdn.net/img/view/2017/9/25/1544861.jpeg,0,0.978681445,228,277,512,561,284,284,fluttershy
1546375.jpeg,https://derpicdn.net/img/view/2017/9/27/1546375.jpeg,0,0.990480304,729,2,1469,742,740,740,fluttershy
1548416.jpeg,https://derpicdn.net/img/view/2017/9/30/1548416.jpeg,0,0.9786551,592,60,1300,768,708,708,fluttershy
1549961.jpeg,https://derpicdn.net/img/view/2017/10/2/1549961.jpeg,0,0.996998549,240,0,958,693,718,693,fluttershy
1550373.jpeg,https://derpicdn.net/img/view/2017/10/2/1550373.jpeg,0,0.968743443,356,0,1513,1147,1157,1147,fluttershy
1550511.jpeg,https://derpicdn.net/img/view/2017/10/2/1550511.jpeg,0,0.997738242,1370,0,3262,1806,1892,1806,fluttershy
1551917.jpeg,https://derpicdn.net/img/view/2017/10/4/1551917.jpeg,0,0.977595806,70,0,486,413,416,413,fluttershy
1552704.jpeg,https://derpicdn.net/img/view/2017/10/5/1552704.jpeg,0,0.941731691,445,71,1986,1681,1541,1610,fluttershy
1552850.jpeg,https://derpicdn.net/img/view/2017/10/5/1552850.jpeg,0,0.996264935,50,0,808,639,758,639,fluttershy
1553428.jpeg,https://derpicdn.net/img/view/2017/10/6/1553428.jpeg,0,0.995507598,124,99,428,403,304,304,fluttershy
1555932.jpeg,https://derpicdn.net/img/view/2017/10/9/1555932.jpeg,0,0.993140042,855,212,2121,1478,1266,1266,fluttershy
1556911.jpeg,https://derpicdn.net/img/view/2017/10/10/1556911.jpeg,0,0.997483313,45,0,587,503,542,503,fluttershy
1560435.jpeg,https://derpicdn.net/img/view/2017/10/13/1560435.jpeg,0,0.953072429,328,0,1057,746,729,746,fluttershy
1560688.jpeg,https://derpicdn.net/img/view/2017/10/14/1560688.jpeg,0,0.906424999,2072,2746,3122,3796,1050,1050,fluttershy
1566876.jpeg,https://derpicdn.net/img/view/2017/10/21/1566876.jpeg,0,0.981369019,396,72,692,368,296,296,fluttershy
1567978.jpeg,https://derpicdn.net/img/view/2017/10/22/1567978.jpeg,0,0.955459058,546,0,956,403,410,403,fluttershy
1568182.jpeg,https://derpicdn.net/img/view/2017/10/23/1568182.jpeg,0,0.995711327,423,0,1235,795,812,795,fluttershy
1568459.jpeg,https://derpicdn.net/img/view/2017/10/23/1568459.jpeg,0,0.991412938,136,0,848,682,712,682,fluttershy
1571609.jpeg,https://derpicdn.net/img/view/2017/10/27/1571609.jpeg,0,0.991634786,251,129,643,521,392,392,fluttershy
1572723.jpeg,https://derpicdn.net/img/view/2017/10/29/1572723.jpeg,0,0.995758355,520,45,682,207,162,162,fluttershy
1572723.jpeg,https://derpicdn.net/img/view/2017/10/29/1572723.jpeg,1,0.995667577,177,42,353,218,176,176,fluttershy
1572723.jpeg,https://derpicdn.net/img/view/2017/10/29/1572723.jpeg,2,0.994491518,441,367,679,605,238,238,fluttershy
1573225.jpeg,https://derpicdn.net/img/view/2017/10/29/1573225.jpeg,1,0.998748779,256,196,604,544,348,348,fluttershy
1577928.jpeg,https://derpicdn.net/img/view/2017/11/4/1577928.jpeg,0,0.997309208,271,141,711,581,440,440,fluttershy
1579336.jpeg,https://derpicdn.net/img/view/2017/11/6/1579336.jpeg,0,0.951690137,739,304,2399,1964,1660,1660,fluttershy
1579951.jpeg,https://derpicdn.net/img/view/2017/11/6/1579951.jpeg,0,0.962083817,1132,102,2000,1044,868,942,fluttershy
1582436.jpeg,https://derpicdn.net/img/view/2017/11/9/1582436.jpeg,0,0.975697815,163,62,633,532,470,470,fluttershy
1583195.jpeg,https://derpicdn.net/img/view/2017/11/10/1583195.jpeg,0,0.918445766,115,160,703,748,588,588,fluttershy
1583832.jpeg,https://derpicdn.net/img/view/2017/11/11/1583832.jpeg,0,0.997809052,1549,669,2287,1407,738,738,fluttershy
1584036.jpeg,https://derpicdn.net/img/view/2017/11/11/1584036.jpeg,0,0.994486809,0,0,1500,1491,1500,1491,fluttershy
1586080.jpeg,https://derpicdn.net/img/view/2017/11/14/1586080.jpeg,0,0.983806372,26,0,604,548,578,548,fluttershy
1587011.jpeg,https://derpicdn.net/img/view/2017/11/15/1587011.jpeg,0,0.992913544,204,0,616,399,412,399,fluttershy
1588166.jpeg,https://derpicdn.net/img/view/2017/11/17/1588166.jpeg,0,0.999398828,861,623,1339,1101,478,478,fluttershy
1588217.jpeg,https://derpicdn.net/img/view/2017/11/17/1588217.jpeg,0,0.921881974,98,105,700,707,602,602,fluttershy
1589448.jpeg,https://derpicdn.net/img/view/2017/11/18/1589448.jpeg,0,0.961877525,85,0,350,286,265,286,fluttershy
1590088.jpeg,https://derpicdn.net/img/view/2017/11/19/1590088.jpeg,0,0.99365288,182,157,632,607,450,450,fluttershy
1590350.jpeg,https://derpicdn.net/img/view/2017/11/20/1590350.jpeg,0,0.994494021,171,46,800,728,629,682,fluttershy
1591769.jpeg,https://derpicdn.net/img/view/2017/11/22/1591769.jpeg,0,0.975018203,580,0,956,343,376,343,fluttershy
1591771.jpeg,https://derpicdn.net/img/view/2017/11/22/1591771.jpeg,0,0.970926523,477,173,697,393,220,220,fluttershy
1593791.jpeg,https://derpicdn.net/img/view/2017/11/25/1593791.jpeg,0,0.977870822,177,0,697,476,520,476,fluttershy
1598244.jpeg,https://derpicdn.net/img/view/2017/12/1/1598244.jpeg,0,0.99640578,188,3,472,287,284,284,fluttershy
1598302.jpeg,https://derpicdn.net/img/view/2017/12/1/1598302.jpeg,0,0.976869285,264,0,1766,1080,1502,1080,fluttershy
1599156.jpeg,https://derpicdn.net/img/view/2017/12/2/1599156.jpeg,0,0.948811531,244,41,774,571,530,530,fluttershy
1600254.jpeg,https://derpicdn.net/img/view/2017/12/4/1600254.jpeg,0,0.991487622,42,0,572,492,530,492,fluttershy
1600391.jpeg,https://derpicdn.net/img/view/2017/12/4/1600391.jpeg,0,0.980103135,206,25,1420,1239,1214,1214,fluttershy
1603248.jpeg,https://derpicdn.net/img/view/2017/12/8/1603248.jpeg,0,0.977930486,0,206,835,1000,835,794,fluttershy
1604339.jpeg,https://derpicdn.net/img/view/2017/12/10/1604339.jpeg,0,0.954064906,193,0,573,364,380,364,fluttershy
1604467.jpeg,https://derpicdn.net/img/view/2017/12/10/1604467.jpeg,0,0.992462993,13,119,271,377,258,258,fluttershy
1607724.jpeg,https://derpicdn.net/img/view/2017/12/14/1607724.jpeg,0,0.998239934,387,34,1593,1240,1206,1206,fluttershy
1607883.jpeg,https://derpicdn.net/img/view/2017/12/14/1607883.jpeg,0,0.988434196,163,0,599,430,436,430,fluttershy
1609898.jpeg,https://derpicdn.net/img/view/2017/12/17/1609898.jpeg,0,0.979826987,86,3,730,647,644,644,fluttershy
1612324.jpeg,https://derpicdn.net/img/view/2017/12/20/1612324.jpeg,0,0.961907208,0,257,1083,1349,1083,1092,fluttershy
1614628.jpeg,https://derpicdn.net/img/view/2017/12/24/1614628.jpeg,1,0.977249563,140,439,398,697,258,258,fluttershy
1616563.jpeg,https://derpicdn.net/img/view/2017/12/26/1616563.jpeg,0,0.987581313,192,0,614,329,422,329,fluttershy
1617834.jpeg,https://derpicdn.net/img/view/2017/12/28/1617834.jpeg,0,0.991882145,484,11,1920,1447,1436,1436,fluttershy
1620193.jpeg,https://derpicdn.net/img/view/2017/12/31/1620193.jpeg,0,0.999830127,0,0,1947,1995,1947,1995,fluttershy
1622309.jpeg,https://derpicdn.net/img/view/2018/1/2/1622309.jpeg,0,0.985910535,60,0,376,302,316,302,fluttershy
1622339.jpeg,https://derpicdn.net/img/view/2018/1/2/1622339.jpeg,0,0.993929923,607,11,1461,865,854,854,fluttershy
1622792.jpeg,https://derpicdn.net/img/view/2018/1/3/1622792.jpeg,0,0.997243941,214,67,556,409,342,342,fluttershy
1622917.jpeg,https://derpicdn.net/img/view/2018/1/3/1622917.jpeg,0,0.990728378,150,13,946,809,796,796,fluttershy
1623132.jpeg,https://derpicdn.net/img/view/2018/1/3/1623132.jpeg,0,0.936094463,636,378,1194,936,558,558,fluttershy
1625432.jpeg,https://derpicdn.net/img/view/2018/1/6/1625432.jpeg,0,0.981199026,636,0,1218,464,582,464,fluttershy
1625830.jpeg,https://derpicdn.net/img/view/2018/1/6/1625830.jpeg,0,0.993643403,161,0,695,524,534,524,fluttershy
1626328.jpeg,https://derpicdn.net/img/view/2018/1/7/1626328.jpeg,0,0.943142831,586,383,1604,1401,1018,1018,fluttershy
1627195.jpeg,https://derpicdn.net/img/view/2018/1/8/1627195.jpeg,0,0.964444339,283,544,867,1128,584,584,fluttershy
1627477.jpeg,https://derpicdn.net/img/view/2018/1/8/1627477.jpeg,0,0.996273041,549,500,2481,2432,1932,1932,fluttershy
1627853.jpeg,https://derpicdn.net/img/view/2018/1/9/1627853.jpeg,0,0.968648195,13,0,915,842,902,842,fluttershy
1628410.jpeg,https://derpicdn.net/img/view/2018/1/9/1628410.jpeg,0,0.957317114,510,95,1230,815,720,720,fluttershy
1630003.jpeg,https://derpicdn.net/img/view/2018/1/11/1630003.jpeg,0,0.995684326,1358,0,5676,3356,4318,3356,fluttershy
1632060.jpeg,https://derpicdn.net/img/view/2018/1/14/1632060.jpeg,0,0.973093688,1297,0,3473,1969,2176,1969,fluttershy
1634622.jpeg,https://derpicdn.net/img/view/2018/1/17/1634622.jpeg,0,0.998210073,164,0,574,389,410,389,fluttershy
1634785.jpeg,https://derpicdn.net/img/view/2018/1/18/1634785.jpeg,0,0.992503941,126,0,906,768,780,768,fluttershy
1635556.jpeg,https://derpicdn.net/img/view/2018/1/19/1635556.jpeg,0,0.998604476,1082,91,1866,875,784,784,fluttershy
1636575.jpeg,https://derpicdn.net/img/view/2018/1/20/1636575.jpeg,0,0.982799888,226,0,904,621,678,621,fluttershy
1638852.jpeg,https://derpicdn.net/img/view/2018/1/23/1638852.jpeg,0,0.996991277,643,0,1141,473,498,473,fluttershy
1640668.jpeg,https://derpicdn.net/img/view/2018/1/25/1640668.jpeg,0,0.988513887,0,85,729,768,729,683,fluttershy
1640668.jpeg,https://derpicdn.net/img/view/2018/1/25/1640668.jpeg,1,0.924959838,94,0,696,580,602,580,fluttershy
1642176.jpeg,https://derpicdn.net/img/view/2018/1/27/1642176.jpeg,0,0.930302441,195,53,977,835,782,782,fluttershy
1645912.jpeg,https://derpicdn.net/img/view/2018/2/1/1645912.jpeg,0,0.97145462,662,130,1066,534,404,404,fluttershy
1648376.jpeg,https://derpicdn.net/img/view/2018/2/4/1648376.jpeg,0,0.994779229,215,117,2265,2167,2050,2050,fluttershy
1648574.jpeg,https://derpicdn.net/img/view/2018/2/4/1648574.jpeg,0,0.990424335,155,0,783,591,628,591,fluttershy
1649194.jpeg,https://derpicdn.net/img/view/2018/2/5/1649194.jpeg,0,0.926165164,435,0,655,219,220,219,fluttershy
1650554.jpeg,https://derpicdn.net/img/view/2018/2/7/1650554.jpeg,0,0.946919382,0,0,505,537,505,537,fluttershy
1651500.jpeg,https://derpicdn.net/img/view/2018/2/9/1651500.jpeg,0,0.946397543,505,0,1211,600,706,600,fluttershy
1654179.jpeg,https://derpicdn.net/img/view/2018/2/12/1654179.jpeg,0,0.990861475,215,0,1075,854,860,854,fluttershy
1654235.jpeg,https://derpicdn.net/img/view/2018/2/12/1654235.jpeg,0,0.997119069,133,110,777,754,644,644,fluttershy
1654896.jpeg,https://derpicdn.net/img/view/2018/2/13/1654896.jpeg,0,0.993655741,346,0,1138,746,792,746,fluttershy
1655847.jpeg,https://derpicdn.net/img/view/2018/2/14/1655847.jpeg,0,0.931244075,90,51,688,649,598,598,fluttershy
1660421.jpeg,https://derpicdn.net/img/view/2018/2/19/1660421.jpeg,0,0.974552512,81,24,1156,1146,1075,1122,fluttershy
1660506.jpeg,https://derpicdn.net/img/view/2018/2/19/1660506.jpeg,0,0.998383403,182,0,812,553,630,553,fluttershy
1663542.jpeg,https://derpicdn.net/img/view/2018/2/23/1663542.jpeg,0,0.99002099,495,22,1280,860,785,838,fluttershy
1664275.jpeg,https://derpicdn.net/img/view/2018/2/24/1664275.jpeg,0,0.933087647,0,122,737,912,737,790,fluttershy
1665275.jpeg,https://derpicdn.net/img/view/2018/2/25/1665275.jpeg,0,0.996454477,0,0,623,573,623,573,fluttershy
1665898.jpeg,https://derpicdn.net/img/view/2018/2/25/1665898.jpeg,0,0.984484017,250,0,898,604,648,604,fluttershy
1667274.jpeg,https://derpicdn.net/img/view/2018/2/27/1667274.jpeg,1,0.935272098,224,220,1550,1546,1326,1326,fluttershy
1668387.jpeg,https://derpicdn.net/img/view/2018/2/28/1668387.jpeg,0,0.987558067,308,90,674,456,366,366,fluttershy
1669823.jpeg,https://derpicdn.net/img/view/2018/3/2/1669823.jpeg,0,0.996373892,19,23,497,501,478,478,fluttershy
1669862.jpeg,https://derpicdn.net/img/view/2018/3/2/1669862.jpeg,0,0.997050166,311,49,1061,799,750,750,fluttershy
1670397.jpeg,https://derpicdn.net/img/view/2018/3/3/1670397.jpeg,0,0.911674082,0,20,1240,1372,1240,1352,fluttershy
1670843.jpeg,https://derpicdn.net/img/view/2018/3/3/1670843.jpeg,0,0.926226735,504,0,1098,583,594,583,fluttershy
1671621.jpeg,https://derpicdn.net/img/view/2018/3/4/1671621.jpeg,0,0.997995734,798,76,1280,586,482,510,fluttershy
1672502.jpeg,https://derpicdn.net/img/view/2018/3/5/1672502.jpeg,0,0.997323632,371,0,1373,929,1002,929,fluttershy
1672862.jpeg,https://derpicdn.net/img/view/2018/3/6/1672862.jpeg,0,0.944277823,4,41,318,355,314,314,fluttershy
1673010.jpeg,https://derpicdn.net/img/view/2018/3/6/1673010.jpeg,0,0.996004581,1170,216,2056,1102,886,886,fluttershy
1673256.jpeg,https://derpicdn.net/img/view/2018/3/6/1673256.jpeg,0,0.958861411,0,52,608,786,608,734,fluttershy
1677636.jpeg,https://derpicdn.net/img/view/2018/3/11/1677636.jpeg,0,0.959452927,345,45,1911,1611,1566,1566,fluttershy
1677937.jpeg,https://derpicdn.net/img/view/2018/3/12/1677937.jpeg,0,0.99626416,171,0,1345,1105,1174,1105,fluttershy
1679034.jpeg,https://derpicdn.net/img/view/2018/3/13/1679034.jpeg,0,0.99708575,0,0,910,769,910,769,fluttershy
1679752.jpeg,https://derpicdn.net/img/view/2018/3/14/1679752.jpeg,0,0.991915226,709,3,963,257,254,254,fluttershy
1680287.jpeg,https://derpicdn.net/img/view/2018/3/14/1680287.jpeg,0,0.986669958,367,12,813,458,446,446,fluttershy
1680288.jpeg,https://derpicdn.net/img/view/2018/3/14/1680288.jpeg,0,0.993076682,110,0,608,494,498,494,fluttershy
1681800.jpeg,https://derpicdn.net/img/view/2018/3/16/1681800.jpeg,0,0.998358667,1547,737,2315,1505,768,768,fluttershy
1682474.jpeg,https://derpicdn.net/img/view/2018/3/16/1682474.jpeg,0,0.950881302,1514,542,2016,1044,502,502,fluttershy
1684134.jpeg,https://derpicdn.net/img/view/2018/3/18/1684134.jpeg,0,0.950883269,0,50,791,898,791,848,fluttershy
1686025.jpeg,https://derpicdn.net/img/view/2018/3/20/1686025.jpeg,0,0.941037834,1983,1046,3269,2332,1286,1286,fluttershy
1686614.jpeg,https://derpicdn.net/img/view/2018/3/21/1686614.jpeg,0,0.976582527,624,597,1914,1887,1290,1290,fluttershy
1687204.jpeg,https://derpicdn.net/img/view/2018/3/22/1687204.jpeg,0,0.989279985,305,102,595,392,290,290,fluttershy
1689928.jpeg,https://derpicdn.net/img/view/2018/3/25/1689928.jpeg,0,0.99167949,122,0,1200,1078,1078,1078,fluttershy
1692092.jpeg,https://derpicdn.net/img/view/2018/3/27/1692092.jpeg,0,0.998259842,663,71,1899,1307,1236,1236,fluttershy
1692247.jpeg,https://derpicdn.net/img/view/2018/3/27/1692247.jpeg,0,0.972184241,71,0,1219,1080,1148,1080,fluttershy
1693881.jpeg,https://derpicdn.net/img/view/2018/3/29/1693881.jpeg,0,0.97096622,365,5,661,301,296,296,fluttershy
1698827.jpeg,https://derpicdn.net/img/view/2018/4/4/1698827.jpeg,0,0.995888591,198,0,618,383,420,383,fluttershy
1700526.jpeg,https://derpicdn.net/img/view/2018/4/6/1700526.jpeg,0,0.988351941,0,0,674,645,674,645,fluttershy
1700586.jpeg,https://derpicdn.net/img/view/2018/4/6/1700586.jpeg,0,0.983817935,661,176,2219,1734,1558,1558,fluttershy
1700676.jpeg,https://derpicdn.net/img/view/2018/4/6/1700676.jpeg,0,0.994916022,96,0,778,609,682,609,fluttershy
1700755.jpeg,https://derpicdn.net/img/view/2018/4/6/1700755.jpeg,0,0.9915362,64,0,620,529,556,529,fluttershy
1700849.jpeg,https://derpicdn.net/img/view/2018/4/6/1700849.jpeg,0,0.939249456,3,0,407,380,404,380,fluttershy
1701695.jpeg,https://derpicdn.net/img/view/2018/4/7/1701695.jpeg,0,0.94676429,16,89,396,469,380,380,fluttershy
1701743.jpeg,https://derpicdn.net/img/view/2018/4/7/1701743.jpeg,0,0.961493552,301,461,457,617,156,156,fluttershy
1702594.jpeg,https://derpicdn.net/img/view/2018/4/8/1702594.jpeg,0,0.977145493,129,94,515,480,386,386,fluttershy
1702706.jpeg,https://derpicdn.net/img/view/2018/4/8/1702706.jpeg,0,0.998543441,843,112,1375,644,532,532,fluttershy
1704959.jpeg,https://derpicdn.net/img/view/2018/4/11/1704959.jpeg,0,0.96081996,494,3,768,277,274,274,fluttershy
1705302.jpeg,https://derpicdn.net/img/view/2018/4/11/1705302.jpeg,0,0.994408965,678,0,1356,676,678,676,fluttershy
1706837.jpeg,https://derpicdn.net/img/view/2018/4/13/1706837.jpeg,0,0.965451896,47,24,1024,1008,977,984,fluttershy
1707366.jpeg,https://derpicdn.net/img/view/2018/4/14/1707366.jpeg,0,0.994737267,716,0,1348,579,632,579,fluttershy
1707367.jpeg,https://derpicdn.net/img/view/2018/4/14/1707367.jpeg,0,0.928684413,118,96,590,568,472,472,fluttershy
1707487.jpeg,https://derpicdn.net/img/view/2018/4/14/1707487.jpeg,0,0.945844531,0,479,800,1639,800,1160,fluttershy
1711159.jpeg,https://derpicdn.net/img/view/2018/4/18/1711159.jpeg,0,0.989819288,0,37,400,463,400,426,fluttershy
1711829.jpeg,https://derpicdn.net/img/view/2018/4/19/1711829.jpeg,0,0.998414159,661,187,1007,533,346,346,fluttershy
1712597.jpeg,https://derpicdn.net/img/view/2018/4/20/1712597.jpeg,0,0.984372735,507,0,1359,773,852,773,fluttershy
1713259.jpeg,https://derpicdn.net/img/view/2018/4/21/1713259.jpeg,0,0.998273313,33,0,833,765,800,765,fluttershy
1716013.jpeg,https://derpicdn.net/img/view/2018/4/24/1716013.jpeg,0,0.963695467,1010,1247,1930,2167,920,920,fluttershy
1720818.jpeg,https://derpicdn.net/img/view/2018/4/30/1720818.jpeg,0,0.980395734,230,27,522,319,292,292,fluttershy
1721412.jpeg,https://derpicdn.net/img/view/2018/5/1/1721412.jpeg,0,0.939783096,1650,954,2236,1540,586,586,fluttershy
1721945.jpeg,https://derpicdn.net/img/view/2018/5/1/1721945.jpeg,0,0.993147433,331,241,767,677,436,436,fluttershy
1723779.jpeg,https://derpicdn.net/img/view/2018/5/4/1723779.jpeg,0,0.977383077,0,0,955,1036,955,1036,fluttershy
1725940.jpeg,https://derpicdn.net/img/view/2018/5/6/1725940.jpeg,0,0.980430186,225,61,1975,1811,1750,1750,fluttershy
1729676.jpeg,https://derpicdn.net/img/view/2018/5/11/1729676.jpeg,0,0.999206066,291,0,605,302,314,302,fluttershy
1731616.jpeg,https://derpicdn.net/img/view/2018/5/13/1731616.jpeg,0,0.989109755,73,84,433,444,360,360,fluttershy
1731617.jpeg,https://derpicdn.net/img/view/2018/5/13/1731617.jpeg,0,0.983546436,285,112,1641,1468,1356,1356,fluttershy
1731619.jpeg,https://derpicdn.net/img/view/2018/5/13/1731619.jpeg,0,0.990383923,88,10,510,432,422,422,fluttershy
1732596.jpeg,https://derpicdn.net/img/view/2018/5/14/1732596.jpeg,0,0.997008741,542,25,1622,1105,1080,1080,fluttershy
1733563.jpeg,https://derpicdn.net/img/view/2018/5/15/1733563.jpeg,0,0.988224506,148,0,530,374,382,374,fluttershy
1734698.jpeg,https://derpicdn.net/img/view/2018/5/17/1734698.jpeg,0,0.973227024,106,0,1664,1367,1558,1367,fluttershy
1735248.jpeg,https://derpicdn.net/img/view/2018/5/18/1735248.jpeg,0,0.986637294,1570,266,2294,990,724,724,fluttershy
1735864.jpeg,https://derpicdn.net/img/view/2018/5/18/1735864.jpeg,0,0.978964984,284,326,526,568,242,242,fluttershy
1736945.jpeg,https://derpicdn.net/img/view/2018/5/20/1736945.jpeg,0,0.906213939,388,0,1196,773,808,773,fluttershy
1740681.jpeg,https://derpicdn.net/img/view/2018/5/25/1740681.jpeg,0,0.943180203,143,40,1227,1124,1084,1084,fluttershy
1745330.jpeg,https://derpicdn.net/img/view/2018/5/30/1745330.jpeg,0,0.966875434,427,157,809,539,382,382,fluttershy
1745551.jpeg,https://derpicdn.net/img/view/2018/5/30/1745551.jpeg,0,0.991241395,553,62,1347,856,794,794,fluttershy
1745899.jpeg,https://derpicdn.net/img/view/2018/5/31/1745899.jpeg,0,0.994442225,164,0,1204,1002,1040,1002,fluttershy
1746943.jpeg,https://derpicdn.net/img/view/2018/6/1/1746943.jpeg,0,0.95332247,1487,1079,2427,2019,940,940,fluttershy
1747485.jpeg,https://derpicdn.net/img/view/2018/6/2/1747485.jpeg,0,0.978997529,158,3,630,475,472,472,fluttershy
1748818.jpeg,https://derpicdn.net/img/view/2018/6/3/1748818.jpeg,0,0.995148659,1099,0,3377,2194,2278,2194,fluttershy
1753722.jpeg,https://derpicdn.net/img/view/2018/6/9/1753722.jpeg,0,0.913778722,590,166,946,522,356,356,fluttershy
1755971.jpeg,https://derpicdn.net/img/view/2018/6/12/1755971.jpeg,0,0.992380142,238,39,816,617,578,578,fluttershy
1756636.jpeg,https://derpicdn.net/img/view/2018/6/13/1756636.jpeg,0,0.998997033,255,127,555,427,300,300,fluttershy
1756663.jpeg,https://derpicdn.net/img/view/2018/6/13/1756663.jpeg,0,0.914883435,218,0,1298,1069,1080,1069,fluttershy
1758409.jpeg,https://derpicdn.net/img/view/2018/6/15/1758409.jpeg,0,0.99173677,25,0,479,436,454,436,fluttershy
1760606.jpeg,https://derpicdn.net/img/view/2018/6/18/1760606.jpeg,0,0.998619199,451,117,1195,861,744,744,fluttershy
1761284.jpeg,https://derpicdn.net/img/view/2018/6/19/1761284.jpeg,0,0.991171002,47,0,789,674,742,674,fluttershy
1762304.jpeg,https://derpicdn.net/img/view/2018/6/20/1762304.jpeg,0,0.927108645,72,0,690,602,618,602,fluttershy
1762338.jpeg,https://derpicdn.net/img/view/2018/6/20/1762338.jpeg,0,0.981460392,0,0,824,903,824,903,fluttershy
1765319.jpeg,https://derpicdn.net/img/view/2018/6/25/1765319.jpeg,0,0.923291624,1025,0,3149,2087,2124,2087,fluttershy
1767534.jpeg,https://derpicdn.net/img/view/2018/6/27/1767534.jpeg,0,0.990771353,219,0,773,513,554,513,fluttershy
1770167.jpeg,https://derpicdn.net/img/view/2018/7/1/1770167.jpeg,0,0.998661637,189,0,803,592,614,592,fluttershy
1770354.jpeg,https://derpicdn.net/img/view/2018/7/1/1770354.jpeg,0,0.997597933,891,3,1927,1039,1036,1036,fluttershy
1771365.jpeg,https://derpicdn.net/img/view/2018/7/2/1771365.jpeg,0,0.980972826,57,14,1141,1098,1084,1084,fluttershy
1772639.jpeg,https://derpicdn.net/img/view/2018/7/4/1772639.jpeg,0,0.981949925,91,0,443,330,352,330,fluttershy
1772981.jpeg,https://derpicdn.net/img/view/2018/7/4/1772981.jpeg,0,0.994492114,107,373,487,753,380,380,fluttershy
1775190.jpeg,https://derpicdn.net/img/view/2018/7/7/1775190.jpeg,0,0.961435497,932,539,1802,1409,870,870,fluttershy
1777262.jpeg,https://derpicdn.net/img/view/2018/7/10/1777262.jpeg,0,0.976627052,166,0,1398,1187,1232,1187,fluttershy
1778227.jpeg,https://derpicdn.net/img/view/2018/7/11/1778227.jpeg,0,0.98568809,283,0,1223,873,940,873,fluttershy
1778256.jpeg,https://derpicdn.net/img/view/2018/7/11/1778256.jpeg,0,0.974966645,0,0,706,713,706,713,fluttershy
1778310.jpeg,https://derpicdn.net/img/view/2018/7/11/1778310.jpeg,0,0.937410831,168,0,1294,1019,1126,1019,fluttershy
1778336.jpeg,https://derpicdn.net/img/view/2018/7/11/1778336.jpeg,0,0.959130049,25,0,1205,1064,1180,1064,fluttershy
1778337.jpeg,https://derpicdn.net/img/view/2018/7/11/1778337.jpeg,0,0.932709873,0,89,979,1165,979,1076,fluttershy
1778814.jpeg,https://derpicdn.net/img/view/2018/7/11/1778814.jpeg,0,0.95630312,44,0,446,374,402,374,fluttershy
1779561.jpeg,https://derpicdn.net/img/view/2018/7/12/1779561.jpeg,0,0.996952057,357,63,865,571,508,508,fluttershy
1782116.jpeg,https://derpicdn.net/img/view/2018/7/16/1782116.jpeg,0,0.997186661,90,0,720,537,630,537,fluttershy
1782123.jpeg,https://derpicdn.net/img/view/2018/7/16/1782123.jpeg,0,0.993761182,448,0,1260,802,812,802,fluttershy
1782286.jpeg,https://derpicdn.net/img/view/2018/7/16/1782286.jpeg,0,0.98630476,862,0,1556,665,694,665,fluttershy
1784340.jpeg,https://derpicdn.net/img/view/2018/7/19/1784340.jpeg,0,0.99016875,247,17,501,271,254,254,fluttershy
1784340.jpeg,https://derpicdn.net/img/view/2018/7/19/1784340.jpeg,1,0.942869067,427,572,755,900,328,328,fluttershy
1784407.jpeg,https://derpicdn.net/img/view/2018/7/19/1784407.jpeg,1,0.970781505,599,0,1071,509,472,509,fluttershy
1784478.jpeg,https://derpicdn.net/img/view/2018/7/19/1784478.jpeg,0,0.990652978,246,14,504,272,258,258,fluttershy
1784478.jpeg,https://derpicdn.net/img/view/2018/7/19/1784478.jpeg,1,0.933569729,428,584,728,884,300,300,fluttershy
1784715.jpeg,https://derpicdn.net/img/view/2018/7/19/1784715.jpeg,0,0.933733106,219,0,953,680,734,680,fluttershy
1784788.jpeg,https://derpicdn.net/img/view/2018/7/19/1784788.jpeg,0,0.9708004,120,0,1442,1235,1322,1235,fluttershy
1786140.jpeg,https://derpicdn.net/img/view/2018/7/21/1786140.jpeg,0,0.995992064,129,8,605,484,476,476,fluttershy
1787662.jpeg,https://derpicdn.net/img/view/2018/7/23/1787662.jpeg,0,0.977488756,39,0,869,708,830,708,fluttershy
1788668.jpeg,https://derpicdn.net/img/view/2018/7/24/1788668.jpeg,0,0.947636306,100,31,492,423,392,392,fluttershy
1788984.jpeg,https://derpicdn.net/img/view/2018/7/24/1788984.jpeg,0,0.998884916,143,0,693,537,550,537,fluttershy
1789446.jpeg,https://derpicdn.net/img/view/2018/7/25/1789446.jpeg,0,0.980393052,0,0,548,538,548,538,fluttershy
1789449.jpeg,https://derpicdn.net/img/view/2018/7/25/1789449.jpeg,0,0.938438535,28,0,656,609,628,609,fluttershy
1789451.jpeg,https://derpicdn.net/img/view/2018/7/25/1789451.jpeg,0,0.990287066,113,0,768,632,655,632,fluttershy
1789519.jpeg,https://derpicdn.net/img/view/2018/7/25/1789519.jpeg,0,0.986398637,336,16,744,424,408,408,fluttershy
1789807.jpeg,https://derpicdn.net/img/view/2018/7/25/1789807.jpeg,0,0.994688869,1421,16,2361,956,940,940,fluttershy
1792729.jpeg,https://derpicdn.net/img/view/2018/7/29/1792729.jpeg,0,0.999431789,1926,1483,2382,1939,456,456,fluttershy
1792797.jpeg,https://derpicdn.net/img/view/2018/7/29/1792797.jpeg,0,0.999011576,843,0,1625,748,782,748,fluttershy
1794291.jpeg,https://derpicdn.net/img/view/2018/7/31/1794291.jpeg,0,0.994816065,0,8,2114,2222,2114,2214,fluttershy
1795185.jpeg,https://derpicdn.net/img/view/2018/8/1/1795185.jpeg,0,0.991762221,329,0,1024,696,695,696,fluttershy
1803970.jpeg,https://derpicdn.net/img/view/2018/8/11/1803970.jpeg,0,0.965334952,211,0,937,638,726,638,fluttershy
1804234.jpeg,https://derpicdn.net/img/view/2018/8/11/1804234.jpeg,0,0.990118027,512,97,762,347,250,250,fluttershy
1805382.jpeg,https://derpicdn.net/img/view/2018/8/13/1805382.jpeg,0,0.994341671,68,0,436,353,368,353,fluttershy
1806621.jpeg,https://derpicdn.net/img/view/2018/8/14/1806621.jpeg,0,0.947372854,670,637,1562,1529,892,892,fluttershy
1807184.jpeg,https://derpicdn.net/img/view/2018/8/15/1807184.jpeg,0,0.932114124,891,428,1299,836,408,408,fluttershy
1808767.jpeg,https://derpicdn.net/img/view/2018/8/16/1808767.jpeg,0,0.989921033,0,0,338,321,338,321,fluttershy
1810657.jpeg,https://derpicdn.net/img/view/2018/8/19/1810657.jpeg,0,0.993117511,141,24,815,698,674,674,fluttershy
1810741.jpeg,https://derpicdn.net/img/view/2018/8/19/1810741.jpeg,0,0.997267127,240,67,722,549,482,482,fluttershy
1810751.jpeg,https://derpicdn.net/img/view/2018/8/19/1810751.jpeg,0,0.94671917,268,26,774,532,506,506,fluttershy
1812528.jpeg,https://derpicdn.net/img/view/2018/8/21/1812528.jpeg,0,0.92129451,51,83,761,793,710,710,fluttershy
1817560.jpeg,https://derpicdn.net/img/view/2018/8/27/1817560.jpeg,0,0.994144619,1590,453,4076,2939,2486,2486,fluttershy
1818521.jpeg,https://derpicdn.net/img/view/2018/8/28/1818521.jpeg,0,0.991493344,73,0,679,601,606,601,fluttershy
1818522.jpeg,https://derpicdn.net/img/view/2018/8/28/1818522.jpeg,0,0.967332244,80,0,732,626,652,626,fluttershy
1819941.jpeg,https://derpicdn.net/img/view/2018/8/30/1819941.jpeg,0,0.981716812,199,0,959,649,760,649,fluttershy
1820066.jpeg,https://derpicdn.net/img/view/2018/8/30/1820066.jpeg,0,0.978846431,134,0,600,453,466,453,fluttershy
1821401.jpeg,https://derpicdn.net/img/view/2018/8/31/1821401.jpeg,0,0.953503966,80,38,710,668,630,630,fluttershy
1822275.jpeg,https://derpicdn.net/img/view/2018/9/1/1822275.jpeg,0,0.994113028,1104,896,2206,1998,1102,1102,fluttershy
1827277.jpeg,https://derpicdn.net/img/view/2018/9/7/1827277.jpeg,0,0.949533045,126,311,758,943,632,632,fluttershy
1827603.jpeg,https://derpicdn.net/img/view/2018/9/8/1827603.jpeg,0,0.980075121,174,0,1048,827,874,827,fluttershy
1828199.jpeg,https://derpicdn.net/img/view/2018/9/9/1828199.jpeg,0,0.959115803,574,74,1218,718,644,644,fluttershy
1828661.jpeg,https://derpicdn.net/img/view/2018/9/9/1828661.jpeg,0,0.982275128,269,0,1905,1615,1636,1615,fluttershy
1830362.jpeg,https://derpicdn.net/img/view/2018/9/11/1830362.jpeg,0,0.990843058,400,82,940,622,540,540,fluttershy
1830396.jpeg,https://derpicdn.net/img/view/2018/9/11/1830396.jpeg,0,0.981762886,866,96,1888,1118,1022,1022,fluttershy
1831650.jpeg,https://derpicdn.net/img/view/2018/9/13/1831650.jpeg,0,0.998921633,142,0,754,588,612,588,fluttershy
1836018.jpeg,https://derpicdn.net/img/view/2018/9/19/1836018.jpeg,0,0.994515896,805,213,1041,449,236,236,fluttershy
1836018.jpeg,https://derpicdn.net/img/view/2018/9/19/1836018.jpeg,1,0.95828712,28,966,488,1426,460,460,fluttershy
1836798.jpeg,https://derpicdn.net/img/view/2018/9/20/1836798.jpeg,0,0.995123863,1406,0,2036,546,630,546,fluttershy
1836969.jpeg,https://derpicdn.net/img/view/2018/9/20/1836969.jpeg,0,0.992990911,260,0,746,468,486,468,fluttershy
1840156.jpeg,https://derpicdn.net/img/view/2018/9/24/1840156.jpeg,0,0.989388287,594,0,1366,764,772,764,fluttershy
1843626.jpeg,https://derpicdn.net/img/view/2018/9/29/1843626.jpeg,0,0.99124378,506,102,1466,1062,960,960,fluttershy
1845001.jpeg,https://derpicdn.net/img/view/2018/9/30/1845001.jpeg,0,0.986929536,242,5,568,331,326,326,fluttershy
1847889.jpeg,https://derpicdn.net/img/view/2018/10/4/1847889.jpeg,0,0.97919935,0,0,903,944,903,944,fluttershy
1850368.jpeg,https://derpicdn.net/img/view/2018/10/7/1850368.jpeg,0,0.976467133,0,34,441,498,441,464,fluttershy
1852326.jpeg,https://derpicdn.net/img/view/2018/10/9/1852326.jpeg,0,0.969792545,903,106,1745,948,842,842,fluttershy
1853404.jpeg,https://derpicdn.net/img/view/2018/10/10/1853404.jpeg,0,0.965526402,1349,323,2333,1307,984,984,fluttershy
1853560.jpeg,https://derpicdn.net/img/view/2018/10/11/1853560.jpeg,0,0.90186286,109,0,609,427,500,427,fluttershy
1854137.jpeg,https://derpicdn.net/img/view/2018/10/11/1854137.jpeg,0,0.996680439,107,20,653,566,546,546,fluttershy
1855076.jpeg,https://derpicdn.net/img/view/2018/10/13/1855076.jpeg,0,0.988794327,358,0,1920,1080,1562,1080,fluttershy
1855619.jpeg,https://derpicdn.net/img/view/2018/10/13/1855619.jpeg,0,0.963112414,126,0,1188,1060,1062,1060,fluttershy
1855768.jpeg,https://derpicdn.net/img/view/2018/10/13/1855768.jpeg,0,0.976786017,266,4,714,452,448,448,fluttershy
1857164.jpeg,https://derpicdn.net/img/view/2018/10/15/1857164.jpeg,0,0.994007885,640,0,1442,772,802,772,fluttershy
1858775.jpeg,https://derpicdn.net/img/view/2018/10/17/1858775.jpeg,0,0.961726964,472,0,3644,2616,3172,2616,fluttershy
1859910.jpeg,https://derpicdn.net/img/view/2018/10/18/1859910.jpeg,0,0.992213726,509,0,955,421,446,421,fluttershy
1860110.jpeg,https://derpicdn.net/img/view/2018/10/18/1860110.jpeg,0,0.97082752,568,0,834,223,266,223,fluttershy
1861814.jpeg,https://derpicdn.net/img/view/2018/10/20/1861814.jpeg,0,0.976359129,29,0,1341,1210,1312,1210,fluttershy
1862136.jpeg,https://derpicdn.net/img/view/2018/10/21/1862136.jpeg,0,0.988048017,86,29,584,527,498,498,fluttershy
1864921.jpeg,https://derpicdn.net/img/view/2018/10/24/1864921.jpeg,0,0.938571393,301,0,903,506,602,506,fluttershy
1865210.jpeg,https://derpicdn.net/img/view/2018/10/24/1865210.jpeg,0,0.984864295,329,122,819,612,490,490,fluttershy
1865832.jpeg,https://derpicdn.net/img/view/2018/10/25/1865832.jpeg,0,0.99577713,704,0,1744,993,1040,993,fluttershy
1866161.jpeg,https://derpicdn.net/img/view/2018/10/26/1866161.jpeg,0,0.989094853,711,228,1093,610,382,382,fluttershy
1870526.jpeg,https://derpicdn.net/img/view/2018/10/30/1870526.jpeg,0,0.900819898,271,25,845,599,574,574,fluttershy
1870651.jpeg,https://derpicdn.net/img/view/2018/10/30/1870651.jpeg,0,0.963335276,0,0,695,600,695,600,fluttershy
1870970.jpeg,https://derpicdn.net/img/view/2018/10/31/1870970.jpeg,0,0.999547064,331,98,677,444,346,346,fluttershy
1871396.jpeg,https://derpicdn.net/img/view/2018/10/31/1871396.jpeg,0,0.997102797,116,0,788,647,672,647,fluttershy
1871850.jpeg,https://derpicdn.net/img/view/2018/10/31/1871850.jpeg,0,0.987350166,147,20,643,516,496,496,fluttershy
1873126.jpeg,https://derpicdn.net/img/view/2018/11/2/1873126.jpeg,0,0.926692307,0,0,343,390,343,390,fluttershy
1873127.jpeg,https://derpicdn.net/img/view/2018/11/2/1873127.jpeg,0,0.980623305,108,29,372,293,264,264,fluttershy
1873510.jpeg,https://derpicdn.net/img/view/2018/11/2/1873510.jpeg,0,0.957460403,110,5,872,767,762,762,fluttershy
1873694.jpeg,https://derpicdn.net/img/view/2018/11/3/1873694.jpeg,0,0.985715747,0,0,1091,1046,1091,1046,fluttershy
1874934.jpeg,https://derpicdn.net/img/view/2018/11/4/1874934.jpeg,0,0.994681656,80,344,402,666,322,322,fluttershy
1875222.jpeg,https://derpicdn.net/img/view/2018/11/5/1875222.jpeg,0,0.996085048,84,32,494,442,410,410,fluttershy
1875709.jpeg,https://derpicdn.net/img/view/2018/11/5/1875709.jpeg,0,0.940585554,651,203,1639,1185,988,982,fluttershy
1877326.jpeg,https://derpicdn.net/img/view/2018/11/7/1877326.jpeg,0,0.938412428,0,0,807,738,807,738,fluttershy
1877462.jpeg,https://derpicdn.net/img/view/2018/11/8/1877462.jpeg,0,0.994872749,325,20,923,618,598,598,fluttershy
1878315.jpeg,https://derpicdn.net/img/view/2018/11/9/1878315.jpeg,0,0.993051291,79,57,453,431,374,374,fluttershy
1878540.jpeg,https://derpicdn.net/img/view/2018/11/9/1878540.jpeg,0,0.983150542,1061,630,3265,2834,2204,2204,fluttershy
1878925.jpeg,https://derpicdn.net/img/view/2018/11/10/1878925.jpeg,0,0.973674119,247,0,665,413,418,413,fluttershy
1879867.jpeg,https://derpicdn.net/img/view/2018/11/11/1879867.jpeg,0,0.949991047,13,64,1361,1412,1348,1348,fluttershy
1879901.jpeg,https://derpicdn.net/img/view/2018/11/11/1879901.jpeg,0,0.973146319,46,0,1094,1037,1048,1037,fluttershy
1880049.jpeg,https://derpicdn.net/img/view/2018/11/11/1880049.jpeg,0,0.932803333,263,140,1001,878,738,738,fluttershy
1882079.jpeg,https://derpicdn.net/img/view/2018/11/14/1882079.jpeg,0,0.98982507,0,0,716,794,716,794,fluttershy
1882220.jpeg,https://derpicdn.net/img/view/2018/11/14/1882220.jpeg,0,0.999578655,516,0,938,371,422,371,fluttershy
1882220.jpeg,https://derpicdn.net/img/view/2018/11/14/1882220.jpeg,1,0.94805336,984,72,1386,474,402,402,fluttershy
1883078.jpeg,https://derpicdn.net/img/view/2018/11/15/1883078.jpeg,0,0.996167123,471,148,1023,700,552,552,fluttershy
1884467.jpeg,https://derpicdn.net/img/view/2018/11/17/1884467.jpeg,0,0.998277009,1915,1244,2725,2054,810,810,fluttershy
1884467.jpeg,https://derpicdn.net/img/view/2018/11/17/1884467.jpeg,1,0.949792445,1013,300,1843,1130,830,830,fluttershy
1885111.jpeg,https://derpicdn.net/img/view/2018/11/18/1885111.jpeg,0,0.986354947,0,0,714,679,714,679,fluttershy
1887171.jpeg,https://derpicdn.net/img/view/2018/11/20/1887171.jpeg,0,0.996926069,400,152,930,682,530,530,fluttershy
1887652.jpeg,https://derpicdn.net/img/view/2018/11/21/1887652.jpeg,0,0.993285298,653,0,1280,618,627,618,fluttershy
1888963.jpeg,https://derpicdn.net/img/view/2018/11/23/1888963.jpeg,0,0.982263505,247,56,1365,1174,1118,1118,fluttershy
1889227.jpeg,https://derpicdn.net/img/view/2018/11/23/1889227.jpeg,0,0.989684403,153,0,2173,1819,2020,1819,fluttershy
1890509.jpeg,https://derpicdn.net/img/view/2018/11/25/1890509.jpeg,0,0.933647454,81,97,489,505,408,408,fluttershy
1890509.jpeg,https://derpicdn.net/img/view/2018/11/25/1890509.jpeg,1,0.901510179,0,0,414,423,414,423,fluttershy
1892093.jpeg,https://derpicdn.net/img/view/2018/11/27/1892093.jpeg,0,0.997944176,0,0,743,665,743,665,fluttershy
1892169.jpeg,https://derpicdn.net/img/view/2018/11/27/1892169.jpeg,0,0.934407592,328,26,688,386,360,360,fluttershy
1892984.jpeg,https://derpicdn.net/img/view/2018/11/28/1892984.jpeg,0,0.987285674,188,0,796,544,608,544,fluttershy
189350.jpeg,https://derpicdn.net/img/view/2012/12/21/189350.jpeg,0,0.995544136,390,20,790,420,400,400,fluttershy
1893582.jpeg,https://derpicdn.net/img/view/2018/11/29/1893582.jpeg,0,0.997307062,157,0,1181,1020,1024,1020,fluttershy
1894035.jpeg,https://derpicdn.net/img/view/2018/11/29/1894035.jpeg,0,0.992284358,354,1,954,601,600,600,fluttershy
1894287.jpeg,https://derpicdn.net/img/view/2018/11/30/1894287.jpeg,0,0.926536381,135,21,3355,3241,3220,3220,fluttershy
1894490.jpeg,https://derpicdn.net/img/view/2018/11/30/1894490.jpeg,0,0.974807382,963,0,2017,1008,1054,1008,fluttershy
1894608.jpeg,https://derpicdn.net/img/view/2018/11/30/1894608.jpeg,0,0.997926116,477,107,1297,927,820,820,fluttershy
1894877.jpeg,https://derpicdn.net/img/view/2018/12/1/1894877.jpeg,0,0.945222855,232,346,696,810,464,464,fluttershy
1894967.jpeg,https://derpicdn.net/img/view/2018/12/1/1894967.jpeg,0,0.987641215,100,0,808,648,708,648,fluttershy
1895510.jpeg,https://derpicdn.net/img/view/2018/12/1/1895510.jpeg,0,0.994820833,501,851,867,1217,366,366,fluttershy
1895510.jpeg,https://derpicdn.net/img/view/2018/12/1/1895510.jpeg,1,0.990742147,1044,0,1602,518,558,518,fluttershy
1895510.jpeg,https://derpicdn.net/img/view/2018/12/1/1895510.jpeg,2,0.972969472,687,377,1195,885,508,508,fluttershy
1895708.jpeg,https://derpicdn.net/img/view/2018/12/1/1895708.jpeg,0,0.964249492,57,0,655,566,598,566,fluttershy
1896317.jpeg,https://derpicdn.net/img/view/2018/12/2/1896317.jpeg,0,0.996450841,77,0,945,863,868,863,fluttershy
1896458.jpeg,https://derpicdn.net/img/view/2018/12/2/1896458.jpeg,0,0.951597929,71,0,1461,1298,1390,1298,fluttershy
1896476.jpeg,https://derpicdn.net/img/view/2018/12/2/1896476.jpeg,0,0.932168841,285,0,1479,1140,1194,1140,fluttershy
1896633.jpeg,https://derpicdn.net/img/view/2018/12/2/1896633.jpeg,0,0.993035495,0,0,606,623,606,623,fluttershy
1897468.jpeg,https://derpicdn.net/img/view/2018/12/3/1897468.jpeg,0,0.941325366,138,115,410,387,272,272,fluttershy
1901271.jpeg,https://derpicdn.net/img/view/2018/12/7/1901271.jpeg,0,0.982953608,129,0,2327,2099,2198,2099,fluttershy
1902769.jpeg,https://derpicdn.net/img/view/2018/12/8/1902769.jpeg,0,0.943388522,139,382,349,592,210,210,fluttershy
1902770.jpeg,https://derpicdn.net/img/view/2018/12/8/1902770.jpeg,0,0.996603787,343,684,591,932,248,248,fluttershy
1902770.jpeg,https://derpicdn.net/img/view/2018/12/8/1902770.jpeg,2,0.959149003,425,346,649,570,224,224,fluttershy
1902770.jpeg,https://derpicdn.net/img/view/2018/12/8/1902770.jpeg,3,0.94516027,34,720,182,868,148,148,fluttershy
1903690.jpeg,https://derpicdn.net/img/view/2018/12/9/1903690.jpeg,0,0.987730622,121,33,777,689,656,656,fluttershy
1906290.jpeg,https://derpicdn.net/img/view/2018/12/12/1906290.jpeg,0,0.997530699,549,0,979,391,430,391,fluttershy
1906315.jpeg,https://derpicdn.net/img/view/2018/12/12/1906315.jpeg,0,0.970540285,57,0,387,308,330,308,fluttershy
1908121.jpeg,https://derpicdn.net/img/view/2018/12/14/1908121.jpeg,0,0.992342055,178,90,800,712,622,622,fluttershy
1908399.jpeg,https://derpicdn.net/img/view/2018/12/14/1908399.jpeg,0,0.976832628,0,37,334,373,334,336,fluttershy
1908504.jpeg,https://derpicdn.net/img/view/2018/12/14/1908504.jpeg,0,0.927013338,546,0,1024,497,478,497,fluttershy
1915256.jpeg,https://derpicdn.net/img/view/2018/12/22/1915256.jpeg,0,0.977812707,206,49,550,393,344,344,fluttershy
1915361.jpeg,https://derpicdn.net/img/view/2018/12/22/1915361.jpeg,0,0.991740525,33,86,921,974,888,888,fluttershy
1917711.jpeg,https://derpicdn.net/img/view/2018/12/24/1917711.jpeg,0,0.999281168,484,371,778,665,294,294,fluttershy
1918331.jpeg,https://derpicdn.net/img/view/2018/12/25/1918331.jpeg,0,0.993999064,262,0,654,388,392,388,fluttershy
1918332.jpeg,https://derpicdn.net/img/view/2018/12/25/1918332.jpeg,0,0.992005467,125,0,677,526,552,526,fluttershy
1919189.jpeg,https://derpicdn.net/img/view/2018/12/26/1919189.jpeg,0,0.987059534,490,211,914,635,424,424,fluttershy
1919826.jpeg,https://derpicdn.net/img/view/2018/12/27/1919826.jpeg,0,0.964959502,74,172,300,398,226,226,fluttershy
1920163.jpeg,https://derpicdn.net/img/view/2018/12/27/1920163.jpeg,0,0.955962002,145,0,1141,971,996,971,fluttershy
1925211.jpeg,https://derpicdn.net/img/view/2019/1/2/1925211.jpeg,0,0.981591582,49,21,1165,1137,1116,1116,fluttershy
1925282.jpeg,https://derpicdn.net/img/view/2019/1/3/1925282.jpeg,0,0.998771191,85,0,553,459,468,459,fluttershy
1925395.jpeg,https://derpicdn.net/img/view/2019/1/3/1925395.jpeg,1,0.909480095,524,0,910,352,386,352,fluttershy
1926433.jpeg,https://derpicdn.net/img/view/2019/1/4/1926433.jpeg,0,0.937426448,497,33,1037,573,540,540,fluttershy
1928179.jpeg,https://derpicdn.net/img/view/2019/1/6/1928179.jpeg,0,0.997408211,182,10,820,648,638,638,fluttershy
1928664.jpeg,https://derpicdn.net/img/view/2019/1/7/1928664.jpeg,0,0.966257095,661,10,1229,578,568,568,fluttershy
1928665.jpeg,https://derpicdn.net/img/view/2019/1/7/1928665.jpeg,0,0.995443821,44,47,782,785,738,738,fluttershy
1929501.jpeg,https://derpicdn.net/img/view/2019/1/8/1929501.jpeg,0,0.989635706,244,0,646,388,402,388,fluttershy
1929916.jpeg,https://derpicdn.net/img/view/2019/1/8/1929916.jpeg,0,0.95108664,162,0,2446,2240,2284,2240,fluttershy
1930051.jpeg,https://derpicdn.net/img/view/2019/1/8/1930051.jpeg,0,0.996195376,357,0,979,606,622,606,fluttershy
1932884.jpeg,https://derpicdn.net/img/view/2019/1/12/1932884.jpeg,0,0.990614355,744,126,2366,1748,1622,1622,fluttershy
1934756.jpeg,https://derpicdn.net/img/view/2019/1/14/1934756.jpeg,0,0.974205375,371,185,987,801,616,616,fluttershy
1937064.jpeg,https://derpicdn.net/img/view/2019/1/16/1937064.jpeg,0,0.996963203,180,148,654,622,474,474,fluttershy
1937710.jpeg,https://derpicdn.net/img/view/2019/1/17/1937710.jpeg,0,0.900744021,162,220,1920,2138,1758,1918,fluttershy
1938631.jpeg,https://derpicdn.net/img/view/2019/1/18/1938631.jpeg,0,0.932857037,701,146,1253,698,552,552,fluttershy
1938925.jpeg,https://derpicdn.net/img/view/2019/1/19/1938925.jpeg,0,0.997832358,204,0,724,465,520,465,fluttershy
1938994.jpeg,https://derpicdn.net/img/view/2019/1/19/1938994.jpeg,0,0.998585582,366,45,790,469,424,424,fluttershy
1939278.jpeg,https://derpicdn.net/img/view/2019/1/19/1939278.jpeg,0,0.997771323,600,15,1346,761,746,746,fluttershy
1940117.jpeg,https://derpicdn.net/img/view/2019/1/20/1940117.jpeg,0,0.968859911,1492,699,2078,1285,586,586,fluttershy
1940233.jpeg,https://derpicdn.net/img/view/2019/1/20/1940233.jpeg,0,0.990811408,443,218,1073,848,630,630,fluttershy
1940795.jpeg,https://derpicdn.net/img/view/2019/1/21/1940795.jpeg,0,0.98021704,389,25,800,467,411,442,fluttershy
1941006.jpeg,https://derpicdn.net/img/view/2019/1/21/1941006.jpeg,0,0.982988536,847,613,1201,967,354,354,fluttershy
1941266.jpeg,https://derpicdn.net/img/view/2019/1/21/1941266.jpeg,0,0.998667896,108,0,540,404,432,404,fluttershy
1941269.jpeg,https://derpicdn.net/img/view/2019/1/21/1941269.jpeg,0,0.94288969,132,81,394,343,262,262,fluttershy
1941725.jpeg,https://derpicdn.net/img/view/2019/1/22/1941725.jpeg,0,0.969919682,319,0,1287,833,968,833,fluttershy
1944925.jpeg,https://derpicdn.net/img/view/2019/1/26/1944925.jpeg,0,0.966008484,570,0,1837,1037,1267,1037,fluttershy
1945186.jpeg,https://derpicdn.net/img/view/2019/1/26/1945186.jpeg,0,0.995566785,524,968,942,1386,418,418,fluttershy
1945583.jpeg,https://derpicdn.net/img/view/2019/1/27/1945583.jpeg,0,0.941724002,26,0,1200,1169,1174,1169,fluttershy
1946950.jpeg,https://derpicdn.net/img/view/2019/1/28/1946950.jpeg,0,0.995885015,28,0,490,442,462,442,fluttershy
1947714.jpeg,https://derpicdn.net/img/view/2019/1/29/1947714.jpeg,0,0.978350043,280,168,1140,1028,860,860,fluttershy
1948454.jpeg,https://derpicdn.net/img/view/2019/1/30/1948454.jpeg,0,0.998140991,269,143,673,547,404,404,fluttershy
1948633.jpeg,https://derpicdn.net/img/view/2019/1/30/1948633.jpeg,0,0.950226903,2074,0,3686,1478,1612,1478,fluttershy
1949630.jpeg,https://derpicdn.net/img/view/2019/1/31/1949630.jpeg,0,0.991220176,231,118,1011,898,780,780,fluttershy
1950243.jpeg,https://derpicdn.net/img/view/2019/2/1/1950243.jpeg,0,0.983814359,37,0,1009,875,972,875,fluttershy
1951488.jpeg,https://derpicdn.net/img/view/2019/2/2/1951488.jpeg,0,0.976564765,919,25,1397,503,478,478,fluttershy
1951692.jpeg,https://derpicdn.net/img/view/2019/2/3/1951692.jpeg,0,0.999693453,465,18,1197,750,732,732,fluttershy
1951693.jpeg,https://derpicdn.net/img/view/2019/2/3/1951693.jpeg,0,0.997169375,253,0,861,585,608,585,fluttershy
1953360.jpeg,https://derpicdn.net/img/view/2019/2/4/1953360.jpeg,0,0.975312114,2415,1044,3347,1976,932,932,fluttershy
1953622.jpeg,https://derpicdn.net/img/view/2019/2/4/1953622.jpeg,0,0.975266457,27,149,1139,1261,1112,1112,fluttershy
1953623.jpeg,https://derpicdn.net/img/view/2019/2/4/1953623.jpeg,0,0.946772099,15,137,1145,1267,1130,1130,fluttershy
1955169.jpeg,https://derpicdn.net/img/view/2019/2/6/1955169.jpeg,0,0.993460059,157,0,915,741,758,741,fluttershy
1956688.jpeg,https://derpicdn.net/img/view/2019/2/8/1956688.jpeg,0,0.968133092,0,228,343,580,343,352,fluttershy
1957754.jpeg,https://derpicdn.net/img/view/2019/2/9/1957754.jpeg,0,0.903953195,93,0,761,650,668,650,fluttershy
1958469.jpeg,https://derpicdn.net/img/view/2019/2/10/1958469.jpeg,0,0.998472273,418,233,778,593,360,360,fluttershy
1958474.jpeg,https://derpicdn.net/img/view/2019/2/10/1958474.jpeg,0,0.984862208,317,75,587,345,270,270,fluttershy
1958996.jpeg,https://derpicdn.net/img/view/2019/2/11/1958996.jpeg,0,0.99500066,211,0,776,607,565,607,fluttershy
1960431.jpeg,https://derpicdn.net/img/view/2019/2/12/1960431.jpeg,0,0.970479131,204,0,704,462,500,462,fluttershy
1960587.jpeg,https://derpicdn.net/img/view/2019/2/13/1960587.jpeg,0,0.990209877,615,591,1979,1909,1364,1318,fluttershy
1961416.jpeg,https://derpicdn.net/img/view/2019/2/14/1961416.jpeg,0,0.964927197,66,0,456,378,390,378,fluttershy
1961676.jpeg,https://derpicdn.net/img/view/2019/2/14/1961676.jpeg,0,0.996465623,858,527,2278,1947,1420,1420,fluttershy
1961684.jpeg,https://derpicdn.net/img/view/2019/2/14/1961684.jpeg,0,0.940977991,642,286,2634,2278,1992,1992,fluttershy
1961811.jpeg,https://derpicdn.net/img/view/2019/2/14/1961811.jpeg,0,0.994149029,411,84,1625,1298,1214,1214,fluttershy
1961828.jpeg,https://derpicdn.net/img/view/2019/2/14/1961828.jpeg,0,0.987741411,341,3,1015,677,674,674,fluttershy
1962301.jpeg,https://derpicdn.net/img/view/2019/2/14/1962301.jpeg,0,0.933776021,96,0,2126,1916,2030,1916,fluttershy
1963085.jpeg,https://derpicdn.net/img/view/2019/2/15/1963085.jpeg,0,0.974517643,239,0,951,699,712,699,fluttershy
1963440.jpeg,https://derpicdn.net/img/view/2019/2/16/1963440.jpeg,0,0.99526763,544,19,1106,581,562,562,fluttershy
1964859.jpeg,https://derpicdn.net/img/view/2019/2/17/1964859.jpeg,0,0.976581216,116,204,850,1050,734,846,fluttershy
1965047.jpeg,https://derpicdn.net/img/view/2019/2/18/1965047.jpeg,0,0.967934012,0,0,4169,4455,4169,4455,fluttershy
1965700.jpeg,https://derpicdn.net/img/view/2019/2/19/1965700.jpeg,0,0.99159658,946,0,2168,1149,1222,1149,fluttershy
196582.jpeg,https://derpicdn.net/img/view/2012/12/29/196582.jpeg,0,0.990610898,426,7,980,561,554,554,fluttershy
1967113.jpeg,https://derpicdn.net/img/view/2019/2/20/1967113.jpeg,0,0.999056101,316,33,922,639,606,606,fluttershy
1967511.jpeg,https://derpicdn.net/img/view/2019/2/21/1967511.jpeg,0,0.987060189,605,113,1607,1115,1002,1002,fluttershy
1968771.jpeg,https://derpicdn.net/img/view/2019/2/22/1968771.jpeg,0,0.998982072,0,487,2797,3695,2797,3208,fluttershy
1968771.jpeg,https://derpicdn.net/img/view/2019/2/22/1968771.jpeg,1,0.987474859,2263,166,5394,4016,3131,3850,fluttershy
1969550.jpeg,https://derpicdn.net/img/view/2019/2/23/1969550.jpeg,0,0.975216687,253,43,1425,1215,1172,1172,fluttershy
1969876.jpeg,https://derpicdn.net/img/view/2019/2/23/1969876.jpeg,0,0.900890768,0,0,1280,1687,1280,1687,fluttershy
1970400.jpeg,https://derpicdn.net/img/view/2019/2/24/1970400.jpeg,0,0.998497188,261,80,721,540,460,460,fluttershy
1971754.jpeg,https://derpicdn.net/img/view/2019/2/26/1971754.jpeg,0,0.99500227,1419,0,2865,1368,1446,1368,fluttershy
1971826.jpeg,https://derpicdn.net/img/view/2019/2/26/1971826.jpeg,0,0.960660815,373,168,881,676,508,508,fluttershy
1972233.jpeg,https://derpicdn.net/img/view/2019/2/26/1972233.jpeg,0,0.97845,246,10,658,422,412,412,fluttershy
1972513.jpeg,https://derpicdn.net/img/view/2019/2/26/1972513.jpeg,0,0.906008065,70,0,602,521,532,521,fluttershy
1973439.jpeg,https://derpicdn.net/img/view/2019/2/28/1973439.jpeg,0,0.99798274,227,214,519,506,292,292,fluttershy
1974957.jpeg,https://derpicdn.net/img/view/2019/3/1/1974957.jpeg,0,0.999376655,309,116,1017,824,708,708,fluttershy
1977867.jpeg,https://derpicdn.net/img/view/2019/3/5/1977867.jpeg,0,0.989935815,2,0,607,556,605,556,fluttershy
1979179.jpeg,https://derpicdn.net/img/view/2019/3/7/1979179.jpeg,0,0.9953053,135,0,1117,951,982,951,fluttershy
1979254.jpeg,https://derpicdn.net/img/view/2019/3/7/1979254.jpeg,0,0.99704659,322,191,658,527,336,336,fluttershy
1979872.jpeg,https://derpicdn.net/img/view/2019/3/7/1979872.jpeg,0,0.93461597,209,105,791,687,582,582,fluttershy
1981181.jpeg,https://derpicdn.net/img/view/2019/3/9/1981181.jpeg,0,0.975974381,274,0,608,309,334,309,fluttershy
1981502.jpeg,https://derpicdn.net/img/view/2019/3/9/1981502.jpeg,0,0.913655698,247,71,623,447,376,376,fluttershy
1982232.jpeg,https://derpicdn.net/img/view/2019/3/10/1982232.jpeg,0,0.95216018,60,0,826,694,766,694,fluttershy
1982451.jpeg,https://derpicdn.net/img/view/2019/3/10/1982451.jpeg,0,0.989474535,0,0,1834,2078,1834,2078,fluttershy
1983652.jpeg,https://derpicdn.net/img/view/2019/3/12/1983652.jpeg,0,0.991225541,109,72,639,602,530,530,fluttershy
1983676.jpeg,https://derpicdn.net/img/view/2019/3/12/1983676.jpeg,0,0.994379699,101,0,1217,981,1116,981,fluttershy
1984097.jpeg,https://derpicdn.net/img/view/2019/3/13/1984097.jpeg,0,0.936959743,1116,307,1958,1149,842,842,fluttershy
1985018.jpeg,https://derpicdn.net/img/view/2019/3/14/1985018.jpeg,0,0.985125363,363,0,787,405,424,405,fluttershy
1985352.jpeg,https://derpicdn.net/img/view/2019/3/14/1985352.jpeg,0,0.993667722,0,0,674,632,674,632,fluttershy
1985579.jpeg,https://derpicdn.net/img/view/2019/3/14/1985579.jpeg,0,0.949175417,751,69,1245,563,494,494,fluttershy
1985789.jpeg,https://derpicdn.net/img/view/2019/3/15/1985789.jpeg,0,0.949546278,577,0,967,342,390,342,fluttershy
1986176.jpeg,https://derpicdn.net/img/view/2019/3/15/1986176.jpeg,0,0.933279455,14,11,912,909,898,898,fluttershy
1986922.jpeg,https://derpicdn.net/img/view/2019/3/16/1986922.jpeg,0,0.996966064,201,0,923,706,722,706,fluttershy
1987761.jpeg,https://derpicdn.net/img/view/2019/3/17/1987761.jpeg,0,0.910576046,754,78,3898,3222,3144,3144,fluttershy
1989776.jpeg,https://derpicdn.net/img/view/2019/3/19/1989776.jpeg,0,0.998253524,416,0,850,415,434,415,fluttershy
1990181.jpeg,https://derpicdn.net/img/view/2019/3/19/1990181.jpeg,0,0.979203939,235,163,541,469,306,306,fluttershy
1990217.jpeg,https://derpicdn.net/img/view/2019/3/19/1990217.jpeg,0,0.984533191,33,0,1387,1351,1354,1351,fluttershy
1990976.jpeg,https://derpicdn.net/img/view/2019/3/20/1990976.jpeg,0,0.993589103,486,414,954,882,468,468,fluttershy
1991008.jpeg,https://derpicdn.net/img/view/2019/3/20/1991008.jpeg,0,0.998908222,376,139,1272,1035,896,896,fluttershy
199336.jpeg,https://derpicdn.net/img/view/2013/1/1/199336.jpeg,0,0.992126882,63,0,385,306,322,306,fluttershy
1994537.jpeg,https://derpicdn.net/img/view/2019/3/25/1994537.jpeg,0,0.998782694,457,198,943,684,486,486,fluttershy
1995567.jpeg,https://derpicdn.net/img/view/2019/3/26/1995567.jpeg,0,0.98238188,0,0,677,654,677,654,fluttershy
1995569.jpeg,https://derpicdn.net/img/view/2019/3/26/1995569.jpeg,0,0.959209263,83,0,541,452,458,452,fluttershy
1995570.jpeg,https://derpicdn.net/img/view/2019/3/26/1995570.jpeg,0,0.969028652,0,0,535,523,535,523,fluttershy
1996569.jpeg,https://derpicdn.net/img/view/2019/3/28/1996569.jpeg,0,0.996699929,494,0,1488,961,994,961,fluttershy
1996619.jpeg,https://derpicdn.net/img/view/2019/3/28/1996619.jpeg,0,0.978301406,110,0,488,356,378,356,fluttershy
1997061.jpeg,https://derpicdn.net/img/view/2019/3/28/1997061.jpeg,0,0.9983145,135,124,349,338,214,214,fluttershy
1997061.jpeg,https://derpicdn.net/img/view/2019/3/28/1997061.jpeg,1,0.985158026,302,185,570,453,268,268,fluttershy
1997735.jpeg,https://derpicdn.net/img/view/2019/3/29/1997735.jpeg,0,0.975427687,0,60,1920,2176,1920,2116,fluttershy
2000130.jpeg,https://derpicdn.net/img/view/2019/4/1/2000130.jpeg,0,0.969292581,156,0,1076,862,920,862,fluttershy
2000877.jpeg,https://derpicdn.net/img/view/2019/4/2/2000877.jpeg,0,0.984613538,203,0,1023,742,820,742,fluttershy
2001232.jpeg,https://derpicdn.net/img/view/2019/4/2/2001232.jpeg,0,0.993133366,315,0,1025,632,710,632,fluttershy
2001233.jpeg,https://derpicdn.net/img/view/2019/4/2/2001233.jpeg,0,0.910228193,324,0,812,473,488,473,fluttershy
2002966.jpeg,https://derpicdn.net/img/view/2019/4/4/2002966.jpeg,0,0.998759151,715,0,1323,581,608,581,fluttershy
2004360.jpeg,https://derpicdn.net/img/view/2019/4/6/2004360.jpeg,0,0.95476675,49,0,405,346,356,346,fluttershy
2004886.jpeg,https://derpicdn.net/img/view/2019/4/6/2004886.jpeg,0,0.996228337,187,42,605,460,418,418,fluttershy
2005278.jpeg,https://derpicdn.net/img/view/2019/4/7/2005278.jpeg,0,0.995660245,72,1,542,471,470,470,fluttershy
2005388.jpeg,https://derpicdn.net/img/view/2019/4/7/2005388.jpeg,0,0.99850738,596,55,1236,695,640,640,fluttershy
2005530.jpeg,https://derpicdn.net/img/view/2019/4/7/2005530.jpeg,0,0.996060669,354,0,992,616,638,616,fluttershy
2005590.jpeg,https://derpicdn.net/img/view/2019/4/7/2005590.jpeg,0,0.999020338,301,0,555,240,254,240,fluttershy
2005590.jpeg,https://derpicdn.net/img/view/2019/4/7/2005590.jpeg,1,0.987806678,24,410,322,708,298,298,fluttershy
2005590.jpeg,https://derpicdn.net/img/view/2019/4/7/2005590.jpeg,2,0.986924052,263,398,600,736,337,338,fluttershy
2005590.jpeg,https://derpicdn.net/img/view/2019/4/7/2005590.jpeg,3,0.955213904,44,13,302,271,258,258,fluttershy
2005694.jpeg,https://derpicdn.net/img/view/2019/4/7/2005694.jpeg,0,0.99802357,805,364,1179,738,374,374,fluttershy
2005694.jpeg,https://derpicdn.net/img/view/2019/4/7/2005694.jpeg,1,0.934532762,383,20,911,548,528,528,fluttershy
2006138.jpeg,https://derpicdn.net/img/view/2019/4/8/2006138.jpeg,0,0.918521702,303,285,613,595,310,310,fluttershy
2006890.jpeg,https://derpicdn.net/img/view/2019/4/8/2006890.jpeg,0,0.908058882,0,86,1120,1254,1120,1168,fluttershy
2007474.jpeg,https://derpicdn.net/img/view/2019/4/9/2007474.jpeg,0,0.971139669,1005,310,1837,1142,832,832,fluttershy
2007474.jpeg,https://derpicdn.net/img/view/2019/4/9/2007474.jpeg,1,0.940180957,533,4019,1419,4905,886,886,fluttershy
2008297.jpeg,https://derpicdn.net/img/view/2019/4/10/2008297.jpeg,0,0.958760679,347,683,759,1095,412,412,fluttershy
2008412.jpeg,https://derpicdn.net/img/view/2019/4/10/2008412.jpeg,0,0.994710982,141,0,627,470,486,470,fluttershy
2009142.jpeg,https://derpicdn.net/img/view/2019/4/11/2009142.jpeg,0,0.995025814,22,247,430,655,408,408,fluttershy
2011640.jpeg,https://derpicdn.net/img/view/2019/4/14/2011640.jpeg,0,0.966822445,75,0,389,302,314,302,fluttershy
2014497.jpeg,https://derpicdn.net/img/view/2019/4/16/2014497.jpeg,0,0.993320882,82,93,604,615,522,522,fluttershy
2015304.jpeg,https://derpicdn.net/img/view/2019/4/17/2015304.jpeg,0,0.910896003,41,13,459,431,418,418,fluttershy
2016127.jpeg,https://derpicdn.net/img/view/2019/4/18/2016127.jpeg,0,0.994347036,0,15,1215,1280,1215,1265,fluttershy
2016682.jpeg,https://derpicdn.net/img/view/2019/4/19/2016682.jpeg,0,0.920586765,336,0,1326,943,990,943,fluttershy
2017383.jpeg,https://derpicdn.net/img/view/2019/4/20/2017383.jpeg,0,0.972446144,483,81,729,327,246,246,fluttershy
2017789.jpeg,https://derpicdn.net/img/view/2019/4/20/2017789.jpeg,0,0.997728348,230,0,1810,1485,1580,1485,fluttershy
2018015.jpeg,https://derpicdn.net/img/view/2019/4/20/2018015.jpeg,0,0.98385644,206,0,1033,824,827,824,fluttershy
2019004.jpeg,https://derpicdn.net/img/view/2019/4/21/2019004.jpeg,0,0.97740221,86,0,777,620,691,620,fluttershy
2019359.jpeg,https://derpicdn.net/img/view/2019/4/22/2019359.jpeg,0,0.978260636,1328,22,1752,446,424,424,fluttershy
2020966.jpeg,https://derpicdn.net/img/view/2019/4/23/2020966.jpeg,0,0.99805057,0,0,1523,1555,1523,1555,fluttershy
2021447.jpeg,https://derpicdn.net/img/view/2019/4/24/2021447.jpeg,0,0.995907009,427,476,987,1036,560,560,fluttershy
2021706.jpeg,https://derpicdn.net/img/view/2019/4/24/2021706.jpeg,0,0.998038232,929,541,1521,1133,592,592,fluttershy
2023087.jpeg,https://derpicdn.net/img/view/2019/4/26/2023087.jpeg,0,0.984104931,125,5,867,747,742,742,fluttershy
2023827.jpeg,https://derpicdn.net/img/view/2019/4/27/2023827.jpeg,0,0.919931233,38,31,508,501,470,470,fluttershy
2024396.jpeg,https://derpicdn.net/img/view/2019/4/27/2024396.jpeg,0,0.999700367,536,36,1032,532,496,496,fluttershy
2026416.jpeg,https://derpicdn.net/img/view/2019/4/29/2026416.jpeg,0,0.95553565,195,0,1906,1468,1711,1468,fluttershy
2027145.jpeg,https://derpicdn.net/img/view/2019/4/30/2027145.jpeg,0,0.953595638,691,0,1889,1187,1198,1187,fluttershy
2027309.jpeg,https://derpicdn.net/img/view/2019/4/30/2027309.jpeg,0,0.977247477,23,0,1583,1200,1560,1200,fluttershy
2029708.jpeg,https://derpicdn.net/img/view/2019/5/3/2029708.jpeg,0,0.972919524,168,0,606,395,438,395,fluttershy
2030045.jpeg,https://derpicdn.net/img/view/2019/5/3/2030045.jpeg,0,0.993614435,948,527,2028,1607,1080,1080,fluttershy
2031202.jpeg,https://derpicdn.net/img/view/2019/5/5/2031202.jpeg,0,0.992649436,89,93,327,331,238,238,fluttershy
2033788.jpeg,https://derpicdn.net/img/view/2019/5/8/2033788.jpeg,0,0.952759445,170,224,538,592,368,368,fluttershy
2034891.jpeg,https://derpicdn.net/img/view/2019/5/9/2034891.jpeg,0,0.958990276,838,206,1430,798,592,592,fluttershy
2035184.jpeg,https://derpicdn.net/img/view/2019/5/10/2035184.jpeg,0,0.996164978,111,0,789,652,678,652,fluttershy
2035943.jpeg,https://derpicdn.net/img/view/2019/5/11/2035943.jpeg,0,0.997565985,279,74,1167,962,888,888,fluttershy
2036748.jpeg,https://derpicdn.net/img/view/2019/5/12/2036748.jpeg,0,0.942137659,0,199,101,301,101,102,fluttershy
2037518.jpeg,https://derpicdn.net/img/view/2019/5/12/2037518.jpeg,0,0.990883172,272,97,552,377,280,280,fluttershy
2037518.jpeg,https://derpicdn.net/img/view/2019/5/12/2037518.jpeg,1,0.921391845,516,86,828,398,312,312,fluttershy
2041666.jpeg,https://derpicdn.net/img/view/2019/5/17/2041666.jpeg,0,0.954273403,66,9,360,303,294,294,fluttershy
2042007.jpeg,https://derpicdn.net/img/view/2019/5/18/2042007.jpeg,0,0.968044996,102,0,740,591,638,591,fluttershy
2042196.jpeg,https://derpicdn.net/img/view/2019/5/18/2042196.jpeg,0,0.934669375,57,0,857,770,800,770,fluttershy
2046095.jpeg,https://derpicdn.net/img/view/2019/5/22/2046095.jpeg,0,0.961548924,134,55,1082,1003,948,948,fluttershy
2047114.jpeg,https://derpicdn.net/img/view/2019/5/23/2047114.jpeg,0,0.942652106,342,6,664,328,322,322,fluttershy
2049110.jpeg,https://derpicdn.net/img/view/2019/5/26/2049110.jpeg,0,0.982540548,66,0,1134,991,1068,991,fluttershy
2049113.jpeg,https://derpicdn.net/img/view/2019/5/26/2049113.jpeg,0,0.971080661,87,0,1029,843,942,843,fluttershy
2049302.jpeg,https://derpicdn.net/img/view/2019/5/26/2049302.jpeg,0,0.923530519,296,105,656,465,360,360,fluttershy
2051057.jpeg,https://derpicdn.net/img/view/2019/5/27/2051057.jpeg,0,0.996990085,546,0,1078,527,532,527,fluttershy
2052077.jpeg,https://derpicdn.net/img/view/2019/5/29/2052077.jpeg,0,0.961572468,0,0,770,768,770,768,fluttershy
2052209.jpeg,https://derpicdn.net/img/view/2019/5/29/2052209.jpeg,0,0.943819702,129,63,1185,1119,1056,1056,fluttershy
2052553.jpeg,https://derpicdn.net/img/view/2019/5/29/2052553.jpeg,0,0.980226994,625,0,1527,750,902,750,fluttershy
2053081.jpeg,https://derpicdn.net/img/view/2019/5/30/2053081.jpeg,0,0.987560809,115,73,849,807,734,734,fluttershy
2054342.jpeg,https://derpicdn.net/img/view/2019/5/31/2054342.jpeg,0,0.987483025,329,47,671,389,342,342,fluttershy
2055716.jpeg,https://derpicdn.net/img/view/2019/6/2/2055716.jpeg,0,0.964254677,154,226,1054,1080,900,854,fluttershy
2055761.jpeg,https://derpicdn.net/img/view/2019/6/2/2055761.jpeg,0,0.974095583,63,0,625,518,562,518,fluttershy
2056851.jpeg,https://derpicdn.net/img/view/2019/6/3/2056851.jpeg,0,0.963003635,647,185,881,419,234,234,fluttershy
2057439.jpeg,https://derpicdn.net/img/view/2019/6/4/2057439.jpeg,0,0.998627543,43,0,2245,1825,2202,1825,fluttershy
2058460.jpeg,https://derpicdn.net/img/view/2019/6/5/2058460.jpeg,0,0.99874121,377,0,1429,881,1052,881,fluttershy
2058786.jpeg,https://derpicdn.net/img/view/2019/6/5/2058786.jpeg,0,0.966124594,150,89,914,853,764,764,fluttershy
2061350.jpeg,https://derpicdn.net/img/view/2019/6/9/2061350.jpeg,0,0.996677995,138,0,1374,1208,1236,1208,fluttershy
2061366.jpeg,https://derpicdn.net/img/view/2019/6/9/2061366.jpeg,0,0.972547531,242,35,1638,1431,1396,1396,fluttershy
2061787.jpeg,https://derpicdn.net/img/view/2019/6/9/2061787.jpeg,0,0.981705368,758,926,2074,2242,1316,1316,fluttershy
2061864.jpeg,https://derpicdn.net/img/view/2019/6/10/2061864.jpeg,0,0.955695033,243,124,1645,1526,1402,1402,fluttershy
2062404.jpeg,https://derpicdn.net/img/view/2019/6/10/2062404.jpeg,0,0.99452585,495,0,1347,831,852,831,fluttershy
2062406.jpeg,https://derpicdn.net/img/view/2019/6/10/2062406.jpeg,0,0.983592749,238,0,1014,769,776,769,fluttershy
2062487.jpeg,https://derpicdn.net/img/view/2019/6/10/2062487.jpeg,0,0.976655483,150,55,602,507,452,452,fluttershy
2062688.jpeg,https://derpicdn.net/img/view/2019/6/11/2062688.jpeg,0,0.947117448,39,83,283,327,244,244,fluttershy
2066073.jpeg,https://derpicdn.net/img/view/2019/6/15/2066073.jpeg,0,0.996485412,397,137,743,483,346,346,fluttershy
2069332.jpeg,https://derpicdn.net/img/view/2019/6/19/2069332.jpeg,0,0.946290612,1252,6,1544,298,292,292,fluttershy
2070781.jpeg,https://derpicdn.net/img/view/2019/6/20/2070781.jpeg,0,0.987644255,0,0,682,642,682,642,fluttershy
2072881.jpeg,https://derpicdn.net/img/view/2019/6/23/2072881.jpeg,0,0.991298795,106,45,596,535,490,490,fluttershy
2072997.jpeg,https://derpicdn.net/img/view/2019/6/23/2072997.jpeg,0,0.996148109,199,31,587,419,388,388,fluttershy
2074475.jpeg,https://derpicdn.net/img/view/2019/6/24/2074475.jpeg,0,0.997472823,309,20,843,554,534,534,fluttershy
2075050.jpeg,https://derpicdn.net/img/view/2019/6/25/2075050.jpeg,0,0.98695296,54,191,336,473,282,282,fluttershy
2075050.jpeg,https://derpicdn.net/img/view/2019/6/25/2075050.jpeg,1,0.978950143,380,0,806,364,426,364,fluttershy
2076342.jpeg,https://derpicdn.net/img/view/2019/6/27/2076342.jpeg,0,0.99429363,689,0,1607,884,918,884,fluttershy
2077665.jpeg,https://derpicdn.net/img/view/2019/6/28/2077665.jpeg,0,0.99826628,212,0,880,642,668,642,fluttershy
207854.jpeg,https://derpicdn.net/img/view/2013/1/9/207854.jpeg,0,0.920251369,36,6,328,298,292,292,fluttershy
2078778.jpeg,https://derpicdn.net/img/view/2019/6/29/2078778.jpeg,0,0.988598347,315,41,879,605,564,564,fluttershy
2079192.jpeg,https://derpicdn.net/img/view/2019/6/30/2079192.jpeg,0,0.988322675,171,0,2217,1927,2046,1927,fluttershy
2079306.jpeg,https://derpicdn.net/img/view/2019/6/30/2079306.jpeg,0,0.995711982,541,60,923,442,382,382,fluttershy
2080798.jpeg,https://derpicdn.net/img/view/2019/7/2/2080798.jpeg,0,0.991347373,218,0,1076,846,858,846,fluttershy
2081675.jpeg,https://derpicdn.net/img/view/2019/7/3/2081675.jpeg,0,0.997400701,222,0,1064,841,842,841,fluttershy
2082912.jpeg,https://derpicdn.net/img/view/2019/7/4/2082912.jpeg,0,0.965895653,127,44,541,458,414,414,fluttershy
2083468.jpeg,https://derpicdn.net/img/view/2019/7/5/2083468.jpeg,0,0.998683274,373,8,727,362,354,354,fluttershy
2083581.jpeg,https://derpicdn.net/img/view/2019/7/5/2083581.jpeg,0,0.997853935,727,779,1000,1077,273,298,fluttershy
2083581.jpeg,https://derpicdn.net/img/view/2019/7/5/2083581.jpeg,1,0.991883039,642,14,950,322,308,308,fluttershy
2083581.jpeg,https://derpicdn.net/img/view/2019/7/5/2083581.jpeg,2,0.988138258,369,30,659,320,290,290,fluttershy
2083581.jpeg,https://derpicdn.net/img/view/2019/7/5/2083581.jpeg,3,0.953316092,19,0,423,360,404,360,fluttershy
2083584.jpeg,https://derpicdn.net/img/view/2019/7/5/2083584.jpeg,0,0.964043796,144,0,670,516,526,516,fluttershy
2083827.jpeg,https://derpicdn.net/img/view/2019/7/5/2083827.jpeg,0,0.997508883,822,20,1608,806,786,786,fluttershy
2084384.jpeg,https://derpicdn.net/img/view/2019/7/6/2084384.jpeg,0,0.99847275,420,178,908,666,488,488,fluttershy
2085294.jpeg,https://derpicdn.net/img/view/2019/7/7/2085294.jpeg,0,0.986179054,160,0,910,741,750,741,fluttershy
2085337.jpeg,https://derpicdn.net/img/view/2019/7/7/2085337.jpeg,0,0.96872437,321,0,1015,659,694,659,fluttershy
2090954.jpeg,https://derpicdn.net/img/view/2019/7/13/2090954.jpeg,0,0.964497507,689,0,1639,761,950,761,fluttershy
2092943.jpeg,https://derpicdn.net/img/view/2019/7/16/2092943.jpeg,0,0.997575164,471,847,819,1195,348,348,fluttershy
2092943.jpeg,https://derpicdn.net/img/view/2019/7/16/2092943.jpeg,1,0.959025502,304,22,634,352,330,330,fluttershy
2093702.jpeg,https://derpicdn.net/img/view/2019/7/16/2093702.jpeg,0,0.981230557,73,0,659,583,586,583,fluttershy
2093746.jpeg,https://derpicdn.net/img/view/2019/7/16/2093746.jpeg,0,0.984906316,10,8,486,484,476,476,fluttershy
2093794.jpeg,https://derpicdn.net/img/view/2019/7/17/2093794.jpeg,0,0.996826291,481,122,823,464,342,342,fluttershy
2094350.jpeg,https://derpicdn.net/img/view/2019/7/17/2094350.jpeg,0,0.961590767,614,619,1016,1021,402,402,fluttershy
2096691.jpeg,https://derpicdn.net/img/view/2019/7/20/2096691.jpeg,0,0.998124123,0,0,802,855,802,855,fluttershy
2096692.jpeg,https://derpicdn.net/img/view/2019/7/20/2096692.jpeg,0,0.985151649,0,116,1080,1268,1080,1152,fluttershy
2096740.jpeg,https://derpicdn.net/img/view/2019/7/20/2096740.jpeg,0,0.923480093,473,26,1353,906,880,880,fluttershy
2097165.jpeg,https://derpicdn.net/img/view/2019/7/21/2097165.jpeg,0,0.997886837,130,144,786,800,656,656,fluttershy
2097738.jpeg,https://derpicdn.net/img/view/2019/7/21/2097738.jpeg,0,0.986137152,345,19,1059,733,714,714,fluttershy
2098958.jpeg,https://derpicdn.net/img/view/2019/7/23/2098958.jpeg,0,0.997499466,276,120,688,532,412,412,fluttershy
2098991.jpeg,https://derpicdn.net/img/view/2019/7/23/2098991.jpeg,1,0.923924804,96,322,288,514,192,192,fluttershy
2099730.jpeg,https://derpicdn.net/img/view/2019/7/23/2099730.jpeg,0,0.991125286,13,0,451,436,438,436,fluttershy
2100347.jpeg,https://derpicdn.net/img/view/2019/7/24/2100347.jpeg,0,0.993994057,208,0,652,434,444,434,fluttershy
2100655.jpeg,https://derpicdn.net/img/view/2019/7/25/2100655.jpeg,0,0.945693493,130,0,790,618,660,618,fluttershy
2100749.jpeg,https://derpicdn.net/img/view/2019/7/25/2100749.jpeg,0,0.99919802,224,70,642,488,418,418,fluttershy
2101149.jpeg,https://derpicdn.net/img/view/2019/7/25/2101149.jpeg,0,0.933986008,120,25,886,791,766,766,fluttershy
2101152.jpeg,https://derpicdn.net/img/view/2019/7/25/2101152.jpeg,0,0.998535812,835,468,2273,1906,1438,1438,fluttershy
2104214.jpeg,https://derpicdn.net/img/view/2019/7/29/2104214.jpeg,0,0.997182429,296,0,612,309,316,309,fluttershy
2104502.jpeg,https://derpicdn.net/img/view/2019/7/30/2104502.jpeg,0,0.96845758,0,8,1222,1280,1222,1272,fluttershy
2105121.jpeg,https://derpicdn.net/img/view/2019/7/30/2105121.jpeg,0,0.985842586,508,0,1000,482,492,482,fluttershy
2106589.jpeg,https://derpicdn.net/img/view/2019/8/1/2106589.jpeg,0,0.959880531,122,20,512,420,390,400,fluttershy
2107463.jpeg,https://derpicdn.net/img/view/2019/8/2/2107463.jpeg,0,0.98016274,0,0,742,724,742,724,fluttershy
2108212.jpeg,https://derpicdn.net/img/view/2019/8/3/2108212.jpeg,0,0.998876095,89,34,861,806,772,772,fluttershy
2108559.jpeg,https://derpicdn.net/img/view/2019/8/4/2108559.jpeg,0,0.970025599,526,20,1258,752,732,732,fluttershy
2110586.jpeg,https://derpicdn.net/img/view/2019/8/6/2110586.jpeg,0,0.998081028,66,49,708,691,642,642,fluttershy
2112040.jpeg,https://derpicdn.net/img/view/2019/8/8/2112040.jpeg,0,0.98801887,508,59,1268,819,760,760,fluttershy
2112817.jpeg,https://derpicdn.net/img/view/2019/8/9/2112817.jpeg,0,0.941510737,314,0,1810,1386,1496,1386,fluttershy
2112898.jpeg,https://derpicdn.net/img/view/2019/8/9/2112898.jpeg,0,0.997729421,172,14,638,480,466,466,fluttershy
2113897.jpeg,https://derpicdn.net/img/view/2019/8/10/2113897.jpeg,1,0.96048671,117,27,455,365,338,338,fluttershy
2114527.jpeg,https://derpicdn.net/img/view/2019/8/11/2114527.jpeg,0,0.920642257,0,848,4961,6328,4961,5480,fluttershy
2114947.jpeg,https://derpicdn.net/img/view/2019/8/11/2114947.jpeg,0,0.998704195,17,88,359,430,342,342,fluttershy
2115126.jpeg,https://derpicdn.net/img/view/2019/8/11/2115126.jpeg,0,0.969535947,0,0,579,715,579,715,fluttershy
2116306.jpeg,https://derpicdn.net/img/view/2019/8/12/2116306.jpeg,0,0.982699156,555,186,1549,1180,994,994,fluttershy
2117981.jpeg,https://derpicdn.net/img/view/2019/8/14/2117981.jpeg,0,0.98042053,14,0,574,537,560,537,fluttershy
2119230.jpeg,https://derpicdn.net/img/view/2019/8/16/2119230.jpeg,0,0.989084542,85,45,571,531,486,486,fluttershy
2119536.jpeg,https://derpicdn.net/img/view/2019/8/16/2119536.jpeg,0,0.957887173,527,409,741,623,214,214,fluttershy
2119553.jpeg,https://derpicdn.net/img/view/2019/8/16/2119553.jpeg,0,0.991983712,351,234,583,466,232,232,fluttershy
2119777.jpeg,https://derpicdn.net/img/view/2019/8/16/2119777.jpeg,0,0.976051748,70,40,536,494,466,454,fluttershy
2120772.jpeg,https://derpicdn.net/img/view/2019/8/17/2120772.jpeg,0,0.997322798,791,0,1521,677,730,677,fluttershy
2121116.jpeg,https://derpicdn.net/img/view/2019/8/18/2121116.jpeg,0,0.987017393,1062,0,1822,575,760,575,fluttershy
2122826.jpeg,https://derpicdn.net/img/view/2019/8/20/2122826.jpeg,0,0.984901011,146,0,572,387,426,387,fluttershy
2126828.jpeg,https://derpicdn.net/img/view/2019/8/25/2126828.jpeg,0,0.955942988,131,0,1211,1058,1080,1058,fluttershy
2127136.jpeg,https://derpicdn.net/img/view/2019/8/25/2127136.jpeg,0,0.917405665,158,67,2376,2285,2218,2218,fluttershy
2128346.jpeg,https://derpicdn.net/img/view/2019/8/26/2128346.jpeg,0,0.948962748,0,0,620,545,620,545,fluttershy
2128349.jpeg,https://derpicdn.net/img/view/2019/8/26/2128349.jpeg,0,0.947597921,182,381,972,1171,790,790,fluttershy
2129188.jpeg,https://derpicdn.net/img/view/2019/8/27/2129188.jpeg,0,0.998491347,3304,546,5274,2516,1970,1970,fluttershy
2131772.jpeg,https://derpicdn.net/img/view/2019/8/30/2131772.jpeg,0,0.991391301,250,79,878,707,628,628,fluttershy
2133621.jpeg,https://derpicdn.net/img/view/2019/9/1/2133621.jpeg,0,0.997262478,188,4,542,358,354,354,fluttershy
2134161.jpeg,https://derpicdn.net/img/view/2019/9/2/2134161.jpeg,0,0.996379435,329,0,733,394,404,394,fluttershy
2135097.jpeg,https://derpicdn.net/img/view/2019/9/3/2135097.jpeg,0,0.948527336,38,48,668,678,630,630,fluttershy
2136465.jpeg,https://derpicdn.net/img/view/2019/9/4/2136465.jpeg,0,0.952617109,115,22,1043,950,928,928,fluttershy
2137437.jpeg,https://derpicdn.net/img/view/2019/9/6/2137437.jpeg,0,0.991282284,187,12,657,482,470,470,fluttershy
2139239.jpeg,https://derpicdn.net/img/view/2019/9/8/2139239.jpeg,0,0.93331039,100,0,1610,1080,1510,1080,fluttershy
2140218.jpeg,https://derpicdn.net/img/view/2019/9/9/2140218.jpeg,0,0.989182711,475,0,1289,782,814,782,fluttershy
2140313.jpeg,https://derpicdn.net/img/view/2019/9/9/2140313.jpeg,0,0.999252081,880,125,2090,1335,1210,1210,fluttershy
2141290.jpeg,https://derpicdn.net/img/view/2019/9/10/2141290.jpeg,0,0.972604275,71,0,577,504,506,504,fluttershy
2141939.jpeg,https://derpicdn.net/img/view/2019/9/11/2141939.jpeg,0,0.979480088,687,0,1517,757,830,757,fluttershy
2142745.jpeg,https://derpicdn.net/img/view/2019/9/13/2142745.jpeg,0,0.943935215,438,0,1453,1062,1015,1062,fluttershy
2142752.jpeg,https://derpicdn.net/img/view/2019/9/13/2142752.jpeg,0,0.985582173,53,0,875,774,822,774,fluttershy
2142970.jpeg,https://derpicdn.net/img/view/2019/9/13/2142970.jpeg,0,0.991764963,284,0,860,575,576,575,fluttershy
2144362.jpeg,https://derpicdn.net/img/view/2019/9/15/2144362.jpeg,0,0.987834036,195,53,1135,993,940,940,fluttershy
2144800.jpeg,https://derpicdn.net/img/view/2019/9/15/2144800.jpeg,0,0.986171544,0,84,947,1088,947,1004,fluttershy
2146242.jpeg,https://derpicdn.net/img/view/2019/9/17/2146242.jpeg,0,0.963362098,0,0,351,338,351,338,fluttershy
2147951.jpeg,https://derpicdn.net/img/view/2019/9/19/2147951.jpeg,1,0.984896421,274,118,806,650,532,532,fluttershy
2147951.jpeg,https://derpicdn.net/img/view/2019/9/19/2147951.jpeg,3,0.907928288,163,970,729,1536,566,566,fluttershy
2148840.jpeg,https://derpicdn.net/img/view/2019/9/20/2148840.jpeg,1,0.988914132,3,0,267,241,264,241,fluttershy
2149118.jpeg,https://derpicdn.net/img/view/2019/9/21/2149118.jpeg,0,0.956879735,168,15,830,677,662,662,fluttershy
2149468.jpeg,https://derpicdn.net/img/view/2019/9/21/2149468.jpeg,0,0.957553446,0,0,1384,1496,1384,1496,fluttershy
2149547.jpeg,https://derpicdn.net/img/view/2019/9/21/2149547.jpeg,0,0.966458976,503,974,1855,2326,1352,1352,fluttershy
215000.jpeg,https://derpicdn.net/img/view/2013/1/17/215000.jpeg,0,0.90737766,356,0,1774,1148,1418,1148,fluttershy
2151816.jpeg,https://derpicdn.net/img/view/2019/9/24/2151816.jpeg,0,0.902850568,75,0,587,470,512,470,fluttershy
2152387.jpeg,https://derpicdn.net/img/view/2019/9/25/2152387.jpeg,0,0.98983413,812,783,1488,1459,676,676,fluttershy
2153350.jpeg,https://derpicdn.net/img/view/2019/9/26/2153350.jpeg,0,0.928486943,12,0,376,327,364,327,fluttershy
2156160.jpeg,https://derpicdn.net/img/view/2019/9/29/2156160.jpeg,0,0.994398832,46,0,762,724,716,724,fluttershy
2157030.jpeg,https://derpicdn.net/img/view/2019/9/30/2157030.jpeg,0,0.997636795,242,0,464,218,222,218,fluttershy
2157210.jpeg,https://derpicdn.net/img/view/2019/10/1/2157210.jpeg,0,0.995754004,19,2,1181,1164,1162,1162,fluttershy
2157378.jpeg,https://derpicdn.net/img/view/2019/10/1/2157378.jpeg,0,0.98554945,348,0,1184,711,836,711,fluttershy
2158863.jpeg,https://derpicdn.net/img/view/2019/10/3/2158863.jpeg,0,0.994764626,375,312,1169,1106,794,794,fluttershy
2158985.jpeg,https://derpicdn.net/img/view/2019/10/3/2158985.jpeg,0,0.991322458,288,28,1798,1538,1510,1510,fluttershy
2163174.jpeg,https://derpicdn.net/img/view/2019/10/8/2163174.jpeg,0,0.95137471,0,0,774,869,774,869,fluttershy
2163623.jpeg,https://derpicdn.net/img/view/2019/10/9/2163623.jpeg,0,0.992371917,17,0,483,414,466,414,fluttershy
2163639.jpeg,https://derpicdn.net/img/view/2019/10/9/2163639.jpeg,0,0.978630126,67,0,869,799,802,799,fluttershy
2164403.jpeg,https://derpicdn.net/img/view/2019/10/10/2164403.jpeg,0,0.932174504,104,332,566,794,462,462,fluttershy
2164513.jpeg,https://derpicdn.net/img/view/2019/10/10/2164513.jpeg,0,0.971757889,284,50,580,346,296,296,fluttershy
2164688.jpeg,https://derpicdn.net/img/view/2019/10/10/2164688.jpeg,0,0.97552228,89,0,581,466,492,466,fluttershy
2166886.jpeg,https://derpicdn.net/img/view/2019/10/13/2166886.jpeg,0,0.997795701,284,0,824,503,540,503,fluttershy
2167311.jpeg,https://derpicdn.net/img/view/2019/10/13/2167311.jpeg,0,0.995696366,368,0,672,295,304,295,fluttershy
2167527.jpeg,https://derpicdn.net/img/view/2019/10/13/2167527.jpeg,0,0.999000907,683,0,1361,587,678,587,fluttershy
2168056.jpeg,https://derpicdn.net/img/view/2019/10/13/2168056.jpeg,0,0.989396155,707,42,1151,486,444,444,fluttershy
2168096.jpeg,https://derpicdn.net/img/view/2019/10/13/2168096.jpeg,0,0.989765406,98,20,574,496,476,476,fluttershy
2168972.jpeg,https://derpicdn.net/img/view/2019/10/14/2168972.jpeg,0,0.931171536,112,10,1238,1136,1126,1126,fluttershy
2170832.jpeg,https://derpicdn.net/img/view/2019/10/16/2170832.jpeg,0,0.982516527,397,10,959,572,562,562,fluttershy
2171002.jpeg,https://derpicdn.net/img/view/2019/10/16/2171002.jpeg,0,0.999207139,319,0,665,339,346,339,fluttershy
2173319.jpeg,https://derpicdn.net/img/view/2019/10/19/2173319.jpeg,0,0.9554618,167,21,1023,720,856,699,fluttershy
2174665.jpeg,https://derpicdn.net/img/view/2019/10/20/2174665.jpeg,0,0.977514207,359,9,2007,1657,1648,1648,fluttershy
2174995.jpeg,https://derpicdn.net/img/view/2019/10/21/2174995.jpeg,0,0.917688906,365,80,981,696,616,616,fluttershy
2175715.jpeg,https://derpicdn.net/img/view/2019/10/21/2175715.jpeg,0,0.951831341,0,0,895,862,895,862,fluttershy
2177535.jpeg,https://derpicdn.net/img/view/2019/10/24/2177535.jpeg,0,0.995595217,182,0,1408,1222,1226,1222,fluttershy
2179350.jpeg,https://derpicdn.net/img/view/2019/10/26/2179350.jpeg,0,0.972369969,57,0,919,824,862,824,fluttershy
2179416.jpeg,https://derpicdn.net/img/view/2019/10/26/2179416.jpeg,0,0.992008567,339,12,943,616,604,604,fluttershy
2179609.jpeg,https://derpicdn.net/img/view/2019/10/26/2179609.jpeg,0,0.995078802,509,0,1705,1187,1196,1187,fluttershy
2180700.jpeg,https://derpicdn.net/img/view/2019/10/27/2180700.jpeg,0,0.976839483,41,0,1407,1339,1366,1339,fluttershy
2180828.jpeg,https://derpicdn.net/img/view/2019/10/28/2180828.jpeg,0,0.985907197,0,35,977,1103,977,1068,fluttershy
2180985.jpeg,https://derpicdn.net/img/view/2019/10/28/2180985.jpeg,0,0.924910903,735,36,2027,1328,1292,1292,fluttershy
2182310.jpeg,https://derpicdn.net/img/view/2019/10/29/2182310.jpeg,0,0.999560773,617,14,1155,552,538,538,fluttershy
2182707.jpeg,https://derpicdn.net/img/view/2019/10/30/2182707.jpeg,0,0.952555835,1207,92,2553,1438,1346,1346,fluttershy
2183031.jpeg,https://derpicdn.net/img/view/2019/10/30/2183031.jpeg,0,0.97802788,0,0,760,852,760,852,fluttershy
2183168.jpeg,https://derpicdn.net/img/view/2019/10/30/2183168.jpeg,0,0.952540755,354,92,648,386,294,294,fluttershy
2183686.jpeg,https://derpicdn.net/img/view/2019/10/31/2183686.jpeg,0,0.993618131,212,0,1264,862,1052,862,fluttershy
2183899.jpeg,https://derpicdn.net/img/view/2019/10/31/2183899.jpeg,0,0.974327445,269,48,769,548,500,500,fluttershy
2185181.jpeg,https://derpicdn.net/img/view/2019/11/2/2185181.jpeg,0,0.985703111,115,0,597,465,482,465,fluttershy
2187703.jpeg,https://derpicdn.net/img/view/2019/11/4/2187703.jpeg,0,0.99160105,371,188,1297,1114,926,926,fluttershy
2188839.jpeg,https://derpicdn.net/img/view/2019/11/6/2188839.jpeg,0,0.999610424,588,68,2076,1556,1488,1488,fluttershy
2189107.jpeg,https://derpicdn.net/img/view/2019/11/6/2189107.jpeg,0,0.941567779,42,29,970,957,928,928,fluttershy
2190734.jpeg,https://derpicdn.net/img/view/2019/11/8/2190734.jpeg,0,0.981639862,244,0,956,693,712,693,fluttershy
2191093.jpeg,https://derpicdn.net/img/view/2019/11/9/2191093.jpeg,0,0.946464062,302,142,1000,840,698,698,fluttershy
2191994.jpeg,https://derpicdn.net/img/view/2019/11/10/2191994.jpeg,0,0.982174277,307,0,1053,724,746,724,fluttershy
2192175.jpeg,https://derpicdn.net/img/view/2019/11/10/2192175.jpeg,0,0.971669614,151,45,369,263,218,218,fluttershy
2194084.jpeg,https://derpicdn.net/img/view/2019/11/12/2194084.jpeg,0,0.990997612,7,98,813,904,806,806,fluttershy
2195432.jpeg,https://derpicdn.net/img/view/2019/11/14/2195432.jpeg,0,0.980366886,838,63,1648,873,810,810,fluttershy
2195646.jpeg,https://derpicdn.net/img/view/2019/11/14/2195646.jpeg,1,0.999040008,17,0,865,841,848,841,fluttershy
2197846.jpeg,https://derpicdn.net/img/view/2019/11/16/2197846.jpeg,0,0.997443795,73,0,639,473,566,473,fluttershy
2198977.jpeg,https://derpicdn.net/img/view/2019/11/17/2198977.jpeg,0,0.972446382,22,0,572,545,550,545,fluttershy
2200035.jpeg,https://derpicdn.net/img/view/2019/11/19/2200035.jpeg,0,0.978945732,680,225,2342,1887,1662,1662,fluttershy
2200587.jpeg,https://derpicdn.net/img/view/2019/11/20/2200587.jpeg,0,0.962176323,256,49,766,559,510,510,fluttershy
2202324.jpeg,https://derpicdn.net/img/view/2019/11/22/2202324.jpeg,0,0.977875233,673,0,1481,766,808,766,fluttershy
2202602.jpeg,https://derpicdn.net/img/view/2019/11/22/2202602.jpeg,2,0.986352682,1136,1672,2316,2852,1180,1180,fluttershy
2203544.jpeg,https://derpicdn.net/img/view/2019/11/23/2203544.jpeg,0,0.983797371,302,101,836,635,534,534,fluttershy
2204056.jpeg,https://derpicdn.net/img/view/2019/11/23/2204056.jpeg,0,0.997936964,149,0,973,621,824,621,fluttershy
2207447.jpeg,https://derpicdn.net/img/view/2019/11/28/2207447.jpeg,0,0.991398692,2670,1441,3726,2497,1056,1056,fluttershy
2207447.jpeg,https://derpicdn.net/img/view/2019/11/28/2207447.jpeg,1,0.989305317,2644,68,3982,1406,1338,1338,fluttershy
2208085.jpeg,https://derpicdn.net/img/view/2019/11/29/2208085.jpeg,0,0.959031582,200,131,1032,963,832,832,fluttershy
2209200.jpeg,https://derpicdn.net/img/view/2019/11/30/2209200.jpeg,0,0.979534328,0,0,920,938,920,938,fluttershy
2210253.jpeg,https://derpicdn.net/img/view/2019/12/1/2210253.jpeg,0,0.994592786,469,437,1697,1665,1228,1228,fluttershy
2211288.jpeg,https://derpicdn.net/img/view/2019/12/3/2211288.jpeg,0,0.980937243,48,5,302,259,254,254,fluttershy
2211346.jpeg,https://derpicdn.net/img/view/2019/12/3/2211346.jpeg,0,0.955194652,27,27,703,703,676,676,fluttershy
2211771.jpeg,https://derpicdn.net/img/view/2019/12/3/2211771.jpeg,0,0.974865019,433,0,1853,1388,1420,1388,fluttershy
2211838.jpeg,https://derpicdn.net/img/view/2019/12/3/2211838.jpeg,0,0.980831921,0,102,638,670,638,568,fluttershy
2214648.jpeg,https://derpicdn.net/img/view/2019/12/7/2214648.jpeg,0,0.986411214,542,21,1182,661,640,640,fluttershy
2214649.jpeg,https://derpicdn.net/img/view/2019/12/7/2214649.jpeg,0,0.985025525,573,34,1171,632,598,598,fluttershy
2215330.jpeg,https://derpicdn.net/img/view/2019/12/8/2215330.jpeg,0,0.990931988,346,276,1202,1132,856,856,fluttershy
2216518.jpeg,https://derpicdn.net/img/view/2019/12/9/2216518.jpeg,0,0.963559031,86,0,1062,944,976,944,fluttershy
2217002.jpeg,https://derpicdn.net/img/view/2019/12/10/2217002.jpeg,0,0.99103117,115,29,831,745,716,716,fluttershy
2217660.jpeg,https://derpicdn.net/img/view/2019/12/10/2217660.jpeg,0,0.996596992,101,53,747,699,646,646,fluttershy
2218365.jpeg,https://derpicdn.net/img/view/2019/12/11/2218365.jpeg,0,0.989992142,33,0,929,706,896,706,fluttershy
2219752.jpeg,https://derpicdn.net/img/view/2019/12/13/2219752.jpeg,0,0.977101624,47,0,866,821,819,821,fluttershy
2220080.jpeg,https://derpicdn.net/img/view/2019/12/14/2220080.jpeg,0,0.920323968,57,56,1015,1014,958,958,fluttershy
2220599.jpeg,https://derpicdn.net/img/view/2019/12/14/2220599.jpeg,0,0.974692762,132,0,802,657,670,657,fluttershy
2222068.jpeg,https://derpicdn.net/img/view/2019/12/16/2222068.jpeg,0,0.924724758,459,0,1774,1380,1315,1380,fluttershy
2222890.jpeg,https://derpicdn.net/img/view/2019/12/17/2222890.jpeg,0,0.994100273,92,0,474,358,382,358,fluttershy
2222905.jpeg,https://derpicdn.net/img/view/2019/12/17/2222905.jpeg,0,0.977710962,332,0,1044,683,712,683,fluttershy
2224209.jpeg,https://derpicdn.net/img/view/2019/12/19/2224209.jpeg,0,0.981273949,149,0,4011,3410,3862,3410,fluttershy
2224614.jpeg,https://derpicdn.net/img/view/2019/12/19/2224614.jpeg,0,0.938826799,151,0,827,631,676,631,fluttershy
232001.jpeg,https://derpicdn.net/img/view/2013/2/3/232001.jpeg,0,0.912571549,443,21,903,481,460,460,fluttershy
232790.jpeg,https://derpicdn.net/img/view/2013/2/4/232790.jpeg,0,0.976919949,1331,0,1835,424,504,424,fluttershy
236910.jpeg,https://derpicdn.net/img/view/2013/2/8/236910.jpeg,0,0.967668414,29,0,645,582,616,582,fluttershy
241277.jpeg,https://derpicdn.net/img/view/2013/2/12/241277.jpeg,0,0.990139544,242,0,598,340,356,340,fluttershy
261344.jpeg,https://derpicdn.net/img/view/2013/3/3/261344.jpeg,0,0.997004211,809,156,1349,696,540,540,fluttershy
262120.jpeg,https://derpicdn.net/img/view/2013/3/4/262120.jpeg,0,0.998378754,368,149,650,435,282,286,fluttershy
266121.jpeg,https://derpicdn.net/img/view/2013/3/8/266121.jpeg,0,0.933661819,909,648,1737,1476,828,828,fluttershy
270048.jpeg,https://derpicdn.net/img/view/2013/3/14/270048.jpeg,0,0.925460398,375,1270,995,1890,620,620,fluttershy
275484.jpeg,https://derpicdn.net/img/view/2013/3/20/275484.jpeg,0,0.997667074,328,24,796,492,468,468,fluttershy
292039.jpeg,https://derpicdn.net/img/view/2013/4/8/292039.jpeg,0,0.993941486,79,0,683,598,604,598,fluttershy
295605.jpeg,https://derpicdn.net/img/view/2013/4/12/295605.jpeg,0,0.988329649,255,13,651,409,396,396,fluttershy
297606.jpeg,https://derpicdn.net/img/view/2013/4/14/297606.jpeg,0,0.93403101,307,358,659,710,352,352,fluttershy
304081.jpeg,https://derpicdn.net/img/view/2013/4/21/304081.jpeg,0,0.98162818,420,0,2280,1765,1860,1765,fluttershy
304781.jpeg,https://derpicdn.net/img/view/2013/4/21/304781.jpeg,0,0.920443118,0,0,530,510,530,510,fluttershy
305288.jpeg,https://derpicdn.net/img/view/2013/4/22/305288.jpeg,1,0.935191453,257,183,565,491,308,308,fluttershy
308816.jpeg,https://derpicdn.net/img/view/2013/4/26/308816.jpeg,0,0.99790144,25,0,423,385,398,385,fluttershy
310400.jpeg,https://derpicdn.net/img/view/2013/4/28/310400.jpeg,0,0.991220295,233,0,1109,857,876,857,fluttershy
320046.jpeg,https://derpicdn.net/img/view/2013/5/8/320046.jpeg,0,0.986066818,388,207,810,629,422,422,fluttershy
327881.jpeg,https://derpicdn.net/img/view/2013/5/18/327881.jpeg,0,0.971648812,252,50,572,370,320,320,fluttershy
329123.jpeg,https://derpicdn.net/img/view/2013/5/19/329123.jpeg,0,0.970808089,161,48,1879,1766,1718,1718,fluttershy
332510.jpeg,https://derpicdn.net/img/view/2013/5/24/332510.jpeg,0,0.990410388,83,194,549,660,466,466,fluttershy
333534.jpeg,https://derpicdn.net/img/view/2013/5/25/333534.jpeg,0,0.981147051,146,46,766,666,620,620,fluttershy
334629.jpeg,https://derpicdn.net/img/view/2013/5/27/334629.jpeg,0,0.993598342,1061,765,2539,2243,1478,1478,fluttershy
335734.jpeg,https://derpicdn.net/img/view/2013/5/28/335734.jpeg,0,0.926074862,351,69,643,361,292,292,fluttershy
336209.jpeg,https://derpicdn.net/img/view/2013/5/29/336209.jpeg,0,0.995267034,480,221,736,477,256,256,fluttershy
339039.jpeg,https://derpicdn.net/img/view/2013/6/2/339039.jpeg,0,0.998126149,222,0,656,428,434,428,fluttershy
364935.jpeg,https://derpicdn.net/img/view/2013/7/5/364935.jpeg,0,0.922568142,1182,601,1894,1313,712,712,fluttershy
366121.jpeg,https://derpicdn.net/img/view/2013/7/6/366121.jpeg,0,0.999108136,386,146,908,668,522,522,fluttershy
382587.jpeg,https://derpicdn.net/img/view/2013/7/24/382587.jpeg,0,0.989077032,574,270,1942,1638,1368,1368,fluttershy
388413.jpeg,https://derpicdn.net/img/view/2013/8/1/388413.jpeg,0,0.990342498,9,0,1005,993,996,993,fluttershy
399234.jpeg,https://derpicdn.net/img/view/2013/8/13/399234.jpeg,0,0.959967375,198,59,2302,2163,2104,2104,fluttershy
413360.jpeg,https://derpicdn.net/img/view/2013/8/29/413360.jpeg,0,0.999482632,623,170,1445,992,822,822,fluttershy
418629.jpeg,https://derpicdn.net/img/view/2013/9/4/418629.jpeg,0,0.983305097,165,0,691,508,526,508,fluttershy
423985.jpeg,https://derpicdn.net/img/view/2013/9/10/423985.jpeg,0,0.928086877,332,1,524,193,192,192,fluttershy
424388.jpeg,https://derpicdn.net/img/view/2013/9/10/424388.jpeg,0,0.992354691,813,265,2651,2103,1838,1838,fluttershy
428080.jpeg,https://derpicdn.net/img/view/2013/9/15/428080.jpeg,0,0.925048649,108,0,356,240,248,240,fluttershy
432281.jpeg,https://derpicdn.net/img/view/2013/9/21/432281.jpeg,0,0.921118498,194,3,768,581,574,578,fluttershy
434694.jpeg,https://derpicdn.net/img/view/2013/9/25/434694.jpeg,0,0.946422815,386,74,600,296,214,222,fluttershy
435602.jpeg,https://derpicdn.net/img/view/2013/9/26/435602.jpeg,0,0.99675405,211,47,609,445,398,398,fluttershy
435984.jpeg,https://derpicdn.net/img/view/2013/9/27/435984.jpeg,0,0.99266535,230,0,1930,1659,1700,1659,fluttershy
452742.jpeg,https://derpicdn.net/img/view/2013/10/20/452742.jpeg,0,0.999720871,1780,228,2294,742,514,514,fluttershy
452742.jpeg,https://derpicdn.net/img/view/2013/10/20/452742.jpeg,1,0.999456942,20,1436,554,1970,534,534,fluttershy
452742.jpeg,https://derpicdn.net/img/view/2013/10/20/452742.jpeg,2,0.999383032,2756,2512,3340,3096,584,584,fluttershy
452742.jpeg,https://derpicdn.net/img/view/2013/10/20/452742.jpeg,4,0.998421729,1016,228,1544,756,528,528,fluttershy
452742.jpeg,https://derpicdn.net/img/view/2013/10/20/452742.jpeg,5,0.998145938,2785,1419,3319,1953,534,534,fluttershy
452742.jpeg,https://derpicdn.net/img/view/2013/10/20/452742.jpeg,6,0.989812016,148,2660,648,3160,500,500,fluttershy
452742.jpeg,https://derpicdn.net/img/view/2013/10/20/452742.jpeg,7,0.942369759,2061,2627,2547,3113,486,486,fluttershy
453102.jpeg,https://derpicdn.net/img/view/2013/10/20/453102.jpeg,0,0.99557513,320,0,830,436,510,436,fluttershy
460012.jpeg,https://derpicdn.net/img/view/2013/10/30/460012.jpeg,0,0.973302126,1403,450,2463,1510,1060,1060,fluttershy
462483.jpeg,https://derpicdn.net/img/view/2013/11/2/462483.jpeg,0,0.981582403,549,402,961,814,412,412,fluttershy
462619.jpeg,https://derpicdn.net/img/view/2013/11/2/462619.jpeg,0,0.977589846,260,253,456,449,196,196,fluttershy
462619.jpeg,https://derpicdn.net/img/view/2013/11/2/462619.jpeg,2,0.92945838,1045,229,1199,383,154,154,fluttershy
464981.jpeg,https://derpicdn.net/img/view/2013/11/5/464981.jpeg,0,0.983280182,109,0,611,495,502,495,fluttershy
465076.jpeg,https://derpicdn.net/img/view/2013/11/5/465076.jpeg,0,0.928344667,124,31,594,501,470,470,fluttershy
465435.jpeg,https://derpicdn.net/img/view/2013/11/6/465435.jpeg,0,0.920271635,44,38,392,388,348,350,fluttershy
468847.jpeg,https://derpicdn.net/img/view/2013/11/10/468847.jpeg,0,0.957018197,789,0,3000,1842,2211,1842,fluttershy
475114.jpeg,https://derpicdn.net/img/view/2013/11/18/475114.jpeg,0,0.987136841,0,0,1171,1141,1171,1141,fluttershy
475776.jpeg,https://derpicdn.net/img/view/2013/11/19/475776.jpeg,0,0.963549614,160,289,318,447,158,158,fluttershy
493236.jpeg,https://derpicdn.net/img/view/2013/12/8/493236.jpeg,0,0.995158911,471,9,939,477,468,468,fluttershy
495443.jpeg,https://derpicdn.net/img/view/2013/12/12/495443.jpeg,0,0.993480742,184,0,376,185,192,185,fluttershy
498727.jpeg,https://derpicdn.net/img/view/2013/12/16/498727.jpeg,0,0.91360414,380,15,1586,1221,1206,1206,fluttershy
499477.jpeg,https://derpicdn.net/img/view/2013/12/17/499477.jpeg,0,0.986254394,234,0,434,196,200,196,fluttershy
507365.jpeg,https://derpicdn.net/img/view/2013/12/27/507365.jpeg,0,0.995739579,141,83,363,305,222,222,fluttershy
507365.jpeg,https://derpicdn.net/img/view/2013/12/27/507365.jpeg,1,0.968908727,577,80,813,316,236,236,fluttershy
508575.jpeg,https://derpicdn.net/img/view/2013/12/28/508575.jpeg,0,0.996056199,831,58,1247,474,416,416,fluttershy
508768.jpeg,https://derpicdn.net/img/view/2013/12/29/508768.jpeg,0,0.966858387,152,0,962,770,810,770,fluttershy
509276.jpeg,https://derpicdn.net/img/view/2013/12/29/509276.jpeg,0,0.98615545,472,327,1248,1103,776,776,fluttershy
509292.jpeg,https://derpicdn.net/img/view/2013/12/29/509292.jpeg,0,0.942686081,1072,74,1766,768,694,694,fluttershy
509362.jpeg,https://derpicdn.net/img/view/2013/12/29/509362.jpeg,0,0.975758612,355,366,765,776,410,410,fluttershy
509469.jpeg,https://derpicdn.net/img/view/2013/12/29/509469.jpeg,0,0.967625618,217,196,431,410,214,214,fluttershy
509522.jpeg,https://derpicdn.net/img/view/2013/12/29/509522.jpeg,0,0.957854152,494,746,1116,1368,622,622,fluttershy
510578.jpeg,https://derpicdn.net/img/view/2013/12/31/510578.jpeg,0,0.994078934,427,0,3399,2791,2972,2791,fluttershy
512290.jpeg,https://derpicdn.net/img/view/2014/1/1/512290.jpeg,0,0.987374008,296,55,756,515,460,460,fluttershy
513965.jpeg,https://derpicdn.net/img/view/2014/1/3/513965.jpeg,0,0.998035312,143,32,619,508,476,476,fluttershy
514458.jpeg,https://derpicdn.net/img/view/2014/1/4/514458.jpeg,0,0.937043786,558,0,1260,646,702,646,fluttershy
514519.jpeg,https://derpicdn.net/img/view/2014/1/4/514519.jpeg,0,0.989374459,543,384,859,768,316,384,fluttershy
514519.jpeg,https://derpicdn.net/img/view/2014/1/4/514519.jpeg,1,0.98185277,0,0,280,242,280,242,fluttershy
514519.jpeg,https://derpicdn.net/img/view/2014/1/4/514519.jpeg,2,0.976127803,102,585,482,965,380,380,fluttershy
514519.jpeg,https://derpicdn.net/img/view/2014/1/4/514519.jpeg,3,0.900597572,370,0,704,281,334,281,fluttershy
514757.jpeg,https://derpicdn.net/img/view/2014/1/4/514757.jpeg,0,0.9829638,258,0,592,329,334,329,fluttershy
517721.jpeg,https://derpicdn.net/img/view/2014/1/7/517721.jpeg,0,0.991925776,261,963,1049,1751,788,788,fluttershy
517721.jpeg,https://derpicdn.net/img/view/2014/1/7/517721.jpeg,1,0.911032856,449,236,979,766,530,530,fluttershy
518240.jpeg,https://derpicdn.net/img/view/2014/1/7/518240.jpeg,0,0.957278907,893,252,1345,704,452,452,fluttershy
518576.jpeg,https://derpicdn.net/img/view/2014/1/8/518576.jpeg,0,0.99763,239,44,591,396,352,352,fluttershy
522840.jpeg,https://derpicdn.net/img/view/2014/1/12/522840.jpeg,0,0.99320668,193,402,663,872,470,470,fluttershy
523513.jpeg,https://derpicdn.net/img/view/2014/1/13/523513.jpeg,0,0.994279504,1046,0,1352,289,306,289,fluttershy
529438.jpeg,https://derpicdn.net/img/view/2014/1/20/529438.jpeg,0,0.968590796,18,0,1140,1047,1122,1047,fluttershy
531476.jpeg,https://derpicdn.net/img/view/2014/1/22/531476.jpeg,0,0.995019555,493,0,797,302,304,302,fluttershy
531476.jpeg,https://derpicdn.net/img/view/2014/1/22/531476.jpeg,1,0.924034417,231,387,711,867,480,480,fluttershy
553276.jpeg,https://derpicdn.net/img/view/2014/2/15/553276.jpeg,0,0.982088387,200,121,762,683,562,562,fluttershy
555424.jpeg,https://derpicdn.net/img/view/2014/2/18/555424.jpeg,0,0.993549168,238,0,612,348,374,348,fluttershy
558292.jpeg,https://derpicdn.net/img/view/2014/2/21/558292.jpeg,0,0.972356737,269,34,833,598,564,564,fluttershy
558383.jpeg,https://derpicdn.net/img/view/2014/2/21/558383.jpeg,0,0.92547071,253,11,595,353,342,342,fluttershy
559895.jpeg,https://derpicdn.net/img/view/2014/2/23/559895.jpeg,0,0.971506238,494,0,1324,816,830,816,fluttershy
563424.jpeg,https://derpicdn.net/img/view/2014/2/28/563424.jpeg,0,0.972034276,76,51,688,663,612,612,fluttershy
563700.jpeg,https://derpicdn.net/img/view/2014/2/28/563700.jpeg,0,0.984612823,260,38,546,324,286,286,fluttershy
564469.jpeg,https://derpicdn.net/img/view/2014/3/1/564469.jpeg,0,0.955739558,360,34,1162,836,802,802,fluttershy
564971.jpeg,https://derpicdn.net/img/view/2014/3/2/564971.jpeg,0,0.998830974,60,0,562,483,502,483,fluttershy
573925.jpeg,https://derpicdn.net/img/view/2014/3/13/573925.jpeg,0,0.958862245,7,5,253,251,246,246,fluttershy
577004.jpeg,https://derpicdn.net/img/view/2014/3/16/577004.jpeg,0,0.94942987,30,0,408,364,378,364,fluttershy
597726.jpeg,https://derpicdn.net/img/view/2014/4/11/597726.jpeg,0,0.998889089,209,40,535,366,326,326,fluttershy
599849.jpeg,https://derpicdn.net/img/view/2014/4/13/599849.jpeg,0,0.959843934,115,0,959,831,844,831,fluttershy
601932.jpeg,https://derpicdn.net/img/view/2014/4/16/601932.jpeg,0,0.994212985,0,1364,329,1694,329,330,fluttershy
601932.jpeg,https://derpicdn.net/img/view/2014/4/16/601932.jpeg,2,0.947619379,10,112,478,580,468,468,fluttershy
611283.jpeg,https://derpicdn.net/img/view/2014/4/27/611283.jpeg,0,0.960725665,687,0,2935,2084,2248,2084,fluttershy
625644.jpeg,https://derpicdn.net/img/view/2014/5/13/625644.jpeg,0,0.97033596,237,0,833,560,596,560,fluttershy
629637.jpeg,https://derpicdn.net/img/view/2014/5/18/629637.jpeg,0,0.965566337,124,7,712,595,588,588,fluttershy
635515.jpeg,https://derpicdn.net/img/view/2014/5/24/635515.jpeg,0,0.995761395,130,115,346,331,216,216,fluttershy
635515.jpeg,https://derpicdn.net/img/view/2014/5/24/635515.jpeg,1,0.986625373,545,83,821,359,276,276,fluttershy
635675.jpeg,https://derpicdn.net/img/view/2014/5/24/635675.jpeg,0,0.934620738,26,0,216,182,190,182,fluttershy
638810.jpeg,https://derpicdn.net/img/view/2014/5/28/638810.jpeg,0,0.953270733,582,0,1004,410,422,410,fluttershy
642841.jpeg,https://derpicdn.net/img/view/2014/6/2/642841.jpeg,0,0.981039524,186,494,390,698,204,204,fluttershy
643271.jpeg,https://derpicdn.net/img/view/2014/6/2/643271.jpeg,0,0.950994074,0,89,500,733,500,644,fluttershy
644597.jpeg,https://derpicdn.net/img/view/2014/6/4/644597.jpeg,0,0.999420881,272,0,954,651,682,651,fluttershy
644771.jpeg,https://derpicdn.net/img/view/2014/6/4/644771.jpeg,0,0.939471304,153,0,431,275,278,275,fluttershy
645264.jpeg,https://derpicdn.net/img/view/2014/6/5/645264.jpeg,0,0.98415637,558,0,1012,431,454,431,fluttershy
648025.jpeg,https://derpicdn.net/img/view/2014/6/8/648025.jpeg,0,0.991424501,1488,642,2096,1250,608,608,fluttershy
656758.jpeg,https://derpicdn.net/img/view/2014/6/19/656758.jpeg,0,0.994135141,195,0,617,416,422,416,fluttershy
662664.jpeg,https://derpicdn.net/img/view/2014/6/27/662664.jpeg,0,0.992320359,85,0,971,731,886,731,fluttershy
663695.jpeg,https://derpicdn.net/img/view/2014/6/29/663695.jpeg,0,0.931290567,567,193,881,507,314,314,fluttershy
664782.jpeg,https://derpicdn.net/img/view/2014/6/30/664782.jpeg,0,0.99497056,11,44,241,274,230,230,fluttershy
668742.jpeg,https://derpicdn.net/img/view/2014/7/6/668742.jpeg,0,0.928648531,128,62,396,330,268,268,fluttershy
688152.jpeg,https://derpicdn.net/img/view/2014/8/1/688152.jpeg,0,0.990323067,262,226,624,588,362,362,fluttershy
690133.jpeg,https://derpicdn.net/img/view/2014/8/3/690133.jpeg,0,0.984329641,1209,156,2145,1092,936,936,fluttershy
692533.jpeg,https://derpicdn.net/img/view/2014/8/6/692533.jpeg,0,0.992761612,540,0,986,371,446,371,fluttershy
692533.jpeg,https://derpicdn.net/img/view/2014/8/6/692533.jpeg,1,0.992624998,24,0,476,452,452,452,fluttershy
695203.jpeg,https://derpicdn.net/img/view/2014/8/9/695203.jpeg,0,0.998223364,970,498,1682,1210,712,712,fluttershy
695369.jpeg,https://derpicdn.net/img/view/2014/8/9/695369.jpeg,0,0.995892763,320,100,854,634,534,534,fluttershy
701574.jpeg,https://derpicdn.net/img/view/2014/8/17/701574.jpeg,0,0.995121002,34,0,1830,1080,1796,1080,fluttershy
709143.jpeg,https://derpicdn.net/img/view/2014/8/27/709143.jpeg,0,0.976312876,437,76,811,450,374,374,fluttershy
711764.jpeg,https://derpicdn.net/img/view/2014/8/31/711764.jpeg,0,0.960642755,329,23,755,449,426,426,fluttershy
712975.jpeg,https://derpicdn.net/img/view/2014/9/1/712975.jpeg,0,0.986854255,0,0,1120,1108,1120,1108,fluttershy
718061.jpeg,https://derpicdn.net/img/view/2014/9/8/718061.jpeg,0,0.962816596,1202,743,2096,1637,894,894,fluttershy
723339.jpeg,https://derpicdn.net/img/view/2014/9/16/723339.jpeg,0,0.990733504,265,13,649,397,384,384,fluttershy
730004.jpeg,https://derpicdn.net/img/view/2014/9/26/730004.jpeg,0,0.999174654,545,834,1311,1600,766,766,fluttershy
738493.jpeg,https://derpicdn.net/img/view/2014/10/8/738493.jpeg,1,0.958964646,1518,0,2280,755,762,755,fluttershy
738840.jpeg,https://derpicdn.net/img/view/2014/10/8/738840.jpeg,0,0.967332423,802,1705,1958,2861,1156,1156,fluttershy
745227.jpeg,https://derpicdn.net/img/view/2014/10/18/745227.jpeg,0,0.949084461,499,0,1983,1260,1484,1260,fluttershy
748484.jpeg,https://derpicdn.net/img/view/2014/10/22/748484.jpeg,0,0.998043895,0,6,1141,1198,1141,1192,fluttershy
751602.jpeg,https://derpicdn.net/img/view/2014/10/27/751602.jpeg,0,0.995435178,267,32,905,670,638,638,fluttershy
754602.jpeg,https://derpicdn.net/img/view/2014/10/31/754602.jpeg,0,0.976179779,72,0,2250,2254,2178,2254,fluttershy
757637.jpeg,https://derpicdn.net/img/view/2014/11/4/757637.jpeg,0,0.937221169,288,344,760,816,472,472,fluttershy
757637.jpeg,https://derpicdn.net/img/view/2014/11/4/757637.jpeg,1,0.924916387,547,82,1103,638,556,556,fluttershy
7605.jpeg,https://derpicdn.net/img/view/2012/6/18/7605.jpeg,0,0.983446598,26,0,945,854,919,854,fluttershy
760536.jpeg,https://derpicdn.net/img/view/2014/11/8/760536.jpeg,1,0.960642517,1980,837,2844,1701,864,864,fluttershy
760806.jpeg,https://derpicdn.net/img/view/2014/11/8/760806.jpeg,0,0.979630589,1326,283,1650,607,324,324,fluttershy
761106.jpeg,https://derpicdn.net/img/view/2014/11/9/761106.jpeg,0,0.988231838,245,1301,883,1939,638,638,fluttershy
763618.jpeg,https://derpicdn.net/img/view/2014/11/13/763618.jpeg,0,0.988260686,22,13,838,829,816,816,fluttershy
764584.jpeg,https://derpicdn.net/img/view/2014/11/14/764584.jpeg,0,0.956929982,98,17,1024,951,926,934,fluttershy
770488.jpeg,https://derpicdn.net/img/view/2014/11/23/770488.jpeg,0,0.987031043,0,74,449,560,449,486,fluttershy
774086.jpeg,https://derpicdn.net/img/view/2014/11/29/774086.jpeg,0,0.956295788,0,56,445,514,445,458,fluttershy
776625.jpeg,https://derpicdn.net/img/view/2014/12/2/776625.jpeg,0,0.998209536,175,0,805,599,630,599,fluttershy
778868.jpeg,https://derpicdn.net/img/view/2014/12/6/778868.jpeg,0,0.964603543,362,227,788,653,426,426,fluttershy
784547.jpeg,https://derpicdn.net/img/view/2014/12/14/784547.jpeg,0,0.997155488,60,0,354,280,294,280,fluttershy
786227.jpeg,https://derpicdn.net/img/view/2014/12/16/786227.jpeg,0,0.969950616,137,0,741,587,604,587,fluttershy
786242.jpeg,https://derpicdn.net/img/view/2014/12/16/786242.jpeg,0,0.998067975,694,38,1212,556,518,518,fluttershy
788074.jpeg,https://derpicdn.net/img/view/2014/12/19/788074.jpeg,0,0.94076246,953,0,1765,766,812,766,fluttershy
788243.jpeg,https://derpicdn.net/img/view/2014/12/19/788243.jpeg,0,0.981157303,141,11,641,511,500,500,fluttershy
788802.jpeg,https://derpicdn.net/img/view/2014/12/20/788802.jpeg,0,0.996992707,569,30,1451,912,882,882,fluttershy
796220.jpeg,https://derpicdn.net/img/view/2014/12/30/796220.jpeg,0,0.997413516,296,0,528,227,232,227,fluttershy
797791.jpeg,https://derpicdn.net/img/view/2015/1/2/797791.jpeg,0,0.998666108,350,2,1590,1242,1240,1240,fluttershy
801607.jpeg,https://derpicdn.net/img/view/2015/1/7/801607.jpeg,0,0.960113943,177,0,611,414,434,414,fluttershy
802516.jpeg,https://derpicdn.net/img/view/2015/1/9/802516.jpeg,0,0.906690896,54,0,532,474,478,474,fluttershy
802769.jpeg,https://derpicdn.net/img/view/2015/1/9/802769.jpeg,0,0.971387267,974,968,2176,2170,1202,1202,fluttershy
807895.jpeg,https://derpicdn.net/img/view/2015/1/16/807895.jpeg,0,0.994837046,744,800,1286,1342,542,542,fluttershy
819706.jpeg,https://derpicdn.net/img/view/2015/2/2/819706.jpeg,0,0.952631831,0,23,777,903,777,880,fluttershy
820128.jpeg,https://derpicdn.net/img/view/2015/2/2/820128.jpeg,0,0.987051189,101,0,461,345,360,345,fluttershy
830594.jpeg,https://derpicdn.net/img/view/2015/2/17/830594.jpeg,0,0.995384395,1872,419,3054,1601,1182,1182,fluttershy
833480.jpeg,https://derpicdn.net/img/view/2015/2/20/833480.jpeg,0,0.994189203,158,570,354,766,196,196,fluttershy
833480.jpeg,https://derpicdn.net/img/view/2015/2/20/833480.jpeg,1,0.975368977,107,167,321,381,214,214,fluttershy
833480.jpeg,https://derpicdn.net/img/view/2015/2/20/833480.jpeg,2,0.971358657,562,198,774,410,212,212,fluttershy
833480.jpeg,https://derpicdn.net/img/view/2015/2/20/833480.jpeg,3,0.934287488,335,548,545,758,210,210,fluttershy
833480.jpeg,https://derpicdn.net/img/view/2015/2/20/833480.jpeg,4,0.932599008,302,134,556,388,254,254,fluttershy
833875.jpeg,https://derpicdn.net/img/view/2015/2/21/833875.jpeg,1,0.989750385,633,63,1167,597,534,534,fluttershy
834354.jpeg,https://derpicdn.net/img/view/2015/2/21/834354.jpeg,0,0.989573896,142,0,2834,2412,2692,2412,fluttershy
835468.jpeg,https://derpicdn.net/img/view/2015/2/23/835468.jpeg,0,0.999532819,394,0,814,397,420,397,fluttershy
837384.jpeg,https://derpicdn.net/img/view/2015/2/25/837384.jpeg,0,0.988670111,0,0,1280,1327,1280,1327,fluttershy
841092.jpeg,https://derpicdn.net/img/view/2015/3/2/841092.jpeg,0,0.964529872,390,0,1118,664,728,664,fluttershy
846698.jpeg,https://derpicdn.net/img/view/2015/3/10/846698.jpeg,0,0.973045647,25,0,411,357,386,357,fluttershy
849723.jpeg,https://derpicdn.net/img/view/2015/3/15/849723.jpeg,0,0.976986349,86,0,388,302,302,302,fluttershy
854286.jpeg,https://derpicdn.net/img/view/2015/3/21/854286.jpeg,0,0.983784914,0,0,671,710,671,710,fluttershy
858521.jpeg,https://derpicdn.net/img/view/2015/3/27/858521.jpeg,0,0.932983696,512,19,892,399,380,380,fluttershy
861016.jpeg,https://derpicdn.net/img/view/2015/3/30/861016.jpeg,0,0.957826078,307,101,1242,1043,935,942,fluttershy
864533.jpeg,https://derpicdn.net/img/view/2015/4/4/864533.jpeg,0,0.963496625,0,0,1196,806,1196,806,fluttershy
869590.jpeg,https://derpicdn.net/img/view/2015/4/9/869590.jpeg,0,0.958925605,184,18,1202,1036,1018,1018,fluttershy
877710.jpeg,https://derpicdn.net/img/view/2015/4/19/877710.jpeg,0,0.989664376,14,0,1640,1593,1626,1593,fluttershy
881569.jpeg,https://derpicdn.net/img/view/2015/4/24/881569.jpeg,0,0.967582762,0,0,1000,1011,1000,1011,fluttershy
884953.jpeg,https://derpicdn.net/img/view/2015/4/28/884953.jpeg,0,0.998359978,304,0,754,413,450,413,fluttershy
887724.jpeg,https://derpicdn.net/img/view/2015/5/2/887724.jpeg,0,0.995431781,284,34,942,692,658,658,fluttershy
889533.jpeg,https://derpicdn.net/img/view/2015/5/5/889533.jpeg,0,0.985523403,73,0,789,675,716,675,fluttershy
889533.jpeg,https://derpicdn.net/img/view/2015/5/5/889533.jpeg,1,0.975038826,705,319,1165,779,460,460,fluttershy
891275.jpeg,https://derpicdn.net/img/view/2015/5/7/891275.jpeg,0,0.975824594,234,27,410,203,176,176,fluttershy
891275.jpeg,https://derpicdn.net/img/view/2015/5/7/891275.jpeg,1,0.924602389,767,391,947,571,180,180,fluttershy
894244.jpeg,https://derpicdn.net/img/view/2015/5/11/894244.jpeg,0,0.984698594,106,17,310,221,204,204,fluttershy
895624.jpeg,https://derpicdn.net/img/view/2015/5/14/895624.jpeg,0,0.905076444,1244,0,1936,641,692,641,fluttershy
898166.jpeg,https://derpicdn.net/img/view/2015/5/17/898166.jpeg,0,0.97680819,1088,0,2324,1234,1236,1234,fluttershy
898166.jpeg,https://derpicdn.net/img/view/2015/5/17/898166.jpeg,1,0.958089888,512,705,1924,2117,1412,1412,fluttershy
899889.jpeg,https://derpicdn.net/img/view/2015/5/19/899889.jpeg,0,0.961939931,0,0,259,255,259,255,fluttershy
908383.jpeg,https://derpicdn.net/img/view/2015/6/1/908383.jpeg,0,0.997127175,312,9,1144,841,832,832,fluttershy
909055.jpeg,https://derpicdn.net/img/view/2015/6/2/909055.jpeg,0,0.907403827,135,0,900,848,765,848,fluttershy
916821.jpeg,https://derpicdn.net/img/view/2015/6/14/916821.jpeg,0,0.961105049,0,0,788,815,788,815,fluttershy
918968.jpeg,https://derpicdn.net/img/view/2015/6/17/918968.jpeg,0,0.944872618,403,201,1155,953,752,752,fluttershy
926143.jpeg,https://derpicdn.net/img/view/2015/6/29/926143.jpeg,0,0.977323234,244,0,918,573,674,573,fluttershy
926454.jpeg,https://derpicdn.net/img/view/2015/6/29/926454.jpeg,0,0.90471822,457,41,1165,749,708,708,fluttershy
938077.jpeg,https://derpicdn.net/img/view/2015/7/16/938077.jpeg,0,0.974658847,305,67,847,609,542,542,fluttershy
945261.jpeg,https://derpicdn.net/img/view/2015/7/27/945261.jpeg,0,0.933994234,0,160,2425,3174,2425,3014,fluttershy
945884.jpeg,https://derpicdn.net/img/view/2015/7/28/945884.jpeg,0,0.928850949,84,0,966,870,882,870,fluttershy
946031.jpeg,https://derpicdn.net/img/view/2015/7/28/946031.jpeg,1,0.998675764,1178,237,1698,757,520,520,fluttershy
949718.jpeg,https://derpicdn.net/img/view/2015/8/3/949718.jpeg,0,0.965026975,230,65,908,743,678,678,fluttershy
970087.jpeg,https://derpicdn.net/img/view/2015/8/31/970087.jpeg,0,0.950760245,112,50,370,308,258,258,fluttershy
972149.jpeg,https://derpicdn.net/img/view/2015/9/3/972149.jpeg,0,0.956197202,256,1070,2128,2942,1872,1872,fluttershy
972607.jpeg,https://derpicdn.net/img/view/2015/9/4/972607.jpeg,0,0.922251403,74,148,800,894,726,746,fluttershy
975400.jpeg,https://derpicdn.net/img/view/2015/9/8/975400.jpeg,2,0.989157617,1161,190,1509,538,348,348,fluttershy
975400.jpeg,https://derpicdn.net/img/view/2015/9/8/975400.jpeg,3,0.970418692,28,53,302,327,274,274,fluttershy
975473.jpeg,https://derpicdn.net/img/view/2015/9/8/975473.jpeg,0,0.958802283,204,293,372,461,168,168,fluttershy
988329.jpeg,https://derpicdn.net/img/view/2015/9/26/988329.jpeg,0,0.99640739,85,0,449,346,364,346,fluttershy
991679.jpeg,https://derpicdn.net/img/view/2015/9/30/991679.jpeg,0,0.976700783,640,185,994,539,354,354,fluttershy
992607.jpeg,https://derpicdn.net/img/view/2015/10/2/992607.jpeg,0,0.951171577,446,23,746,323,300,300,fluttershy
993819.jpeg,https://derpicdn.net/img/view/2015/10/3/993819.jpeg,0,0.9829849,0,14,1153,1194,1153,1180,fluttershy
994983.jpeg,https://derpicdn.net/img/view/2015/10/5/994983.jpeg,0,0.971897125,755,89,1417,751,662,662,fluttershy
997875.jpeg,https://derpicdn.net/img/view/2015/10/9/997875.jpeg,0,0.971438587,103,67,845,809,742,742,fluttershy
1002191.jpg,https://derpicdn.net/img/view/2015/10/14/1002191.jpg,0,0.998221934,476,3,814,341,338,338,pinkie pie
1002191.jpg,https://derpicdn.net/img/view/2015/10/14/1002191.jpg,1,0.996229231,91,0,491,368,400,368,pinkie pie
1002191.jpg,https://derpicdn.net/img/view/2015/10/14/1002191.jpg,0,0.998221934,491,19,799,327,308,308,pinkie pie
1002191.jpg,https://derpicdn.net/img/view/2015/10/14/1002191.jpg,1,0.996229231,109,0,473,350,364,350,pinkie pie
1002191.jpg,https://derpicdn.net/img/view/2015/10/14/1002191.jpg,0,0.998221934,491,19,799,327,308,308,pinkie pie
1002191.jpg,https://derpicdn.net/img/view/2015/10/14/1002191.jpg,1,0.996229231,109,0,473,350,364,350,pinkie pie
1004053.png,https://derpicdn.net/img/view/2015/10/17/1004053.png,0,0.963036358,115,0,931,740,816,740,pinkie pie
1004053.png,https://derpicdn.net/img/view/2015/10/17/1004053.png,0,0.963036358,152,0,894,688,742,688,pinkie pie
1004053.png,https://derpicdn.net/img/view/2015/10/17/1004053.png,0,0.963036358,152,0,894,688,742,688,pinkie pie
1006000.png,https://derpicdn.net/img/view/2015/10/19/1006000.png,0,0.914201617,159,0,1801,1594,1642,1594,pinkie pie
1006000.png,https://derpicdn.net/img/view/2015/10/19/1006000.png,0,0.914201617,234,28,1726,1520,1492,1492,pinkie pie
1006000.png,https://derpicdn.net/img/view/2015/10/19/1006000.png,0,0.914201617,234,28,1726,1520,1492,1492,pinkie pie
1009905.jpg,https://derpicdn.net/img/view/2015/10/25/1009905.jpg,0,0.999600828,0,0,633,582,633,582,pinkie pie
1009905.jpg,https://derpicdn.net/img/view/2015/10/25/1009905.jpg,1,0.997935891,629,0,1195,544,566,544,pinkie pie
1009905.jpg,https://derpicdn.net/img/view/2015/10/25/1009905.jpg,2,0.990247607,774,631,1285,1143,511,512,pinkie pie
1009905.jpg,https://derpicdn.net/img/view/2015/10/25/1009905.jpg,3,0.967313826,89,617,641,1169,552,552,pinkie pie
1009905.jpg,https://derpicdn.net/img/view/2015/10/25/1009905.jpg,0,0.999600828,12,0,604,551,592,551,pinkie pie
1009905.jpg,https://derpicdn.net/img/view/2015/10/25/1009905.jpg,1,0.997935891,656,4,1168,516,512,512,pinkie pie
1009905.jpg,https://derpicdn.net/img/view/2015/10/25/1009905.jpg,2,0.990247607,796,653,1262,1119,466,466,pinkie pie
1009905.jpg,https://derpicdn.net/img/view/2015/10/25/1009905.jpg,3,0.967313826,115,643,615,1143,500,500,pinkie pie
1009905.jpg,https://derpicdn.net/img/view/2015/10/25/1009905.jpg,0,0.999600828,12,0,604,551,592,551,pinkie pie
1009905.jpg,https://derpicdn.net/img/view/2015/10/25/1009905.jpg,1,0.997935891,656,4,1168,516,512,512,pinkie pie
1009905.jpg,https://derpicdn.net/img/view/2015/10/25/1009905.jpg,2,0.990247607,796,653,1262,1119,466,466,pinkie pie
1009905.jpg,https://derpicdn.net/img/view/2015/10/25/1009905.jpg,3,0.967313826,115,643,615,1143,500,500,pinkie pie
1010820.png,https://derpicdn.net/img/view/2015/10/28/1010820.png,0,0.959762812,732,0,1938,1194,1206,1194,pinkie pie
1010820.png,https://derpicdn.net/img/view/2015/10/28/1010820.png,0,0.959762812,785,43,1881,1139,1096,1096,pinkie pie
1010820.png,https://derpicdn.net/img/view/2015/10/28/1010820.png,0,0.959762812,785,43,1881,1139,1096,1096,pinkie pie
1011446.png,https://derpicdn.net/img/view/2015/10/29/1011446.png,0,0.938586295,0,0,625,573,625,573,pinkie pie
1011446.png,https://derpicdn.net/img/view/2015/10/29/1011446.png,0,0.938586295,24,0,596,544,572,544,pinkie pie
1011446.png,https://derpicdn.net/img/view/2015/10/29/1011446.png,0,0.938586295,24,0,596,544,572,544,pinkie pie
1013831.png,https://derpicdn.net/img/view/2015/11/1/1013831.png,0,0.997379243,607,533,867,793,260,260,pinkie pie
1013831.png,https://derpicdn.net/img/view/2015/11/1/1013831.png,1,0.996605039,10,2,282,274,272,272,pinkie pie
1013831.png,https://derpicdn.net/img/view/2015/11/1/1013831.png,2,0.994335949,279,4,563,288,284,284,pinkie pie
1013831.png,https://derpicdn.net/img/view/2015/11/1/1013831.png,3,0.961280406,19,521,263,765,244,244,pinkie pie
1013831.png,https://derpicdn.net/img/view/2015/11/1/1013831.png,0,0.997379243,619,545,855,781,236,236,pinkie pie
1013831.png,https://derpicdn.net/img/view/2015/11/1/1013831.png,1,0.996605039,23,15,269,261,246,246,pinkie pie
1013831.png,https://derpicdn.net/img/view/2015/11/1/1013831.png,2,0.994335949,293,17,551,275,258,258,pinkie pie
1013831.png,https://derpicdn.net/img/view/2015/11/1/1013831.png,3,0.961280406,29,531,253,755,224,224,pinkie pie
1013831.png,https://derpicdn.net/img/view/2015/11/1/1013831.png,0,0.997379243,619,545,855,781,236,236,pinkie pie
1013831.png,https://derpicdn.net/img/view/2015/11/1/1013831.png,1,0.996605039,23,15,269,261,246,246,pinkie pie
1013831.png,https://derpicdn.net/img/view/2015/11/1/1013831.png,2,0.994335949,293,17,551,275,258,258,pinkie pie
1013831.png,https://derpicdn.net/img/view/2015/11/1/1013831.png,3,0.961280406,29,531,253,755,224,224,pinkie pie
1013881.png,https://derpicdn.net/img/view/2015/11/1/1013881.png,0,0.997747481,0,22,701,724,701,702,pinkie pie
1013881.png,https://derpicdn.net/img/view/2015/11/1/1013881.png,2,0.978709459,1323,190,1923,790,600,600,pinkie pie
1013881.png,https://derpicdn.net/img/view/2015/11/1/1013881.png,0,0.997747481,0,0,728,752,728,752,pinkie pie
1013881.png,https://derpicdn.net/img/view/2015/11/1/1013881.png,2,0.978709459,1349,217,1895,763,546,546,pinkie pie
1013881.png,https://derpicdn.net/img/view/2015/11/1/1013881.png,0,0.997747481,0,0,728,752,728,752,pinkie pie
1013881.png,https://derpicdn.net/img/view/2015/11/1/1013881.png,2,0.978709459,1349,217,1895,763,546,546,pinkie pie
1014210.png,https://derpicdn.net/img/view/2015/11/1/1014210.png,0,0.959639311,21,0,461,400,440,400,pinkie pie
1014210.png,https://derpicdn.net/img/view/2015/11/1/1014210.png,0,0.959639311,41,0,441,380,400,380,pinkie pie
1014210.png,https://derpicdn.net/img/view/2015/11/1/1014210.png,0,0.959639311,41,0,441,380,400,380,pinkie pie
1017145.png,https://derpicdn.net/img/view/2015/11/6/1017145.png,0,0.998474658,240,0,970,674,730,674,pinkie pie
1017145.png,https://derpicdn.net/img/view/2015/11/6/1017145.png,0,0.998474658,274,0,936,633,662,633,pinkie pie
1017145.png,https://derpicdn.net/img/view/2015/11/6/1017145.png,0,0.998474658,274,0,936,633,662,633,pinkie pie
1020350.png,https://derpicdn.net/img/view/2015/11/10/1020350.png,0,0.955025017,190,0,622,364,432,364,pinkie pie
1020350.png,https://derpicdn.net/img/view/2015/11/10/1020350.png,0,0.955025017,210,0,602,337,392,337,pinkie pie
1020350.png,https://derpicdn.net/img/view/2015/11/10/1020350.png,0,0.955025017,210,0,602,337,392,337,pinkie pie
1020351.png,https://derpicdn.net/img/view/2015/11/10/1020351.png,0,0.998570383,0,0,438,407,438,407,pinkie pie
1020351.png,https://derpicdn.net/img/view/2015/11/10/1020351.png,0,0.998570383,10,0,418,382,408,382,pinkie pie
1020351.png,https://derpicdn.net/img/view/2015/11/10/1020351.png,0,0.998570383,10,0,418,382,408,382,pinkie pie
1023995.png,https://derpicdn.net/img/view/2015/11/16/1023995.png,0,0.995304108,157,429,1375,1647,1218,1218,pinkie pie
1023995.png,https://derpicdn.net/img/view/2015/11/16/1023995.png,0,0.995304108,211,482,1319,1590,1108,1108,pinkie pie
1023995.png,https://derpicdn.net/img/view/2015/11/16/1023995.png,0,0.995304108,211,482,1319,1590,1108,1108,pinkie pie
1030070.png,https://derpicdn.net/img/view/2015/11/25/1030070.png,0,0.968690574,358,155,892,689,534,534,pinkie pie
1031734.png,https://derpicdn.net/img/view/2015/11/28/1031734.png,0,0.908225894,969,0,1959,933,990,933,pinkie pie
1032177.png,https://derpicdn.net/img/view/2015/11/28/1032177.png,0,0.925317943,608,305,1110,807,502,502,pinkie pie
1032422.png,https://derpicdn.net/img/view/2015/11/28/1032422.png,0,0.924081981,617,316,1103,802,486,486,pinkie pie
103467.png,https://derpicdn.net/img/view/2012/9/21/103467.png,0,0.979740381,0,0,857,927,857,927,pinkie pie
1034820.png,https://derpicdn.net/img/view/2015/12/1/1034820.png,0,0.999084949,514,302,1576,1364,1062,1062,pinkie pie
1034820.png,https://derpicdn.net/img/view/2015/12/1/1034820.png,1,0.995494664,2276,797,3296,1817,1020,1020,pinkie pie
1034837.png,https://derpicdn.net/img/view/2015/12/1/1034837.png,0,0.965981007,559,182,735,358,176,176,pinkie pie
1036320.png,https://derpicdn.net/img/view/2015/12/3/1036320.png,0,0.982913315,46,9,684,647,638,638,pinkie pie
1036365.png,https://derpicdn.net/img/view/2015/12/4/1036365.png,0,0.978155017,301,0,771,440,470,440,pinkie pie
1036521.png,https://derpicdn.net/img/view/2015/12/4/1036521.png,0,0.994487286,317,0,743,416,426,416,pinkie pie
1037406.png,https://derpicdn.net/img/view/2015/12/5/1037406.png,1,0.972560763,81,344,587,850,506,506,pinkie pie
1037406.png,https://derpicdn.net/img/view/2015/12/5/1037406.png,2,0.957066953,1314,351,1868,905,554,554,pinkie pie
1038558.png,https://derpicdn.net/img/view/2015/12/6/1038558.png,0,0.99275893,298,42,698,442,400,400,pinkie pie
1040359.jpg,https://derpicdn.net/img/view/2015/12/9/1040359.jpg,0,0.936999202,252,383,936,1067,684,684,pinkie pie
1041170.png,https://derpicdn.net/img/view/2015/12/10/1041170.png,0,0.984072208,37,0,907,761,870,761,pinkie pie
1042113.png,https://derpicdn.net/img/view/2015/12/11/1042113.png,0,0.971198976,327,12,969,654,642,642,pinkie pie
1042644.png,https://derpicdn.net/img/view/2015/12/12/1042644.png,0,0.973145604,264,78,628,442,364,364,pinkie pie
1044658.jpg,https://derpicdn.net/img/view/2015/12/15/1044658.jpg,0,0.987134576,350,40,916,606,566,566,pinkie pie
1045984.png,https://derpicdn.net/img/view/2015/12/17/1045984.png,1,0.951006353,486,34,756,304,270,270,pinkie pie
1048763.png,https://derpicdn.net/img/view/2015/12/20/1048763.png,0,0.971665502,430,65,656,291,226,226,pinkie pie
1052442.png,https://derpicdn.net/img/view/2015/12/25/1052442.png,0,0.999168098,0,0,561,576,561,576,pinkie pie
1052649.png,https://derpicdn.net/img/view/2015/12/25/1052649.png,0,0.978383541,227,127,541,441,314,314,pinkie pie
1056126.png,https://derpicdn.net/img/view/2015/12/30/1056126.png,0,0.999585092,360,71,848,559,488,488,pinkie pie
1056582.jpg,https://derpicdn.net/img/view/2015/12/31/1056582.jpg,0,0.998348713,1956,47,2640,731,684,684,pinkie pie
1058741.png,https://derpicdn.net/img/view/2016/1/3/1058741.png,0,0.990055621,1307,0,1807,463,500,463,pinkie pie
1063153.png,https://derpicdn.net/img/view/2016/1/10/1063153.png,0,0.966473401,376,0,830,410,454,410,pinkie pie
1064813.png,https://derpicdn.net/img/view/2016/1/11/1064813.png,0,0.950878143,75,54,481,460,406,406,pinkie pie
1066568.png,https://derpicdn.net/img/view/2016/1/14/1066568.png,0,0.934999168,84,0,558,451,474,451,pinkie pie
107159.png,https://derpicdn.net/img/view/2012/9/26/107159.png,1,0.990803301,812,215,1166,569,354,354,pinkie pie
107159.png,https://derpicdn.net/img/view/2012/9/26/107159.png,2,0.963658392,1220,227,1552,559,332,332,pinkie pie
1082227.png,https://derpicdn.net/img/view/2016/2/7/1082227.png,0,0.994987428,308,240,720,652,412,412,pinkie pie
1085769.png,https://derpicdn.net/img/view/2016/2/11/1085769.png,0,0.979566872,236,0,782,487,546,487,pinkie pie
1087804.png,https://derpicdn.net/img/view/2016/2/14/1087804.png,0,0.934597611,952,74,2500,1682,1548,1608,pinkie pie
1087822.png,https://derpicdn.net/img/view/2016/2/14/1087822.png,0,0.991197884,287,219,489,421,202,202,pinkie pie
1087822.png,https://derpicdn.net/img/view/2016/2/14/1087822.png,1,0.986764729,83,160,377,454,294,294,pinkie pie
1088329.png,https://derpicdn.net/img/view/2016/2/15/1088329.png,0,0.993811786,362,113,684,435,322,322,pinkie pie
109014.png,https://derpicdn.net/img/view/2012/9/29/109014.png,0,0.980865419,0,126,900,1266,900,1140,pinkie pie
1095889.png,https://derpicdn.net/img/view/2016/2/24/1095889.png,0,0.998984873,361,53,1005,697,644,644,pinkie pie
1097630.png,https://derpicdn.net/img/view/2016/2/27/1097630.png,0,0.996907771,0,0,606,617,606,617,pinkie pie
1099609.png,https://derpicdn.net/img/view/2016/2/29/1099609.png,0,0.996469498,598,425,1076,903,478,478,pinkie pie
1100845.png,https://derpicdn.net/img/view/2016/3/2/1100845.png,0,0.984475195,0,0,1131,1335,1131,1335,pinkie pie
1102172.png,https://derpicdn.net/img/view/2016/3/5/1102172.png,0,0.951603711,370,0,2542,2037,2172,2037,pinkie pie
1102919.jpg,https://derpicdn.net/img/view/2016/3/6/1102919.jpg,0,0.966248453,90,0,448,348,358,348,pinkie pie
1102920.jpg,https://derpicdn.net/img/view/2016/3/6/1102920.jpg,0,0.974541485,91,0,447,347,356,347,pinkie pie
1108749.jpg,https://derpicdn.net/img/view/2016/3/14/1108749.jpg,0,0.909082532,2583,515,4249,2181,1666,1666,pinkie pie
1113469.png,https://derpicdn.net/img/view/2016/3/21/1113469.png,0,0.962243795,171,4,597,430,426,426,pinkie pie
1113470.png,https://derpicdn.net/img/view/2016/3/21/1113470.png,0,0.973445833,189,24,585,420,396,396,pinkie pie
11150.png,https://derpicdn.net/img/view/2012/6/20/11150.png,0,0.982438743,82,1,358,277,276,276,pinkie pie
1116716.jpg,https://derpicdn.net/img/view/2016/3/25/1116716.jpg,0,0.996885478,1129,0,1791,661,662,661,pinkie pie
1117821.png,https://derpicdn.net/img/view/2016/3/27/1117821.png,0,0.999222398,376,0,1594,1163,1218,1163,pinkie pie
1118443.png,https://derpicdn.net/img/view/2016/3/27/1118443.png,0,0.981180489,452,66,760,374,308,308,pinkie pie
1118443.png,https://derpicdn.net/img/view/2016/3/27/1118443.png,1,0.932314336,276,55,580,359,304,304,pinkie pie
1120364.png,https://derpicdn.net/img/view/2016/3/30/1120364.png,0,0.98517555,0,31,344,381,344,350,pinkie pie
1120364.png,https://derpicdn.net/img/view/2016/3/30/1120364.png,1,0.941523612,69,0,382,320,313,320,pinkie pie
1127326.png,https://derpicdn.net/img/view/2016/4/8/1127326.png,0,0.990495086,2005,1040,2937,1972,932,932,pinkie pie
1128305.jpg,https://derpicdn.net/img/view/2016/4/9/1128305.jpg,0,0.905390024,891,391,1657,1157,766,766,pinkie pie
1132935.png,https://derpicdn.net/img/view/2016/4/16/1132935.png,0,0.975373447,2907,0,4003,1074,1096,1074,pinkie pie
1137798.png,https://derpicdn.net/img/view/2016/4/22/1137798.png,0,0.98315382,0,0,814,783,814,783,pinkie pie
1141495.png,https://derpicdn.net/img/view/2016/4/28/1141495.png,0,0.92838949,135,53,747,665,612,612,pinkie pie
1143350.png,https://derpicdn.net/img/view/2016/4/30/1143350.png,0,0.97647053,415,55,1075,715,660,660,pinkie pie
1147389.png,https://derpicdn.net/img/view/2016/5/6/1147389.png,0,0.908762872,509,84,901,476,392,392,pinkie pie
1150498.png,https://derpicdn.net/img/view/2016/5/10/1150498.png,0,0.970186293,84,0,1370,1209,1286,1209,pinkie pie
1158643.jpg,https://derpicdn.net/img/view/2016/5/20/1158643.jpg,0,0.96499306,347,17,783,453,436,436,pinkie pie
1166642.png,https://derpicdn.net/img/view/2016/5/30/1166642.png,0,0.977681816,985,537,1855,1407,870,870,pinkie pie
1166780.png,https://derpicdn.net/img/view/2016/5/30/1166780.png,0,0.908075035,102,197,832,900,730,703,pinkie pie
1166970.png,https://derpicdn.net/img/view/2016/5/31/1166970.png,0,0.994523525,192,22,624,454,432,432,pinkie pie
1166970.png,https://derpicdn.net/img/view/2016/5/31/1166970.png,1,0.905234575,423,374,665,616,242,242,pinkie pie
1172859.png,https://derpicdn.net/img/view/2016/6/7/1172859.png,0,0.957886815,267,50,573,356,306,306,pinkie pie
1173642.jpg,https://derpicdn.net/img/view/2016/6/8/1173642.jpg,0,0.998440385,69,0,401,322,332,322,pinkie pie
1178281.png,https://derpicdn.net/img/view/2016/6/14/1178281.png,0,0.989353478,0,0,1364,1080,1364,1080,pinkie pie
1181667.jpg,https://derpicdn.net/img/view/2016/6/19/1181667.jpg,1,0.98086226,410,1085,766,1441,356,356,pinkie pie
1185884.png,https://derpicdn.net/img/view/2016/6/24/1185884.png,0,0.989745259,206,0,1628,1415,1422,1415,pinkie pie
1186071.png,https://derpicdn.net/img/view/2016/6/24/1186071.png,0,0.968051732,36,0,458,414,422,414,pinkie pie
1189625.png,https://derpicdn.net/img/view/2016/6/29/1189625.png,0,0.966175854,301,0,1019,638,718,638,pinkie pie
1191169.png,https://derpicdn.net/img/view/2016/7/1/1191169.png,0,0.994781852,364,25,1944,1605,1580,1580,pinkie pie
1205038.png,https://derpicdn.net/img/view/2016/7/20/1205038.png,0,0.997446418,77,0,1155,1029,1078,1029,pinkie pie
1212.jpg,https://derpicdn.net/img/view/2012/1/22/1212.jpg,0,0.927401006,145,0,843,596,698,596,pinkie pie
1217089.png,https://derpicdn.net/img/view/2016/8/4/1217089.png,0,0.989614069,114,111,570,567,456,456,pinkie pie
12180.png,https://derpicdn.net/img/view/2012/6/20/12180.png,0,0.982974231,738,55,1026,343,288,288,pinkie pie
12180.png,https://derpicdn.net/img/view/2012/6/20/12180.png,1,0.95576334,165,74,461,370,296,296,pinkie pie
1220545.png,https://derpicdn.net/img/view/2016/8/8/1220545.png,0,0.941093087,0,0,1165,1042,1165,1042,pinkie pie
1221014.png,https://derpicdn.net/img/view/2016/8/9/1221014.png,0,0.97176069,125,29,771,675,646,646,pinkie pie
1221540.png,https://derpicdn.net/img/view/2016/8/10/1221540.png,0,0.989441216,869,193,1375,699,506,506,pinkie pie
1232164.png,https://derpicdn.net/img/view/2016/8/23/1232164.png,0,0.99478215,222,0,750,506,528,506,pinkie pie
1234975.png,https://derpicdn.net/img/view/2016/8/27/1234975.png,0,0.940490305,193,102,927,836,734,734,pinkie pie
1238286.png,https://derpicdn.net/img/view/2016/8/31/1238286.png,0,0.999497414,1398,0,2000,580,602,580,pinkie pie
1238286.png,https://derpicdn.net/img/view/2016/8/31/1238286.png,1,0.998195171,389,15,945,571,556,556,pinkie pie
1238286.png,https://derpicdn.net/img/view/2016/8/31/1238286.png,2,0.997130513,0,0,425,445,425,445,pinkie pie
1238286.png,https://derpicdn.net/img/view/2016/8/31/1238286.png,3,0.950850368,0,1023,542,1691,542,668,pinkie pie
1240103.png,https://derpicdn.net/img/view/2016/9/2/1240103.png,0,0.901363313,381,99,921,639,540,540,pinkie pie
1243754.png,https://derpicdn.net/img/view/2016/9/7/1243754.png,0,0.93429184,109,107,1017,1015,908,908,pinkie pie
1251918.png,https://derpicdn.net/img/view/2016/9/18/1251918.png,0,0.980101764,707,169,1547,1009,840,840,pinkie pie
1254275.png,https://derpicdn.net/img/view/2016/9/20/1254275.png,0,0.988962412,277,0,945,661,668,661,pinkie pie
1254275.png,https://derpicdn.net/img/view/2016/9/20/1254275.png,1,0.988781512,1825,110,2387,672,562,562,pinkie pie
1254275.png,https://derpicdn.net/img/view/2016/9/20/1254275.png,2,0.972721696,1095,47,1715,667,620,620,pinkie pie
1262807.png,https://derpicdn.net/img/view/2016/10/1/1262807.png,0,0.931509376,136,0,2762,2612,2626,2612,pinkie pie
1266202.png,https://derpicdn.net/img/view/2016/10/6/1266202.png,0,0.932048857,400,13,674,287,274,274,pinkie pie
1275099.png,https://derpicdn.net/img/view/2016/10/17/1275099.png,0,0.982863903,206,77,498,369,292,292,pinkie pie
1276843.png,https://derpicdn.net/img/view/2016/10/19/1276843.png,0,0.980973005,143,61,587,505,444,444,pinkie pie
1278.jpg,https://derpicdn.net/img/view/2012/1/22/1278.jpg,0,0.986294687,169,111,559,501,390,390,pinkie pie
1279981.png,https://derpicdn.net/img/view/2016/10/23/1279981.png,0,0.940216422,144,45,1316,1217,1172,1172,pinkie pie
1283906.png,https://derpicdn.net/img/view/2016/10/29/1283906.png,0,0.990977407,22,0,310,287,288,287,pinkie pie
1285424.png,https://derpicdn.net/img/view/2016/10/31/1285424.png,0,0.996543407,124,0,770,569,646,569,pinkie pie
1286568.png,https://derpicdn.net/img/view/2016/11/1/1286568.png,0,0.959444642,0,0,596,570,596,570,pinkie pie
1290168.png,https://derpicdn.net/img/view/2016/11/6/1290168.png,0,0.979894757,243,0,742,489,499,489,pinkie pie
1290280.png,https://derpicdn.net/img/view/2016/11/6/1290280.png,0,0.928774834,0,0,1230,1045,1230,1045,pinkie pie
1302933.png,https://derpicdn.net/img/view/2016/11/25/1302933.png,0,0.935488284,238,31,894,693,656,662,pinkie pie
1303593.png,https://derpicdn.net/img/view/2016/11/25/1303593.png,0,0.999391556,297,0,1047,717,750,717,pinkie pie
1305399.png,https://derpicdn.net/img/view/2016/11/28/1305399.png,0,0.992843807,995,93,1615,713,620,620,pinkie pie
1305399.png,https://derpicdn.net/img/view/2016/11/28/1305399.png,1,0.97340852,42,0,794,747,752,747,pinkie pie
1308517.png,https://derpicdn.net/img/view/2016/12/2/1308517.png,0,0.982145011,638,489,1238,1089,600,600,pinkie pie
1314002.png,https://derpicdn.net/img/view/2016/12/10/1314002.png,0,0.976255178,982,0,1512,476,530,476,pinkie pie
1319268.png,https://derpicdn.net/img/view/2016/12/17/1319268.png,0,0.999500036,1400,0,2000,579,600,579,pinkie pie
1319268.png,https://derpicdn.net/img/view/2016/12/17/1319268.png,1,0.997995794,390,15,948,573,558,558,pinkie pie
1319268.png,https://derpicdn.net/img/view/2016/12/17/1319268.png,2,0.996694267,0,0,418,443,418,443,pinkie pie
1319268.png,https://derpicdn.net/img/view/2016/12/17/1319268.png,3,0.950496256,0,1023,542,1691,542,668,pinkie pie
1319669.png,https://derpicdn.net/img/view/2016/12/18/1319669.png,0,0.987018526,58,0,781,522,723,522,pinkie pie
1319849.png,https://derpicdn.net/img/view/2016/12/18/1319849.png,0,0.959284782,1809,62,2409,662,600,600,pinkie pie
1319849.png,https://derpicdn.net/img/view/2016/12/18/1319849.png,1,0.942885399,97,0,1017,867,920,867,pinkie pie
1321635.png,https://derpicdn.net/img/view/2016/12/20/1321635.png,0,0.987513304,323,41,727,445,404,404,pinkie pie
1324169.png,https://derpicdn.net/img/view/2016/12/24/1324169.png,0,0.999464691,882,263,1246,627,364,364,pinkie pie
1324169.png,https://derpicdn.net/img/view/2016/12/24/1324169.png,1,0.997665584,291,0,649,330,358,330,pinkie pie
1324169.png,https://derpicdn.net/img/view/2016/12/24/1324169.png,2,0.994652212,0,377,373,759,373,382,pinkie pie
1324169.png,https://derpicdn.net/img/view/2016/12/24/1324169.png,4,0.941530824,542,382,912,752,370,370,pinkie pie
1326522.png,https://derpicdn.net/img/view/2016/12/27/1326522.png,0,0.971456409,336,33,1734,1431,1398,1398,pinkie pie
1329250.png,https://derpicdn.net/img/view/2016/12/31/1329250.png,0,0.922527194,495,24,1655,1184,1160,1160,pinkie pie
1348700.png,https://derpicdn.net/img/view/2017/1/26/1348700.png,0,0.964238167,97,3,679,585,582,582,pinkie pie
1349536.png,https://derpicdn.net/img/view/2017/1/28/1349536.png,0,0.989624083,283,26,661,404,378,378,pinkie pie
1354205.png,https://derpicdn.net/img/view/2017/2/3/1354205.png,0,0.986516416,1499,0,4055,2123,2556,2123,pinkie pie
1359009.png,https://derpicdn.net/img/view/2017/2/9/1359009.png,0,0.985304415,43,0,1443,1337,1400,1337,pinkie pie
1360136.png,https://derpicdn.net/img/view/2017/2/11/1360136.png,0,0.924684525,3175,1792,3683,2300,508,508,pinkie pie
1363446.png,https://derpicdn.net/img/view/2017/2/15/1363446.png,0,0.959802568,26,288,1038,1300,1012,1012,pinkie pie
1363446.png,https://derpicdn.net/img/view/2017/2/15/1363446.png,1,0.95532912,1285,1462,1891,2068,606,606,pinkie pie
1372005.png,https://derpicdn.net/img/view/2017/2/24/1372005.png,0,0.989173055,295,43,759,507,464,464,pinkie pie
1374618.png,https://derpicdn.net/img/view/2017/2/27/1374618.png,0,0.992690682,79,0,1475,1199,1396,1199,pinkie pie
1374800.png,https://derpicdn.net/img/view/2017/2/27/1374800.png,0,0.931015193,281,75,1163,957,882,882,pinkie pie
1377210.png,https://derpicdn.net/img/view/2017/3/2/1377210.png,0,0.962539852,79,0,2201,1954,2122,1954,pinkie pie
1379626.png,https://derpicdn.net/img/view/2017/3/5/1379626.png,0,0.974131465,240,314,1154,1228,914,914,pinkie pie
1380.jpg,https://derpicdn.net/img/view/2012/1/22/1380.jpg,0,0.954567492,299,2,900,644,601,642,pinkie pie
1380711.png,https://derpicdn.net/img/view/2017/3/6/1380711.png,0,0.997530639,242,140,1104,1002,862,862,pinkie pie
1381053.png,https://derpicdn.net/img/view/2017/3/6/1381053.png,0,0.977827072,226,0,1756,1517,1530,1517,pinkie pie
1382436.png,https://derpicdn.net/img/view/2017/3/8/1382436.png,0,0.999054432,407,4,1043,640,636,636,pinkie pie
1397.jpg,https://derpicdn.net/img/view/2012/1/22/1397.jpg,0,0.965791464,646,82,1050,486,404,404,pinkie pie
1399378.png,https://derpicdn.net/img/view/2017/3/29/1399378.png,0,0.960983038,856,48,1720,912,864,864,pinkie pie
1399378.png,https://derpicdn.net/img/view/2017/3/29/1399378.png,1,0.940295517,1711,895,2417,1601,706,706,pinkie pie
1400000.png,https://derpicdn.net/img/view/2017/3/30/1400000.png,0,0.981523812,245,0,1083,831,838,831,pinkie pie
1400393.png,https://derpicdn.net/img/view/2017/3/31/1400393.png,0,0.986519456,1047,106,1585,644,538,538,pinkie pie
1400393.png,https://derpicdn.net/img/view/2017/3/31/1400393.png,1,0.939182222,1080,442,1576,938,496,496,pinkie pie
1403924.png,https://derpicdn.net/img/view/2017/4/4/1403924.png,0,0.99618566,220,75,842,697,622,622,pinkie pie
1403959.png,https://derpicdn.net/img/view/2017/4/4/1403959.png,0,0.973712504,187,313,669,795,482,482,pinkie pie
1406157.png,https://derpicdn.net/img/view/2017/4/7/1406157.png,0,0.995366275,3,0,1849,1798,1846,1798,pinkie pie
1408.jpg,https://derpicdn.net/img/view/2012/1/22/1408.jpg,0,0.995173514,242,1,708,467,466,466,pinkie pie
1408.jpg,https://derpicdn.net/img/view/2012/1/22/1408.jpg,1,0.983548522,0,121,259,399,259,278,pinkie pie
1409552.png,https://derpicdn.net/img/view/2017/4/12/1409552.png,0,0.983208954,437,10,707,280,270,270,pinkie pie
1409556.png,https://derpicdn.net/img/view/2017/4/12/1409556.png,0,0.998406947,454,23,708,277,254,254,pinkie pie
1414472.png,https://derpicdn.net/img/view/2017/4/17/1414472.png,0,0.971321583,2298,1123,3568,2393,1270,1270,pinkie pie
1420144.png,https://derpicdn.net/img/view/2017/4/24/1420144.png,0,0.976838648,821,121,1589,889,768,768,pinkie pie
1420783.png,https://derpicdn.net/img/view/2017/4/24/1420783.png,0,0.970733464,1114,394,1566,846,452,452,pinkie pie
1422448.png,https://derpicdn.net/img/view/2017/4/26/1422448.png,0,0.983317196,986,0,2636,1549,1650,1549,pinkie pie
1424167.png,https://derpicdn.net/img/view/2017/4/29/1424167.png,0,0.99363178,324,0,964,634,640,634,pinkie pie
1424493.png,https://derpicdn.net/img/view/2017/4/29/1424493.png,0,0.991225421,138,0,1030,774,892,774,pinkie pie
1424505.png,https://derpicdn.net/img/view/2017/4/29/1424505.png,0,0.997720242,870,0,1630,704,760,704,pinkie pie
1424505.png,https://derpicdn.net/img/view/2017/4/29/1424505.png,1,0.990048409,151,0,1005,782,854,782,pinkie pie
14260.png,https://derpicdn.net/img/view/2012/6/21/14260.png,0,0.992181718,157,0,635,453,478,453,pinkie pie
1428151.png,https://derpicdn.net/img/view/2017/5/4/1428151.png,0,0.985558569,52,0,720,665,668,665,pinkie pie
1428779.png,https://derpicdn.net/img/view/2017/5/4/1428779.png,0,0.996698856,0,0,571,531,571,531,pinkie pie
1429389.png,https://derpicdn.net/img/view/2017/5/5/1429389.png,0,0.986136436,64,0,670,519,606,519,pinkie pie
1429389.png,https://derpicdn.net/img/view/2017/5/5/1429389.png,1,0.982408941,468,0,1058,576,590,576,pinkie pie
1429389.png,https://derpicdn.net/img/view/2017/5/5/1429389.png,2,0.970525026,1036,30,1756,750,720,720,pinkie pie
1429389.png,https://derpicdn.net/img/view/2017/5/5/1429389.png,3,0.94310689,793,462,1165,834,372,372,pinkie pie
1437461.png,https://derpicdn.net/img/view/2017/5/15/1437461.png,0,0.984283984,399,30,1049,680,650,650,pinkie pie
1440838.png,https://derpicdn.net/img/view/2017/5/20/1440838.png,0,0.986374259,263,56,853,646,590,590,pinkie pie
1441804.png,https://derpicdn.net/img/view/2017/5/21/1441804.png,0,0.989174545,823,111,2067,1355,1244,1244,pinkie pie
1441804.png,https://derpicdn.net/img/view/2017/5/21/1441804.png,1,0.985497177,1987,1027,2951,1991,964,964,pinkie pie
1448671.png,https://derpicdn.net/img/view/2017/5/29/1448671.png,0,0.926450253,844,164,2020,1340,1176,1176,pinkie pie
1462114.png,https://derpicdn.net/img/view/2017/6/15/1462114.png,0,0.987223029,1384,588,2794,1998,1410,1410,pinkie pie
1467919.png,https://derpicdn.net/img/view/2017/6/21/1467919.png,0,0.986316383,37,0,743,598,706,598,pinkie pie
1468095.png,https://derpicdn.net/img/view/2017/6/21/1468095.png,0,0.981052935,531,51,1701,1221,1170,1170,pinkie pie
1469462.png,https://derpicdn.net/img/view/2017/6/23/1469462.png,0,0.991956115,2858,0,6976,3942,4118,3942,pinkie pie
1470153.png,https://derpicdn.net/img/view/2017/6/24/1470153.png,0,0.990359187,402,112,846,556,444,444,pinkie pie
1472200.png,https://derpicdn.net/img/view/2017/6/26/1472200.png,0,0.994700193,137,36,537,436,400,400,pinkie pie
1472505.png,https://derpicdn.net/img/view/2017/6/27/1472505.png,0,0.998183131,11,214,893,1096,882,882,pinkie pie
1479567.png,https://derpicdn.net/img/view/2017/7/6/1479567.png,0,0.99178791,139,13,1919,1793,1780,1780,pinkie pie
1483198.png,https://derpicdn.net/img/view/2017/7/10/1483198.png,0,0.970843732,252,0,1004,711,752,711,pinkie pie
1484317.png,https://derpicdn.net/img/view/2017/7/12/1484317.png,0,0.988022268,287,60,711,484,424,424,pinkie pie
1486050.png,https://derpicdn.net/img/view/2017/7/14/1486050.png,0,0.998261034,344,44,1000,700,656,656,pinkie pie
1492314.png,https://derpicdn.net/img/view/2017/7/22/1492314.png,0,0.995706797,0,790,421,1252,421,462,pinkie pie
1492314.png,https://derpicdn.net/img/view/2017/7/22/1492314.png,1,0.939577401,636,1,974,339,338,338,pinkie pie
1492314.png,https://derpicdn.net/img/view/2017/7/22/1492314.png,2,0.926650822,300,264,700,664,400,400,pinkie pie
150082.jpg,https://derpicdn.net/img/view/2012/11/12/150082.jpg,0,0.994211853,29,32,323,326,294,294,pinkie pie
150082.jpg,https://derpicdn.net/img/view/2012/11/12/150082.jpg,1,0.959928215,366,0,720,313,354,313,pinkie pie
1504955.png,https://derpicdn.net/img/view/2017/8/7/1504955.png,0,0.927457631,219,13,1135,929,916,916,pinkie pie
1506917.png,https://derpicdn.net/img/view/2017/8/10/1506917.png,0,0.975717723,304,242,804,742,500,500,pinkie pie
1506933.png,https://derpicdn.net/img/view/2017/8/10/1506933.png,0,0.918707907,1438,540,4398,3500,2960,2960,pinkie pie
1510980.png,https://derpicdn.net/img/view/2017/8/14/1510980.png,0,0.965737164,572,107,1718,1253,1146,1146,pinkie pie
1512655.png,https://derpicdn.net/img/view/2017/8/17/1512655.png,0,0.996674776,1317,0,3597,2267,2280,2267,pinkie pie
1513019.png,https://derpicdn.net/img/view/2017/8/17/1513019.png,0,0.920425713,0,0,788,814,788,814,pinkie pie
1516271.png,https://derpicdn.net/img/view/2017/8/21/1516271.png,0,0.992511511,400,0,714,293,314,293,pinkie pie
1518424.png,https://derpicdn.net/img/view/2017/8/24/1518424.png,0,0.99974519,0,212,888,1104,888,892,pinkie pie
1526475.png,https://derpicdn.net/img/view/2017/9/3/1526475.png,0,0.931397915,230,69,548,387,318,318,pinkie pie
1527292.png,https://derpicdn.net/img/view/2017/9/4/1527292.png,0,0.98880899,13,10,1200,1051,1187,1041,pinkie pie
1527292.png,https://derpicdn.net/img/view/2017/9/4/1527292.png,1,0.938178718,0,0,903,876,903,876,pinkie pie
1527878.png,https://derpicdn.net/img/view/2017/9/4/1527878.png,0,0.957730234,94,2,470,378,376,376,pinkie pie
1530451.png,https://derpicdn.net/img/view/2017/9/8/1530451.png,0,0.973745942,56,11,376,331,320,320,pinkie pie
1531136.png,https://derpicdn.net/img/view/2017/9/9/1531136.png,0,0.998347342,14,5,560,551,546,546,pinkie pie
1531146.png,https://derpicdn.net/img/view/2017/9/9/1531146.png,0,0.952036023,276,88,970,782,694,694,pinkie pie
1531297.png,https://derpicdn.net/img/view/2017/9/9/1531297.png,0,0.992627203,188,0,790,586,602,586,pinkie pie
1531775.png,https://derpicdn.net/img/view/2017/9/10/1531775.png,0,0.99696964,15,0,709,658,694,658,pinkie pie
1533638.png,https://derpicdn.net/img/view/2017/9/12/1533638.png,0,0.999450028,369,0,663,258,294,258,pinkie pie
1534431.png,https://derpicdn.net/img/view/2017/9/13/1534431.png,0,0.912552238,117,93,593,569,476,476,pinkie pie
1535275.png,https://derpicdn.net/img/view/2017/9/14/1535275.png,0,0.997101426,162,40,2934,2812,2772,2772,pinkie pie
1536156.png,https://derpicdn.net/img/view/2017/9/15/1536156.png,0,0.999267876,650,0,1318,522,668,522,pinkie pie
1538127.png,https://derpicdn.net/img/view/2017/9/17/1538127.png,0,0.970601022,33,0,479,442,446,442,pinkie pie
1538667.png,https://derpicdn.net/img/view/2017/9/18/1538667.png,0,0.988161623,59,73,800,825,741,752,pinkie pie
1553967.png,https://derpicdn.net/img/view/2017/10/7/1553967.png,0,0.960518837,0,128,412,570,412,442,pinkie pie
1555757.png,https://derpicdn.net/img/view/2017/10/8/1555757.png,0,0.996900141,2205,286,3395,1476,1190,1190,pinkie pie
1555757.png,https://derpicdn.net/img/view/2017/10/8/1555757.png,1,0.968395233,1099,58,2637,1596,1538,1538,pinkie pie
1559955.png,https://derpicdn.net/img/view/2017/10/13/1559955.png,0,0.992665291,244,29,1168,953,924,924,pinkie pie
156126.png,https://derpicdn.net/img/view/2012/11/18/156126.png,0,0.963890016,18,302,228,512,210,210,pinkie pie
156578.png,https://derpicdn.net/img/view/2012/11/18/156578.png,0,0.985002398,18,0,546,512,528,512,pinkie pie
1571147.png,https://derpicdn.net/img/view/2017/10/27/1571147.png,0,0.909955442,0,0,1070,1084,1070,1084,pinkie pie
1573070.png,https://derpicdn.net/img/view/2017/10/29/1573070.png,0,0.988492131,398,0,4198,3772,3800,3772,pinkie pie
1576294.png,https://derpicdn.net/img/view/2017/11/2/1576294.png,0,0.972349286,794,262,1888,1356,1094,1094,pinkie pie
1576379.png,https://derpicdn.net/img/view/2017/11/2/1576379.png,0,0.998974264,0,0,429,432,429,432,pinkie pie
1582599.png,https://derpicdn.net/img/view/2017/11/10/1582599.png,0,0.955441475,114,28,602,516,488,488,pinkie pie
1582662.png,https://derpicdn.net/img/view/2017/11/10/1582662.png,0,0.945019424,14,0,284,251,270,251,pinkie pie
1582730.png,https://derpicdn.net/img/view/2017/11/10/1582730.png,0,0.993775725,947,319,1581,953,634,634,pinkie pie
1585946.png,https://derpicdn.net/img/view/2017/11/14/1585946.png,0,0.978897333,299,0,1471,1114,1172,1114,pinkie pie
1590987.png,https://derpicdn.net/img/view/2017/11/21/1590987.png,0,0.979084134,62,0,1148,975,1086,975,pinkie pie
1592135.png,https://derpicdn.net/img/view/2017/11/22/1592135.png,0,0.986458361,112,0,710,557,598,557,pinkie pie
1595971.png,https://derpicdn.net/img/view/2017/11/28/1595971.png,0,0.910735071,0,0,1133,1290,1133,1290,pinkie pie
1598318.png,https://derpicdn.net/img/view/2017/12/1/1598318.png,0,0.994189203,1012,0,1832,763,820,763,pinkie pie
1598318.png,https://derpicdn.net/img/view/2017/12/1/1598318.png,1,0.993129134,1081,1053,1775,1747,694,694,pinkie pie
1598318.png,https://derpicdn.net/img/view/2017/12/1/1598318.png,2,0.952499926,83,0,839,723,756,723,pinkie pie
1600035.png,https://derpicdn.net/img/view/2017/12/4/1600035.png,0,0.997248352,178,3,452,277,274,274,pinkie pie
1602278.png,https://derpicdn.net/img/view/2017/12/7/1602278.png,0,0.935037315,1093,0,3427,1905,2334,1905,pinkie pie
1602688.png,https://derpicdn.net/img/view/2017/12/7/1602688.png,0,0.970980108,410,52,722,364,312,312,pinkie pie
1612507.png,https://derpicdn.net/img/view/2017/12/21/1612507.png,0,0.992018998,0,50,931,1018,931,968,pinkie pie
1613308.png,https://derpicdn.net/img/view/2017/12/22/1613308.png,0,0.9893139,38,227,844,1009,806,782,pinkie pie
1615098.png,https://derpicdn.net/img/view/2017/12/24/1615098.png,0,0.99981463,14,0,846,828,832,828,pinkie pie
1615098.png,https://derpicdn.net/img/view/2017/12/24/1615098.png,1,0.99266696,1092,894,2000,1812,908,918,pinkie pie
1615098.png,https://derpicdn.net/img/view/2017/12/24/1615098.png,2,0.986823976,1043,0,1853,807,810,807,pinkie pie
1615098.png,https://derpicdn.net/img/view/2017/12/24/1615098.png,3,0.968368769,110,938,938,1766,828,828,pinkie pie
1615312.png,https://derpicdn.net/img/view/2017/12/24/1615312.png,0,0.972582459,319,9,819,509,500,500,pinkie pie
1616638.png,https://derpicdn.net/img/view/2017/12/26/1616638.png,0,0.966778398,419,131,649,361,230,230,pinkie pie
1616638.png,https://derpicdn.net/img/view/2017/12/26/1616638.png,1,0.922982037,231,32,551,352,320,320,pinkie pie
1617643.png,https://derpicdn.net/img/view/2017/12/27/1617643.png,0,0.990059853,637,190,1071,624,434,434,pinkie pie
1617643.png,https://derpicdn.net/img/view/2017/12/27/1617643.png,1,0.979639471,303,368,655,720,352,352,pinkie pie
1623688.png,https://derpicdn.net/img/view/2018/1/4/1623688.png,0,0.980471075,324,0,690,355,366,355,pinkie pie
1632532.png,https://derpicdn.net/img/view/2018/1/15/1632532.png,0,0.998614192,1369,576,3695,2902,2326,2326,pinkie pie
1634913.png,https://derpicdn.net/img/view/2018/1/18/1634913.png,0,0.973308861,66,646,876,1456,810,810,pinkie pie
1636009.png,https://derpicdn.net/img/view/2018/1/19/1636009.png,0,0.974805772,298,0,1228,792,930,792,pinkie pie
1637087.png,https://derpicdn.net/img/view/2018/1/20/1637087.png,0,0.998070598,166,0,606,439,440,439,pinkie pie
1643660.png,https://derpicdn.net/img/view/2018/1/29/1643660.png,0,0.995150626,57,50,557,550,500,500,pinkie pie
1644047.png,https://derpicdn.net/img/view/2018/1/29/1644047.png,0,0.998340845,258,43,726,511,468,468,pinkie pie
1644825.png,https://derpicdn.net/img/view/2018/1/30/1644825.png,0,0.992963612,232,0,614,376,382,376,pinkie pie
1646464.png,https://derpicdn.net/img/view/2018/2/2/1646464.png,0,0.996483624,549,128,1179,758,630,630,pinkie pie
1649967.png,https://derpicdn.net/img/view/2018/2/6/1649967.png,0,0.921909571,209,0,1291,1026,1082,1026,pinkie pie
1657751.png,https://derpicdn.net/img/view/2018/2/16/1657751.png,0,0.982702851,304,524,2552,2772,2248,2248,pinkie pie
1658262.png,https://derpicdn.net/img/view/2018/2/17/1658262.png,0,0.988575518,0,15,727,749,727,734,pinkie pie
1660463.png,https://derpicdn.net/img/view/2018/2/19/1660463.png,0,0.975632787,34,81,542,589,508,508,pinkie pie
1660679.png,https://derpicdn.net/img/view/2018/2/19/1660679.png,0,0.986573398,0,0,1744,1679,1744,1679,pinkie pie
1662441.png,https://derpicdn.net/img/view/2018/2/22/1662441.png,0,0.997985065,2223,0,4363,1977,2140,1977,pinkie pie
1668002.png,https://derpicdn.net/img/view/2018/2/28/1668002.png,0,0.998542905,163,0,1095,890,932,890,pinkie pie
1669038.png,https://derpicdn.net/img/view/2018/3/1/1669038.png,0,0.990356684,291,12,683,404,392,392,pinkie pie
1670075.png,https://derpicdn.net/img/view/2018/3/2/1670075.png,0,0.98819983,85,0,489,398,404,398,pinkie pie
1670227.png,https://derpicdn.net/img/view/2018/3/3/1670227.png,0,0.998206913,0,0,1175,1200,1175,1200,pinkie pie
1670737.png,https://derpicdn.net/img/view/2018/3/3/1670737.png,0,0.991828144,53,0,739,614,686,614,pinkie pie
1672294.png,https://derpicdn.net/img/view/2018/3/5/1672294.png,0,0.980381548,1015,40,1907,932,892,892,pinkie pie
1672989.png,https://derpicdn.net/img/view/2018/3/6/1672989.png,0,0.986869276,63,185,977,1083,914,898,pinkie pie
1673755.png,https://derpicdn.net/img/view/2018/3/7/1673755.png,0,0.977887809,1078,6,2118,1046,1040,1040,pinkie pie
1678690.png,https://derpicdn.net/img/view/2018/3/13/1678690.png,0,0.98477459,1020,0,1956,936,936,936,pinkie pie
1681761.png,https://derpicdn.net/img/view/2018/3/16/1681761.png,0,0.993264258,1063,54,1907,898,844,844,pinkie pie
1685253.png,https://derpicdn.net/img/view/2018/3/19/1685253.png,0,0.970593572,61,29,573,541,512,512,pinkie pie
1685258.png,https://derpicdn.net/img/view/2018/3/19/1685258.png,0,0.983515978,336,49,810,523,474,474,pinkie pie
1685351.png,https://derpicdn.net/img/view/2018/3/20/1685351.png,0,0.99848938,121,0,699,567,578,567,pinkie pie
1688266.png,https://derpicdn.net/img/view/2018/3/23/1688266.png,0,0.901887357,498,0,2376,1860,1878,1860,pinkie pie
1692809.png,https://derpicdn.net/img/view/2018/3/28/1692809.png,0,0.990832269,19,0,1199,1130,1180,1130,pinkie pie
1693710.png,https://derpicdn.net/img/view/2018/3/29/1693710.png,0,0.985316932,85,114,1631,1660,1546,1546,pinkie pie
1697557.png,https://derpicdn.net/img/view/2018/4/2/1697557.png,0,0.900873661,708,337,1412,1041,704,704,pinkie pie
1700301.png,https://derpicdn.net/img/view/2018/4/6/1700301.png,0,0.930284441,2286,0,3430,1093,1144,1093,pinkie pie
1702399.png,https://derpicdn.net/img/view/2018/4/8/1702399.png,0,0.908955097,199,0,821,589,622,589,pinkie pie
1706744.png,https://derpicdn.net/img/view/2018/4/13/1706744.png,0,0.993219316,120,0,990,853,870,853,pinkie pie
1711132.png,https://derpicdn.net/img/view/2018/4/18/1711132.png,0,0.976999581,0,0,3300,3261,3300,3261,pinkie pie
1711197.png,https://derpicdn.net/img/view/2018/4/18/1711197.png,0,0.91890651,188,0,2378,2153,2190,2153,pinkie pie
1718180.png,https://derpicdn.net/img/view/2018/4/27/1718180.png,0,0.971954286,1020,236,2104,1320,1084,1084,pinkie pie
1719897.png,https://derpicdn.net/img/view/2018/4/29/1719897.png,0,0.974776685,85,212,2193,2320,2108,2108,pinkie pie
1722066.png,https://derpicdn.net/img/view/2018/5/2/1722066.png,0,0.998128235,358,31,880,553,522,522,pinkie pie
1724971.png,https://derpicdn.net/img/view/2018/5/5/1724971.png,0,0.958345771,1894,1727,2554,2387,660,660,pinkie pie
1724973.png,https://derpicdn.net/img/view/2018/5/5/1724973.png,0,0.997405648,1438,725,2326,1613,888,888,pinkie pie
1725008.png,https://derpicdn.net/img/view/2018/5/5/1725008.png,0,0.952948213,1744,151,3594,2001,1850,1850,pinkie pie
1725534.png,https://derpicdn.net/img/view/2018/5/6/1725534.png,0,0.986985981,187,0,1343,1052,1156,1052,pinkie pie
1726308.png,https://derpicdn.net/img/view/2018/5/6/1726308.png,0,0.986347079,63,0,1927,1830,1864,1830,pinkie pie
1728466.png,https://derpicdn.net/img/view/2018/5/9/1728466.png,0,0.965664625,125,0,681,535,556,535,pinkie pie
1728813.png,https://derpicdn.net/img/view/2018/5/10/1728813.png,0,0.974179864,313,63,1011,761,698,698,pinkie pie
1731797.png,https://derpicdn.net/img/view/2018/5/13/1731797.png,0,0.967406273,517,64,1235,782,718,718,pinkie pie
1732182.png,https://derpicdn.net/img/view/2018/5/14/1732182.png,0,0.967998207,259,0,1419,1144,1160,1144,pinkie pie
1733987.png,https://derpicdn.net/img/view/2018/5/16/1733987.png,0,0.946650684,138,0,998,839,860,839,pinkie pie
1741726.png,https://derpicdn.net/img/view/2018/5/26/1741726.png,0,0.997402728,549,0,1025,457,476,457,pinkie pie
1742054.png,https://derpicdn.net/img/view/2018/5/26/1742054.png,0,0.945470989,185,0,1114,917,929,917,pinkie pie
1744889.png,https://derpicdn.net/img/view/2018/5/29/1744889.png,0,0.987180829,370,3,1658,1291,1288,1288,pinkie pie
1746304.png,https://derpicdn.net/img/view/2018/5/31/1746304.png,0,0.951125145,215,47,2465,2297,2250,2250,pinkie pie
1755057.png,https://derpicdn.net/img/view/2018/6/11/1755057.png,0,0.900927663,87,1,359,273,272,272,pinkie pie
1755065.png,https://derpicdn.net/img/view/2018/6/11/1755065.png,0,0.987518072,38,0,362,314,324,314,pinkie pie
1755677.png,https://derpicdn.net/img/view/2018/6/12/1755677.png,0,0.993990302,1065,0,1771,668,706,668,pinkie pie
1759756.png,https://derpicdn.net/img/view/2018/6/17/1759756.png,0,0.930606961,829,362,1549,1082,720,720,pinkie pie
1760048.png,https://derpicdn.net/img/view/2018/6/17/1760048.png,0,0.990746796,1623,67,2613,1057,990,990,pinkie pie
1762489.png,https://derpicdn.net/img/view/2018/6/21/1762489.png,0,0.993365049,49,0,1223,1147,1174,1147,pinkie pie
1770184.png,https://derpicdn.net/img/view/2018/7/1/1770184.png,0,0.946713865,1030,218,2018,1206,988,988,pinkie pie
1771644.png,https://derpicdn.net/img/view/2018/7/3/1771644.png,0,0.992635667,407,112,1113,818,706,706,pinkie pie
1772467.png,https://derpicdn.net/img/view/2018/7/4/1772467.png,0,0.965995789,425,0,1851,1080,1426,1080,pinkie pie
1773834.png,https://derpicdn.net/img/view/2018/7/6/1773834.png,0,0.929604948,0,0,1629,1607,1629,1607,pinkie pie
1774743.png,https://derpicdn.net/img/view/2018/7/7/1774743.png,0,0.992136598,594,117,996,519,402,402,pinkie pie
1777889.png,https://derpicdn.net/img/view/2018/7/10/1777889.png,0,0.983422637,218,100,1198,1080,980,980,pinkie pie
1779017.png,https://derpicdn.net/img/view/2018/7/12/1779017.png,0,0.99620682,426,168,2138,1880,1712,1712,pinkie pie
1782278.png,https://derpicdn.net/img/view/2018/7/16/1782278.png,0,0.997691393,1137,262,1569,694,432,432,pinkie pie
1782384.png,https://derpicdn.net/img/view/2018/7/16/1782384.png,0,0.99857235,582,0,986,346,404,346,pinkie pie
1782384.png,https://derpicdn.net/img/view/2018/7/16/1782384.png,1,0.997057736,135,0,543,351,408,351,pinkie pie
1788640.png,https://derpicdn.net/img/view/2018/7/24/1788640.png,0,0.997953653,433,98,1045,710,612,612,pinkie pie
1789040.png,https://derpicdn.net/img/view/2018/7/25/1789040.png,0,0.991465628,219,0,615,396,396,396,pinkie pie
1789811.png,https://derpicdn.net/img/view/2018/7/25/1789811.png,0,0.991659582,842,474,1654,1286,812,812,pinkie pie
1790321.png,https://derpicdn.net/img/view/2018/7/26/1790321.png,0,0.989771008,560,0,1588,866,1028,866,pinkie pie
1792568.png,https://derpicdn.net/img/view/2018/7/29/1792568.png,0,0.95570606,42,0,578,522,536,522,pinkie pie
1793395.png,https://derpicdn.net/img/view/2018/7/30/1793395.png,0,0.995037258,2393,58,4663,2328,2270,2270,pinkie pie
1798247.png,https://derpicdn.net/img/view/2018/8/5/1798247.png,0,0.994788408,271,0,1029,727,758,727,pinkie pie
1799409.png,https://derpicdn.net/img/view/2018/8/6/1799409.png,0,0.971572459,50,210,1520,1680,1470,1470,pinkie pie
1800192.png,https://derpicdn.net/img/view/2018/8/7/1800192.png,0,0.970075786,447,0,2149,1667,1702,1667,pinkie pie
1802758.png,https://derpicdn.net/img/view/2018/8/9/1802758.png,0,0.994732857,216,22,679,500,463,478,pinkie pie
1803114.png,https://derpicdn.net/img/view/2018/8/10/1803114.png,0,0.968752623,585,0,1005,394,420,394,pinkie pie
1803492.png,https://derpicdn.net/img/view/2018/8/10/1803492.png,0,0.975735009,657,518,1169,1030,512,512,pinkie pie
1808640.png,https://derpicdn.net/img/view/2018/8/16/1808640.png,0,0.985428035,2347,866,3287,1806,940,940,pinkie pie
1808640.png,https://derpicdn.net/img/view/2018/8/16/1808640.png,1,0.975303531,3268,566,4000,1448,732,882,pinkie pie
1808640.png,https://derpicdn.net/img/view/2018/8/16/1808640.png,2,0.966877759,606,0,1446,769,840,769,pinkie pie
1810380.png,https://derpicdn.net/img/view/2018/8/18/1810380.png,0,0.994495153,158,175,768,785,610,610,pinkie pie
1813781.png,https://derpicdn.net/img/view/2018/8/23/1813781.png,0,0.97482723,301,0,1189,812,888,812,pinkie pie
1814074.png,https://derpicdn.net/img/view/2018/8/23/1814074.png,0,0.996956646,632,80,1836,1284,1204,1204,pinkie pie
1821748.png,https://derpicdn.net/img/view/2018/9/1/1821748.png,0,0.988899052,176,0,910,634,734,634,pinkie pie
1827138.png,https://derpicdn.net/img/view/2018/9/7/1827138.png,0,0.985197008,625,58,1175,608,550,550,pinkie pie
1828976.png,https://derpicdn.net/img/view/2018/9/9/1828976.png,0,0.999015749,841,0,2413,1505,1572,1505,pinkie pie
1829980.png,https://derpicdn.net/img/view/2018/9/11/1829980.png,0,0.997903466,433,38,841,446,408,408,pinkie pie
1831331.png,https://derpicdn.net/img/view/2018/9/12/1831331.png,0,0.991057575,89,13,935,859,846,846,pinkie pie
1833600.png,https://derpicdn.net/img/view/2018/9/16/1833600.png,0,0.969216168,573,0,2897,2263,2324,2263,pinkie pie
1838777.png,https://derpicdn.net/img/view/2018/9/22/1838777.png,0,0.985713482,46,0,428,370,382,370,pinkie pie
1845670.png,https://derpicdn.net/img/view/2018/10/1/1845670.png,0,0.999577582,707,0,1791,934,1084,934,pinkie pie
1845813.png,https://derpicdn.net/img/view/2018/10/2/1845813.png,0,0.997690499,822,8,2460,1646,1638,1638,pinkie pie
1848545.png,https://derpicdn.net/img/view/2018/10/5/1848545.png,0,0.998589575,452,33,2198,1779,1746,1746,pinkie pie
1848763.png,https://derpicdn.net/img/view/2018/10/5/1848763.png,0,0.911321998,565,134,1017,586,452,452,pinkie pie
1849470.png,https://derpicdn.net/img/view/2018/10/6/1849470.png,0,0.990397334,936,137,1818,1019,882,882,pinkie pie
1849470.png,https://derpicdn.net/img/view/2018/10/6/1849470.png,1,0.988397658,8,131,916,1039,908,908,pinkie pie
1849536.png,https://derpicdn.net/img/view/2018/10/6/1849536.png,0,0.993409693,31,0,431,395,400,395,pinkie pie
1854.jpg,https://derpicdn.net/img/view/2012/1/23/1854.jpg,0,0.915370703,195,177,705,687,510,510,pinkie pie
1856869.png,https://derpicdn.net/img/view/2018/10/15/1856869.png,0,0.998259544,239,50,783,594,544,544,pinkie pie
1875142.png,https://derpicdn.net/img/view/2018/11/4/1875142.png,0,0.979563296,303,0,832,514,529,514,pinkie pie
1877982.png,https://derpicdn.net/img/view/2018/11/8/1877982.png,0,0.965599298,482,227,924,669,442,442,pinkie pie
1878254.png,https://derpicdn.net/img/view/2018/11/9/1878254.png,0,0.998195291,638,138,1592,1092,954,954,pinkie pie
1880196.png,https://derpicdn.net/img/view/2018/11/11/1880196.png,0,0.98151809,166,0,500,324,334,324,pinkie pie
1885489.png,https://derpicdn.net/img/view/2018/11/18/1885489.png,0,0.999599397,514,462,990,938,476,476,pinkie pie
1888127.png,https://derpicdn.net/img/view/2018/11/22/1888127.png,0,0.992938697,361,57,989,685,628,628,pinkie pie
189.png,https://derpicdn.net/img/view/2012/1/12/189.png,0,0.960553467,14,372,1056,1414,1042,1042,pinkie pie
1890406.png,https://derpicdn.net/img/view/2018/11/25/1890406.png,0,0.979724646,254,307,1032,1085,778,778,pinkie pie
1893149.png,https://derpicdn.net/img/view/2018/11/28/1893149.png,0,0.983089864,175,8,835,668,660,660,pinkie pie
1893312.png,https://derpicdn.net/img/view/2018/11/28/1893312.png,0,0.99477756,358,0,916,522,558,522,pinkie pie
1893312.png,https://derpicdn.net/img/view/2018/11/28/1893312.png,1,0.98326081,450,682,1014,1246,564,564,pinkie pie
1893312.png,https://derpicdn.net/img/view/2018/11/28/1893312.png,2,0.967186689,13,383,565,935,552,552,pinkie pie
1894953.png,https://derpicdn.net/img/view/2018/12/1/1894953.png,0,0.922314465,466,21,1016,571,550,550,pinkie pie
1895117.png,https://derpicdn.net/img/view/2018/12/1/1895117.png,0,0.999569714,712,0,1782,928,1070,928,pinkie pie
1895606.png,https://derpicdn.net/img/view/2018/12/1/1895606.png,0,0.907253981,337,0,1439,1095,1102,1095,pinkie pie
1895883.png,https://derpicdn.net/img/view/2018/12/2/1895883.png,0,0.998631537,531,0,1495,921,964,921,pinkie pie
1913235.png,https://derpicdn.net/img/view/2018/12/20/1913235.png,0,0.983603776,148,79,856,787,708,708,pinkie pie
1928567.png,https://derpicdn.net/img/view/2019/1/6/1928567.png,0,0.99576962,118,34,606,522,488,488,pinkie pie
1928567.png,https://derpicdn.net/img/view/2019/1/6/1928567.png,1,0.990117848,757,82,1167,492,410,410,pinkie pie
1930466.png,https://derpicdn.net/img/view/2019/1/9/1930466.png,0,0.998805285,819,0,2500,1576,1681,1576,pinkie pie
1930780.png,https://derpicdn.net/img/view/2019/1/9/1930780.png,0,0.97562325,481,225,925,669,444,444,pinkie pie
19313.png,https://derpicdn.net/img/view/2012/6/24/19313.png,0,0.97831136,609,97,885,373,276,276,pinkie pie
1937073.png,https://derpicdn.net/img/view/2019/1/16/1937073.png,0,0.998047352,460,47,1890,1477,1430,1430,pinkie pie
1942526.png,https://derpicdn.net/img/view/2019/1/23/1942526.png,0,0.967094243,3252,0,6885,3549,3633,3549,pinkie pie
1943441.png,https://derpicdn.net/img/view/2019/1/24/1943441.png,0,0.989599645,471,0,2048,1574,1577,1574,pinkie pie
1943441.png,https://derpicdn.net/img/view/2019/1/24/1943441.png,1,0.96349287,0,232,1488,1850,1488,1618,pinkie pie
1946751.png,https://derpicdn.net/img/view/2019/1/28/1946751.png,0,0.978746057,0,0,1114,1158,1114,1158,pinkie pie
1947890.png,https://derpicdn.net/img/view/2019/1/29/1947890.png,0,0.975104868,211,85,467,341,256,256,pinkie pie
1948832.png,https://derpicdn.net/img/view/2019/1/30/1948832.png,0,0.921939671,434,53,1026,645,592,592,pinkie pie
1949649.png,https://derpicdn.net/img/view/2019/1/31/1949649.png,0,0.990091085,524,0,1404,792,880,792,pinkie pie
1964773.png,https://derpicdn.net/img/view/2019/2/17/1964773.png,0,0.92044729,533,8,1343,818,810,810,pinkie pie
1968957.png,https://derpicdn.net/img/view/2019/2/22/1968957.png,0,0.980470896,4,0,720,658,716,658,pinkie pie
1970265.png,https://derpicdn.net/img/view/2019/2/24/1970265.png,0,0.969878733,352,0,1032,638,680,638,pinkie pie
1975541.png,https://derpicdn.net/img/view/2019/3/2/1975541.png,0,0.987108767,301,0,4481,3860,4180,3860,pinkie pie
1977618.png,https://derpicdn.net/img/view/2019/3/4/1977618.png,0,0.985776544,231,0,789,556,558,556,pinkie pie
1980164.png,https://derpicdn.net/img/view/2019/3/8/1980164.png,0,0.931442738,834,0,1810,975,976,975,pinkie pie
1981634.png,https://derpicdn.net/img/view/2019/3/9/1981634.png,0,0.996769726,1633,0,2461,917,828,917,pinkie pie
1982203.png,https://derpicdn.net/img/view/2019/3/10/1982203.png,0,0.992410362,321,46,735,460,414,414,pinkie pie
1983822.png,https://derpicdn.net/img/view/2019/3/12/1983822.png,0,0.952249169,239,381,453,595,214,214,pinkie pie
1990639.png,https://derpicdn.net/img/view/2019/3/20/1990639.png,0,0.966812134,457,145,777,465,320,320,pinkie pie
1990640.png,https://derpicdn.net/img/view/2019/3/20/1990640.png,0,0.981304407,461,156,763,458,302,302,pinkie pie
1991683.png,https://derpicdn.net/img/view/2019/3/21/1991683.png,0,0.954414606,146,28,878,760,732,732,pinkie pie
1993160.png,https://derpicdn.net/img/view/2019/3/23/1993160.png,0,0.9880687,1195,211,1779,795,584,584,pinkie pie
1993160.png,https://derpicdn.net/img/view/2019/3/23/1993160.png,1,0.9767434,1697,49,2199,567,502,518,pinkie pie
1999439.png,https://derpicdn.net/img/view/2019/3/31/1999439.png,0,0.990153193,521,57,1215,751,694,694,pinkie pie
2008963.png,https://derpicdn.net/img/view/2019/4/11/2008963.png,0,0.950168133,1985,970,3241,2226,1256,1256,pinkie pie
2021442.png,https://derpicdn.net/img/view/2019/4/24/2021442.png,0,0.978352606,144,0,1182,967,1038,967,pinkie pie
2022294.png,https://derpicdn.net/img/view/2019/4/25/2022294.png,0,0.974930227,32,0,1148,1112,1116,1112,pinkie pie
2026817.png,https://derpicdn.net/img/view/2019/4/29/2026817.png,0,0.993831158,370,232,846,708,476,476,pinkie pie
2030084.png,https://derpicdn.net/img/view/2019/5/3/2030084.png,0,0.972735465,115,0,603,468,488,468,pinkie pie
2031051.png,https://derpicdn.net/img/view/2019/5/5/2031051.png,0,0.988573313,185,35,1135,985,950,950,pinkie pie
2033010.png,https://derpicdn.net/img/view/2019/5/7/2033010.png,0,0.98587054,437,0,4733,4120,4296,4120,pinkie pie
2038484.png,https://derpicdn.net/img/view/2019/5/14/2038484.png,0,0.9035092,886,143,4722,3979,3836,3836,pinkie pie
2040927.png,https://derpicdn.net/img/view/2019/5/16/2040927.png,0,0.967408717,394,187,2320,2277,1926,2090,pinkie pie
2041880.png,https://derpicdn.net/img/view/2019/5/18/2041880.png,0,0.999084115,274,212,1168,1106,894,894,pinkie pie
2044751.png,https://derpicdn.net/img/view/2019/5/21/2044751.png,0,0.973767698,948,501,1840,1393,892,892,pinkie pie
2051022.png,https://derpicdn.net/img/view/2019/5/27/2051022.png,0,0.992080152,127,168,813,854,686,686,pinkie pie
2071284.png,https://derpicdn.net/img/view/2019/6/21/2071284.png,0,0.9977718,836,0,1886,1024,1050,1024,pinkie pie
2071894.png,https://derpicdn.net/img/view/2019/6/22/2071894.png,0,0.993659139,262,0,802,519,540,519,pinkie pie
2072076.png,https://derpicdn.net/img/view/2019/6/22/2072076.png,0,0.972103238,56,0,680,589,624,589,pinkie pie
2072449.png,https://derpicdn.net/img/view/2019/6/22/2072449.png,0,0.967230439,402,328,1452,1378,1050,1050,pinkie pie
2075619.png,https://derpicdn.net/img/view/2019/6/26/2075619.png,0,0.986416876,335,100,801,566,466,466,pinkie pie
2076703.png,https://derpicdn.net/img/view/2019/6/27/2076703.png,0,0.933429658,0,15,904,1097,904,1082,pinkie pie
2090429.png,https://derpicdn.net/img/view/2019/7/13/2090429.png,0,0.996689379,300,0,712,369,412,369,pinkie pie
2093227.png,https://derpicdn.net/img/view/2019/7/16/2093227.png,0,0.995346904,2,158,572,728,570,570,pinkie pie
2093902.png,https://derpicdn.net/img/view/2019/7/17/2093902.png,0,0.997234583,710,9,1784,1083,1074,1074,pinkie pie
2103028.png,https://derpicdn.net/img/view/2019/7/28/2103028.png,0,0.996227086,598,93,1324,819,726,726,pinkie pie
2107641.png,https://derpicdn.net/img/view/2019/8/3/2107641.png,0,0.995634735,581,164,1303,886,722,722,pinkie pie
2107643.png,https://derpicdn.net/img/view/2019/8/3/2107643.png,0,0.987658203,570,160,1296,886,726,726,pinkie pie
2108369.png,https://derpicdn.net/img/view/2019/8/3/2108369.png,0,0.947655797,1834,0,3820,1670,1986,1670,pinkie pie
2109979.png,https://derpicdn.net/img/view/2019/8/5/2109979.png,0,0.947771668,236,32,556,352,320,320,pinkie pie
2111687.png,https://derpicdn.net/img/view/2019/8/7/2111687.png,0,0.98763746,0,0,262,246,262,246,pinkie pie
2111692.png,https://derpicdn.net/img/view/2019/8/7/2111692.png,0,0.985421121,2,0,304,291,302,291,pinkie pie
2120837.png,https://derpicdn.net/img/view/2019/8/17/2120837.png,0,0.907689333,165,50,959,844,794,794,pinkie pie
2125642.png,https://derpicdn.net/img/view/2019/8/23/2125642.png,0,0.916088462,355,263,2011,1919,1656,1656,pinkie pie
2125915.png,https://derpicdn.net/img/view/2019/8/24/2125915.png,0,0.960505605,41,0,482,443,441,443,pinkie pie
2128212.png,https://derpicdn.net/img/view/2019/8/26/2128212.png,0,0.916422069,255,0,1604,1285,1349,1285,pinkie pie
2130043.png,https://derpicdn.net/img/view/2019/8/28/2130043.png,0,0.994203091,363,103,1321,1061,958,958,pinkie pie
2136417.png,https://derpicdn.net/img/view/2019/9/4/2136417.png,0,0.988237441,205,47,845,687,640,640,pinkie pie
2137779.png,https://derpicdn.net/img/view/2019/9/6/2137779.png,0,0.97244662,6,0,1916,1824,1910,1824,pinkie pie
2139620.png,https://derpicdn.net/img/view/2019/9/8/2139620.png,0,0.969070315,1601,623,2627,1649,1026,1026,pinkie pie
2143174.png,https://derpicdn.net/img/view/2019/9/13/2143174.png,0,0.987148404,0,0,914,912,914,912,pinkie pie
2145943.png,https://derpicdn.net/img/view/2019/9/16/2145943.png,0,0.994817615,603,85,1453,935,850,850,pinkie pie
2153008.png,https://derpicdn.net/img/view/2019/9/25/2153008.png,0,0.971295655,256,45,876,665,620,620,pinkie pie
2154474.png,https://derpicdn.net/img/view/2019/9/27/2154474.png,0,0.990371168,848,0,1702,846,854,846,pinkie pie
2165325.png,https://derpicdn.net/img/view/2019/10/11/2165325.png,0,0.977611542,144,113,894,863,750,750,pinkie pie
2165325.png,https://derpicdn.net/img/view/2019/10/11/2165325.png,1,0.926527739,1022,46,1928,952,906,906,pinkie pie
2171665.png,https://derpicdn.net/img/view/2019/10/17/2171665.png,0,0.901307225,186,12,2420,2246,2234,2234,pinkie pie
2189222.png,https://derpicdn.net/img/view/2019/11/6/2189222.png,0,0.989208579,828,0,2632,1794,1804,1794,pinkie pie
2192787.png,https://derpicdn.net/img/view/2019/11/11/2192787.png,0,0.951196849,811,236,2769,2194,1958,1958,pinkie pie
2212128.png,https://derpicdn.net/img/view/2019/12/4/2212128.png,0,0.971476912,295,0,1531,1126,1236,1126,pinkie pie
2213460.png,https://derpicdn.net/img/view/2019/12/6/2213460.png,0,0.930186629,623,33,1675,1085,1052,1052,pinkie pie
2215080.png,https://derpicdn.net/img/view/2019/12/7/2215080.png,0,0.963534415,115,0,2025,1639,1910,1639,pinkie pie
2228207.png,https://derpicdn.net/img/view/2019/12/23/2228207.png,0,0.956899226,0,18,2480,3082,2480,3064,pinkie pie
2228896.jpg,https://derpicdn.net/img/view/2019/12/24/2228896.jpg,0,0.951883912,241,0,1511,1041,1270,1041,pinkie pie
2229272.png,https://derpicdn.net/img/view/2019/12/25/2229272.png,0,0.94858098,491,0,1907,1346,1416,1346,pinkie pie
2231123.jpg,https://derpicdn.net/img/view/2019/12/27/2231123.jpg,0,0.998057425,890,48,1260,418,370,370,pinkie pie
2231123.jpg,https://derpicdn.net/img/view/2019/12/27/2231123.jpg,1,0.996711135,139,55,721,637,582,582,pinkie pie
2231123.jpg,https://derpicdn.net/img/view/2019/12/27/2231123.jpg,2,0.995556772,669,637,1237,1205,568,568,pinkie pie
2231683.jpg,https://derpicdn.net/img/view/2019/12/28/2231683.jpg,0,0.998370171,305,6,619,320,314,314,pinkie pie
2234951.jpg,https://derpicdn.net/img/view/2019/12/31/2234951.jpg,0,0.998643219,789,434,1193,838,404,404,pinkie pie
2234951.jpg,https://derpicdn.net/img/view/2019/12/31/2234951.jpg,1,0.995137274,39,537,461,959,422,422,pinkie pie
2234951.jpg,https://derpicdn.net/img/view/2019/12/31/2234951.jpg,2,0.989570439,285,43,659,417,374,374,pinkie pie
2235908.jpg,https://derpicdn.net/img/view/2020/1/1/2235908.jpg,0,0.928999066,92,0,730,602,638,602,pinkie pie
2238704.jpg,https://derpicdn.net/img/view/2020/1/4/2238704.jpg,0,0.985013425,61,987,603,1529,542,542,pinkie pie
224.jpg,https://derpicdn.net/img/view/2012/1/15/224.jpg,0,0.998130143,162,0,554,391,392,391,pinkie pie
2240543.png,https://derpicdn.net/img/view/2020/1/6/2240543.png,0,0.953088462,158,0,1125,971,967,971,pinkie pie
2241841.jpg,https://derpicdn.net/img/view/2020/1/8/2241841.jpg,0,0.951016486,997,230,3223,2456,2226,2226,pinkie pie
2242377.png,https://derpicdn.net/img/view/2020/1/9/2242377.png,0,0.932862043,310,57,636,383,326,326,pinkie pie
2247417.png,https://derpicdn.net/img/view/2020/1/14/2247417.png,0,0.980911613,200,0,2940,1457,2740,1457,pinkie pie
2247417.png,https://derpicdn.net/img/view/2020/1/14/2247417.png,1,0.98025924,625,0,2909,1457,2284,1457,pinkie pie
2250684.jpg,https://derpicdn.net/img/view/2020/1/18/2250684.jpg,0,0.996880949,232,0,754,481,522,481,pinkie pie
2253676.jpg,https://derpicdn.net/img/view/2020/1/22/2253676.jpg,0,0.993231893,665,613,1099,1047,434,434,pinkie pie
2254241.jpg,https://derpicdn.net/img/view/2020/1/22/2254241.jpg,0,0.995349944,268,0,1318,924,1050,924,pinkie pie
2256043.jpg,https://derpicdn.net/img/view/2020/1/24/2256043.jpg,0,0.932174504,186,61,568,443,382,382,pinkie pie
2256990.png,https://derpicdn.net/img/view/2020/1/25/2256990.png,0,0.979412258,497,24,1345,872,848,848,pinkie pie
2258188.jpg,https://derpicdn.net/img/view/2020/1/27/2258188.jpg,0,0.989611149,301,0,1693,1288,1392,1288,pinkie pie
2261618.jpg,https://derpicdn.net/img/view/2020/1/31/2261618.jpg,0,0.972054362,365,15,1029,679,664,664,pinkie pie
2264972.jpg,https://derpicdn.net/img/view/2020/2/3/2264972.jpg,0,0.993720591,61,0,1165,995,1104,995,pinkie pie
2270949.jpg,https://derpicdn.net/img/view/2020/2/11/2270949.jpg,0,0.996693313,99,0,639,538,540,538,pinkie pie
2271475.png,https://derpicdn.net/img/view/2020/2/11/2271475.png,0,0.996931076,444,0,1458,1001,1014,1001,pinkie pie
2276663.png,https://derpicdn.net/img/view/2020/2/17/2276663.png,0,0.92561847,785,0,2146,1397,1361,1397,pinkie pie
2278313.jpg,https://derpicdn.net/img/view/2020/2/19/2278313.jpg,0,0.993544519,392,25,1130,763,738,738,pinkie pie
2278969.jpg,https://derpicdn.net/img/view/2020/2/20/2278969.jpg,0,0.971169531,232,0,1270,997,1038,997,pinkie pie
2279178.jpg,https://derpicdn.net/img/view/2020/2/20/2279178.jpg,0,0.996831417,0,152,624,820,624,668,pinkie pie
2282369.jpg,https://derpicdn.net/img/view/2020/2/24/2282369.jpg,0,0.969782054,145,22,1015,892,870,870,pinkie pie
2288888.jpg,https://derpicdn.net/img/view/2020/3/3/2288888.jpg,0,0.936703742,242,163,800,817,558,654,pinkie pie
2290297.jpg,https://derpicdn.net/img/view/2020/3/5/2290297.jpg,0,0.954213023,0,8,419,478,419,470,pinkie pie
2293324.png,https://derpicdn.net/img/view/2020/3/9/2293324.png,0,0.997217894,457,35,1615,1193,1158,1158,pinkie pie
2295591.png,https://derpicdn.net/img/view/2020/3/12/2295591.png,0,0.979257405,1374,329,2578,1533,1204,1204,pinkie pie
2297216.jpg,https://derpicdn.net/img/view/2020/3/14/2297216.jpg,0,0.969976246,191,92,1053,954,862,862,pinkie pie
2302316.jpg,https://derpicdn.net/img/view/2020/3/21/2302316.jpg,0,0.999355972,188,217,1528,1557,1340,1340,pinkie pie
2303442.png,https://derpicdn.net/img/view/2020/3/22/2303442.png,0,0.949751914,406,116,844,554,438,438,pinkie pie
2305842.jpg,https://derpicdn.net/img/view/2020/3/25/2305842.jpg,0,0.995071888,325,22,737,434,412,412,pinkie pie
2310127.jpg,https://derpicdn.net/img/view/2020/3/30/2310127.jpg,0,0.990683794,481,0,1135,552,654,552,pinkie pie
2314712.png,https://derpicdn.net/img/view/2020/4/5/2314712.png,0,0.986969173,866,61,1828,1023,962,962,pinkie pie
2314795.png,https://derpicdn.net/img/view/2020/4/5/2314795.png,0,0.949304819,516,16,2078,1578,1562,1562,pinkie pie
2316186.png,https://derpicdn.net/img/view/2020/4/7/2316186.png,0,0.902338505,183,0,2741,2474,2558,2474,pinkie pie
2318882.png,https://derpicdn.net/img/view/2020/4/10/2318882.png,0,0.946383715,219,80,1451,1312,1232,1232,pinkie pie
2320588.jpg,https://derpicdn.net/img/view/2020/4/12/2320588.jpg,0,0.994068563,619,0,1049,398,430,398,pinkie pie
23244.png,https://derpicdn.net/img/view/2012/6/27/23244.png,0,0.945713997,118,89,330,301,212,212,pinkie pie
2326789.jpg,https://derpicdn.net/img/view/2020/4/20/2326789.jpg,0,0.989264011,519,55,1481,1017,962,962,pinkie pie
2332610.png,https://derpicdn.net/img/view/2020/4/26/2332610.png,0,0.987468779,39,0,491,450,452,450,pinkie pie
2336624.png,https://derpicdn.net/img/view/2020/5/1/2336624.png,0,0.977600098,0,30,622,700,622,670,pinkie pie
2338352.jpg,https://derpicdn.net/img/view/2020/5/3/2338352.jpg,0,0.991678894,102,125,730,753,628,628,pinkie pie
2340154.jpg,https://derpicdn.net/img/view/2020/5/5/2340154.jpg,0,0.925773323,416,0,1118,702,702,702,pinkie pie
2340787.png,https://derpicdn.net/img/view/2020/5/6/2340787.png,0,0.995445132,2005,0,3173,901,1168,901,pinkie pie
23555.png,https://derpicdn.net/img/view/2012/6/28/23555.png,0,0.985153079,354,0,746,375,392,375,pinkie pie
267562.png,https://derpicdn.net/img/view/2013/3/10/267562.png,0,0.928246439,361,34,803,476,442,442,pinkie pie
318937.jpg,https://derpicdn.net/img/view/2013/5/7/318937.jpg,0,0.954508185,10,0,816,805,806,805,pinkie pie
319453.png,https://derpicdn.net/img/view/2013/5/8/319453.png,0,0.986854672,89,7,439,357,350,350,pinkie pie
339331.png,https://derpicdn.net/img/view/2013/6/2/339331.png,0,0.99889791,160,0,700,506,540,506,pinkie pie
343602.png,https://derpicdn.net/img/view/2013/6/8/343602.png,0,0.995547056,197,0,387,187,190,187,pinkie pie
343602.png,https://derpicdn.net/img/view/2013/6/8/343602.png,1,0.981055439,440,35,678,273,238,238,pinkie pie
349653.png,https://derpicdn.net/img/view/2013/6/16/349653.png,0,0.996117353,476,142,922,588,446,446,pinkie pie
352072.png,https://derpicdn.net/img/view/2013/6/19/352072.png,0,0.988902092,410,0,1842,1421,1432,1421,pinkie pie
355073.png,https://derpicdn.net/img/view/2013/6/23/355073.png,0,0.947044492,468,81,920,533,452,452,pinkie pie
360761.png,https://derpicdn.net/img/view/2013/6/30/360761.png,0,0.914404452,4,4,804,804,800,800,pinkie pie
370990.png,https://derpicdn.net/img/view/2013/7/12/370990.png,0,0.968685329,0,349,301,655,301,306,pinkie pie
406282.png,https://derpicdn.net/img/view/2013/8/21/406282.png,0,0.994995177,142,2,450,310,308,308,pinkie pie
409.jpg,https://derpicdn.net/img/view/2012/1/16/409.jpg,0,0.956753016,847,304,1379,836,532,532,pinkie pie
4226.png,https://derpicdn.net/img/view/2012/6/3/4226.png,0,0.901169837,337,23,697,383,360,360,pinkie pie
4249.jpg,https://derpicdn.net/img/view/2012/6/3/4249.jpg,0,0.975087941,59,18,591,550,532,532,pinkie pie
4250.png,https://derpicdn.net/img/view/2012/6/3/4250.png,0,0.992835045,39,0,259,208,220,208,pinkie pie
4250.png,https://derpicdn.net/img/view/2012/6/3/4250.png,1,0.97949785,373,16,617,260,244,244,pinkie pie
429124.jpg,https://derpicdn.net/img/view/2013/9/16/429124.jpg,0,0.992110431,67,307,345,585,278,278,pinkie pie
429124.jpg,https://derpicdn.net/img/view/2013/9/16/429124.jpg,1,0.909049332,709,0,999,286,290,286,pinkie pie
429972.png,https://derpicdn.net/img/view/2013/9/17/429972.png,0,0.993992984,117,18,339,240,222,222,pinkie pie
433813.png,https://derpicdn.net/img/view/2013/9/24/433813.png,0,0.995501578,643,0,1201,489,558,489,pinkie pie
433813.png,https://derpicdn.net/img/view/2013/9/24/433813.png,1,0.994588733,37,0,407,334,370,334,pinkie pie
437070.png,https://derpicdn.net/img/view/2013/9/28/437070.png,0,0.948856175,100,0,422,322,322,322,pinkie pie
442680.png,https://derpicdn.net/img/view/2013/10/6/442680.png,0,0.99393481,217,11,505,299,288,288,pinkie pie
442680.png,https://derpicdn.net/img/view/2013/10/6/442680.png,1,0.976573229,537,0,873,307,336,307,pinkie pie
449907.jpg,https://derpicdn.net/img/view/2013/10/16/449907.jpg,0,0.919967294,619,129,1279,789,660,660,pinkie pie
454580.png,https://derpicdn.net/img/view/2013/10/23/454580.png,0,0.926036716,66,0,374,301,308,301,pinkie pie
459816.png,https://derpicdn.net/img/view/2013/10/29/459816.png,0,0.947097301,382,614,1902,2134,1520,1520,pinkie pie
471333.png,https://derpicdn.net/img/view/2013/11/13/471333.png,0,0.973374903,167,0,600,469,433,469,pinkie pie
472287.jpg,https://derpicdn.net/img/view/2013/11/14/472287.jpg,0,0.990706682,472,774,718,1020,246,246,pinkie pie
472287.jpg,https://derpicdn.net/img/view/2013/11/14/472287.jpg,1,0.975021243,157,491,415,749,258,258,pinkie pie
472287.jpg,https://derpicdn.net/img/view/2013/11/14/472287.jpg,2,0.952724516,99,39,335,275,236,236,pinkie pie
472287.jpg,https://derpicdn.net/img/view/2013/11/14/472287.jpg,3,0.952552915,563,0,831,255,268,255,pinkie pie
478882.png,https://derpicdn.net/img/view/2013/11/23/478882.png,0,0.963326395,99,92,1291,1250,1192,1158,pinkie pie
494407.png,https://derpicdn.net/img/view/2013/12/10/494407.png,0,0.967253923,341,0,639,296,298,296,pinkie pie
494828.png,https://derpicdn.net/img/view/2013/12/11/494828.png,0,0.966838419,0,657,1111,1857,1111,1200,pinkie pie
494828.png,https://derpicdn.net/img/view/2013/12/11/494828.png,1,0.946237922,993,341,2223,1571,1230,1230,pinkie pie
517082.png,https://derpicdn.net/img/view/2014/1/6/517082.png,0,0.9528597,278,75,704,501,426,426,pinkie pie
521255.jpg,https://derpicdn.net/img/view/2014/1/11/521255.jpg,0,0.980870306,0,0,318,321,318,321,pinkie pie
523037.png,https://derpicdn.net/img/view/2014/1/13/523037.png,0,0.956169188,0,0,1205,1105,1205,1105,pinkie pie
526287.png,https://derpicdn.net/img/view/2014/1/17/526287.png,0,0.991790771,102,114,998,1010,896,896,pinkie pie
526925.png,https://derpicdn.net/img/view/2014/1/17/526925.png,0,0.922445953,348,6,910,568,562,562,pinkie pie
533891.png,https://derpicdn.net/img/view/2014/1/25/533891.png,0,0.967028975,1188,600,2262,1674,1074,1074,pinkie pie
542130.png,https://derpicdn.net/img/view/2014/2/3/542130.png,0,0.96112746,57,35,599,577,542,542,pinkie pie
544933.png,https://derpicdn.net/img/view/2014/2/6/544933.png,0,0.916957974,792,373,1052,633,260,260,pinkie pie
546571.png,https://derpicdn.net/img/view/2014/2/8/546571.png,0,0.963090658,60,0,680,666,620,666,pinkie pie
548172.png,https://derpicdn.net/img/view/2014/2/10/548172.png,0,0.998991251,285,0,937,630,652,630,pinkie pie
549245.png,https://derpicdn.net/img/view/2014/2/11/549245.png,0,0.92190659,184,36,542,394,358,358,pinkie pie
556679.png,https://derpicdn.net/img/view/2014/2/19/556679.png,0,0.979125679,32,0,634,573,602,573,pinkie pie
556776.png,https://derpicdn.net/img/view/2014/2/20/556776.png,0,0.979621172,27,0,631,574,604,574,pinkie pie
568777.png,https://derpicdn.net/img/view/2014/3/7/568777.png,0,0.979072154,72,0,798,693,726,693,pinkie pie
569860.png,https://derpicdn.net/img/view/2014/3/9/569860.png,0,0.969542861,472,91,956,575,484,484,pinkie pie
574975.png,https://derpicdn.net/img/view/2014/3/14/574975.png,0,0.913538873,183,47,463,327,280,280,pinkie pie
575924.png,https://derpicdn.net/img/view/2014/3/15/575924.png,0,0.97092694,0,43,262,321,262,278,pinkie pie
575948.png,https://derpicdn.net/img/view/2014/3/15/575948.png,0,0.996470213,422,21,942,541,520,520,pinkie pie
594985.png,https://derpicdn.net/img/view/2014/4/7/594985.png,0,0.949689806,50,0,908,745,858,745,pinkie pie
599274.png,https://derpicdn.net/img/view/2014/4/13/599274.png,0,0.94802326,0,784,2674,3464,2674,2680,pinkie pie
601768.png,https://derpicdn.net/img/view/2014/4/16/601768.png,0,0.973451614,77,224,511,658,434,434,pinkie pie
605101.png,https://derpicdn.net/img/view/2014/4/19/605101.png,0,0.983787358,290,53,592,355,302,302,pinkie pie
608380.png,https://derpicdn.net/img/view/2014/4/24/608380.png,0,0.993444264,1328,368,1885,972,557,604,pinkie pie
608380.png,https://derpicdn.net/img/view/2014/4/24/608380.png,1,0.983893454,57,315,901,1159,844,844,pinkie pie
608714.png,https://derpicdn.net/img/view/2014/4/24/608714.png,0,0.941808879,261,7,533,279,272,272,pinkie pie
611121.png,https://derpicdn.net/img/view/2014/4/27/611121.png,0,0.996843696,168,0,502,316,334,316,pinkie pie
613212.png,https://derpicdn.net/img/view/2014/4/29/613212.png,0,0.999428809,223,88,635,500,412,412,pinkie pie
613212.png,https://derpicdn.net/img/view/2014/4/29/613212.png,1,0.993747771,706,120,1050,464,344,344,pinkie pie
614907.png,https://derpicdn.net/img/view/2014/5/1/614907.png,0,0.995853782,1299,344,1885,1006,586,662,pinkie pie
614907.png,https://derpicdn.net/img/view/2014/5/1/614907.png,1,0.982706785,57,316,901,1160,844,844,pinkie pie
61970.jpg,https://derpicdn.net/img/view/2012/7/30/61970.jpg,0,0.952177346,250,0,702,413,452,413,pinkie pie
623550.png,https://derpicdn.net/img/view/2014/5/11/623550.png,0,0.944399893,0,28,528,560,528,532,pinkie pie
624923.png,https://derpicdn.net/img/view/2014/5/12/624923.png,0,0.988707364,34,0,1390,1327,1356,1327,pinkie pie
628515.png,https://derpicdn.net/img/view/2014/5/16/628515.png,0,0.999611855,166,4,548,386,382,382,pinkie pie
639042.png,https://derpicdn.net/img/view/2014/5/28/639042.png,0,0.994941533,601,0,1131,462,530,462,pinkie pie
640685.png,https://derpicdn.net/img/view/2014/5/30/640685.png,0,0.987317443,782,0,1272,420,490,420,pinkie pie
645426.png,https://derpicdn.net/img/view/2014/6/5/645426.png,0,0.985272467,647,123,907,383,260,260,pinkie pie
670373.png,https://derpicdn.net/img/view/2014/7/8/670373.png,0,0.993124783,382,0,626,233,244,233,pinkie pie
676774.png,https://derpicdn.net/img/view/2014/7/17/676774.png,0,0.99087739,497,0,1029,510,532,510,pinkie pie
676923.png,https://derpicdn.net/img/view/2014/7/17/676923.png,0,0.979758918,234,0,1150,1052,916,1052,pinkie pie
68063.png,https://derpicdn.net/img/view/2012/8/6/68063.png,0,0.983863175,288,307,516,535,228,228,pinkie pie
685108.png,https://derpicdn.net/img/view/2014/7/28/685108.png,0,0.976375461,55,0,499,440,444,440,pinkie pie
686634.jpg,https://derpicdn.net/img/view/2014/7/30/686634.jpg,0,0.985376894,0,0,1210,1195,1210,1195,pinkie pie
691502.png,https://derpicdn.net/img/view/2014/8/5/691502.png,0,0.972837567,60,7,706,653,646,646,pinkie pie
695136.png,https://derpicdn.net/img/view/2014/8/9/695136.png,0,0.966040075,5,13,309,317,304,304,pinkie pie
695314.png,https://derpicdn.net/img/view/2014/8/9/695314.png,0,0.980958641,957,98,1585,726,628,628,pinkie pie
699014.png,https://derpicdn.net/img/view/2014/8/13/699014.png,0,0.905227065,1242,447,2152,1357,910,910,pinkie pie
707797.png,https://derpicdn.net/img/view/2014/8/25/707797.png,0,0.976289451,531,67,943,479,412,412,pinkie pie
711986.png,https://derpicdn.net/img/view/2014/8/31/711986.png,0,0.947729826,0,12,309,340,309,328,pinkie pie
712870.jpg,https://derpicdn.net/img/view/2014/9/1/712870.jpg,0,0.941612601,0,0,535,534,535,534,pinkie pie
719.png,https://derpicdn.net/img/view/2012/1/17/719.png,0,0.965911686,229,0,780,564,551,564,pinkie pie
720423.png,https://derpicdn.net/img/view/2014/9/12/720423.png,0,0.981960773,0,521,4693,5233,4693,4712,pinkie pie
722494.png,https://derpicdn.net/img/view/2014/9/15/722494.png,0,0.99341017,915,4,1939,1028,1024,1024,pinkie pie
722544.png,https://derpicdn.net/img/view/2014/9/15/722544.png,0,0.972739995,854,0,1612,753,758,753,pinkie pie
722847.jpg,https://derpicdn.net/img/view/2014/9/15/722847.jpg,0,0.992776275,436,138,1324,1026,888,888,pinkie pie
723528.png,https://derpicdn.net/img/view/2014/9/16/723528.png,0,0.998354018,1012,103,1922,1013,910,910,pinkie pie
728430.jpg,https://derpicdn.net/img/view/2014/9/24/728430.jpg,0,0.990813553,371,247,1015,891,644,644,pinkie pie
732989.png,https://derpicdn.net/img/view/2014/9/30/732989.png,0,0.990963161,99,26,595,522,496,496,pinkie pie
733791.png,https://derpicdn.net/img/view/2014/10/2/733791.png,0,0.992944658,179,0,505,313,326,313,pinkie pie
754224.png,https://derpicdn.net/img/view/2014/10/30/754224.png,0,0.964337647,781,71,1277,567,496,496,pinkie pie
754224.png,https://derpicdn.net/img/view/2014/10/30/754224.png,1,0.912749708,95,261,473,639,378,378,pinkie pie
770939.png,https://derpicdn.net/img/view/2014/11/24/770939.png,0,0.995571733,97,0,1351,1160,1254,1160,pinkie pie
7809.jpg,https://derpicdn.net/img/view/2012/6/18/7809.jpg,0,0.964265168,238,57,464,283,226,226,pinkie pie
782291.png,https://derpicdn.net/img/view/2014/12/10/782291.png,0,0.989692152,75,0,685,598,610,598,pinkie pie
783610.png,https://derpicdn.net/img/view/2014/12/12/783610.png,0,0.960835874,0,226,366,638,366,412,pinkie pie
786714.png,https://derpicdn.net/img/view/2014/12/17/786714.png,0,0.996747136,65,0,835,644,770,644,pinkie pie
791078.png,https://derpicdn.net/img/view/2014/12/23/791078.png,0,0.993298471,43,40,433,430,390,390,pinkie pie
791079.png,https://derpicdn.net/img/view/2014/12/23/791079.png,0,0.984932423,44,79,434,469,390,390,pinkie pie
794156.jpg,https://derpicdn.net/img/view/2014/12/28/794156.jpg,0,0.965765119,91,73,589,571,498,498,pinkie pie
799917.png,https://derpicdn.net/img/view/2015/1/5/799917.png,0,0.981175959,112,0,764,541,652,541,pinkie pie
800978.png,https://derpicdn.net/img/view/2015/1/6/800978.png,0,0.950206637,1080,59,2242,1221,1162,1162,pinkie pie
805732.png,https://derpicdn.net/img/view/2015/1/13/805732.png,0,0.988190889,0,0,574,534,574,534,pinkie pie
807069.png,https://derpicdn.net/img/view/2015/1/15/807069.png,0,0.996453643,0,0,882,864,882,864,pinkie pie
809716.png,https://derpicdn.net/img/view/2015/1/19/809716.png,0,0.990058601,0,0,475,432,475,432,pinkie pie
813419.png,https://derpicdn.net/img/view/2015/1/24/813419.png,0,0.969648778,166,44,606,484,440,440,pinkie pie
817408.png,https://derpicdn.net/img/view/2015/1/29/817408.png,0,0.960972369,560,109,2000,1623,1440,1514,pinkie pie
820336.png,https://derpicdn.net/img/view/2015/2/3/820336.png,0,0.999230802,204,55,616,467,412,412,pinkie pie
822432.png,https://derpicdn.net/img/view/2015/2/6/822432.png,0,0.998273671,444,50,988,594,544,544,pinkie pie
823105.png,https://derpicdn.net/img/view/2015/2/7/823105.png,0,0.992441535,101,5,685,589,584,584,pinkie pie
823193.png,https://derpicdn.net/img/view/2015/2/7/823193.png,0,0.978992462,436,102,640,306,204,204,pinkie pie
823193.png,https://derpicdn.net/img/view/2015/2/7/823193.png,1,0.922884583,216,243,508,535,292,292,pinkie pie
825083.png,https://derpicdn.net/img/view/2015/2/9/825083.png,0,0.939317882,49,4,683,638,634,634,pinkie pie
827464.png,https://derpicdn.net/img/view/2015/2/13/827464.png,0,0.936374128,68,4,1024,992,956,988,pinkie pie
834054.jpg,https://derpicdn.net/img/view/2015/2/21/834054.jpg,0,0.965524554,9,0,500,504,491,504,pinkie pie
834185.jpg,https://derpicdn.net/img/view/2015/2/21/834185.jpg,0,0.955662012,31,13,489,471,458,458,pinkie pie
837537.png,https://derpicdn.net/img/view/2015/2/26/837537.png,0,0.99889791,168,0,786,601,618,601,pinkie pie
839140.jpg,https://derpicdn.net/img/view/2015/2/28/839140.jpg,0,0.990133405,35,0,1185,1134,1150,1134,pinkie pie
840396.png,https://derpicdn.net/img/view/2015/3/2/840396.png,0,0.954138875,82,0,918,800,836,800,pinkie pie
841554.png,https://derpicdn.net/img/view/2015/3/3/841554.png,0,0.994369507,170,85,562,477,392,392,pinkie pie
847380.png,https://derpicdn.net/img/view/2015/3/11/847380.png,0,0.972919583,4,0,808,764,804,764,pinkie pie
85422.png,https://derpicdn.net/img/view/2012/8/29/85422.png,0,0.980493009,401,583,723,905,322,322,pinkie pie
856552.png,https://derpicdn.net/img/view/2015/3/25/856552.png,0,0.993945718,636,87,1600,1051,964,964,pinkie pie
859621.png,https://derpicdn.net/img/view/2015/3/29/859621.png,0,0.998354852,299,0,931,630,632,630,pinkie pie
860009.jpg,https://derpicdn.net/img/view/2015/3/29/860009.jpg,0,0.983135521,802,337,1106,641,304,304,pinkie pie
867551.png,https://derpicdn.net/img/view/2015/4/7/867551.png,0,0.967997491,174,0,666,470,492,470,pinkie pie
867551.png,https://derpicdn.net/img/view/2015/4/7/867551.png,1,0.932357132,371,0,857,478,486,478,pinkie pie
874209.png,https://derpicdn.net/img/view/2015/4/15/874209.png,0,0.994308352,375,0,800,407,425,407,pinkie pie
880884.png,https://derpicdn.net/img/view/2015/4/23/880884.png,0,0.991422117,0,1,478,523,478,522,pinkie pie
881310.jpg,https://derpicdn.net/img/view/2015/4/24/881310.jpg,0,0.99703747,402,65,1188,851,786,786,pinkie pie
884770.png,https://derpicdn.net/img/view/2015/4/28/884770.png,0,0.993032694,26,0,866,743,840,743,pinkie pie
887599.png,https://derpicdn.net/img/view/2015/5/2/887599.png,0,0.994989097,386,1,770,385,384,384,pinkie pie
890070.png,https://derpicdn.net/img/view/2015/5/5/890070.png,0,0.929139376,265,12,711,458,446,446,pinkie pie
891041.png,https://derpicdn.net/img/view/2015/5/7/891041.png,0,0.971705496,209,0,617,406,408,406,pinkie pie
891729.png,https://derpicdn.net/img/view/2015/5/8/891729.png,0,0.921491444,297,10,809,522,512,512,pinkie pie
900164.png,https://derpicdn.net/img/view/2015/5/19/900164.png,0,0.977750897,624,369,1006,751,382,382,pinkie pie
900502.png,https://derpicdn.net/img/view/2015/5/20/900502.png,0,0.93759352,117,66,1000,954,883,888,pinkie pie
901560.png,https://derpicdn.net/img/view/2015/5/22/901560.png,0,0.920583785,1062,1142,1826,1906,764,764,pinkie pie
907600.png,https://derpicdn.net/img/view/2015/5/31/907600.png,0,0.975539148,73,254,2043,2224,1970,1970,pinkie pie
908061.png,https://derpicdn.net/img/view/2015/6/1/908061.png,0,0.982297719,939,312,1779,1152,840,840,pinkie pie
912809.png,https://derpicdn.net/img/view/2015/6/8/912809.png,0,0.950178266,205,139,1500,1499,1295,1360,pinkie pie
912809.png,https://derpicdn.net/img/view/2015/6/8/912809.png,1,0.904468834,441,0,1500,1190,1059,1190,pinkie pie
918320.png,https://derpicdn.net/img/view/2015/6/16/918320.png,0,0.932644844,702,0,1664,962,962,962,pinkie pie
918321.png,https://derpicdn.net/img/view/2015/6/16/918321.png,0,0.940363526,712,7,1660,955,948,948,pinkie pie
919658.png,https://derpicdn.net/img/view/2015/6/19/919658.png,0,0.992827177,409,0,1529,1075,1120,1075,pinkie pie
922312.png,https://derpicdn.net/img/view/2015/6/23/922312.png,0,0.956208766,2,0,950,870,948,870,pinkie pie
924827.png,https://derpicdn.net/img/view/2015/6/27/924827.png,0,0.994710624,121,0,750,613,629,613,pinkie pie
925225.png,https://derpicdn.net/img/view/2015/6/28/925225.png,0,0.905411184,1164,534,1734,1104,570,570,pinkie pie
926334.png,https://derpicdn.net/img/view/2015/6/29/926334.png,0,0.932363629,221,195,395,369,174,174,pinkie pie
928208.png,https://derpicdn.net/img/view/2015/7/2/928208.png,0,0.985991657,150,0,894,730,744,730,pinkie pie
931118.jpg,https://derpicdn.net/img/view/2015/7/6/931118.jpg,0,0.970494509,0,0,814,706,814,706,pinkie pie
938271.png,https://derpicdn.net/img/view/2015/7/16/938271.png,0,0.973708153,789,6,2323,1540,1534,1534,pinkie pie
938596.png,https://derpicdn.net/img/view/2015/7/17/938596.png,0,0.945209801,648,0,1506,825,858,825,pinkie pie
938707.png,https://derpicdn.net/img/view/2015/7/17/938707.png,0,0.99840349,0,0,498,463,498,463,pinkie pie
94392.jpg,https://derpicdn.net/img/view/2012/9/10/94392.jpg,0,0.96186924,131,0,443,307,312,307,pinkie pie
94392.jpg,https://derpicdn.net/img/view/2012/9/10/94392.jpg,1,0.901547551,443,0,779,310,336,310,pinkie pie
94393.jpg,https://derpicdn.net/img/view/2012/9/10/94393.jpg,0,0.948155046,64,0,496,421,432,421,pinkie pie
94396.jpg,https://derpicdn.net/img/view/2012/9/10/94396.jpg,0,0.991485834,79,16,475,412,396,396,pinkie pie
946774.png,https://derpicdn.net/img/view/2015/7/29/946774.png,0,0.994979203,91,0,385,247,294,247,pinkie pie
952056.png,https://derpicdn.net/img/view/2015/8/6/952056.png,0,0.941509783,33,72,465,504,432,432,pinkie pie
955305.png,https://derpicdn.net/img/view/2015/8/11/955305.png,0,0.959225476,257,0,665,394,408,394,pinkie pie
956342.png,https://derpicdn.net/img/view/2015/8/12/956342.png,0,0.93815589,864,0,1814,901,950,901,pinkie pie
957371.png,https://derpicdn.net/img/view/2015/8/14/957371.png,0,0.998592913,608,87,1484,963,876,876,pinkie pie
957377.png,https://derpicdn.net/img/view/2015/8/14/957377.png,0,0.99863714,605,86,1487,968,882,882,pinkie pie
959667.png,https://derpicdn.net/img/view/2015/8/17/959667.png,0,0.975291729,59,0,345,265,286,265,pinkie pie
959668.png,https://derpicdn.net/img/view/2015/8/17/959668.png,0,0.997005284,53,0,523,407,470,407,pinkie pie
962921.png,https://derpicdn.net/img/view/2015/8/21/962921.png,0,0.977659881,477,10,997,536,520,526,pinkie pie
965174.png,https://derpicdn.net/img/view/2015/8/25/965174.png,0,0.937745333,373,66,1005,698,632,632,pinkie pie
965716.png,https://derpicdn.net/img/view/2015/8/25/965716.png,0,0.996600568,172,255,558,641,386,386,pinkie pie
967854.png,https://derpicdn.net/img/view/2015/8/29/967854.png,0,0.997128367,45,3,333,291,288,288,pinkie pie
977840.png,https://derpicdn.net/img/view/2015/9/12/977840.png,0,0.993195415,221,0,999,684,778,684,pinkie pie
979747.png,https://derpicdn.net/img/view/2015/9/14/979747.png,0,0.978273153,201,0,1679,1445,1478,1445,pinkie pie
988016.png,https://derpicdn.net/img/view/2015/9/26/988016.png,0,0.997583628,184,0,668,439,484,439,pinkie pie
993195.png,https://derpicdn.net/img/view/2015/10/2/993195.png,0,0.990279257,279,0,843,503,564,503,pinkie pie
993528.png,https://derpicdn.net/img/view/2015/10/3/993528.png,0,0.997547746,93,0,699,545,606,545,pinkie pie
995775.png,https://derpicdn.net/img/view/2015/10/6/995775.png,0,0.962881088,1024,0,3668,2518,2644,2518,pinkie pie
1007070.png,https://derpicdn.net/img/view/2015/10/21/1007070.png,0,0.966147244,128,0,494,356,366,356,pinkie pie
1009099.png,https://derpicdn.net/img/view/2015/10/24/1009099.png,0,0.944648147,0,0,1288,1080,1288,1080,pinkie pie
1018114.png,https://derpicdn.net/img/view/2015/11/7/1018114.png,0,0.951993406,0,18,562,642,562,624,pinkie pie
1019794.png,https://derpicdn.net/img/view/2015/11/9/1019794.png,0,0.990786076,782,0,1942,1112,1160,1112,pinkie pie
1021688.png,https://derpicdn.net/img/view/2015/11/12/1021688.png,0,0.968048334,673,259,983,569,310,310,pinkie pie
1030579.png,https://derpicdn.net/img/view/2015/11/26/1030579.png,0,0.994688809,543,0,1963,1412,1420,1412,pinkie pie
1031253.png,https://derpicdn.net/img/view/2015/11/27/1031253.png,0,0.976018131,537,73,979,515,442,442,pinkie pie
1037159.png,https://derpicdn.net/img/view/2015/12/5/1037159.png,0,0.969160616,1197,136,2011,950,814,814,pinkie pie
1039283.png,https://derpicdn.net/img/view/2015/12/7/1039283.png,0,0.972350597,128,0,460,324,332,324,pinkie pie
1040063.png,https://derpicdn.net/img/view/2015/12/9/1040063.png,0,0.984418035,323,54,781,512,458,458,pinkie pie
1040366.png,https://derpicdn.net/img/view/2015/12/9/1040366.png,0,0.982417166,256,0,770,501,514,501,pinkie pie
1040366.png,https://derpicdn.net/img/view/2015/12/9/1040366.png,0,0.982417166,256,0,770,501,514,501,pinkie pie
1043363.png,https://derpicdn.net/img/view/2015/12/13/1043363.png,0,0.943173289,246,69,672,495,426,426,pinkie pie
1048842.png,https://derpicdn.net/img/view/2015/12/20/1048842.png,0,0.972171366,98,0,916,808,818,808,pinkie pie
1055713.png,https://derpicdn.net/img/view/2015/12/30/1055713.png,0,0.998147786,230,0,586,353,356,353,pinkie pie
1057151.jpg,https://derpicdn.net/img/view/2016/1/1/1057151.jpg,0,0.975595713,152,0,594,425,442,425,pinkie pie
1060373.png,https://derpicdn.net/img/view/2016/1/5/1060373.png,0,0.995351315,400,41,1154,795,754,754,pinkie pie
1062868.png,https://derpicdn.net/img/view/2016/1/9/1062868.png,0,0.90898174,673,0,1741,939,1068,939,pinkie pie
1063144.png,https://derpicdn.net/img/view/2016/1/10/1063144.png,0,0.998081446,204,1,804,601,600,600,pinkie pie
1064811.png,https://derpicdn.net/img/view/2016/1/11/1064811.png,0,0.951502681,377,0,787,360,410,360,pinkie pie
1065606.png,https://derpicdn.net/img/view/2016/1/13/1065606.png,0,0.914531052,359,0,759,344,400,344,pinkie pie
1065637.png,https://derpicdn.net/img/view/2016/1/13/1065637.png,0,0.991159201,836,18,1536,718,700,700,pinkie pie
1069969.png,https://derpicdn.net/img/view/2016/1/20/1069969.png,0,0.960190177,40,50,396,406,356,356,pinkie pie
1071260.jpg,https://derpicdn.net/img/view/2016/1/22/1071260.jpg,0,0.984366179,579,247,871,539,292,292,pinkie pie
1073950.png,https://derpicdn.net/img/view/2016/1/26/1073950.png,0,0.968242645,6,62,318,374,312,312,pinkie pie
1074249.png,https://derpicdn.net/img/view/2016/1/26/1074249.png,0,0.99596101,159,112,719,672,560,560,pinkie pie
1076476.png,https://derpicdn.net/img/view/2016/1/30/1076476.png,0,0.987071037,369,4,733,368,364,364,pinkie pie
1077224.png,https://derpicdn.net/img/view/2016/1/31/1077224.png,0,0.989447355,0,0,867,876,867,876,pinkie pie
1079991.png,https://derpicdn.net/img/view/2016/2/4/1079991.png,0,0.978756964,47,0,647,595,600,595,pinkie pie
1092199.jpg,https://derpicdn.net/img/view/2016/2/19/1092199.jpg,0,0.965376556,375,17,741,383,366,366,pinkie pie
1101837.png,https://derpicdn.net/img/view/2016/3/4/1101837.png,0,0.950576186,143,0,460,326,317,326,pinkie pie
1103393.png,https://derpicdn.net/img/view/2016/3/6/1103393.png,0,0.99380368,180,0,1808,1622,1628,1622,pinkie pie
1112723.jpg,https://derpicdn.net/img/view/2016/3/20/1112723.jpg,0,0.959836721,143,0,577,415,434,415,pinkie pie
1115689.png,https://derpicdn.net/img/view/2016/3/24/1115689.png,0,0.939397216,276,340,3370,3434,3094,3094,pinkie pie
1115909.png,https://derpicdn.net/img/view/2016/3/24/1115909.png,0,0.965201855,884,27,1276,419,392,392,pinkie pie
1122987.jpg,https://derpicdn.net/img/view/2016/4/2/1122987.jpg,0,0.975159705,14,0,662,620,648,620,pinkie pie
1123036.png,https://derpicdn.net/img/view/2016/4/3/1123036.png,0,0.919015825,0,0,701,696,701,696,pinkie pie
1127988.png,https://derpicdn.net/img/view/2016/4/9/1127988.png,0,0.995199382,89,0,853,732,764,732,pinkie pie
1132295.png,https://derpicdn.net/img/view/2016/4/15/1132295.png,0,0.99491936,143,45,435,337,292,292,pinkie pie
1141159.jpg,https://derpicdn.net/img/view/2016/4/27/1141159.jpg,0,0.987003982,501,371,981,851,480,480,pinkie pie
1155825.jpg,https://derpicdn.net/img/view/2016/5/17/1155825.jpg,0,0.971410155,402,203,730,531,328,328,pinkie pie
1159.jpg,https://derpicdn.net/img/view/2012/1/22/1159.jpg,0,0.983776271,202,36,598,432,396,396,pinkie pie
1164345.png,https://derpicdn.net/img/view/2016/5/27/1164345.png,0,0.998444676,286,0,808,512,522,512,pinkie pie
1167608.png,https://derpicdn.net/img/view/2016/6/1/1167608.png,0,0.983210087,42,0,856,797,814,797,pinkie pie
1170921.png,https://derpicdn.net/img/view/2016/6/5/1170921.png,1,0.991623938,1162,193,1576,607,414,414,pinkie pie
1172511.png,https://derpicdn.net/img/view/2016/6/7/1172511.png,0,0.966795087,997,178,3121,2302,2124,2124,pinkie pie
1187970.png,https://derpicdn.net/img/view/2016/6/27/1187970.png,0,0.911193132,240,88,782,630,542,542,pinkie pie
1190337.png,https://derpicdn.net/img/view/2016/6/30/1190337.png,0,0.975737393,336,21,768,453,432,432,pinkie pie
1190338.png,https://derpicdn.net/img/view/2016/6/30/1190338.png,0,0.982864916,326,12,780,466,454,454,pinkie pie
1190623.png,https://derpicdn.net/img/view/2016/7/1/1190623.png,0,0.959973574,93,0,391,298,298,298,pinkie pie
1203213.png,https://derpicdn.net/img/view/2016/7/17/1203213.png,0,0.935379803,219,18,715,514,496,496,pinkie pie
1208164.png,https://derpicdn.net/img/view/2016/7/24/1208164.png,0,0.985472381,7,10,619,622,612,612,pinkie pie
1208520.png,https://derpicdn.net/img/view/2016/7/25/1208520.png,0,0.968374312,19,32,531,544,512,512,pinkie pie
1209878.png,https://derpicdn.net/img/view/2016/7/26/1209878.png,0,0.994147301,239,0,1001,744,762,744,pinkie pie
1210045.png,https://derpicdn.net/img/view/2016/7/27/1210045.png,0,0.999130309,217,0,1591,1312,1374,1312,pinkie pie
1211260.png,https://derpicdn.net/img/view/2016/7/28/1211260.png,0,0.991583347,574,160,836,422,262,262,pinkie pie
1211260.png,https://derpicdn.net/img/view/2016/7/28/1211260.png,1,0.909886241,198,552,442,796,244,244,pinkie pie
1215422.png,https://derpicdn.net/img/view/2016/8/2/1215422.png,0,0.998664618,0,33,724,861,724,828,pinkie pie
1215422.png,https://derpicdn.net/img/view/2016/8/2/1215422.png,1,0.9883641,485,17,1200,775,715,758,pinkie pie
1235618.png,https://derpicdn.net/img/view/2016/8/28/1235618.png,0,0.997257769,535,0,1219,675,684,675,pinkie pie
1241904.png,https://derpicdn.net/img/view/2016/9/4/1241904.png,0,0.930105805,514,84,942,512,428,428,pinkie pie
1242592.png,https://derpicdn.net/img/view/2016/9/5/1242592.png,0,0.997444689,0,0,761,762,761,762,pinkie pie
1247111.png,https://derpicdn.net/img/view/2016/9/11/1247111.png,0,0.982067585,377,49,831,503,454,454,pinkie pie
1248527.png,https://derpicdn.net/img/view/2016/9/13/1248527.png,0,0.996010244,456,58,1012,614,556,556,pinkie pie
1250186.png,https://derpicdn.net/img/view/2016/9/16/1250186.png,0,0.994963944,83,524,391,832,308,308,pinkie pie
1250186.png,https://derpicdn.net/img/view/2016/9/16/1250186.png,1,0.98161608,465,16,791,342,326,326,pinkie pie
1250186.png,https://derpicdn.net/img/view/2016/9/16/1250186.png,2,0.979778171,73,8,397,332,324,324,pinkie pie
1250186.png,https://derpicdn.net/img/view/2016/9/16/1250186.png,3,0.937053859,454,525,762,833,308,308,pinkie pie
1250328.png,https://derpicdn.net/img/view/2016/9/16/1250328.png,0,0.932517886,143,0,501,344,358,344,pinkie pie
1255606.png,https://derpicdn.net/img/view/2016/9/22/1255606.png,0,0.980267882,445,0,855,382,410,382,pinkie pie
1269363.png,https://derpicdn.net/img/view/2016/10/10/1269363.png,0,0.97847718,649,0,1455,751,806,751,pinkie pie
1273144.png,https://derpicdn.net/img/view/2016/10/15/1273144.png,0,0.991563976,247,79,797,629,550,550,pinkie pie
1273144.png,https://derpicdn.net/img/view/2016/10/15/1273144.png,1,0.945394814,239,1340,797,1898,558,558,pinkie pie
1279005.png,https://derpicdn.net/img/view/2016/10/22/1279005.png,0,0.911651313,494,0,2975,1812,2481,1812,pinkie pie
1282833.png,https://derpicdn.net/img/view/2016/10/27/1282833.png,0,0.992715955,212,133,1012,933,800,800,pinkie pie
1284931.png,https://derpicdn.net/img/view/2016/10/30/1284931.png,0,0.998093247,448,103,948,603,500,500,pinkie pie
1286626.png,https://derpicdn.net/img/view/2016/11/1/1286626.png,0,0.99628675,199,206,631,638,432,432,pinkie pie
1303693.png,https://derpicdn.net/img/view/2016/11/26/1303693.png,0,0.901035905,0,49,1655,2081,1655,2032,pinkie pie
1304411.png,https://derpicdn.net/img/view/2016/11/27/1304411.png,0,0.995112002,302,11,1036,745,734,734,pinkie pie
1314840.png,https://derpicdn.net/img/view/2016/12/11/1314840.png,0,0.990579545,136,0,900,740,764,740,pinkie pie
1315296.png,https://derpicdn.net/img/view/2016/12/11/1315296.png,0,0.993886471,481,79,1053,651,572,572,pinkie pie
1318653.png,https://derpicdn.net/img/view/2016/12/16/1318653.png,0,0.915959239,271,94,639,462,368,368,pinkie pie
1324.png,https://derpicdn.net/img/view/2012/1/22/1324.png,0,0.995246112,778,74,1180,476,402,402,pinkie pie
1324.png,https://derpicdn.net/img/view/2012/1/22/1324.png,1,0.975538135,114,81,598,565,484,484,pinkie pie
1327591.png,https://derpicdn.net/img/view/2016/12/29/1327591.png,0,0.975736678,339,8,1487,1156,1148,1148,pinkie pie
1334051.png,https://derpicdn.net/img/view/2017/1/7/1334051.png,0,0.987220049,332,189,628,485,296,296,pinkie pie
1338437.png,https://derpicdn.net/img/view/2017/1/13/1338437.png,0,0.998006046,618,20,822,224,204,204,pinkie pie
1338437.png,https://derpicdn.net/img/view/2017/1/13/1338437.png,1,0.97538197,131,2,631,502,500,500,pinkie pie
1340319.png,https://derpicdn.net/img/view/2017/1/15/1340319.png,0,0.946479321,131,34,1083,986,952,952,pinkie pie
1342.png,https://derpicdn.net/img/view/2012/1/22/1342.png,0,0.950276315,130,143,814,827,684,684,pinkie pie
1348905.png,https://derpicdn.net/img/view/2017/1/27/1348905.png,0,0.999236584,343,63,971,691,628,628,pinkie pie
1353470.png,https://derpicdn.net/img/view/2017/2/2/1353470.png,0,0.958726704,15,36,667,688,652,652,pinkie pie
1354839.png,https://derpicdn.net/img/view/2017/2/4/1354839.png,0,0.992232502,43,0,737,691,694,691,pinkie pie
1358600.png,https://derpicdn.net/img/view/2017/2/9/1358600.png,0,0.989819884,202,102,1242,1142,1040,1040,pinkie pie
1361521.png,https://derpicdn.net/img/view/2017/2/13/1361521.png,0,0.993881762,37,7,793,763,756,756,pinkie pie
1361635.png,https://derpicdn.net/img/view/2017/2/13/1361635.png,0,0.986629486,556,0,1596,975,1040,975,pinkie pie
1368958.png,https://derpicdn.net/img/view/2017/2/21/1368958.png,0,0.970357299,0,0,768,766,768,766,pinkie pie
1370569.png,https://derpicdn.net/img/view/2017/2/23/1370569.png,0,0.904913008,125,165,737,777,612,612,pinkie pie
1373598.png,https://derpicdn.net/img/view/2017/2/26/1373598.png,0,0.983228803,200,240,932,972,732,732,pinkie pie
1374799.png,https://derpicdn.net/img/view/2017/2/27/1374799.png,0,0.970409214,467,36,1217,786,750,750,pinkie pie
1378457.png,https://derpicdn.net/img/view/2017/3/3/1378457.png,0,0.998093247,822,433,1616,1227,794,794,pinkie pie
1381471.png,https://derpicdn.net/img/view/2017/3/7/1381471.png,0,0.941234767,19,0,359,311,340,311,pinkie pie
1386.jpg,https://derpicdn.net/img/view/2012/1/22/1386.jpg,0,0.993088841,210,470,508,768,298,298,pinkie pie
1394419.png,https://derpicdn.net/img/view/2017/3/23/1394419.png,0,0.997771561,234,9,928,703,694,694,pinkie pie
1398908.png,https://derpicdn.net/img/view/2017/3/29/1398908.png,0,0.996277213,403,9,899,505,496,496,pinkie pie
1400619.png,https://derpicdn.net/img/view/2017/3/31/1400619.png,0,0.968511641,199,22,477,300,278,278,pinkie pie
1400664.png,https://derpicdn.net/img/view/2017/3/31/1400664.png,0,0.981316268,0,0,753,774,753,774,pinkie pie
1400664.png,https://derpicdn.net/img/view/2017/3/31/1400664.png,0,0.981316268,0,0,753,774,753,774,pinkie pie
1401691.png,https://derpicdn.net/img/view/2017/4/1/1401691.png,0,0.991688967,460,88,974,602,514,514,pinkie pie
1405154.png,https://derpicdn.net/img/view/2017/4/6/1405154.png,0,0.986427486,198,0,832,630,634,630,pinkie pie
1407266.png,https://derpicdn.net/img/view/2017/4/9/1407266.png,0,0.97975266,531,109,807,385,276,276,pinkie pie
1407266.png,https://derpicdn.net/img/view/2017/4/9/1407266.png,1,0.971892416,170,241,428,499,258,258,pinkie pie
1408203.png,https://derpicdn.net/img/view/2017/4/10/1408203.png,0,0.991529942,69,49,1799,1779,1730,1730,pinkie pie
1408433.png,https://derpicdn.net/img/view/2017/4/10/1408433.png,0,0.991395056,3950,315,6110,2475,2160,2160,pinkie pie
1409574.png,https://derpicdn.net/img/view/2017/4/12/1409574.png,0,0.987428188,37,27,1073,1063,1036,1036,pinkie pie
1417305.png,https://derpicdn.net/img/view/2017/4/21/1417305.png,0,0.997444749,488,0,1932,1313,1444,1313,pinkie pie
1420218.png,https://derpicdn.net/img/view/2017/4/24/1420218.png,0,0.978134692,165,55,763,653,598,598,pinkie pie
1425142.png,https://derpicdn.net/img/view/2017/4/30/1425142.png,0,0.902818143,314,588,4186,4460,3872,3872,pinkie pie
1425177.png,https://derpicdn.net/img/view/2017/4/30/1425177.png,0,0.986586511,0,0,609,460,609,460,pinkie pie
1425557.png,https://derpicdn.net/img/view/2017/4/30/1425557.png,0,0.920516551,49,0,1681,1566,1632,1566,pinkie pie
1428088.png,https://derpicdn.net/img/view/2017/5/4/1428088.png,0,0.961232185,20,35,486,501,466,466,pinkie pie
1441112.png,https://derpicdn.net/img/view/2017/5/20/1441112.png,0,0.956272185,43,4,305,266,262,262,pinkie pie
1441257.png,https://derpicdn.net/img/view/2017/5/20/1441257.png,0,0.968053579,190,36,480,326,290,290,pinkie pie
1446272.png,https://derpicdn.net/img/view/2017/5/26/1446272.png,0,0.939921975,90,40,976,926,886,886,pinkie pie
1447134.png,https://derpicdn.net/img/view/2017/5/27/1447134.png,0,0.953624308,319,53,695,429,376,376,pinkie pie
1447715.png,https://derpicdn.net/img/view/2017/5/28/1447715.png,0,0.902534425,235,1,2249,2015,2014,2014,pinkie pie
1449966.png,https://derpicdn.net/img/view/2017/5/30/1449966.png,0,0.929282069,0,0,1703,1826,1703,1826,pinkie pie
1454847.png,https://derpicdn.net/img/view/2017/6/5/1454847.png,0,0.985137761,0,0,1073,1039,1073,1039,pinkie pie
1456285.png,https://derpicdn.net/img/view/2017/6/7/1456285.png,0,0.992980242,335,0,4020,3702,3685,3702,pinkie pie
1460114.png,https://derpicdn.net/img/view/2017/6/12/1460114.png,0,0.997248292,247,155,543,451,296,296,pinkie pie
1465062.png,https://derpicdn.net/img/view/2017/6/18/1465062.png,0,0.99117142,225,24,907,706,682,682,pinkie pie
1465656.png,https://derpicdn.net/img/view/2017/6/19/1465656.png,0,0.981900156,2429,154,4205,1930,1776,1776,pinkie pie
1468680.png,https://derpicdn.net/img/view/2017/6/22/1468680.png,0,0.980057001,132,71,788,727,656,656,pinkie pie
1469297.png,https://derpicdn.net/img/view/2017/6/22/1469297.png,0,0.978539646,281,221,717,657,436,436,pinkie pie
1475298.png,https://derpicdn.net/img/view/2017/6/30/1475298.png,0,0.960005522,90,29,500,483,410,454,pinkie pie
1476879.png,https://derpicdn.net/img/view/2017/7/2/1476879.png,0,0.990982354,139,15,875,751,736,736,pinkie pie
1476879.png,https://derpicdn.net/img/view/2017/7/2/1476879.png,0,0.990982354,139,15,875,751,736,736,pinkie pie
1480913.png,https://derpicdn.net/img/view/2017/7/7/1480913.png,0,0.976121187,829,37,1625,833,796,796,pinkie pie
1480913.png,https://derpicdn.net/img/view/2017/7/7/1480913.png,1,0.966911197,578,902,1040,1364,462,462,pinkie pie
1485752.png,https://derpicdn.net/img/view/2017/7/14/1485752.png,0,0.957625031,12,40,428,456,416,416,pinkie pie
1485752.png,https://derpicdn.net/img/view/2017/7/14/1485752.png,0,0.957625031,12,40,428,456,416,416,pinkie pie
1496462.png,https://derpicdn.net/img/view/2017/7/27/1496462.png,0,0.904284239,12,378,198,564,186,186,pinkie pie
1496521.png,https://derpicdn.net/img/view/2017/7/28/1496521.png,0,0.909493148,899,450,1275,826,376,376,pinkie pie
1497932.png,https://derpicdn.net/img/view/2017/7/29/1497932.png,0,0.971599877,738,0,3000,2175,2262,2175,pinkie pie
1501735.png,https://derpicdn.net/img/view/2017/8/3/1501735.png,0,0.990498781,222,24,840,642,618,618,pinkie pie
1501914.png,https://derpicdn.net/img/view/2017/8/3/1501914.png,0,0.964616358,885,0,2259,1296,1374,1296,pinkie pie
1503111.png,https://derpicdn.net/img/view/2017/8/5/1503111.png,0,0.928930283,810,777,1444,1411,634,634,pinkie pie
1503111.png,https://derpicdn.net/img/view/2017/8/5/1503111.png,0,0.928930283,810,777,1444,1411,634,634,pinkie pie
1504836.png,https://derpicdn.net/img/view/2017/8/7/1504836.png,0,0.980798781,1983,185,5878,4131,3895,3946,pinkie pie
1505511.png,https://derpicdn.net/img/view/2017/8/8/1505511.png,0,0.993458092,486,51,1038,603,552,552,pinkie pie
1505533.png,https://derpicdn.net/img/view/2017/8/8/1505533.png,0,0.99316299,1552,59,5344,3851,3792,3792,pinkie pie
1507015.png,https://derpicdn.net/img/view/2017/8/10/1507015.png,0,0.999267876,83,0,471,351,388,351,pinkie pie
1507462.png,https://derpicdn.net/img/view/2017/8/10/1507462.png,0,0.993647695,1342,0,4114,2670,2772,2670,pinkie pie
1509422.png,https://derpicdn.net/img/view/2017/8/13/1509422.png,0,0.997538269,2485,556,4737,2808,2252,2252,pinkie pie
15095.jpg,https://derpicdn.net/img/view/2012/6/22/15095.jpg,0,0.99472326,204,282,438,516,234,234,pinkie pie
1510472.png,https://derpicdn.net/img/view/2017/8/14/1510472.png,0,0.997570217,413,0,1375,863,962,863,pinkie pie
1513066.png,https://derpicdn.net/img/view/2017/8/17/1513066.png,0,0.933921397,29,0,431,386,402,386,pinkie pie
1513430.png,https://derpicdn.net/img/view/2017/8/18/1513430.png,0,0.997088075,189,0,825,589,636,589,pinkie pie
1514000.png,https://derpicdn.net/img/view/2017/8/19/1514000.png,0,0.971985698,472,95,1160,783,688,688,pinkie pie
1514761.png,https://derpicdn.net/img/view/2017/8/19/1514761.png,0,0.939608395,0,0,418,442,418,442,pinkie pie
15155.png,https://derpicdn.net/img/view/2012/6/22/15155.png,0,0.997279584,1459,0,3401,1833,1942,1833,pinkie pie
1518399.png,https://derpicdn.net/img/view/2017/8/23/1518399.png,0,0.987570286,96,0,504,380,408,380,pinkie pie
1532622.png,https://derpicdn.net/img/view/2017/9/10/1532622.png,0,0.996019006,62,0,956,858,894,858,pinkie pie
1537822.png,https://derpicdn.net/img/view/2017/9/17/1537822.png,0,0.909013748,148,0,2316,1440,2168,1440,pinkie pie
1539844.png,https://derpicdn.net/img/view/2017/9/20/1539844.png,0,0.976906896,277,0,1127,812,850,812,pinkie pie
1546495.png,https://derpicdn.net/img/view/2017/9/28/1546495.png,0,0.987151682,70,0,788,705,718,705,pinkie pie
1546621.png,https://derpicdn.net/img/view/2017/9/28/1546621.png,0,0.973368347,382,24,1026,668,644,644,pinkie pie
1552324.png,https://derpicdn.net/img/view/2017/10/5/1552324.png,0,0.984995484,46,0,1556,1346,1510,1346,pinkie pie
1553237.png,https://derpicdn.net/img/view/2017/10/6/1553237.png,0,0.952382863,219,107,1033,921,814,814,pinkie pie
1553898.png,https://derpicdn.net/img/view/2017/10/7/1553898.png,0,0.996954978,259,0,857,550,598,550,pinkie pie
1553898.png,https://derpicdn.net/img/view/2017/10/7/1553898.png,0,0.996954978,259,0,857,550,598,550,pinkie pie
155461.jpg,https://derpicdn.net/img/view/2012/11/17/155461.jpg,0,0.968301892,918,391,1243,737,325,346,pinkie pie
1561433.png,https://derpicdn.net/img/view/2017/10/15/1561433.png,0,0.985588014,5,39,1280,1341,1275,1302,pinkie pie
1561657.png,https://derpicdn.net/img/view/2017/10/15/1561657.png,0,0.995268345,3,61,361,419,358,358,pinkie pie
156431.png,https://derpicdn.net/img/view/2012/11/18/156431.png,0,0.97151351,30,0,354,304,324,304,pinkie pie
1566021.png,https://derpicdn.net/img/view/2017/10/20/1566021.png,0,0.964394271,301,0,1439,1012,1138,1012,pinkie pie
1567494.png,https://derpicdn.net/img/view/2017/10/22/1567494.png,0,0.990999818,108,0,940,813,832,813,pinkie pie
1570199.png,https://derpicdn.net/img/view/2017/10/25/1570199.png,0,0.956264913,186,43,750,607,564,564,pinkie pie
1570487.png,https://derpicdn.net/img/view/2017/10/26/1570487.png,0,0.998890042,814,185,2058,1429,1244,1244,pinkie pie
1570487.png,https://derpicdn.net/img/view/2017/10/26/1570487.png,1,0.985597134,3191,282,4393,1484,1202,1202,pinkie pie
1573484.png,https://derpicdn.net/img/view/2017/10/30/1573484.png,0,0.964566886,66,0,808,707,742,707,pinkie pie
157440.png,https://derpicdn.net/img/view/2012/11/19/157440.png,0,0.980402231,333,0,927,458,594,458,pinkie pie
1576199.png,https://derpicdn.net/img/view/2017/11/2/1576199.png,0,0.99454397,12,200,1046,1256,1034,1056,pinkie pie
1577476.png,https://derpicdn.net/img/view/2017/11/4/1577476.png,0,0.975570738,0,0,830,791,830,791,pinkie pie
1582814.png,https://derpicdn.net/img/view/2017/11/10/1582814.png,0,0.998523116,2359,0,3471,1024,1112,1024,pinkie pie
1583604.png,https://derpicdn.net/img/view/2017/11/11/1583604.png,0,0.966282785,695,196,1427,928,732,732,pinkie pie
1583604.png,https://derpicdn.net/img/view/2017/11/11/1583604.png,0,0.966282785,695,196,1427,928,732,732,pinkie pie
1584652.png,https://derpicdn.net/img/view/2017/11/12/1584652.png,0,0.986228704,33,0,1285,1209,1252,1209,pinkie pie
1584972.png,https://derpicdn.net/img/view/2017/11/12/1584972.png,0,0.989941716,55,0,613,531,558,531,pinkie pie
1585435.png,https://derpicdn.net/img/view/2017/11/13/1585435.png,0,0.967148185,426,82,672,328,246,246,pinkie pie
15862.png,https://derpicdn.net/img/view/2012/6/22/15862.png,0,0.95759505,178,0,830,591,652,591,pinkie pie
1586204.png,https://derpicdn.net/img/view/2017/11/14/1586204.png,0,0.996994317,1286,2517,1818,3049,532,532,pinkie pie
1589169.png,https://derpicdn.net/img/view/2017/11/18/1589169.png,0,0.966598928,1648,2527,8022,8901,6374,6374,pinkie pie
1590304.png,https://derpicdn.net/img/view/2017/11/19/1590304.png,0,0.996777415,529,374,1245,1090,716,716,pinkie pie
1590788.png,https://derpicdn.net/img/view/2017/11/20/1590788.png,0,0.963608325,756,0,1316,546,560,546,pinkie pie
1595472.png,https://derpicdn.net/img/view/2017/11/27/1595472.png,0,0.973112643,78,2,325,264,247,262,pinkie pie
1595980.png,https://derpicdn.net/img/view/2017/11/28/1595980.png,0,0.94271034,0,65,1419,1551,1419,1486,pinkie pie
1599683.png,https://derpicdn.net/img/view/2017/12/3/1599683.png,0,0.922562778,108,0,1214,720,1106,720,pinkie pie
1605276.png,https://derpicdn.net/img/view/2017/12/11/1605276.png,0,0.901349306,361,354,1293,1286,932,932,pinkie pie
1609174.png,https://derpicdn.net/img/view/2017/12/16/1609174.png,0,0.958807528,399,0,1125,706,726,706,pinkie pie
1613101.png,https://derpicdn.net/img/view/2017/12/22/1613101.png,0,0.937087834,153,0,1305,966,1152,966,pinkie pie
1614222.png,https://derpicdn.net/img/view/2017/12/23/1614222.png,0,0.975543082,0,0,779,880,779,880,pinkie pie
1615219.png,https://derpicdn.net/img/view/2017/12/24/1615219.png,0,0.991731584,0,167,2234,2439,2234,2272,pinkie pie
1616787.png,https://derpicdn.net/img/view/2017/12/26/1616787.png,0,0.955261052,137,0,3685,2725,3548,2725,pinkie pie
1618178.png,https://derpicdn.net/img/view/2017/12/28/1618178.png,0,0.987955511,521,373,1259,1111,738,738,pinkie pie
1628158.png,https://derpicdn.net/img/view/2018/1/9/1628158.png,0,0.931678951,0,0,645,684,645,684,pinkie pie
1637089.png,https://derpicdn.net/img/view/2018/1/20/1637089.png,0,0.919402063,147,0,631,465,484,465,pinkie pie
1637409.png,https://derpicdn.net/img/view/2018/1/21/1637409.png,0,0.99957335,196,128,748,680,552,552,pinkie pie
1637409.png,https://derpicdn.net/img/view/2018/1/21/1637409.png,0,0.99957335,196,128,748,680,552,552,pinkie pie
1639347.png,https://derpicdn.net/img/view/2018/1/24/1639347.png,0,0.914586306,661,0,1615,922,954,922,pinkie pie
1640629.png,https://derpicdn.net/img/view/2018/1/25/1640629.png,0,0.995243549,207,92,445,330,238,238,pinkie pie
1645017.png,https://derpicdn.net/img/view/2018/1/31/1645017.png,0,0.983443558,1204,976,1798,1570,594,594,pinkie pie
164842.jpg,https://derpicdn.net/img/view/2012/11/27/164842.jpg,0,0.934354007,280,0,1330,959,1050,959,pinkie pie
1651935.png,https://derpicdn.net/img/view/2018/2/9/1651935.png,0,0.936908126,1577,383,2273,1079,696,696,pinkie pie
1652047.png,https://derpicdn.net/img/view/2018/2/9/1652047.png,0,0.992068768,47,89,433,475,386,386,pinkie pie
1652047.png,https://derpicdn.net/img/view/2018/2/9/1652047.png,1,0.987313509,392,116,744,468,352,352,pinkie pie
1652675.png,https://derpicdn.net/img/view/2018/2/10/1652675.png,0,0.933684468,573,266,1289,982,716,716,pinkie pie
1654661.png,https://derpicdn.net/img/view/2018/2/13/1654661.png,0,0.985342979,479,664,1101,1286,622,622,pinkie pie
166169.jpg,https://derpicdn.net/img/view/2012/11/28/166169.jpg,0,0.984884977,1008,323,1330,645,322,322,pinkie pie
166169.jpg,https://derpicdn.net/img/view/2012/11/28/166169.jpg,2,0.933285832,976,84,1250,358,274,274,pinkie pie
166169.jpg,https://derpicdn.net/img/view/2012/11/28/166169.jpg,3,0.925801635,0,402,159,596,159,194,pinkie pie
1662708.png,https://derpicdn.net/img/view/2018/2/22/1662708.png,0,0.998179436,13,0,2275,1964,2262,1964,pinkie pie
1665349.png,https://derpicdn.net/img/view/2018/2/25/1665349.png,0,0.937287807,75,0,1153,964,1078,964,pinkie pie
1667411.png,https://derpicdn.net/img/view/2018/2/27/1667411.png,0,0.995730639,676,358,1670,1352,994,994,pinkie pie
1670650.png,https://derpicdn.net/img/view/2018/3/3/1670650.png,0,0.986678243,176,0,720,523,544,523,pinkie pie
1672051.png,https://derpicdn.net/img/view/2018/3/5/1672051.png,0,0.985388339,0,0,645,617,645,617,pinkie pie
1674452.png,https://derpicdn.net/img/view/2018/3/8/1674452.png,0,0.998462021,359,0,987,563,628,563,pinkie pie
1675454.png,https://derpicdn.net/img/view/2018/3/9/1675454.png,0,0.997555971,0,7,374,423,374,416,pinkie pie
1675454.png,https://derpicdn.net/img/view/2018/3/9/1675454.png,1,0.963043272,513,96,789,372,276,276,pinkie pie
1676320.png,https://derpicdn.net/img/view/2018/3/10/1676320.png,0,0.953173518,78,0,688,582,610,582,pinkie pie
1678691.png,https://derpicdn.net/img/view/2018/3/13/1678691.png,0,0.998724818,0,0,880,909,880,909,pinkie pie
1685721.png,https://derpicdn.net/img/view/2018/3/20/1685721.png,0,0.975777864,11,87,349,400,338,313,pinkie pie
1685721.png,https://derpicdn.net/img/view/2018/3/20/1685721.png,1,0.941361368,62,17,400,365,338,348,pinkie pie
1686284.png,https://derpicdn.net/img/view/2018/3/21/1686284.png,0,0.971005321,0,0,623,633,623,633,pinkie pie
1690192.png,https://derpicdn.net/img/view/2018/3/25/1690192.png,0,0.977974951,217,0,995,712,778,712,pinkie pie
1690721.png,https://derpicdn.net/img/view/2018/3/25/1690721.png,0,0.986690104,417,0,1280,800,863,800,pinkie pie
1696824.png,https://derpicdn.net/img/view/2018/4/1/1696824.png,0,0.985473335,0,0,1660,1614,1660,1614,pinkie pie
1697168.png,https://derpicdn.net/img/view/2018/4/2/1697168.png,0,0.963276863,81,0,979,844,898,844,pinkie pie
1697716.png,https://derpicdn.net/img/view/2018/4/3/1697716.png,0,0.999391139,0,2,846,888,846,886,pinkie pie
1697836.png,https://derpicdn.net/img/view/2018/4/3/1697836.png,0,0.999649405,106,0,1000,822,894,822,pinkie pie
1702515.png,https://derpicdn.net/img/view/2018/4/8/1702515.png,0,0.994051456,1617,424,2761,1568,1144,1144,pinkie pie
1702972.png,https://derpicdn.net/img/view/2018/4/8/1702972.png,0,0.991849482,459,252,991,784,532,532,pinkie pie
1706199.png,https://derpicdn.net/img/view/2018/4/12/1706199.png,0,0.980574906,383,58,1073,748,690,690,pinkie pie
1706766.png,https://derpicdn.net/img/view/2018/4/13/1706766.png,0,0.958911955,0,0,3202,3564,3202,3564,pinkie pie
1708183.png,https://derpicdn.net/img/view/2018/4/15/1708183.png,0,0.941651106,20,0,648,536,628,536,pinkie pie
1708989.png,https://derpicdn.net/img/view/2018/4/15/1708989.png,0,0.957695961,128,204,878,954,750,750,pinkie pie
1709761.png,https://derpicdn.net/img/view/2018/4/16/1709761.png,0,0.981775701,367,0,827,432,460,432,pinkie pie
1710246.png,https://derpicdn.net/img/view/2018/4/17/1710246.png,0,0.969136417,0,254,343,600,343,346,pinkie pie
1711115.png,https://derpicdn.net/img/view/2018/4/18/1711115.png,0,0.972253919,0,0,722,600,722,600,pinkie pie
1722173.png,https://derpicdn.net/img/view/2018/5/2/1722173.png,0,0.984620631,138,227,730,819,592,592,pinkie pie
1733845.png,https://derpicdn.net/img/view/2018/5/16/1733845.png,0,0.97930485,94,0,832,703,738,703,pinkie pie
1735521.png,https://derpicdn.net/img/view/2018/5/18/1735521.png,0,0.9738608,161,60,2477,2376,2316,2316,pinkie pie
1738738.png,https://derpicdn.net/img/view/2018/5/22/1738738.png,0,0.99000442,32,0,887,831,855,831,pinkie pie
1743541.png,https://derpicdn.net/img/view/2018/5/28/1743541.png,0,0.971951067,0,0,1058,941,1058,941,pinkie pie
1743541.png,https://derpicdn.net/img/view/2018/5/28/1743541.png,0,0.971951067,0,0,1058,941,1058,941,pinkie pie
1745714.png,https://derpicdn.net/img/view/2018/5/31/1745714.png,0,0.972910166,16,15,1266,1265,1250,1250,pinkie pie
1745786.png,https://derpicdn.net/img/view/2018/5/31/1745786.png,0,0.963973999,28,0,260,232,232,232,pinkie pie
1745786.png,https://derpicdn.net/img/view/2018/5/31/1745786.png,0,0.963973999,28,0,260,232,232,232,pinkie pie
1746681.png,https://derpicdn.net/img/view/2018/6/1/1746681.png,0,0.982007086,70,474,3534,3938,3464,3464,pinkie pie
1749248.png,https://derpicdn.net/img/view/2018/6/3/1749248.png,0,0.952081084,334,78,1490,1234,1156,1156,pinkie pie
1757039.png,https://derpicdn.net/img/view/2018/6/13/1757039.png,0,0.976467311,89,34,1247,1192,1158,1158,pinkie pie
1757039.png,https://derpicdn.net/img/view/2018/6/13/1757039.png,0,0.976467311,89,34,1247,1192,1158,1158,pinkie pie
1762340.png,https://derpicdn.net/img/view/2018/6/20/1762340.png,0,0.982216597,9,3,349,343,340,340,pinkie pie
1762842.png,https://derpicdn.net/img/view/2018/6/21/1762842.png,0,0.982779026,119,402,637,920,518,518,pinkie pie
1765697.png,https://derpicdn.net/img/view/2018/6/25/1765697.png,0,0.987501919,108,0,2550,2328,2442,2328,pinkie pie
1771425.png,https://derpicdn.net/img/view/2018/7/2/1771425.png,0,0.963398278,26,0,550,503,524,503,pinkie pie
1771833.png,https://derpicdn.net/img/view/2018/7/3/1771833.png,0,0.991424143,400,4,1142,746,742,742,pinkie pie
1777353.png,https://derpicdn.net/img/view/2018/7/10/1777353.png,0,0.907877564,94,0,750,625,656,625,pinkie pie
1778196.png,https://derpicdn.net/img/view/2018/7/11/1778196.png,0,0.902516246,306,7,902,603,596,596,pinkie pie
1788131.png,https://derpicdn.net/img/view/2018/7/24/1788131.png,0,0.95830965,694,0,2022,1286,1328,1286,pinkie pie
1788240.png,https://derpicdn.net/img/view/2018/7/24/1788240.png,0,0.982710719,425,230,1075,880,650,650,pinkie pie
1788300.png,https://derpicdn.net/img/view/2018/7/24/1788300.png,0,0.994189858,2,163,324,485,322,322,pinkie pie
1789497.png,https://derpicdn.net/img/view/2018/7/25/1789497.png,0,0.998993516,0,41,557,607,557,566,pinkie pie
1791507.png,https://derpicdn.net/img/view/2018/7/28/1791507.png,0,0.91744256,42,0,838,793,796,793,pinkie pie
1794452.png,https://derpicdn.net/img/view/2018/7/31/1794452.png,0,0.979750395,38,0,1508,1410,1470,1410,pinkie pie
1795.png,https://derpicdn.net/img/view/2012/1/23/1795.png,0,0.994587839,64,0,460,353,396,353,pinkie pie
1796238.png,https://derpicdn.net/img/view/2018/8/2/1796238.png,0,0.910658777,824,91,2848,2115,2024,2024,pinkie pie
1799718.png,https://derpicdn.net/img/view/2018/8/6/1799718.png,0,0.967527509,226,0,800,470,574,470,pinkie pie
1802259.png,https://derpicdn.net/img/view/2018/8/9/1802259.png,0,0.993464887,594,49,1482,937,888,888,pinkie pie
1802883.png,https://derpicdn.net/img/view/2018/8/10/1802883.png,0,0.975145221,166,11,1510,1355,1344,1344,pinkie pie
1807299.png,https://derpicdn.net/img/view/2018/8/15/1807299.png,0,0.978859782,32,0,361,301,329,301,pinkie pie
1808142.png,https://derpicdn.net/img/view/2018/8/16/1808142.png,0,0.997801244,238,124,1616,1502,1378,1378,pinkie pie
1813725.png,https://derpicdn.net/img/view/2018/8/22/1813725.png,0,0.987885892,474,147,938,611,464,464,pinkie pie
1814646.png,https://derpicdn.net/img/view/2018/8/24/1814646.png,0,0.987768412,49,0,1265,853,1216,853,pinkie pie
1816083.png,https://derpicdn.net/img/view/2018/8/25/1816083.png,0,0.98412782,11,0,279,257,268,257,pinkie pie
1817790.png,https://derpicdn.net/img/view/2018/8/27/1817790.png,0,0.994642138,173,1664,2301,3792,2128,2128,pinkie pie
1820319.png,https://derpicdn.net/img/view/2018/8/30/1820319.png,0,0.995323777,609,182,1647,1220,1038,1038,pinkie pie
1822886.png,https://derpicdn.net/img/view/2018/9/2/1822886.png,0,0.993393838,630,21,1168,559,538,538,pinkie pie
1823595.png,https://derpicdn.net/img/view/2018/9/3/1823595.png,0,0.966546834,0,0,409,391,409,391,pinkie pie
1825281.png,https://derpicdn.net/img/view/2018/9/5/1825281.png,0,0.971984744,32,0,352,297,320,297,pinkie pie
1827125.png,https://derpicdn.net/img/view/2018/9/7/1827125.png,0,0.994590461,512,100,1010,598,498,498,pinkie pie
1839964.png,https://derpicdn.net/img/view/2018/9/24/1839964.png,0,0.939169347,410,559,1328,1477,918,918,pinkie pie
1840173.png,https://derpicdn.net/img/view/2018/9/24/1840173.png,0,0.989229739,136,19,1500,1399,1364,1380,pinkie pie
1843032.png,https://derpicdn.net/img/view/2018/9/28/1843032.png,0,0.970942974,622,0,1600,1041,978,1041,pinkie pie
1845831.png,https://derpicdn.net/img/view/2018/10/2/1845831.png,0,0.954189003,180,80,678,578,498,498,pinkie pie
1846264.png,https://derpicdn.net/img/view/2018/10/2/1846264.png,0,0.977822542,302,0,780,430,478,430,pinkie pie
1846264.png,https://derpicdn.net/img/view/2018/10/2/1846264.png,1,0.936540186,206,481,608,883,402,402,pinkie pie
1848332.png,https://derpicdn.net/img/view/2018/10/5/1848332.png,0,0.993174672,134,412,632,910,498,498,pinkie pie
1848933.png,https://derpicdn.net/img/view/2018/10/5/1848933.png,0,0.992549777,196,0,1120,810,924,810,pinkie pie
1850610.png,https://derpicdn.net/img/view/2018/10/7/1850610.png,0,0.981237233,991,0,2633,1602,1642,1602,pinkie pie
1850610.png,https://derpicdn.net/img/view/2018/10/7/1850610.png,0,0.981237233,991,0,2633,1602,1642,1602,pinkie pie
1850931.png,https://derpicdn.net/img/view/2018/10/7/1850931.png,0,0.998546124,327,200,1061,934,734,734,pinkie pie
1851512.png,https://derpicdn.net/img/view/2018/10/8/1851512.png,0,0.996781528,198,0,942,687,744,687,pinkie pie
1853021.png,https://derpicdn.net/img/view/2018/10/10/1853021.png,0,0.967867732,65,0,1183,940,1118,940,pinkie pie
1854268.png,https://derpicdn.net/img/view/2018/10/12/1854268.png,0,0.977952957,416,0,1034,611,618,611,pinkie pie
1861151.png,https://derpicdn.net/img/view/2018/10/20/1861151.png,0,0.990795195,257,34,547,324,290,290,pinkie pie
1865878.png,https://derpicdn.net/img/view/2018/10/25/1865878.png,0,0.931947231,173,0,869,612,696,612,pinkie pie
1869608.png,https://derpicdn.net/img/view/2018/10/29/1869608.png,0,0.987343192,75,107,983,1015,908,908,pinkie pie
18705.jpg,https://derpicdn.net/img/view/2012/6/24/18705.jpg,0,0.984544456,615,21,1117,523,502,502,pinkie pie
18705.jpg,https://derpicdn.net/img/view/2012/6/24/18705.jpg,0,0.984544456,615,21,1117,523,502,502,pinkie pie
1871207.png,https://derpicdn.net/img/view/2018/10/31/1871207.png,0,0.912294805,3,60,2162,2718,2159,2658,pinkie pie
1872178.png,https://derpicdn.net/img/view/2018/11/1/1872178.png,0,0.946403921,42,140,1180,1278,1138,1138,pinkie pie
1875072.png,https://derpicdn.net/img/view/2018/11/4/1875072.png,0,0.953655601,77,0,369,283,292,283,pinkie pie
1878463.png,https://derpicdn.net/img/view/2018/11/9/1878463.png,0,0.969515204,341,0,1100,753,759,753,pinkie pie
1887129.png,https://derpicdn.net/img/view/2018/11/20/1887129.png,0,0.990475833,222,203,630,611,408,408,pinkie pie
1888865.png,https://derpicdn.net/img/view/2018/11/23/1888865.png,0,0.911315858,425,0,1280,720,855,720,pinkie pie
1890289.png,https://derpicdn.net/img/view/2018/11/25/1890289.png,0,0.993381739,156,182,1444,1470,1288,1288,pinkie pie
1891059.png,https://derpicdn.net/img/view/2018/11/26/1891059.png,0,0.995357633,707,71,1461,825,754,754,pinkie pie
1893191.png,https://derpicdn.net/img/view/2018/11/28/1893191.png,0,0.989957511,697,74,1115,492,418,418,pinkie pie
1893512.png,https://derpicdn.net/img/view/2018/11/29/1893512.png,0,0.985800982,740,114,1244,618,504,504,pinkie pie
1895653.png,https://derpicdn.net/img/view/2018/12/1/1895653.png,0,0.993490875,113,0,927,809,814,809,pinkie pie
1896160.png,https://derpicdn.net/img/view/2018/12/2/1896160.png,0,0.959125042,293,0,893,584,600,584,pinkie pie
1902104.png,https://derpicdn.net/img/view/2018/12/8/1902104.png,0,0.921989202,130,0,1134,950,1004,950,pinkie pie
1903572.png,https://derpicdn.net/img/view/2018/12/9/1903572.png,0,0.942765653,64,0,1198,1105,1134,1105,pinkie pie
1904433.png,https://derpicdn.net/img/view/2018/12/10/1904433.png,0,0.999785185,326,34,912,620,586,586,pinkie pie
1904514.png,https://derpicdn.net/img/view/2018/12/10/1904514.png,0,0.931172907,469,395,2335,2261,1866,1866,pinkie pie
1909952.png,https://derpicdn.net/img/view/2018/12/16/1909952.png,0,0.972497761,412,58,758,404,346,346,pinkie pie
19133.jpg,https://derpicdn.net/img/view/2012/6/24/19133.jpg,0,0.981811821,312,8,668,364,356,356,pinkie pie
1919029.png,https://derpicdn.net/img/view/2018/12/26/1919029.png,0,0.984478772,11,33,425,447,414,414,pinkie pie
1923763.png,https://derpicdn.net/img/view/2019/1/1/1923763.png,0,0.956415296,76,8,396,328,320,320,pinkie pie
1926915.png,https://derpicdn.net/img/view/2019/1/5/1926915.png,2,0.950262666,558,0,888,280,330,280,pinkie pie
1926915.png,https://derpicdn.net/img/view/2019/1/5/1926915.png,3,0.936951041,123,44,407,328,284,284,pinkie pie
1926915.png,https://derpicdn.net/img/view/2019/1/5/1926915.png,2,0.950262666,558,0,888,280,330,280,pinkie pie
1926915.png,https://derpicdn.net/img/view/2019/1/5/1926915.png,3,0.936951041,123,44,407,328,284,284,pinkie pie
1927326.png,https://derpicdn.net/img/view/2019/1/5/1927326.png,0,0.990716875,190,0,790,584,600,584,pinkie pie
1931934.png,https://derpicdn.net/img/view/2019/1/10/1931934.png,0,0.992666662,143,0,819,546,676,546,pinkie pie
1936036.png,https://derpicdn.net/img/view/2019/1/15/1936036.png,0,0.918173075,7,600,501,1094,494,494,pinkie pie
1939291.png,https://derpicdn.net/img/view/2019/1/19/1939291.png,0,0.950019538,568,176,1390,998,822,822,pinkie pie
1954317.png,https://derpicdn.net/img/view/2019/2/5/1954317.png,0,0.9971596,1005,37,2135,1167,1130,1130,pinkie pie
1957745.png,https://derpicdn.net/img/view/2019/2/9/1957745.png,0,0.997653544,752,7,1758,1013,1006,1006,pinkie pie
1958216.png,https://derpicdn.net/img/view/2019/2/10/1958216.png,0,0.977028549,141,0,737,554,596,554,pinkie pie
1959841.png,https://derpicdn.net/img/view/2019/2/12/1959841.png,0,0.993358672,0,0,975,987,975,987,pinkie pie
1961373.png,https://derpicdn.net/img/view/2019/2/14/1961373.png,0,0.972597957,144,147,1653,1671,1509,1524,pinkie pie
1967506.png,https://derpicdn.net/img/view/2019/2/21/1967506.png,0,0.98510015,108,0,934,773,826,773,pinkie pie
19719.png,https://derpicdn.net/img/view/2012/6/25/19719.png,0,0.98975116,319,398,547,626,228,228,pinkie pie
19719.png,https://derpicdn.net/img/view/2012/6/25/19719.png,1,0.988343477,652,199,896,443,244,244,pinkie pie
19719.png,https://derpicdn.net/img/view/2012/6/25/19719.png,2,0.98237437,332,58,608,334,276,276,pinkie pie
1978903.png,https://derpicdn.net/img/view/2019/3/6/1978903.png,0,0.991614044,305,1177,643,1515,338,338,pinkie pie
1984471.png,https://derpicdn.net/img/view/2019/3/13/1984471.png,0,0.99345392,48,0,1104,975,1056,975,pinkie pie
1985558.png,https://derpicdn.net/img/view/2019/3/14/1985558.png,0,0.989077866,1155,1044,1867,1756,712,712,pinkie pie
1985558.png,https://derpicdn.net/img/view/2019/3/14/1985558.png,0,0.989077866,1155,1044,1867,1756,712,712,pinkie pie
1990297.png,https://derpicdn.net/img/view/2019/3/19/1990297.png,0,0.933021128,2598,97,5286,2785,2688,2688,pinkie pie
1993795.png,https://derpicdn.net/img/view/2019/3/24/1993795.png,0,0.907862246,668,132,1688,1152,1020,1020,pinkie pie
1996718.png,https://derpicdn.net/img/view/2019/3/28/1996718.png,0,0.982567966,267,554,861,1148,594,594,pinkie pie
1999421.png,https://derpicdn.net/img/view/2019/3/31/1999421.png,0,0.997629523,462,61,1292,891,830,830,pinkie pie
2001152.png,https://derpicdn.net/img/view/2019/4/2/2001152.png,0,0.966403961,395,0,1495,1097,1100,1097,pinkie pie
2002564.png,https://derpicdn.net/img/view/2019/4/4/2002564.png,0,0.924677193,1077,1544,2229,2696,1152,1152,pinkie pie
2003381.png,https://derpicdn.net/img/view/2019/4/5/2003381.png,0,0.973108649,94,245,692,843,598,598,pinkie pie
2003381.png,https://derpicdn.net/img/view/2019/4/5/2003381.png,0,0.973108649,94,245,692,843,598,598,pinkie pie
2007108.png,https://derpicdn.net/img/view/2019/4/9/2007108.png,0,0.99106729,8,0,802,785,794,785,pinkie pie
2008964.png,https://derpicdn.net/img/view/2019/4/11/2008964.png,0,0.933283627,751,226,1279,754,528,528,pinkie pie
2011584.png,https://derpicdn.net/img/view/2019/4/14/2011584.png,0,0.997010291,82,0,584,498,502,498,pinkie pie
2011977.png,https://derpicdn.net/img/view/2019/4/14/2011977.png,0,0.991036236,108,23,434,349,326,326,pinkie pie
2014078.png,https://derpicdn.net/img/view/2019/4/16/2014078.png,0,0.965640068,291,24,537,270,246,246,pinkie pie
2016463.png,https://derpicdn.net/img/view/2019/4/19/2016463.png,0,0.98917073,695,51,1909,1265,1214,1214,pinkie pie
2023596.png,https://derpicdn.net/img/view/2019/4/26/2023596.png,0,0.965240955,25,7,703,685,678,678,pinkie pie
203202.jpg,https://derpicdn.net/img/view/2013/1/5/203202.jpg,0,0.994130433,250,156,458,364,208,208,pinkie pie
2035390.png,https://derpicdn.net/img/view/2019/5/10/2035390.png,0,0.93579644,38,12,1146,1120,1108,1108,pinkie pie
2048752.png,https://derpicdn.net/img/view/2019/5/25/2048752.png,0,0.964843154,36,43,778,785,742,742,pinkie pie
2055372.png,https://derpicdn.net/img/view/2019/6/1/2055372.png,0,0.952940047,464,452,864,852,400,400,pinkie pie
2058815.png,https://derpicdn.net/img/view/2019/6/5/2058815.png,0,0.921209693,136,0,1084,933,948,933,pinkie pie
2060203.png,https://derpicdn.net/img/view/2019/6/7/2060203.png,0,0.960370719,185,0,634,426,449,426,pinkie pie
2060807.png,https://derpicdn.net/img/view/2019/6/8/2060807.png,0,0.987986863,18,40,256,272,238,232,pinkie pie
2063400.png,https://derpicdn.net/img/view/2019/6/12/2063400.png,0,0.98331219,7,0,285,222,278,222,pinkie pie
2063406.png,https://derpicdn.net/img/view/2019/6/12/2063406.png,0,0.967987895,0,0,1421,1497,1421,1497,pinkie pie
206565.png,https://derpicdn.net/img/view/2013/1/8/206565.png,0,0.922977805,38,0,548,500,510,500,pinkie pie
206565.png,https://derpicdn.net/img/view/2013/1/8/206565.png,0,0.922977805,38,0,548,500,510,500,pinkie pie
2074706.png,https://derpicdn.net/img/view/2019/6/25/2074706.png,0,0.945064783,373,125,2535,2287,2162,2162,pinkie pie
2076043.png,https://derpicdn.net/img/view/2019/6/26/2076043.png,0,0.989884913,59,0,1643,1465,1584,1465,pinkie pie
2076391.png,https://derpicdn.net/img/view/2019/6/27/2076391.png,0,0.975648344,483,13,995,525,512,512,pinkie pie
2077523.png,https://derpicdn.net/img/view/2019/6/28/2077523.png,0,0.9862957,49,25,615,591,566,566,pinkie pie
2077547.png,https://derpicdn.net/img/view/2019/6/28/2077547.png,0,0.99368614,474,1,2532,2059,2058,2058,pinkie pie
2084258.png,https://derpicdn.net/img/view/2019/7/6/2084258.png,0,0.961952209,0,0,530,525,530,525,pinkie pie
2084258.png,https://derpicdn.net/img/view/2019/7/6/2084258.png,1,0.933775961,479,180,757,458,278,278,pinkie pie
2088612.png,https://derpicdn.net/img/view/2019/7/11/2088612.png,0,0.987672567,192,76,666,500,474,424,pinkie pie
2092489.png,https://derpicdn.net/img/view/2019/7/15/2092489.png,0,0.978369892,51,281,883,1113,832,832,pinkie pie
2094667.png,https://derpicdn.net/img/view/2019/7/18/2094667.png,0,0.961790502,139,0,769,575,630,575,pinkie pie
2098061.png,https://derpicdn.net/img/view/2019/7/22/2098061.png,0,0.934511125,167,68,579,480,412,412,pinkie pie
2104850.png,https://derpicdn.net/img/view/2019/7/30/2104850.png,0,0.962537169,463,0,1744,1231,1281,1231,pinkie pie
2122828.png,https://derpicdn.net/img/view/2019/8/20/2122828.png,0,0.995709181,281,136,847,702,566,566,pinkie pie
2122828.png,https://derpicdn.net/img/view/2019/8/20/2122828.png,0,0.995709181,281,136,847,702,566,566,pinkie pie
2124996.png,https://derpicdn.net/img/view/2019/8/22/2124996.png,0,0.993420839,228,0,1044,805,816,805,pinkie pie
2124996.png,https://derpicdn.net/img/view/2019/8/22/2124996.png,1,0.929474354,211,836,1061,1686,850,850,pinkie pie
2126861.png,https://derpicdn.net/img/view/2019/8/25/2126861.png,0,0.995875776,195,0,993,735,798,735,pinkie pie
2129257.png,https://derpicdn.net/img/view/2019/8/27/2129257.png,0,0.986115754,184,0,1750,1556,1566,1556,pinkie pie
2134142.png,https://derpicdn.net/img/view/2019/9/2/2134142.png,0,0.933447123,1127,153,2837,1863,1710,1710,pinkie pie
2135863.png,https://derpicdn.net/img/view/2019/9/4/2135863.png,0,0.987550735,377,11,613,247,236,236,pinkie pie
2138897.png,https://derpicdn.net/img/view/2019/9/7/2138897.png,0,0.959998906,46,67,434,455,388,388,pinkie pie
2140208.png,https://derpicdn.net/img/view/2019/9/9/2140208.png,0,0.99420011,1355,361,2659,1665,1304,1304,pinkie pie
2142097.png,https://derpicdn.net/img/view/2019/9/12/2142097.png,0,0.992673457,1663,47,4691,3075,3028,3028,pinkie pie
2144115.png,https://derpicdn.net/img/view/2019/9/14/2144115.png,0,0.975178123,162,192,1468,1498,1306,1306,pinkie pie
2147477.png,https://derpicdn.net/img/view/2019/9/19/2147477.png,0,0.967691779,850,1833,1578,2561,728,728,pinkie pie
2150877.png,https://derpicdn.net/img/view/2019/9/23/2150877.png,0,0.981187701,109,0,1265,1156,1156,1156,pinkie pie
2153105.png,https://derpicdn.net/img/view/2019/9/25/2153105.png,0,0.968917906,153,34,875,756,722,722,pinkie pie
2153107.png,https://derpicdn.net/img/view/2019/9/25/2153107.png,0,0.964247346,143,29,885,771,742,742,pinkie pie
2154615.png,https://derpicdn.net/img/view/2019/9/28/2154615.png,0,0.969380856,577,358,2219,2000,1642,1642,pinkie pie
2154615.png,https://derpicdn.net/img/view/2019/9/28/2154615.png,0,0.969380856,577,358,2219,2000,1642,1642,pinkie pie
2155774.png,https://derpicdn.net/img/view/2019/9/29/2155774.png,0,0.982992589,54,0,806,737,752,737,pinkie pie
2155954.png,https://derpicdn.net/img/view/2019/9/29/2155954.png,0,0.986395836,401,411,755,765,354,354,pinkie pie
2157593.png,https://derpicdn.net/img/view/2019/10/1/2157593.png,0,0.999161959,790,0,1610,762,820,762,pinkie pie
2163282.png,https://derpicdn.net/img/view/2019/10/8/2163282.png,0,0.982407153,308,0,1110,794,802,794,pinkie pie
2170079.png,https://derpicdn.net/img/view/2019/10/15/2170079.png,0,0.954990447,553,243,1115,805,562,562,pinkie pie
217236.png,https://derpicdn.net/img/view/2013/1/19/217236.png,0,0.988550723,221,0,695,459,474,459,pinkie pie
2173241.png,https://derpicdn.net/img/view/2019/10/19/2173241.png,0,0.999577522,85,29,355,299,270,270,pinkie pie
2174620.png,https://derpicdn.net/img/view/2019/10/20/2174620.png,0,0.962986529,4062,1079,6094,3111,2032,2032,pinkie pie
2174620.png,https://derpicdn.net/img/view/2019/10/20/2174620.png,0,0.962986529,4062,1079,6094,3111,2032,2032,pinkie pie
2177580.png,https://derpicdn.net/img/view/2019/10/24/2177580.png,0,0.977392852,20,3,874,857,854,854,pinkie pie
2178438.png,https://derpicdn.net/img/view/2019/10/25/2178438.png,0,0.992761075,53,0,477,417,424,417,pinkie pie
2179481.png,https://derpicdn.net/img/view/2019/10/26/2179481.png,0,0.997417688,299,33,745,479,446,446,pinkie pie
2180816.png,https://derpicdn.net/img/view/2019/10/28/2180816.png,0,0.995164573,224,68,680,524,456,456,pinkie pie
2183758.png,https://derpicdn.net/img/view/2019/10/31/2183758.png,0,0.960276127,14,182,1754,1942,1740,1760,pinkie pie
2189835.png,https://derpicdn.net/img/view/2019/11/7/2189835.png,0,0.98583734,0,0,1139,1148,1139,1148,pinkie pie
2191892.png,https://derpicdn.net/img/view/2019/11/10/2191892.png,0,0.996874094,384,351,900,867,516,516,pinkie pie
2192462.png,https://derpicdn.net/img/view/2019/11/10/2192462.png,0,0.982960999,1268,369,1892,993,624,624,pinkie pie
2198483.png,https://derpicdn.net/img/view/2019/11/17/2198483.png,0,0.950752676,1156,122,2754,1720,1598,1598,pinkie pie
2203288.png,https://derpicdn.net/img/view/2019/11/23/2203288.png,0,0.917197466,113,0,500,362,387,362,pinkie pie
2203288.png,https://derpicdn.net/img/view/2019/11/23/2203288.png,0,0.917197466,113,0,500,362,387,362,pinkie pie
2203292.png,https://derpicdn.net/img/view/2019/11/23/2203292.png,0,0.969372809,18,17,494,493,476,476,pinkie pie
2203292.png,https://derpicdn.net/img/view/2019/11/23/2203292.png,0,0.969372809,18,17,494,493,476,476,pinkie pie
2203293.png,https://derpicdn.net/img/view/2019/11/23/2203293.png,0,0.968193054,59,0,493,415,434,415,pinkie pie
2203293.png,https://derpicdn.net/img/view/2019/11/23/2203293.png,1,0.917834342,0,48,379,464,379,416,pinkie pie
2204415.png,https://derpicdn.net/img/view/2019/11/24/2204415.png,0,0.997680008,0,0,909,880,909,880,pinkie pie
2209386.png,https://derpicdn.net/img/view/2019/11/30/2209386.png,0,0.921815693,305,0,1619,1282,1314,1282,pinkie pie
2211283.png,https://derpicdn.net/img/view/2019/12/3/2211283.png,0,0.99924314,1335,112,1941,718,606,606,pinkie pie
2211283.png,https://derpicdn.net/img/view/2019/12/3/2211283.png,1,0.999038398,2,129,588,715,586,586,pinkie pie
2213206.png,https://derpicdn.net/img/view/2019/12/5/2213206.png,0,0.957181752,68,30,1080,1092,1012,1062,pinkie pie
2213206.png,https://derpicdn.net/img/view/2019/12/5/2213206.png,0,0.957181752,68,30,1080,1092,1012,1062,pinkie pie
2213423.png,https://derpicdn.net/img/view/2019/12/6/2213423.png,0,0.945670784,1323,0,2921,1313,1598,1313,pinkie pie
2220255.png,https://derpicdn.net/img/view/2019/12/14/2220255.png,0,0.98543483,19,0,313,288,294,288,pinkie pie
2223513.png,https://derpicdn.net/img/view/2019/12/18/2223513.png,0,0.929739058,219,0,1395,1162,1176,1162,pinkie pie
2225710.png,https://derpicdn.net/img/view/2019/12/21/2225710.png,0,0.95637089,0,4,908,950,908,946,pinkie pie
2227121.png,https://derpicdn.net/img/view/2019/12/22/2227121.png,0,0.946840644,140,43,1326,1229,1186,1186,pinkie pie
2227531.png,https://derpicdn.net/img/view/2019/12/23/2227531.png,0,0.996821463,491,158,1053,720,562,562,pinkie pie
2228810.png,https://derpicdn.net/img/view/2019/12/24/2228810.png,0,0.99459517,648,16,1268,636,620,620,pinkie pie
2230846.jpg,https://derpicdn.net/img/view/2019/12/26/2230846.jpg,0,0.995679557,7,8,597,598,590,590,pinkie pie
2232308.jpg,https://derpicdn.net/img/view/2019/12/28/2232308.jpg,0,0.997344673,254,880,668,1294,414,414,pinkie pie
2232742.jpg,https://derpicdn.net/img/view/2019/12/29/2232742.jpg,0,0.997600675,324,0,1017,663,693,663,pinkie pie
2232869.jpg,https://derpicdn.net/img/view/2019/12/29/2232869.jpg,0,0.98571527,1082,266,1856,1040,774,774,pinkie pie
2237168.jpg,https://derpicdn.net/img/view/2020/1/3/2237168.jpg,0,0.991065085,500,297,868,665,368,368,pinkie pie
2239836.jpg,https://derpicdn.net/img/view/2020/1/6/2239836.jpg,0,0.998250186,41,0,1079,1031,1038,1031,pinkie pie
2239836.jpg,https://derpicdn.net/img/view/2020/1/6/2239836.jpg,0,0.998250186,41,0,1079,1031,1038,1031,pinkie pie
2240624.jpg,https://derpicdn.net/img/view/2020/1/7/2240624.jpg,0,0.918907881,94,234,680,820,586,586,pinkie pie
2242209.jpg,https://derpicdn.net/img/view/2020/1/8/2242209.jpg,0,0.995985329,381,0,1753,1279,1372,1279,pinkie pie
2242469.jpg,https://derpicdn.net/img/view/2020/1/9/2242469.jpg,0,0.986614048,144,0,738,564,594,564,pinkie pie
2246157.jpg,https://derpicdn.net/img/view/2020/1/13/2246157.jpg,0,0.996867239,247,0,1357,988,1110,988,pinkie pie
2247131.jpg,https://derpicdn.net/img/view/2020/1/14/2247131.jpg,0,0.970230579,0,0,1375,1387,1375,1387,pinkie pie
2249830.jpg,https://derpicdn.net/img/view/2020/1/17/2249830.jpg,0,0.946323693,298,0,1827,1473,1529,1473,pinkie pie
2252269.jpg,https://derpicdn.net/img/view/2020/1/20/2252269.jpg,0,0.922144413,45,23,543,521,498,498,pinkie pie
2254074.jpg,https://derpicdn.net/img/view/2020/1/22/2254074.jpg,0,0.933627427,794,70,1502,778,708,708,pinkie pie
2256318.png,https://derpicdn.net/img/view/2020/1/25/2256318.png,0,0.911564827,239,0,543,272,304,272,pinkie pie
2257309.jpg,https://derpicdn.net/img/view/2020/1/26/2257309.jpg,0,0.982857466,96,39,434,377,338,338,pinkie pie
2257309.jpg,https://derpicdn.net/img/view/2020/1/26/2257309.jpg,1,0.982429385,423,184,725,486,302,302,pinkie pie
2257309.jpg,https://derpicdn.net/img/view/2020/1/26/2257309.jpg,2,0.945075154,404,1,716,313,312,312,pinkie pie
2259353.png,https://derpicdn.net/img/view/2020/1/28/2259353.png,0,0.952970386,731,0,1207,429,476,429,pinkie pie
2259353.png,https://derpicdn.net/img/view/2020/1/28/2259353.png,0,0.952970386,731,0,1207,429,476,429,pinkie pie
2261532.jpg,https://derpicdn.net/img/view/2020/1/31/2261532.jpg,0,0.987551868,138,0,1050,825,912,825,pinkie pie
2263378.png,https://derpicdn.net/img/view/2020/2/2/2263378.png,0,0.99193871,2577,0,5973,3354,3396,3354,pinkie pie
2263974.png,https://derpicdn.net/img/view/2020/2/2/2263974.png,0,0.960741222,163,78,873,788,710,710,pinkie pie
2263974.png,https://derpicdn.net/img/view/2020/2/2/2263974.png,0,0.960741222,163,78,873,788,710,710,pinkie pie
2265581.png,https://derpicdn.net/img/view/2020/2/4/2265581.png,0,0.925381005,20,247,736,963,716,716,pinkie pie
2270712.jpg,https://derpicdn.net/img/view/2020/2/10/2270712.jpg,0,0.986902237,0,0,400,448,400,448,pinkie pie
2274733.jpg,https://derpicdn.net/img/view/2020/2/15/2274733.jpg,0,0.996162534,176,66,344,234,168,168,pinkie pie
2277007.jpg,https://derpicdn.net/img/view/2020/2/17/2277007.jpg,0,0.986528277,13,0,749,674,736,674,pinkie pie
2278497.png,https://derpicdn.net/img/view/2020/2/19/2278497.png,0,0.974698961,56,0,980,919,924,919,pinkie pie
2278497.png,https://derpicdn.net/img/view/2020/2/19/2278497.png,0,0.974698961,56,0,980,919,924,919,pinkie pie
2280157.jpg,https://derpicdn.net/img/view/2020/2/21/2280157.jpg,0,0.912916005,140,0,412,261,272,261,pinkie pie
2284926.png,https://derpicdn.net/img/view/2020/2/27/2284926.png,0,0.988825679,177,0,1036,923,859,923,pinkie pie
2285498.png,https://derpicdn.net/img/view/2020/2/28/2285498.png,0,0.993729413,59,0,1483,1359,1424,1359,pinkie pie
2289489.png,https://derpicdn.net/img/view/2020/3/4/2289489.png,0,0.982898176,0,0,787,724,787,724,pinkie pie
2291326.jpg,https://derpicdn.net/img/view/2020/3/6/2291326.jpg,0,0.912093997,0,0,975,1002,975,1002,pinkie pie
2291954.jpg,https://derpicdn.net/img/view/2020/3/7/2291954.jpg,0,0.976801157,83,0,569,444,486,444,pinkie pie
2291955.jpg,https://derpicdn.net/img/view/2020/3/7/2291955.jpg,0,0.992879927,896,217,1240,561,344,344,pinkie pie
2295909.png,https://derpicdn.net/img/view/2020/3/12/2295909.png,0,0.975132287,627,0,1075,403,448,403,pinkie pie
2297832.png,https://derpicdn.net/img/view/2020/3/15/2297832.png,0,0.913371325,0,11,824,913,824,902,pinkie pie
2301287.png,https://derpicdn.net/img/view/2020/3/19/2301287.png,0,0.988560915,265,104,2203,2042,1938,1938,pinkie pie
2302809.jpg,https://derpicdn.net/img/view/2020/3/21/2302809.jpg,0,0.995164752,364,4,926,566,562,562,pinkie pie
2304590.png,https://derpicdn.net/img/view/2020/3/24/2304590.png,0,0.97372359,363,25,3477,3139,3114,3114,pinkie pie
2304590.png,https://derpicdn.net/img/view/2020/3/24/2304590.png,1,0.966905534,0,0,2912,2647,2912,2647,pinkie pie
2305567.png,https://derpicdn.net/img/view/2020/3/25/2305567.png,0,0.974297941,26,0,240,209,214,209,pinkie pie
2306892.jpg,https://derpicdn.net/img/view/2020/3/26/2306892.jpg,0,0.999268413,578,0,1948,1289,1370,1289,pinkie pie
2306998.jpg,https://derpicdn.net/img/view/2020/3/27/2306998.jpg,0,0.938178539,196,16,692,512,496,496,pinkie pie
2308480.png,https://derpicdn.net/img/view/2020/3/28/2308480.png,0,0.914793968,448,9,1564,1125,1116,1116,pinkie pie
2310946.jpg,https://derpicdn.net/img/view/2020/3/31/2310946.jpg,0,0.999088407,0,0,1127,1091,1127,1091,pinkie pie
2313664.png,https://derpicdn.net/img/view/2020/4/4/2313664.png,0,0.998826981,86,0,544,391,458,391,pinkie pie
2314133.jpg,https://derpicdn.net/img/view/2020/4/4/2314133.jpg,0,0.998444319,304,0,1042,726,738,726,pinkie pie
2321233.jpg,https://derpicdn.net/img/view/2020/4/13/2321233.jpg,0,0.987014413,0,0,1819,1746,1819,1746,pinkie pie
2321233.jpg,https://derpicdn.net/img/view/2020/4/13/2321233.jpg,0,0.987014413,0,0,1819,1746,1819,1746,pinkie pie
2323198.jpg,https://derpicdn.net/img/view/2020/4/15/2323198.jpg,0,0.946828544,235,0,947,698,712,698,pinkie pie
2323460.jpg,https://derpicdn.net/img/view/2020/4/15/2323460.jpg,0,0.995371699,653,0,1831,1123,1178,1123,pinkie pie
2326999.jpg,https://derpicdn.net/img/view/2020/4/20/2326999.jpg,0,0.978818238,24,5,548,529,524,524,pinkie pie
2332374.jpg,https://derpicdn.net/img/view/2020/4/26/2332374.jpg,0,0.996311605,0,66,476,548,476,482,pinkie pie
2332611.png,https://derpicdn.net/img/view/2020/4/26/2332611.png,0,0.956797957,79,0,669,564,590,564,pinkie pie
2332616.png,https://derpicdn.net/img/view/2020/4/26/2332616.png,0,0.996720076,72,0,406,324,334,324,pinkie pie
2332617.png,https://derpicdn.net/img/view/2020/4/26/2332617.png,0,0.954877377,396,65,848,517,452,452,pinkie pie
2332618.jpg,https://derpicdn.net/img/view/2020/4/26/2332618.jpg,0,0.954569757,343,49,805,511,462,462,pinkie pie
2333123.png,https://derpicdn.net/img/view/2020/4/27/2333123.png,0,0.948559105,0,0,2000,1539,2000,1539,pinkie pie
2333123.png,https://derpicdn.net/img/view/2020/4/27/2333123.png,1,0.918146253,33,0,1741,1466,1708,1466,pinkie pie
2334058.jpg,https://derpicdn.net/img/view/2020/4/28/2334058.jpg,0,0.98492384,509,0,1675,1036,1166,1036,pinkie pie
2336594.png,https://derpicdn.net/img/view/2020/5/1/2336594.png,0,0.994772315,107,0,717,543,610,543,pinkie pie
2338496.jpg,https://derpicdn.net/img/view/2020/5/3/2338496.jpg,0,0.956174552,6,34,814,842,808,808,pinkie pie
2341421.png,https://derpicdn.net/img/view/2020/5/7/2341421.png,0,0.976283789,125,0,1153,1024,1028,1024,pinkie pie
2344641.png,https://derpicdn.net/img/view/2020/5/10/2344641.png,0,0.971867323,0,0,2429,2463,2429,2463,pinkie pie
2344741.jpg,https://derpicdn.net/img/view/2020/5/10/2344741.jpg,0,0.994646132,423,271,843,691,420,420,pinkie pie
2346934.jpg,https://derpicdn.net/img/view/2020/5/12/2346934.jpg,0,0.980319202,493,0,1033,528,540,528,pinkie pie
23759.png,https://derpicdn.net/img/view/2012/6/28/23759.png,0,0.918968439,0,0,500,493,500,493,pinkie pie
23759.png,https://derpicdn.net/img/view/2012/6/28/23759.png,0,0.918968439,0,0,500,493,500,493,pinkie pie
2524.png,https://derpicdn.net/img/view/2012/1/28/2524.png,1,0.911803424,889,147,1459,717,570,570,pinkie pie
253883.jpg,https://derpicdn.net/img/view/2013/2/24/253883.jpg,0,0.970557332,79,0,451,339,372,339,pinkie pie
256781.png,https://derpicdn.net/img/view/2013/2/27/256781.png,0,0.906458557,77,0,3263,3069,3186,3069,pinkie pie
256781.png,https://derpicdn.net/img/view/2013/2/27/256781.png,0,0.906458557,77,0,3263,3069,3186,3069,pinkie pie
259348.png,https://derpicdn.net/img/view/2013/3/1/259348.png,0,0.966697156,29,0,517,451,488,451,pinkie pie
265108.jpg,https://derpicdn.net/img/view/2013/3/7/265108.jpg,0,0.997845948,103,0,477,366,374,366,pinkie pie
268112.png,https://derpicdn.net/img/view/2013/3/11/268112.png,0,0.987888813,0,0,2074,2239,2074,2239,pinkie pie
27206.jpg,https://derpicdn.net/img/view/2012/7/1/27206.jpg,0,0.980340958,203,63,983,843,780,780,pinkie pie
27683.png,https://derpicdn.net/img/view/2012/7/1/27683.png,0,0.998176038,675,0,953,266,278,266,pinkie pie
279.png,https://derpicdn.net/img/view/2012/1/15/279.png,0,0.98816365,6,0,1540,1141,1534,1141,pinkie pie
281898.png,https://derpicdn.net/img/view/2013/3/28/281898.png,0,0.956758618,1028,985,1798,1755,770,770,pinkie pie
281898.png,https://derpicdn.net/img/view/2013/3/28/281898.png,0,0.956758618,1028,985,1798,1755,770,770,pinkie pie
295660.png,https://derpicdn.net/img/view/2013/4/12/295660.png,0,0.995817304,1062,242,2286,1466,1224,1224,pinkie pie
308502.jpg,https://derpicdn.net/img/view/2013/4/26/308502.jpg,0,0.946544588,43,3,401,361,358,358,pinkie pie
311281.jpg,https://derpicdn.net/img/view/2013/4/29/311281.jpg,0,0.944837034,196,0,600,399,404,399,pinkie pie
311684.png,https://derpicdn.net/img/view/2013/4/29/311684.png,0,0.968221307,377,8,1173,804,796,796,pinkie pie
316813.png,https://derpicdn.net/img/view/2013/5/5/316813.png,0,0.913003862,41,0,328,321,287,321,pinkie pie
332772.png,https://derpicdn.net/img/view/2013/5/24/332772.png,0,0.9676314,48,0,788,707,740,707,pinkie pie
338437.png,https://derpicdn.net/img/view/2013/6/1/338437.png,0,0.94380337,129,23,427,321,298,298,pinkie pie
350110.png,https://derpicdn.net/img/view/2013/6/16/350110.png,0,0.974754691,432,177,808,553,376,376,pinkie pie
350806.png,https://derpicdn.net/img/view/2013/6/17/350806.png,0,0.98548919,0,0,342,332,342,332,pinkie pie
352968.png,https://derpicdn.net/img/view/2013/6/20/352968.png,0,0.996331751,208,0,714,485,506,485,pinkie pie
354577.png,https://derpicdn.net/img/view/2013/6/22/354577.png,0,0.986682594,53,10,597,554,544,544,pinkie pie
357473.png,https://derpicdn.net/img/view/2013/6/26/357473.png,0,0.999137282,550,2,1862,1314,1312,1312,pinkie pie
365659.png,https://derpicdn.net/img/view/2013/7/6/365659.png,0,0.914300382,237,6,617,386,380,380,pinkie pie
371358.png,https://derpicdn.net/img/view/2013/7/12/371358.png,0,0.988877594,759,776,1355,1372,596,596,pinkie pie
393733.png,https://derpicdn.net/img/view/2013/8/7/393733.png,0,0.960955203,362,42,1174,854,812,812,pinkie pie
394794.png,https://derpicdn.net/img/view/2013/8/8/394794.png,0,0.965394974,0,9,839,873,839,864,pinkie pie
396428.png,https://derpicdn.net/img/view/2013/8/10/396428.png,0,0.929813683,147,0,2141,1967,1994,1967,pinkie pie
39669.jpg,https://derpicdn.net/img/view/2012/7/10/39669.jpg,0,0.999653935,194,0,550,344,356,344,pinkie pie
39677.png,https://derpicdn.net/img/view/2012/7/10/39677.png,0,0.998844862,200,4,674,478,474,474,pinkie pie
413943.png,https://derpicdn.net/img/view/2013/8/29/413943.png,1,0.992741525,38,0,284,213,246,213,pinkie pie
414795.png,https://derpicdn.net/img/view/2013/8/30/414795.png,0,0.99469173,74,0,340,261,266,261,pinkie pie
417123.jpg,https://derpicdn.net/img/view/2013/9/2/417123.jpg,0,0.97693491,1081,94,2039,1052,958,958,pinkie pie
459102.png,https://derpicdn.net/img/view/2013/10/28/459102.png,0,0.989629686,168,0,724,532,556,532,pinkie pie
460052.jpg,https://derpicdn.net/img/view/2013/10/30/460052.jpg,0,0.92559576,133,71,815,753,682,682,pinkie pie
46143.jpg,https://derpicdn.net/img/view/2012/7/16/46143.jpg,0,0.961624861,212,0,766,552,554,552,pinkie pie
480012.png,https://derpicdn.net/img/view/2013/11/24/480012.png,0,0.948992252,178,0,1578,1362,1400,1362,pinkie pie
480644.png,https://derpicdn.net/img/view/2013/11/24/480644.png,0,0.99562788,140,0,900,675,760,675,pinkie pie
496095.png,https://derpicdn.net/img/view/2013/12/13/496095.png,0,0.935374737,83,5,637,559,554,554,pinkie pie
500038.png,https://derpicdn.net/img/view/2013/12/18/500038.png,0,0.925499201,275,0,657,349,382,349,pinkie pie
500803.png,https://derpicdn.net/img/view/2013/12/19/500803.png,0,0.970249116,0,0,517,517,517,517,pinkie pie
515539.png,https://derpicdn.net/img/view/2014/1/5/515539.png,0,0.985883594,0,0,4000,5020,4000,5020,pinkie pie
521374.png,https://derpicdn.net/img/view/2014/1/11/521374.png,0,0.995792925,353,50,993,690,640,640,pinkie pie
525710.png,https://derpicdn.net/img/view/2014/1/16/525710.png,0,0.993243515,833,794,1200,1176,367,382,pinkie pie
525710.png,https://derpicdn.net/img/view/2014/1/16/525710.png,1,0.973439097,12,759,284,1031,272,272,pinkie pie
532620.png,https://derpicdn.net/img/view/2014/1/24/532620.png,0,0.999108851,332,376,956,1000,624,624,pinkie pie
538500.png,https://derpicdn.net/img/view/2014/1/30/538500.png,0,0.936961532,382,25,928,571,546,546,pinkie pie
540845.png,https://derpicdn.net/img/view/2014/2/1/540845.png,0,0.95213908,787,281,1329,823,542,542,pinkie pie
544441.png,https://derpicdn.net/img/view/2014/2/5/544441.png,0,0.997596383,204,0,754,531,550,531,pinkie pie
544443.png,https://derpicdn.net/img/view/2014/2/5/544443.png,0,0.981801033,296,65,750,519,454,454,pinkie pie
548793.png,https://derpicdn.net/img/view/2014/2/10/548793.png,0,0.999371469,364,39,882,557,518,518,pinkie pie
56569.jpg,https://derpicdn.net/img/view/2012/7/25/56569.jpg,0,0.906040072,0,0,393,462,393,462,pinkie pie
567283.jpg,https://derpicdn.net/img/view/2014/3/5/567283.jpg,0,0.997914314,299,19,835,555,536,536,pinkie pie
567283.jpg,https://derpicdn.net/img/view/2014/3/5/567283.jpg,1,0.990490913,730,0,1302,543,572,543,pinkie pie
567395.png,https://derpicdn.net/img/view/2014/3/5/567395.png,0,0.999360144,332,14,974,656,642,642,pinkie pie
571854.png,https://derpicdn.net/img/view/2014/3/11/571854.png,0,0.974766493,0,0,3375,4250,3375,4250,pinkie pie
576123.png,https://derpicdn.net/img/view/2014/3/15/576123.png,1,0.953842521,18,0,378,338,360,338,pinkie pie
595692.png,https://derpicdn.net/img/view/2014/4/8/595692.png,0,0.96661526,10,0,330,306,320,306,pinkie pie
595692.png,https://derpicdn.net/img/view/2014/4/8/595692.png,1,0.91282922,169,103,600,567,431,464,pinkie pie
596575.png,https://derpicdn.net/img/view/2014/4/9/596575.png,0,0.945478559,255,486,785,1016,530,530,pinkie pie
597256.jpg,https://derpicdn.net/img/view/2014/4/10/597256.jpg,0,0.964398682,794,98,1706,1010,912,912,pinkie pie
599008.png,https://derpicdn.net/img/view/2014/4/12/599008.png,0,0.985727966,42,95,1596,1649,1554,1554,pinkie pie
600023.png,https://derpicdn.net/img/view/2014/4/14/600023.png,0,0.984459937,283,49,635,401,352,352,pinkie pie
606520.png,https://derpicdn.net/img/view/2014/4/21/606520.png,0,0.971698284,331,40,1137,846,806,806,pinkie pie
618633.png,https://derpicdn.net/img/view/2014/5/5/618633.png,0,0.922246337,1988,797,3708,2517,1720,1720,pinkie pie
621186.png,https://derpicdn.net/img/view/2014/5/9/621186.png,0,0.948321462,374,0,1140,759,766,759,pinkie pie
630200.png,https://derpicdn.net/img/view/2014/5/18/630200.png,0,0.987660408,284,186,746,648,462,462,pinkie pie
630200.png,https://derpicdn.net/img/view/2014/5/18/630200.png,1,0.950074613,771,155,1147,531,376,376,pinkie pie
634977.png,https://derpicdn.net/img/view/2014/5/24/634977.png,1,0.925352216,264,106,556,398,292,292,pinkie pie
647781.png,https://derpicdn.net/img/view/2014/6/8/647781.png,0,0.997956693,416,0,828,399,412,399,pinkie pie
654201.png,https://derpicdn.net/img/view/2014/6/16/654201.png,0,0.992632389,172,0,802,616,630,616,pinkie pie
655754.png,https://derpicdn.net/img/view/2014/6/17/655754.png,0,0.971199274,95,0,569,457,474,457,pinkie pie
659982.png,https://derpicdn.net/img/view/2014/6/23/659982.png,0,0.999593258,201,36,831,666,630,630,pinkie pie
66064.jpg,https://derpicdn.net/img/view/2012/8/3/66064.jpg,0,0.992162764,21,17,355,351,334,334,pinkie pie
665177.png,https://derpicdn.net/img/view/2014/7/1/665177.png,0,0.961760342,0,0,301,306,301,306,pinkie pie
668388.jpg,https://derpicdn.net/img/view/2014/7/6/668388.jpg,0,0.953295708,431,176,697,442,266,266,pinkie pie
674812.jpg,https://derpicdn.net/img/view/2014/7/14/674812.jpg,0,0.913212597,889,937,2179,2227,1290,1290,pinkie pie
674979.png,https://derpicdn.net/img/view/2014/7/14/674979.png,0,0.971948683,8024,3272,11908,7156,3884,3884,pinkie pie
674979.png,https://derpicdn.net/img/view/2014/7/14/674979.png,0,0.971948683,8024,3272,11908,7156,3884,3884,pinkie pie
678728.png,https://derpicdn.net/img/view/2014/7/20/678728.png,0,0.996259212,91,0,505,395,414,395,pinkie pie
680191.png,https://derpicdn.net/img/view/2014/7/21/680191.png,0,0.901284158,308,180,976,848,668,668,pinkie pie
694705.png,https://derpicdn.net/img/view/2014/8/8/694705.png,0,0.999285519,670,0,1438,730,768,730,pinkie pie
697377.png,https://derpicdn.net/img/view/2014/8/11/697377.png,0,0.982413113,411,0,923,490,512,490,pinkie pie
69985.jpg,https://derpicdn.net/img/view/2012/8/8/69985.jpg,0,0.999662042,300,12,488,200,188,188,pinkie pie
69985.jpg,https://derpicdn.net/img/view/2012/8/8/69985.jpg,1,0.998401165,0,28,194,230,194,202,pinkie pie
707207.png,https://derpicdn.net/img/view/2014/8/24/707207.png,0,0.980373919,480,838,1320,1678,840,840,pinkie pie
718955.png,https://derpicdn.net/img/view/2014/9/9/718955.png,0,0.985302508,271,0,947,646,676,646,pinkie pie
720737.png,https://derpicdn.net/img/view/2014/9/12/720737.png,0,0.963816702,298,271,516,489,218,218,pinkie pie
722423.png,https://derpicdn.net/img/view/2014/9/15/722423.png,0,0.993396163,731,16,1771,1056,1040,1040,pinkie pie
735122.png,https://derpicdn.net/img/view/2014/10/4/735122.png,0,0.940175772,161,13,727,579,566,566,pinkie pie
738060.png,https://derpicdn.net/img/view/2014/10/7/738060.png,0,0.929288328,318,338,1038,1058,720,720,pinkie pie
742858.png,https://derpicdn.net/img/view/2014/10/14/742858.png,0,0.997265995,3,0,471,458,468,458,pinkie pie
742862.png,https://derpicdn.net/img/view/2014/10/14/742862.png,0,0.986771762,139,109,785,755,646,646,pinkie pie
742862.png,https://derpicdn.net/img/view/2014/10/14/742862.png,0,0.986771762,139,109,785,755,646,646,pinkie pie
743030.png,https://derpicdn.net/img/view/2014/10/14/743030.png,0,0.991824925,61,9,571,519,510,510,pinkie pie
744923.png,https://derpicdn.net/img/view/2014/10/17/744923.png,0,0.986234248,0,11,508,539,508,528,pinkie pie
748400.png,https://derpicdn.net/img/view/2014/10/22/748400.png,0,0.952166557,107,0,729,583,622,583,pinkie pie
757624.png,https://derpicdn.net/img/view/2014/11/4/757624.png,0,0.989476025,454,0,1188,725,734,725,pinkie pie
759472.png,https://derpicdn.net/img/view/2014/11/6/759472.png,0,0.99971801,702,121,1064,483,362,362,pinkie pie
759472.png,https://derpicdn.net/img/view/2014/11/6/759472.png,1,0.986482382,402,140,756,494,354,354,pinkie pie
759590.png,https://derpicdn.net/img/view/2014/11/7/759590.png,0,0.958928883,592,14,1444,866,852,852,pinkie pie
771299.jpg,https://derpicdn.net/img/view/2014/11/24/771299.jpg,0,0.944018185,0,0,298,271,298,271,pinkie pie
776618.png,https://derpicdn.net/img/view/2014/12/2/776618.png,0,0.989314437,24,0,698,648,674,648,pinkie pie
77896.png,https://derpicdn.net/img/view/2012/8/19/77896.png,0,0.969123304,893,260,1153,520,260,260,pinkie pie
781917.png,https://derpicdn.net/img/view/2014/12/10/781917.png,0,0.995793521,140,5,464,329,324,324,pinkie pie
786156.png,https://derpicdn.net/img/view/2014/12/16/786156.png,0,0.994201243,199,235,357,393,158,158,pinkie pie
787805.png,https://derpicdn.net/img/view/2014/12/19/787805.png,0,0.961614668,889,93,1553,757,664,664,pinkie pie
794444.jpg,https://derpicdn.net/img/view/2014/12/28/794444.jpg,0,0.976440907,496,73,940,517,444,444,pinkie pie
794828.png,https://derpicdn.net/img/view/2014/12/29/794828.png,0,0.97971189,336,0,996,602,660,602,pinkie pie
796408.png,https://derpicdn.net/img/view/2014/12/31/796408.png,0,0.977317154,285,22,623,360,338,338,pinkie pie
798414.png,https://derpicdn.net/img/view/2015/1/3/798414.png,0,0.936792433,147,65,887,805,740,740,pinkie pie
801005.png,https://derpicdn.net/img/view/2015/1/6/801005.png,0,0.998154223,1000,652,1860,1512,860,860,pinkie pie
8056.png,https://derpicdn.net/img/view/2012/6/18/8056.png,0,0.994590998,147,0,461,301,314,301,pinkie pie
806812.png,https://derpicdn.net/img/view/2015/1/15/806812.png,0,0.969762444,1164,0,2060,669,896,669,pinkie pie
807073.png,https://derpicdn.net/img/view/2015/1/15/807073.png,0,0.942842424,6,0,436,414,430,414,pinkie pie
809189.png,https://derpicdn.net/img/view/2015/1/18/809189.png,0,0.980982661,235,340,423,528,188,188,pinkie pie
80927.png,https://derpicdn.net/img/view/2012/8/23/80927.png,0,0.99496007,157,0,765,590,608,590,pinkie pie
814615.png,https://derpicdn.net/img/view/2015/1/25/814615.png,0,0.978206754,877,180,1779,1082,902,902,pinkie pie
817411.jpg,https://derpicdn.net/img/view/2015/1/29/817411.jpg,0,0.992604911,142,0,1238,1077,1096,1077,pinkie pie
825455.png,https://derpicdn.net/img/view/2015/2/10/825455.png,0,0.913452148,223,0,807,578,584,578,pinkie pie
828980.png,https://derpicdn.net/img/view/2015/2/15/828980.png,0,0.979062259,691,194,1595,1098,904,904,pinkie pie
829951.png,https://derpicdn.net/img/view/2015/2/16/829951.png,0,0.97889787,121,0,311,177,190,177,pinkie pie
830439.png,https://derpicdn.net/img/view/2015/2/16/830439.png,0,0.937475443,0,0,663,622,663,622,pinkie pie
830495.png,https://derpicdn.net/img/view/2015/2/17/830495.png,0,0.933884621,59,0,413,344,354,344,pinkie pie
837555.jpg,https://derpicdn.net/img/view/2015/2/26/837555.jpg,0,0.969893813,56,15,408,367,352,352,pinkie pie
840381.png,https://derpicdn.net/img/view/2015/3/2/840381.png,0,0.939069569,384,0,724,340,340,340,pinkie pie
842855.png,https://derpicdn.net/img/view/2015/3/5/842855.png,0,0.988659143,600,39,1014,453,414,414,pinkie pie
842873.png,https://derpicdn.net/img/view/2015/3/5/842873.png,0,0.997307956,406,2,810,406,404,404,pinkie pie
843057.png,https://derpicdn.net/img/view/2015/3/5/843057.png,0,0.997076809,270,94,522,346,252,252,pinkie pie
852809.png,https://derpicdn.net/img/view/2015/3/19/852809.png,0,0.987286508,335,20,1429,1114,1094,1094,pinkie pie
853354.png,https://derpicdn.net/img/view/2015/3/20/853354.png,0,0.979497552,181,392,723,934,542,542,pinkie pie
854430.png,https://derpicdn.net/img/view/2015/3/21/854430.png,0,0.967202902,0,0,265,274,265,274,pinkie pie
861436.png,https://derpicdn.net/img/view/2015/3/31/861436.png,0,0.948355198,8,13,220,225,212,212,pinkie pie
864823.png,https://derpicdn.net/img/view/2015/4/4/864823.png,0,0.957790136,1488,59,3458,2029,1970,1970,pinkie pie
865476.png,https://derpicdn.net/img/view/2015/4/5/865476.png,0,0.996467292,815,183,1273,641,458,458,pinkie pie
867148.png,https://derpicdn.net/img/view/2015/4/6/867148.png,0,0.949926674,0,0,849,777,849,777,pinkie pie
867566.png,https://derpicdn.net/img/view/2015/4/7/867566.png,0,0.918981194,0,0,839,842,839,842,pinkie pie
868755.png,https://derpicdn.net/img/view/2015/4/8/868755.png,0,0.99513036,164,0,726,561,562,561,pinkie pie
869349.png,https://derpicdn.net/img/view/2015/4/9/869349.png,0,0.987766922,29,0,383,348,354,348,pinkie pie
87402.png,https://derpicdn.net/img/view/2012/9/1/87402.png,0,0.998727202,133,0,379,239,246,239,pinkie pie
875087.jpg,https://derpicdn.net/img/view/2015/4/16/875087.jpg,0,0.999318004,627,17,1599,989,972,972,pinkie pie
876740.png,https://derpicdn.net/img/view/2015/4/18/876740.png,0,0.930159569,791,0,1279,469,488,469,pinkie pie
891401.png,https://derpicdn.net/img/view/2015/5/7/891401.png,0,0.953264713,21,0,975,919,954,919,pinkie pie
891553.png,https://derpicdn.net/img/view/2015/5/8/891553.png,0,0.936220407,120,0,940,819,820,819,pinkie pie
892315.png,https://derpicdn.net/img/view/2015/5/9/892315.png,0,0.997406304,496,0,1056,451,560,451,pinkie pie
892544.png,https://derpicdn.net/img/view/2015/5/9/892544.png,0,0.977525055,163,0,651,477,488,477,pinkie pie
894714.png,https://derpicdn.net/img/view/2015/5/12/894714.png,0,0.996304035,0,0,690,710,690,710,pinkie pie
906269.png,https://derpicdn.net/img/view/2015/5/29/906269.png,0,0.994909048,61,0,443,369,382,369,pinkie pie
906307.png,https://derpicdn.net/img/view/2015/5/29/906307.png,0,0.986367822,74,0,590,451,516,451,pinkie pie
910536.png,https://derpicdn.net/img/view/2015/6/5/910536.png,0,0.997441947,291,403,655,767,364,364,pinkie pie
911142.jpg,https://derpicdn.net/img/view/2015/6/6/911142.jpg,0,0.921545088,96,22,488,414,392,392,pinkie pie
925065.png,https://derpicdn.net/img/view/2015/6/27/925065.png,0,0.934174538,126,0,478,341,352,341,pinkie pie
925344.png,https://derpicdn.net/img/view/2015/6/28/925344.png,0,0.976677418,27,15,537,525,510,510,pinkie pie
925560.png,https://derpicdn.net/img/view/2015/6/28/925560.png,0,0.990139246,68,0,750,665,682,665,pinkie pie
926214.png,https://derpicdn.net/img/view/2015/6/29/926214.png,0,0.985117793,124,0,976,745,852,745,pinkie pie
930589.png,https://derpicdn.net/img/view/2015/7/5/930589.png,0,0.950762749,0,0,747,751,747,751,pinkie pie
937385.png,https://derpicdn.net/img/view/2015/7/15/937385.png,0,0.990064025,242,12,720,490,478,478,pinkie pie
937548.png,https://derpicdn.net/img/view/2015/7/15/937548.png,0,0.99650538,97,0,847,673,750,673,pinkie pie
938665.png,https://derpicdn.net/img/view/2015/7/17/938665.png,0,0.978137016,0,25,959,997,959,972,pinkie pie
943370.png,https://derpicdn.net/img/view/2015/7/25/943370.png,0,0.981922328,140,89,646,595,506,506,pinkie pie
944722.png,https://derpicdn.net/img/view/2015/7/27/944722.png,0,0.96588403,176,0,556,364,380,364,pinkie pie
957674.png,https://derpicdn.net/img/view/2015/8/14/957674.png,0,0.984669149,723,190,1001,468,278,278,pinkie pie
96024.jpg,https://derpicdn.net/img/view/2012/9/12/96024.jpg,0,0.962163985,311,132,689,510,378,378,pinkie pie
96024.jpg,https://derpicdn.net/img/view/2012/9/12/96024.jpg,0,0.962163985,311,132,689,510,378,378,pinkie pie
960378.jpg,https://derpicdn.net/img/view/2015/8/18/960378.jpg,0,0.995145619,208,5,890,687,682,682,pinkie pie
963197.png,https://derpicdn.net/img/view/2015/8/22/963197.png,0,0.929545164,87,0,771,637,684,637,pinkie pie
965124.png,https://derpicdn.net/img/view/2015/8/24/965124.png,0,0.988377571,1732,829,2486,1583,754,754,pinkie pie
966484.png,https://derpicdn.net/img/view/2015/8/26/966484.png,1,0.959480107,0,0,663,542,663,542,pinkie pie
970034.png,https://derpicdn.net/img/view/2015/8/31/970034.png,1,0.930206954,716,274,1100,658,384,384,pinkie pie
971842.jpg,https://derpicdn.net/img/view/2015/9/3/971842.jpg,0,0.997778654,131,37,359,265,228,228,pinkie pie
971885.png,https://derpicdn.net/img/view/2015/9/3/971885.png,0,0.96535641,0,0,496,483,496,483,pinkie pie
980351.png,https://derpicdn.net/img/view/2015/9/15/980351.png,0,0.996670306,327,79,771,523,444,444,pinkie pie
984235.png,https://derpicdn.net/img/view/2015/9/21/984235.png,0,0.990401506,284,8,796,520,512,512,pinkie pie
987868.png,https://derpicdn.net/img/view/2015/9/26/987868.png,0,0.991495669,425,267,709,551,284,284,pinkie pie
988004.png,https://derpicdn.net/img/view/2015/9/26/988004.png,0,0.932698131,399,0,1229,778,830,778,pinkie pie
99271.png,https://derpicdn.net/img/view/2012/9/16/99271.png,0,0.990936637,33,0,411,315,378,315,pinkie pie
993064.png,https://derpicdn.net/img/view/2015/10/2/993064.png,0,0.998998582,47,341,575,869,528,528,pinkie pie
998311.png,https://derpicdn.net/img/view/2015/10/10/998311.png,0,0.996074915,76,9,590,523,514,514,pinkie pie
1002887.png,https://derpicdn.net/img/view/2015/10/15/1002887.png,0,0.947961986,774,289,1254,769,480,480,pinkie pie
1011850.png,https://derpicdn.net/img/view/2015/10/29/1011850.png,1,0.969731688,620,231,974,585,354,354,pinkie pie
1020561.png,https://derpicdn.net/img/view/2015/11/10/1020561.png,0,0.985512078,21,133,979,1091,958,958,pinkie pie
102187.jpg,https://derpicdn.net/img/view/2012/9/20/102187.jpg,0,0.993052483,213,0,1024,910,811,910,pinkie pie
1028064.png,https://derpicdn.net/img/view/2015/11/22/1028064.png,0,0.99787432,9,36,907,934,898,898,pinkie pie
1031708.png,https://derpicdn.net/img/view/2015/11/28/1031708.png,0,0.95888859,964,77,1502,615,538,538,pinkie pie
1039133.png,https://derpicdn.net/img/view/2015/12/7/1039133.png,0,0.980067313,63,203,369,509,306,306,pinkie pie
1058993.jpg,https://derpicdn.net/img/view/2016/1/3/1058993.jpg,0,0.982152104,463,0,733,270,270,270,pinkie pie
1063959.png,https://derpicdn.net/img/view/2016/1/10/1063959.png,0,0.997328043,336,0,762,399,426,399,pinkie pie
1066853.jpg,https://derpicdn.net/img/view/2016/1/15/1066853.jpg,0,0.980748057,95,35,355,295,260,260,pinkie pie
1068956.jpg,https://derpicdn.net/img/view/2016/1/18/1068956.jpg,0,0.976399779,201,11,1581,1391,1380,1380,pinkie pie
1069058.png,https://derpicdn.net/img/view/2016/1/18/1069058.png,0,0.992263675,821,721,1927,1827,1106,1106,pinkie pie
1069653.png,https://derpicdn.net/img/view/2016/1/19/1069653.png,0,0.990713239,0,20,895,954,895,934,pinkie pie
1082539.png,https://derpicdn.net/img/view/2016/2/7/1082539.png,0,0.997495055,82,151,1044,1113,962,962,pinkie pie
1133619.png,https://derpicdn.net/img/view/2016/4/16/1133619.png,0,0.9796561,344,22,934,612,590,590,pinkie pie
1141044.png,https://derpicdn.net/img/view/2016/4/27/1141044.png,0,0.984766006,387,0,965,549,578,549,pinkie pie
1151986.jpg,https://derpicdn.net/img/view/2016/5/12/1151986.jpg,0,0.941364586,0,283,455,683,455,400,pinkie pie
1159944.png,https://derpicdn.net/img/view/2016/5/22/1159944.png,0,0.960909307,62,0,472,350,410,350,pinkie pie
1161779.png,https://derpicdn.net/img/view/2016/5/24/1161779.png,0,0.974572361,235,24,591,380,356,356,pinkie pie
1173527.png,https://derpicdn.net/img/view/2016/6/8/1173527.png,0,0.97978276,260,1,540,281,280,280,pinkie pie
1173527.png,https://derpicdn.net/img/view/2016/6/8/1173527.png,1,0.931730628,47,16,333,302,286,286,pinkie pie
1173907.png,https://derpicdn.net/img/view/2016/6/8/1173907.png,0,0.998063326,0,0,505,522,505,522,pinkie pie
1176658.png,https://derpicdn.net/img/view/2016/6/12/1176658.png,0,0.967696548,0,0,247,247,247,247,pinkie pie
1177264.png,https://derpicdn.net/img/view/2016/6/13/1177264.png,0,0.981372416,19,0,623,602,604,602,pinkie pie
1177989.png,https://derpicdn.net/img/view/2016/6/14/1177989.png,0,0.961615384,52,19,1162,1129,1110,1110,pinkie pie
1180417.png,https://derpicdn.net/img/view/2016/6/17/1180417.png,0,0.992743373,386,17,570,201,184,184,pinkie pie
1186317.jpg,https://derpicdn.net/img/view/2016/6/25/1186317.jpg,0,0.918158948,541,176,825,460,284,284,pinkie pie
1187713.jpg,https://derpicdn.net/img/view/2016/6/27/1187713.jpg,0,0.989280939,61,223,495,657,434,434,pinkie pie
1187713.jpg,https://derpicdn.net/img/view/2016/6/27/1187713.jpg,2,0.984305978,1038,127,1504,613,466,486,pinkie pie
1188368.png,https://derpicdn.net/img/view/2016/6/28/1188368.png,0,0.921363235,622,85,1124,587,502,502,pinkie pie
1202335.png,https://derpicdn.net/img/view/2016/7/16/1202335.png,0,0.990382612,331,0,1195,864,864,864,pinkie pie
1208163.png,https://derpicdn.net/img/view/2016/7/24/1208163.png,0,0.92780596,0,0,562,617,562,617,pinkie pie
1240967.png,https://derpicdn.net/img/view/2016/9/3/1240967.png,0,0.98433584,0,0,1568,1743,1568,1743,pinkie pie
1241075.png,https://derpicdn.net/img/view/2016/9/3/1241075.png,0,0.935807824,184,40,646,502,462,462,pinkie pie
1243634.png,https://derpicdn.net/img/view/2016/9/7/1243634.png,0,0.988501787,351,357,705,711,354,354,pinkie pie
1248116.png,https://derpicdn.net/img/view/2016/9/13/1248116.png,0,0.941120505,482,257,830,605,348,348,pinkie pie
125036.png,https://derpicdn.net/img/view/2012/10/17/125036.png,0,0.979890049,86,197,1452,1500,1366,1303,pinkie pie
126104.png,https://derpicdn.net/img/view/2012/10/18/126104.png,0,0.998290718,61,0,2201,2102,2140,2102,pinkie pie
1263952.png,https://derpicdn.net/img/view/2016/10/3/1263952.png,0,0.99892354,231,92,407,268,176,176,pinkie pie
1267841.png,https://derpicdn.net/img/view/2016/10/8/1267841.png,0,0.991345167,303,0,1277,932,974,932,pinkie pie
1287728.png,https://derpicdn.net/img/view/2016/11/3/1287728.png,0,0.947795808,61,424,887,1250,826,826,pinkie pie
1294427.png,https://derpicdn.net/img/view/2016/11/13/1294427.png,0,0.986973166,150,0,450,253,300,253,pinkie pie
1294973.png,https://derpicdn.net/img/view/2016/11/13/1294973.png,0,0.976435304,433,146,935,648,502,502,pinkie pie
1301540.png,https://derpicdn.net/img/view/2016/11/23/1301540.png,0,0.995545745,236,125,522,411,286,286,pinkie pie
1302364.png,https://derpicdn.net/img/view/2016/11/24/1302364.png,0,0.97634989,121,389,525,793,404,404,pinkie pie
1307209.png,https://derpicdn.net/img/view/2016/12/1/1307209.png,0,0.998935461,267,181,1065,979,798,798,pinkie pie
1307640.png,https://derpicdn.net/img/view/2016/12/1/1307640.png,0,0.974946439,3100,0,5986,2834,2886,2834,pinkie pie
1309731.png,https://derpicdn.net/img/view/2016/12/4/1309731.png,0,0.993685424,115,0,945,785,830,785,pinkie pie
1309732.png,https://derpicdn.net/img/view/2016/12/4/1309732.png,0,0.913376093,345,0,977,591,632,591,pinkie pie
1317654.png,https://derpicdn.net/img/view/2016/12/15/1317654.png,0,0.99826616,273,68,697,492,424,424,pinkie pie
1319395.png,https://derpicdn.net/img/view/2016/12/17/1319395.png,0,0.924580574,0,23,516,687,516,664,pinkie pie
1322449.png,https://derpicdn.net/img/view/2016/12/22/1322449.png,0,0.953130186,281,59,503,281,222,222,pinkie pie
1322575.png,https://derpicdn.net/img/view/2016/12/22/1322575.png,0,0.988664091,153,53,2983,2883,2830,2830,pinkie pie
1328194.png,https://derpicdn.net/img/view/2016/12/30/1328194.png,0,0.989051938,483,0,2621,2041,2138,2041,pinkie pie
133277.png,https://derpicdn.net/img/view/2012/10/26/133277.png,0,0.942873657,330,56,800,526,470,470,pinkie pie
1334555.png,https://derpicdn.net/img/view/2017/1/8/1334555.png,0,0.994673371,723,0,2137,1306,1414,1306,pinkie pie
1340348.png,https://derpicdn.net/img/view/2017/1/15/1340348.png,0,0.977576971,5,19,1080,1187,1075,1168,pinkie pie
1345536.png,https://derpicdn.net/img/view/2017/1/22/1345536.png,0,0.996919036,404,45,1032,673,628,628,pinkie pie
1350759.png,https://derpicdn.net/img/view/2017/1/29/1350759.png,0,0.964741707,146,0,442,276,296,276,pinkie pie
1362150.png,https://derpicdn.net/img/view/2017/2/13/1362150.png,0,0.949992478,73,0,1155,720,1082,720,pinkie pie
1368.jpg,https://derpicdn.net/img/view/2012/1/22/1368.jpg,0,0.961966455,70,0,686,591,616,591,pinkie pie
1376696.png,https://derpicdn.net/img/view/2017/3/1/1376696.png,0,0.949781537,180,0,1314,1102,1134,1102,pinkie pie
1379209.png,https://derpicdn.net/img/view/2017/3/4/1379209.png,0,0.998148382,1017,460,1439,882,422,422,pinkie pie
1379209.png,https://derpicdn.net/img/view/2017/3/4/1379209.png,1,0.987532258,540,302,932,694,392,392,pinkie pie
1379209.png,https://derpicdn.net/img/view/2017/3/4/1379209.png,2,0.977086961,69,438,531,900,462,462,pinkie pie
13806.jpg,https://derpicdn.net/img/view/2012/6/21/13806.jpg,0,0.936446786,172,12,540,380,368,368,pinkie pie
1385383.png,https://derpicdn.net/img/view/2017/3/12/1385383.png,0,0.967172623,113,1217,737,1841,624,624,pinkie pie
1397151.png,https://derpicdn.net/img/view/2017/3/26/1397151.png,0,0.98883909,446,0,904,405,458,405,pinkie pie
1397151.png,https://derpicdn.net/img/view/2017/3/26/1397151.png,1,0.982068479,142,0,584,414,442,414,pinkie pie
1402276.png,https://derpicdn.net/img/view/2017/4/2/1402276.png,0,0.998436987,626,0,1060,415,434,415,pinkie pie
1402277.png,https://derpicdn.net/img/view/2017/4/2/1402277.png,0,0.998436987,626,0,1060,415,434,415,pinkie pie
1402618.png,https://derpicdn.net/img/view/2017/4/2/1402618.png,0,0.976305306,563,204,1343,984,780,780,pinkie pie
1406781.png,https://derpicdn.net/img/view/2017/4/8/1406781.png,0,0.958399773,164,0,1074,885,910,885,pinkie pie
1408710.png,https://derpicdn.net/img/view/2017/4/11/1408710.png,0,0.990754604,189,0,1051,843,862,843,pinkie pie
1410893.png,https://derpicdn.net/img/view/2017/4/14/1410893.png,0,0.972101569,48,0,536,487,488,487,pinkie pie
1414762.png,https://derpicdn.net/img/view/2017/4/18/1414762.png,0,0.93344444,491,0,750,285,259,285,pinkie pie
1424422.png,https://derpicdn.net/img/view/2017/4/29/1424422.png,0,0.994662702,800,251,1236,687,436,436,pinkie pie
1424468.png,https://derpicdn.net/img/view/2017/4/29/1424468.png,0,0.972664118,931,0,1920,1028,989,1028,pinkie pie
1424952.png,https://derpicdn.net/img/view/2017/4/29/1424952.png,0,0.98680824,0,0,608,460,608,460,pinkie pie
1425317.png,https://derpicdn.net/img/view/2017/4/30/1425317.png,1,0.993314147,5009,0,11237,4730,6228,4730,pinkie pie
1425467.png,https://derpicdn.net/img/view/2017/4/30/1425467.png,0,0.997056782,0,0,2202,2181,2202,2181,pinkie pie
1425812.png,https://derpicdn.net/img/view/2017/4/30/1425812.png,0,0.99718523,459,0,833,364,374,364,pinkie pie
14268.png,https://derpicdn.net/img/view/2012/6/21/14268.png,0,0.991101205,0,182,678,900,678,718,pinkie pie
1429556.png,https://derpicdn.net/img/view/2017/5/6/1429556.png,0,0.998097956,575,0,1159,576,584,576,pinkie pie
1432839.png,https://derpicdn.net/img/view/2017/5/9/1432839.png,0,0.934435904,1028,422,1555,1062,527,640,pinkie pie
1434243.png,https://derpicdn.net/img/view/2017/5/11/1434243.png,0,0.941074789,898,0,1726,772,828,772,pinkie pie
1438544.png,https://derpicdn.net/img/view/2017/5/17/1438544.png,0,0.924896002,54,0,544,464,490,464,pinkie pie
1442149.png,https://derpicdn.net/img/view/2017/5/21/1442149.png,0,0.990483403,0,0,813,810,813,810,pinkie pie
1444920.png,https://derpicdn.net/img/view/2017/5/24/1444920.png,0,0.98400104,456,81,854,479,398,398,pinkie pie
1444920.png,https://derpicdn.net/img/view/2017/5/24/1444920.png,1,0.90954262,0,175,233,467,233,292,pinkie pie
1448986.png,https://derpicdn.net/img/view/2017/5/29/1448986.png,0,0.954578698,46,468,1338,1760,1292,1292,pinkie pie
1451008.png,https://derpicdn.net/img/view/2017/5/31/1451008.png,0,0.956624627,234,232,1008,1006,774,774,pinkie pie
1453593.png,https://derpicdn.net/img/view/2017/6/4/1453593.png,0,0.90530324,413,302,727,616,314,314,pinkie pie
1460168.png,https://derpicdn.net/img/view/2017/6/12/1460168.png,0,0.993594289,858,0,2304,1416,1446,1416,pinkie pie
1471698.png,https://derpicdn.net/img/view/2017/6/25/1471698.png,0,0.955618978,184,31,604,451,420,420,pinkie pie
1473841.png,https://derpicdn.net/img/view/2017/6/29/1473841.png,0,0.970912457,58,128,830,900,772,772,pinkie pie
1480975.png,https://derpicdn.net/img/view/2017/7/7/1480975.png,0,0.963632226,1219,583,4017,3359,2798,2776,pinkie pie
1484287.png,https://derpicdn.net/img/view/2017/7/12/1484287.png,0,0.926331699,105,0,1300,1194,1195,1194,pinkie pie
1488164.png,https://derpicdn.net/img/view/2017/7/17/1488164.png,0,0.965001702,150,36,886,772,736,736,pinkie pie
1488253.png,https://derpicdn.net/img/view/2017/7/17/1488253.png,0,0.979292989,0,6,1798,1950,1798,1944,pinkie pie
1491572.png,https://derpicdn.net/img/view/2017/7/21/1491572.png,0,0.962297022,489,0,3000,2460,2511,2460,pinkie pie
14921.jpg,https://derpicdn.net/img/view/2012/6/22/14921.jpg,0,0.956222713,232,9,610,387,378,378,pinkie pie
1495320.png,https://derpicdn.net/img/view/2017/7/26/1495320.png,0,0.907378674,67,0,2759,2626,2692,2626,pinkie pie
1498274.png,https://derpicdn.net/img/view/2017/7/30/1498274.png,0,0.999005973,15,67,449,501,434,434,pinkie pie
1501772.png,https://derpicdn.net/img/view/2017/8/3/1501772.png,0,0.973958254,0,5,1024,1185,1024,1180,pinkie pie
1506909.png,https://derpicdn.net/img/view/2017/8/10/1506909.png,0,0.957713544,57,0,2441,2287,2384,2287,pinkie pie
1508040.png,https://derpicdn.net/img/view/2017/8/11/1508040.png,0,0.959883332,153,66,881,794,728,728,pinkie pie
1508381.png,https://derpicdn.net/img/view/2017/8/11/1508381.png,0,0.980639696,483,583,913,1013,430,430,pinkie pie
1512240.png,https://derpicdn.net/img/view/2017/8/16/1512240.png,0,0.925768971,1134,374,4398,3692,3264,3318,pinkie pie
1513815.png,https://derpicdn.net/img/view/2017/8/18/1513815.png,0,0.980011523,53,9,255,203,202,194,pinkie pie
1517738.png,https://derpicdn.net/img/view/2017/8/23/1517738.png,0,0.996485651,881,192,1145,456,264,264,pinkie pie
1518519.png,https://derpicdn.net/img/view/2017/8/24/1518519.png,0,0.990322292,1107,115,1833,841,726,726,pinkie pie
1533639.png,https://derpicdn.net/img/view/2017/9/12/1533639.png,0,0.988414288,387,0,667,259,280,259,pinkie pie
1535846.png,https://derpicdn.net/img/view/2017/9/15/1535846.png,0,0.971216798,222,0,842,593,620,593,pinkie pie
1536662.png,https://derpicdn.net/img/view/2017/9/16/1536662.png,0,0.973906994,887,0,1207,315,320,315,pinkie pie
1537206.png,https://derpicdn.net/img/view/2017/9/16/1537206.png,0,0.951034009,20,32,518,530,498,498,pinkie pie
1538.jpg,https://derpicdn.net/img/view/2012/1/23/1538.jpg,0,0.964056075,155,46,711,602,556,556,pinkie pie
1544034.png,https://derpicdn.net/img/view/2017/9/24/1544034.png,0,0.964951456,49,6,275,232,226,226,pinkie pie
1544034.png,https://derpicdn.net/img/view/2017/9/24/1544034.png,1,0.951168954,0,278,262,552,262,274,pinkie pie
1544664.png,https://derpicdn.net/img/view/2017/9/25/1544664.png,1,0.958906233,421,230,733,542,312,312,pinkie pie
1547081.png,https://derpicdn.net/img/view/2017/9/28/1547081.png,0,0.938652992,1177,569,3327,2719,2150,2150,pinkie pie
1548931.png,https://derpicdn.net/img/view/2017/10/1/1548931.png,0,0.961131454,491,0,1271,755,780,755,pinkie pie
154996.png,https://derpicdn.net/img/view/2012/11/17/154996.png,0,0.94298768,763,1439,1467,2143,704,704,pinkie pie
1552323.png,https://derpicdn.net/img/view/2017/10/5/1552323.png,0,0.960412681,14,0,960,906,946,906,pinkie pie
15579.png,https://derpicdn.net/img/view/2012/6/22/15579.png,0,0.963246942,0,0,877,990,877,990,pinkie pie
1562774.png,https://derpicdn.net/img/view/2017/10/16/1562774.png,0,0.963181376,87,31,635,579,548,548,pinkie pie
1567763.png,https://derpicdn.net/img/view/2017/10/22/1567763.png,0,0.959786654,127,0,1213,1067,1086,1067,pinkie pie
1571209.png,https://derpicdn.net/img/view/2017/10/27/1571209.png,0,0.911091864,138,20,1200,1084,1062,1064,pinkie pie
1572980.png,https://derpicdn.net/img/view/2017/10/29/1572980.png,0,0.995055616,48,572,886,1410,838,838,pinkie pie
15787.png,https://derpicdn.net/img/view/2012/6/22/15787.png,0,0.98395431,108,0,1502,1315,1394,1315,pinkie pie
1579960.png,https://derpicdn.net/img/view/2017/11/6/1579960.png,0,0.947724283,129,4,667,542,538,538,pinkie pie
1581168.png,https://derpicdn.net/img/view/2017/11/8/1581168.png,0,0.900469661,404,270,1512,1378,1108,1108,pinkie pie
1588478.png,https://derpicdn.net/img/view/2017/11/17/1588478.png,0,0.940440059,418,706,3712,4000,3294,3294,pinkie pie
159108.jpg,https://derpicdn.net/img/view/2012/11/21/159108.jpg,0,0.981167316,129,0,387,247,258,247,pinkie pie
1597206.png,https://derpicdn.net/img/view/2017/11/30/1597206.png,0,0.95899874,141,1,1153,1013,1012,1012,pinkie pie
1598859.png,https://derpicdn.net/img/view/2017/12/2/1598859.png,0,0.985294223,326,0,948,594,622,594,pinkie pie
1598914.png,https://derpicdn.net/img/view/2017/12/2/1598914.png,0,0.980935395,57,65,680,703,623,638,pinkie pie
1600273.png,https://derpicdn.net/img/view/2017/12/4/1600273.png,0,0.982708097,425,194,2423,2192,1998,1998,pinkie pie
1600316.png,https://derpicdn.net/img/view/2017/12/4/1600316.png,0,0.962258816,65,0,800,544,735,544,pinkie pie
1604988.png,https://derpicdn.net/img/view/2017/12/11/1604988.png,0,0.943446934,92,0,1110,886,1018,886,pinkie pie
160760.jpg,https://derpicdn.net/img/view/2012/11/23/160760.jpg,0,0.992327392,228,182,602,556,374,374,pinkie pie
1607895.png,https://derpicdn.net/img/view/2017/12/14/1607895.png,0,0.993764699,249,123,1365,1239,1116,1116,pinkie pie
1610261.png,https://derpicdn.net/img/view/2017/12/18/1610261.png,0,0.987345517,0,108,451,560,451,452,pinkie pie
1610261.png,https://derpicdn.net/img/view/2017/12/18/1610261.png,1,0.970062315,469,59,893,483,424,424,pinkie pie
1610261.png,https://derpicdn.net/img/view/2017/12/18/1610261.png,2,0.963219821,776,65,1220,509,444,444,pinkie pie
1611009.png,https://derpicdn.net/img/view/2017/12/19/1611009.png,0,0.916935802,148,68,1564,1484,1416,1416,pinkie pie
1611092.png,https://derpicdn.net/img/view/2017/12/19/1611092.png,0,0.947925031,299,0,769,443,470,443,pinkie pie
1614849.png,https://derpicdn.net/img/view/2017/12/24/1614849.png,0,0.986567974,260,0,874,584,614,584,pinkie pie
1615063.png,https://derpicdn.net/img/view/2017/12/24/1615063.png,0,0.926151752,122,61,844,783,722,722,pinkie pie
1618393.png,https://derpicdn.net/img/view/2017/12/28/1618393.png,0,0.999005616,102,141,456,495,354,354,pinkie pie
1618393.png,https://derpicdn.net/img/view/2017/12/28/1618393.png,1,0.990350187,794,74,1370,650,576,576,pinkie pie
1618393.png,https://derpicdn.net/img/view/2017/12/28/1618393.png,2,0.901178002,359,315,673,629,314,314,pinkie pie
1619290.png,https://derpicdn.net/img/view/2017/12/29/1619290.png,0,0.989927888,53,0,555,486,502,486,pinkie pie
1623653.png,https://derpicdn.net/img/view/2018/1/4/1623653.png,0,0.975754321,97,12,651,566,554,554,pinkie pie
1626806.png,https://derpicdn.net/img/view/2018/1/7/1626806.png,0,0.977393866,72,0,464,380,392,380,pinkie pie
1632202.png,https://derpicdn.net/img/view/2018/1/14/1632202.png,0,0.998062968,108,330,616,838,508,508,pinkie pie
1637216.png,https://derpicdn.net/img/view/2018/1/21/1637216.png,0,0.976866424,233,71,875,713,642,642,pinkie pie
1637791.png,https://derpicdn.net/img/view/2018/1/21/1637791.png,1,0.939435542,122,0,664,493,542,493,pinkie pie
1645704.png,https://derpicdn.net/img/view/2018/2/1/1645704.png,0,0.955486417,177,0,3119,2913,2942,2913,pinkie pie
1647931.png,https://derpicdn.net/img/view/2018/2/4/1647931.png,0,0.986927688,0,8,569,584,569,576,pinkie pie
1648979.png,https://derpicdn.net/img/view/2018/2/5/1648979.png,0,0.963873625,345,0,839,486,494,486,pinkie pie
1650149.png,https://derpicdn.net/img/view/2018/2/7/1650149.png,0,0.96121037,361,371,789,799,428,428,pinkie pie
1651044.png,https://derpicdn.net/img/view/2018/2/8/1651044.png,0,0.900945127,49,0,667,606,618,606,pinkie pie
1657860.png,https://derpicdn.net/img/view/2018/2/17/1657860.png,0,0.971134007,13,0,1331,1316,1318,1316,pinkie pie
1663658.png,https://derpicdn.net/img/view/2018/2/23/1663658.png,0,0.984582603,398,75,1016,693,618,618,pinkie pie
1665456.png,https://derpicdn.net/img/view/2018/2/25/1665456.png,0,0.988314629,183,0,1377,868,1194,868,pinkie pie
1669425.png,https://derpicdn.net/img/view/2018/3/2/1669425.png,0,0.99138397,543,717,2695,2869,2152,2152,pinkie pie
1673676.png,https://derpicdn.net/img/view/2018/3/7/1673676.png,0,0.994774818,103,0,861,746,758,746,pinkie pie
1676521.png,https://derpicdn.net/img/view/2018/3/10/1676521.png,0,0.967545867,155,0,1073,799,918,799,pinkie pie
1698360.png,https://derpicdn.net/img/view/2018/4/3/1698360.png,0,0.990766943,28,0,670,636,642,636,pinkie pie
1698382.png,https://derpicdn.net/img/view/2018/4/3/1698382.png,0,0.9799245,18,6,638,626,620,620,pinkie pie
1699130.png,https://derpicdn.net/img/view/2018/4/4/1699130.png,0,0.981288135,89,0,717,647,628,647,pinkie pie
1699300.png,https://derpicdn.net/img/view/2018/4/4/1699300.png,0,0.999498844,468,41,750,323,282,282,pinkie pie
1701474.png,https://derpicdn.net/img/view/2018/4/7/1701474.png,0,0.993819177,180,0,630,444,450,444,pinkie pie
1702298.png,https://derpicdn.net/img/view/2018/4/8/1702298.png,0,0.983244359,48,0,662,568,614,568,pinkie pie
1702455.png,https://derpicdn.net/img/view/2018/4/8/1702455.png,0,0.939252436,116,0,404,279,288,279,pinkie pie
1702693.png,https://derpicdn.net/img/view/2018/4/8/1702693.png,0,0.985776901,38,0,1500,1000,1462,1000,pinkie pie
1704200.png,https://derpicdn.net/img/view/2018/4/10/1704200.png,0,0.993417144,42,0,782,708,740,708,pinkie pie
1709497.png,https://derpicdn.net/img/view/2018/4/16/1709497.png,0,0.96469903,99,0,2538,2443,2439,2443,pinkie pie
1710104.png,https://derpicdn.net/img/view/2018/4/17/1710104.png,0,0.996457219,151,0,759,570,608,570,pinkie pie
1710109.png,https://derpicdn.net/img/view/2018/4/17/1710109.png,0,0.900210917,471,116,1335,980,864,864,pinkie pie
1711544.png,https://derpicdn.net/img/view/2018/4/19/1711544.png,0,0.937174618,352,180,644,472,292,292,pinkie pie
1713534.png,https://derpicdn.net/img/view/2018/4/21/1713534.png,0,0.967279077,188,0,1024,826,836,826,pinkie pie
1717565.png,https://derpicdn.net/img/view/2018/4/26/1717565.png,0,0.919069827,587,0,2057,1446,1470,1446,pinkie pie
1718677.png,https://derpicdn.net/img/view/2018/4/28/1718677.png,0,0.971203029,3129,0,3767,609,638,609,pinkie pie
1719364.png,https://derpicdn.net/img/view/2018/4/28/1719364.png,0,0.967221856,624,28,1008,412,384,384,pinkie pie
1720214.png,https://derpicdn.net/img/view/2018/4/29/1720214.png,0,0.978599548,687,64,1493,870,806,806,pinkie pie
1721868.png,https://derpicdn.net/img/view/2018/5/1/1721868.png,0,0.98807323,1166,54,1784,672,618,618,pinkie pie
1721868.png,https://derpicdn.net/img/view/2018/5/1/1721868.png,1,0.982002914,129,344,769,984,640,640,pinkie pie
1724621.png,https://derpicdn.net/img/view/2018/5/5/1724621.png,0,0.972343206,522,372,1448,1298,926,926,pinkie pie
1728243.png,https://derpicdn.net/img/view/2018/5/9/1728243.png,0,0.972663105,77,15,215,153,138,138,pinkie pie
1728243.png,https://derpicdn.net/img/view/2018/5/9/1728243.png,1,0.912124872,463,156,595,288,132,132,pinkie pie
1730449.png,https://derpicdn.net/img/view/2018/5/12/1730449.png,0,0.961318791,27,0,373,331,346,331,pinkie pie
1738190.png,https://derpicdn.net/img/view/2018/5/21/1738190.png,0,0.92682457,58,0,846,759,788,759,pinkie pie
1750022.png,https://derpicdn.net/img/view/2018/6/4/1750022.png,0,0.975385964,26,39,458,471,432,432,pinkie pie
1750421.png,https://derpicdn.net/img/view/2018/6/5/1750421.png,0,0.976861835,208,32,444,268,236,236,pinkie pie
1757859.png,https://derpicdn.net/img/view/2018/6/15/1757859.png,0,0.95868504,404,830,786,1212,382,382,pinkie pie
1760839.png,https://derpicdn.net/img/view/2018/6/18/1760839.png,0,0.958301783,205,0,905,671,700,671,pinkie pie
1761421.png,https://derpicdn.net/img/view/2018/6/19/1761421.png,0,0.964147806,212,0,900,666,688,666,pinkie pie
1768225.png,https://derpicdn.net/img/view/2018/6/28/1768225.png,0,0.987188399,348,517,718,887,370,370,pinkie pie
1770893.png,https://derpicdn.net/img/view/2018/7/2/1770893.png,0,0.936177313,1239,514,2541,1816,1302,1302,pinkie pie
1777091.png,https://derpicdn.net/img/view/2018/7/9/1777091.png,0,0.978250027,506,328,1260,1082,754,754,pinkie pie
1778187.png,https://derpicdn.net/img/view/2018/7/11/1778187.png,0,0.95402962,554,139,1258,843,704,704,pinkie pie
1785130.png,https://derpicdn.net/img/view/2018/7/20/1785130.png,0,0.911871135,55,0,1172,1291,1117,1291,pinkie pie
1789419.png,https://derpicdn.net/img/view/2018/7/25/1789419.png,0,0.963844359,50,5,518,473,468,468,pinkie pie
1789942.png,https://derpicdn.net/img/view/2018/7/26/1789942.png,0,0.993044853,450,133,862,545,412,412,pinkie pie
1793896.png,https://derpicdn.net/img/view/2018/7/31/1793896.png,0,0.925717473,63,0,2769,2630,2706,2630,pinkie pie
1794393.png,https://derpicdn.net/img/view/2018/7/31/1794393.png,0,0.982665062,1688,100,3176,1588,1488,1488,pinkie pie
1797802.png,https://derpicdn.net/img/view/2018/8/4/1797802.png,0,0.949972093,48,0,548,458,500,458,pinkie pie
1799279.png,https://derpicdn.net/img/view/2018/8/6/1799279.png,0,0.981529534,306,0,1154,839,848,839,pinkie pie
1800357.png,https://derpicdn.net/img/view/2018/8/7/1800357.png,0,0.983693838,97,244,731,878,634,634,pinkie pie
1804706.png,https://derpicdn.net/img/view/2018/8/12/1804706.png,0,0.970951438,393,764,1039,1410,646,646,pinkie pie
1806079.png,https://derpicdn.net/img/view/2018/8/13/1806079.png,0,0.984844446,21,295,2135,2409,2114,2114,pinkie pie
1807419.png,https://derpicdn.net/img/view/2018/8/15/1807419.png,0,0.993108153,932,527,3868,3463,2936,2936,pinkie pie
1807818.png,https://derpicdn.net/img/view/2018/8/16/1807818.png,1,0.990994573,431,0,993,544,562,544,pinkie pie
1808570.png,https://derpicdn.net/img/view/2018/8/16/1808570.png,0,0.933829725,15,0,211,180,196,180,pinkie pie
1809914.png,https://derpicdn.net/img/view/2018/8/18/1809914.png,0,0.990964234,0,0,181,186,181,186,pinkie pie
181034.png,https://derpicdn.net/img/view/2012/12/12/181034.png,0,0.99794513,18,0,574,531,556,531,pinkie pie
1812133.png,https://derpicdn.net/img/view/2018/8/21/1812133.png,0,0.991806269,338,0,1894,1419,1556,1419,pinkie pie
1815244.png,https://derpicdn.net/img/view/2018/8/24/1815244.png,1,0.961958408,1921,115,2301,495,380,380,pinkie pie
1825265.png,https://derpicdn.net/img/view/2018/9/5/1825265.png,0,0.971984267,32,0,352,297,320,297,pinkie pie
1835063.png,https://derpicdn.net/img/view/2018/9/17/1835063.png,0,0.990336478,1181,0,2799,1615,1618,1615,pinkie pie
1843787.png,https://derpicdn.net/img/view/2018/9/29/1843787.png,0,0.981589079,274,0,1350,1066,1076,1066,pinkie pie
1848606.png,https://derpicdn.net/img/view/2018/10/5/1848606.png,0,0.992926419,38,0,490,426,452,426,pinkie pie
1851794.png,https://derpicdn.net/img/view/2018/10/8/1851794.png,0,0.945036948,883,65,1205,387,322,322,pinkie pie
1851794.png,https://derpicdn.net/img/view/2018/10/8/1851794.png,1,0.905202627,917,273,1323,679,406,406,pinkie pie
1852553.png,https://derpicdn.net/img/view/2018/10/9/1852553.png,0,0.943392158,178,49,692,563,514,514,pinkie pie
1870319.png,https://derpicdn.net/img/view/2018/10/30/1870319.png,0,0.915686727,25,0,789,681,764,681,pinkie pie
1874325.png,https://derpicdn.net/img/view/2018/11/3/1874325.png,0,0.957892001,1020,420,2764,2164,1744,1744,pinkie pie
1877222.png,https://derpicdn.net/img/view/2018/11/7/1877222.png,0,0.984745026,0,0,1477,1457,1477,1457,pinkie pie
1877223.png,https://derpicdn.net/img/view/2018/11/7/1877223.png,0,0.989272892,1002,0,3402,2297,2400,2297,pinkie pie
1877568.png,https://derpicdn.net/img/view/2018/11/8/1877568.png,0,0.922804296,370,0,874,503,504,503,pinkie pie
1878696.png,https://derpicdn.net/img/view/2018/11/10/1878696.png,0,0.972266018,29,0,2405,2118,2376,2118,pinkie pie
1880876.png,https://derpicdn.net/img/view/2018/11/12/1880876.png,0,0.997010052,324,0,1000,707,676,707,pinkie pie
1885393.png,https://derpicdn.net/img/view/2018/11/18/1885393.png,0,0.982639611,41,0,753,678,712,678,pinkie pie
1887653.png,https://derpicdn.net/img/view/2018/11/21/1887653.png,0,0.955444694,851,48,1869,1066,1018,1018,pinkie pie
1889937.png,https://derpicdn.net/img/view/2018/11/24/1889937.png,0,0.949451447,963,259,1563,859,600,600,pinkie pie
1903499.png,https://derpicdn.net/img/view/2018/12/9/1903499.png,0,0.9309991,285,129,867,711,582,582,pinkie pie
1908686.png,https://derpicdn.net/img/view/2018/12/15/1908686.png,0,0.977003038,54,60,264,270,210,210,pinkie pie
1911104.png,https://derpicdn.net/img/view/2018/12/17/1911104.png,0,0.981326461,1926,135,3576,1785,1650,1650,pinkie pie
1913058.png,https://derpicdn.net/img/view/2018/12/19/1913058.png,0,0.983566761,43,0,441,364,398,364,pinkie pie
1914782.png,https://derpicdn.net/img/view/2018/12/21/1914782.png,0,0.993803322,176,0,818,579,642,579,pinkie pie
1922600.png,https://derpicdn.net/img/view/2018/12/31/1922600.png,0,0.99405086,200,92,686,578,486,486,pinkie pie
1923678.png,https://derpicdn.net/img/view/2019/1/1/1923678.png,0,0.909129918,259,0,1773,1408,1514,1408,pinkie pie
1925313.png,https://derpicdn.net/img/view/2019/1/3/1925313.png,0,0.936710894,158,138,562,542,404,404,pinkie pie
1934137.png,https://derpicdn.net/img/view/2019/1/13/1934137.png,1,0.964631498,85,0,2781,2032,2696,2032,pinkie pie
1934910.png,https://derpicdn.net/img/view/2019/1/14/1934910.png,0,0.9817487,154,0,1000,838,846,838,pinkie pie
1937685.png,https://derpicdn.net/img/view/2019/1/17/1937685.png,0,0.929085076,876,72,1732,928,856,856,pinkie pie
1938403.png,https://derpicdn.net/img/view/2019/1/18/1938403.png,0,0.966169059,159,0,555,390,396,390,pinkie pie
1944542.png,https://derpicdn.net/img/view/2019/1/25/1944542.png,0,0.964526117,539,0,1249,691,710,691,pinkie pie
1944717.png,https://derpicdn.net/img/view/2019/1/26/1944717.png,0,0.941689432,321,0,2547,1600,2226,1600,pinkie pie
1953782.png,https://derpicdn.net/img/view/2019/2/5/1953782.png,0,0.984841585,313,130,3537,3354,3224,3224,pinkie pie
1955354.png,https://derpicdn.net/img/view/2019/2/6/1955354.png,0,0.952584505,149,29,707,587,558,558,pinkie pie
1960869.png,https://derpicdn.net/img/view/2019/2/13/1960869.png,0,0.964148998,285,451,593,759,308,308,pinkie pie
1963069.png,https://derpicdn.net/img/view/2019/2/15/1963069.png,0,0.998578668,557,1,1011,455,454,454,pinkie pie
1968440.png,https://derpicdn.net/img/view/2019/2/22/1968440.png,0,0.937862217,59,0,300,270,241,270,pinkie pie
1973889.png,https://derpicdn.net/img/view/2019/2/28/1973889.png,0,0.983717322,356,7,1062,713,706,706,pinkie pie
1977828.png,https://derpicdn.net/img/view/2019/3/5/1977828.png,0,0.951748371,954,323,1556,925,602,602,pinkie pie
1977874.png,https://derpicdn.net/img/view/2019/3/5/1977874.png,0,0.988396466,311,0,2451,2096,2140,2096,pinkie pie
1982387.png,https://derpicdn.net/img/view/2019/3/10/1982387.png,0,0.977392137,0,2,1089,1140,1089,1138,pinkie pie
1985685.png,https://derpicdn.net/img/view/2019/3/15/1985685.png,0,0.980901837,114,11,812,709,698,698,pinkie pie
1991392.png,https://derpicdn.net/img/view/2019/3/21/1991392.png,0,0.962468028,686,0,1700,900,1014,900,pinkie pie
1993910.png,https://derpicdn.net/img/view/2019/3/24/1993910.png,0,0.978831947,195,0,2044,1731,1849,1731,pinkie pie
1997163.png,https://derpicdn.net/img/view/2019/3/29/1997163.png,0,0.985964537,332,0,914,566,582,566,pinkie pie
2002645.png,https://derpicdn.net/img/view/2019/4/4/2002645.png,0,0.989077866,677,868,1425,1616,748,748,pinkie pie
2005551.png,https://derpicdn.net/img/view/2019/4/7/2005551.png,0,0.992508888,299,100,665,466,366,366,pinkie pie
2008271.png,https://derpicdn.net/img/view/2019/4/10/2008271.png,0,0.988955736,0,0,760,852,760,852,pinkie pie
2014807.png,https://derpicdn.net/img/view/2019/4/17/2014807.png,0,0.992494524,0,0,679,640,679,640,pinkie pie
2016476.png,https://derpicdn.net/img/view/2019/4/19/2016476.png,0,0.951243341,257,0,1333,910,1076,910,pinkie pie
2022018.png,https://derpicdn.net/img/view/2019/4/24/2022018.png,0,0.985965669,343,339,857,853,514,514,pinkie pie
2029067.png,https://derpicdn.net/img/view/2019/5/2/2029067.png,0,0.925206244,247,16,929,698,682,682,pinkie pie
2032826.png,https://derpicdn.net/img/view/2019/5/6/2032826.png,0,0.956403494,289,31,879,621,590,590,pinkie pie
2035086.png,https://derpicdn.net/img/view/2019/5/10/2035086.png,0,0.99096781,43,0,1713,1453,1670,1453,pinkie pie
2039744.png,https://derpicdn.net/img/view/2019/5/15/2039744.png,0,0.970416546,0,13,636,723,636,710,pinkie pie
20476.jpg,https://derpicdn.net/img/view/2012/6/25/20476.jpg,0,0.978232861,603,40,1677,1114,1074,1074,pinkie pie
2050230.png,https://derpicdn.net/img/view/2019/5/27/2050230.png,0,0.905228257,0,76,1412,1624,1412,1548,pinkie pie
2059632.png,https://derpicdn.net/img/view/2019/6/7/2059632.png,0,0.988447666,59,52,459,452,400,400,pinkie pie
2073579.png,https://derpicdn.net/img/view/2019/6/23/2073579.png,0,0.998735011,3273,776,4653,2156,1380,1380,pinkie pie
2073579.png,https://derpicdn.net/img/view/2019/6/23/2073579.png,1,0.932522476,502,837,1744,2079,1242,1242,pinkie pie
208686.jpg,https://derpicdn.net/img/view/2013/1/10/208686.jpg,0,0.974391282,0,745,1139,1881,1139,1136,pinkie pie
2090102.png,https://derpicdn.net/img/view/2019/7/12/2090102.png,0,0.955170572,221,3,449,231,228,228,pinkie pie
2092927.png,https://derpicdn.net/img/view/2019/7/16/2092927.png,0,0.93061173,83,0,500,418,417,418,pinkie pie
2098181.png,https://derpicdn.net/img/view/2019/7/22/2098181.png,0,0.996861577,391,0,787,344,396,344,pinkie pie
2099054.png,https://derpicdn.net/img/view/2019/7/23/2099054.png,0,0.981201172,291,358,1155,1222,864,864,pinkie pie
2101208.png,https://derpicdn.net/img/view/2019/7/25/2101208.png,0,0.916632891,0,0,595,637,595,637,pinkie pie
2104551.png,https://derpicdn.net/img/view/2019/7/30/2104551.png,0,0.994910419,0,38,1278,1183,1278,1145,pinkie pie
2105642.png,https://derpicdn.net/img/view/2019/7/31/2105642.png,0,0.984754741,53,0,803,545,750,545,pinkie pie
2120767.png,https://derpicdn.net/img/view/2019/8/17/2120767.png,0,0.939740419,473,241,1019,787,546,546,pinkie pie
2124859.png,https://derpicdn.net/img/view/2019/8/22/2124859.png,0,0.928578734,2318,257,4988,2927,2670,2670,pinkie pie
2125422.png,https://derpicdn.net/img/view/2019/8/23/2125422.png,0,0.98637104,520,33,1040,553,520,520,pinkie pie
213048.png,https://derpicdn.net/img/view/2013/1/15/213048.png,0,0.999245107,301,47,581,327,280,280,pinkie pie
2132322.png,https://derpicdn.net/img/view/2019/8/31/2132322.png,0,0.994156122,218,0,1062,780,844,780,pinkie pie
2136858.png,https://derpicdn.net/img/view/2019/9/5/2136858.png,0,0.90421921,85,0,1363,1246,1278,1246,pinkie pie
2141558.png,https://derpicdn.net/img/view/2019/9/11/2141558.png,0,0.9259426,25,0,1743,1381,1718,1381,pinkie pie
2143299.png,https://derpicdn.net/img/view/2019/9/13/2143299.png,0,0.984954655,246,285,522,561,276,276,pinkie pie
2161233.png,https://derpicdn.net/img/view/2019/10/6/2161233.png,0,0.94077915,72,29,672,629,600,600,pinkie pie
2162168.png,https://derpicdn.net/img/view/2019/10/6/2162168.png,0,0.934197366,785,90,1759,1064,974,974,pinkie pie
2178411.png,https://derpicdn.net/img/view/2019/10/25/2178411.png,0,0.9916085,518,826,1012,1320,494,494,pinkie pie
217926.jpg,https://derpicdn.net/img/view/2013/1/20/217926.jpg,0,0.93592149,0,50,900,1082,900,1032,pinkie pie
2182914.png,https://derpicdn.net/img/view/2019/10/30/2182914.png,0,0.979758918,263,0,882,604,619,604,pinkie pie
2187822.png,https://derpicdn.net/img/view/2019/11/4/2187822.png,0,0.961726367,254,67,538,351,284,284,pinkie pie
2190790.png,https://derpicdn.net/img/view/2019/11/8/2190790.png,0,0.952564061,33,30,489,486,456,456,pinkie pie
2198618.png,https://derpicdn.net/img/view/2019/11/17/2198618.png,0,0.903426945,313,0,1207,808,894,808,pinkie pie
2198644.png,https://derpicdn.net/img/view/2019/11/17/2198644.png,0,0.996224284,65,8,367,310,302,302,pinkie pie
2198987.png,https://derpicdn.net/img/view/2019/11/17/2198987.png,0,0.991604447,297,0,2229,1678,1932,1678,pinkie pie
2202205.png,https://derpicdn.net/img/view/2019/11/21/2202205.png,0,0.966960192,48,0,470,404,422,404,pinkie pie
2203289.png,https://derpicdn.net/img/view/2019/11/23/2203289.png,0,0.973772109,132,0,500,362,368,362,pinkie pie
2203290.png,https://derpicdn.net/img/view/2019/11/23/2203290.png,0,0.98442018,0,35,425,479,425,444,pinkie pie
2209705.png,https://derpicdn.net/img/view/2019/12/1/2209705.png,0,0.98417455,370,52,778,460,408,408,pinkie pie
2224130.png,https://derpicdn.net/img/view/2019/12/19/2224130.png,0,0.998394907,1432,0,2404,790,972,790,pinkie pie
2226562.png,https://derpicdn.net/img/view/2019/12/21/2226562.png,0,0.974175274,105,0,855,737,750,737,pinkie pie
2227168.jpg,https://derpicdn.net/img/view/2019/12/22/2227168.jpg,0,0.957521737,880,20,2030,1170,1150,1150,pinkie pie
2228053.png,https://derpicdn.net/img/view/2019/12/23/2228053.png,0,0.965195298,260,0,734,466,474,466,pinkie pie
2228427.png,https://derpicdn.net/img/view/2019/12/24/2228427.png,0,0.918560624,57,0,855,770,798,770,pinkie pie
2229103.png,https://derpicdn.net/img/view/2019/12/24/2229103.png,0,0.989371181,804,134,2000,1374,1196,1240,pinkie pie
2237470.jpg,https://derpicdn.net/img/view/2020/1/3/2237470.jpg,0,0.999290943,280,0,1314,1033,1034,1033,pinkie pie
2238882.jpg,https://derpicdn.net/img/view/2020/1/4/2238882.jpg,0,0.994242966,117,24,727,634,610,610,pinkie pie
2240636.jpg,https://derpicdn.net/img/view/2020/1/7/2240636.jpg,0,0.963064194,262,195,568,501,306,306,pinkie pie
2244833.png,https://derpicdn.net/img/view/2020/1/11/2244833.png,0,0.996884286,176,0,694,488,518,488,pinkie pie
2245736.png,https://derpicdn.net/img/view/2020/1/12/2245736.png,0,0.981676161,48,0,615,598,567,598,pinkie pie
2247713.jpg,https://derpicdn.net/img/view/2020/1/15/2247713.jpg,0,0.991241157,301,105,1037,841,736,736,pinkie pie
2248473.png,https://derpicdn.net/img/view/2020/1/15/2248473.png,0,0.959476888,60,0,274,207,214,207,pinkie pie
2249196.png,https://derpicdn.net/img/view/2020/1/16/2249196.png,0,0.955049396,298,4,834,540,536,536,pinkie pie
2249205.jpg,https://derpicdn.net/img/view/2020/1/16/2249205.jpg,0,0.958456576,129,0,695,539,566,539,pinkie pie
2249206.jpg,https://derpicdn.net/img/view/2020/1/16/2249206.jpg,0,0.910868168,109,0,663,537,554,537,pinkie pie
2250306.png,https://derpicdn.net/img/view/2020/1/18/2250306.png,0,0.97679013,514,1274,1218,1978,704,704,pinkie pie
2251039.png,https://derpicdn.net/img/view/2020/1/19/2251039.png,0,0.918595791,0,0,298,267,298,267,pinkie pie
2251086.png,https://derpicdn.net/img/view/2020/1/19/2251086.png,0,0.997710526,344,1742,3404,4802,3060,3060,pinkie pie
2251086.png,https://derpicdn.net/img/view/2020/1/19/2251086.png,1,0.996449232,3825,61,7259,3495,3434,3434,pinkie pie
2263599.jpg,https://derpicdn.net/img/view/2020/2/2/2263599.jpg,0,0.979347289,0,0,1609,1574,1609,1574,pinkie pie
2265307.png,https://derpicdn.net/img/view/2020/2/4/2265307.png,0,0.991093576,252,0,2334,1938,2082,1938,pinkie pie
2266643.jpg,https://derpicdn.net/img/view/2020/2/5/2266643.jpg,0,0.91376555,815,364,1547,1096,732,732,pinkie pie
2268787.jpg,https://derpicdn.net/img/view/2020/2/8/2268787.jpg,0,0.978404582,121,134,1073,1086,952,952,pinkie pie
2269035.png,https://derpicdn.net/img/view/2020/2/8/2269035.png,0,0.985142767,0,21,2117,2207,2117,2186,pinkie pie
2270617.jpg,https://derpicdn.net/img/view/2020/2/10/2270617.jpg,0,0.990827262,592,0,1254,633,662,633,pinkie pie
2270984.png,https://derpicdn.net/img/view/2020/2/11/2270984.png,0,0.988998652,592,233,1056,697,464,464,pinkie pie
2271663.png,https://derpicdn.net/img/view/2020/2/11/2271663.png,0,0.92445749,889,172,1607,890,718,718,pinkie pie
2273685.jpg,https://derpicdn.net/img/view/2020/2/14/2273685.jpg,0,0.96048218,0,0,541,552,541,552,pinkie pie
2274735.jpg,https://derpicdn.net/img/view/2020/2/15/2274735.jpg,0,0.987899601,125,37,317,229,192,192,pinkie pie
2274935.png,https://derpicdn.net/img/view/2020/2/15/2274935.png,0,0.982974291,311,270,655,614,344,344,pinkie pie
2278828.jpg,https://derpicdn.net/img/view/2020/2/20/2278828.jpg,0,0.918261051,186,0,1646,1404,1460,1404,pinkie pie
2279816.jpg,https://derpicdn.net/img/view/2020/2/21/2279816.jpg,0,0.998402119,183,0,1327,995,1144,995,pinkie pie
2280155.jpg,https://derpicdn.net/img/view/2020/2/21/2280155.jpg,0,0.923510373,140,0,412,261,272,261,pinkie pie
2281064.jpg,https://derpicdn.net/img/view/2020/2/22/2281064.jpg,0,0.998275518,832,0,1690,836,858,836,pinkie pie
2283196.png,https://derpicdn.net/img/view/2020/2/25/2283196.png,0,0.998231411,180,0,756,536,576,536,pinkie pie
2283249.jpg,https://derpicdn.net/img/view/2020/2/25/2283249.jpg,0,0.999408484,509,19,1045,555,536,536,pinkie pie
2289921.jpg,https://derpicdn.net/img/view/2020/3/4/2289921.jpg,0,0.984985232,879,992,1489,1602,610,610,pinkie pie
2290619.jpg,https://derpicdn.net/img/view/2020/3/5/2290619.jpg,0,0.985279977,898,40,1816,958,918,918,pinkie pie
2290619.jpg,https://derpicdn.net/img/view/2020/3/5/2290619.jpg,1,0.985042751,99,202,975,1078,876,876,pinkie pie
2290621.jpg,https://derpicdn.net/img/view/2020/3/5/2290621.jpg,0,0.9953385,187,129,1235,1177,1048,1048,pinkie pie
2295367.png,https://derpicdn.net/img/view/2020/3/12/2295367.png,0,0.985796988,282,54,1022,794,740,740,pinkie pie
2297426.jpg,https://derpicdn.net/img/view/2020/3/14/2297426.jpg,0,0.935236275,130,0,618,473,488,473,pinkie pie
2297833.png,https://derpicdn.net/img/view/2020/3/15/2297833.png,0,0.977025151,67,0,701,533,634,533,pinkie pie
2305781.png,https://derpicdn.net/img/view/2020/3/25/2305781.png,0,0.988442898,41,0,351,309,310,309,pinkie pie
2306977.png,https://derpicdn.net/img/view/2020/3/27/2306977.png,0,0.994883358,950,270,1298,618,348,348,pinkie pie
2306977.png,https://derpicdn.net/img/view/2020/3/27/2306977.png,1,0.985431373,1130,332,1542,744,412,412,pinkie pie
2311480.png,https://derpicdn.net/img/view/2020/4/1/2311480.png,0,0.949052334,487,7,2549,2069,2062,2062,pinkie pie
2314124.jpg,https://derpicdn.net/img/view/2020/4/4/2314124.jpg,0,0.99665916,17,0,863,761,846,761,pinkie pie
2315417.png,https://derpicdn.net/img/view/2020/4/6/2315417.png,0,0.998492002,614,188,1294,868,680,680,pinkie pie
2325616.png,https://derpicdn.net/img/view/2020/4/18/2325616.png,0,0.966385365,72,117,692,737,620,620,pinkie pie
2329792.png,https://derpicdn.net/img/view/2020/4/23/2329792.png,0,0.96556133,36,71,1182,1217,1146,1146,pinkie pie
2331826.jpg,https://derpicdn.net/img/view/2020/4/26/2331826.jpg,0,0.978010654,131,0,1007,837,876,837,pinkie pie
2336636.png,https://derpicdn.net/img/view/2020/5/1/2336636.png,0,0.992720783,0,0,846,776,846,776,pinkie pie
2339147.jpg,https://derpicdn.net/img/view/2020/5/4/2339147.jpg,0,0.967872441,0,0,1800,2122,1800,2122,pinkie pie
2343049.jpg,https://derpicdn.net/img/view/2020/5/8/2343049.jpg,0,0.990950525,417,0,1257,731,840,731,pinkie pie
2345031.jpg,https://derpicdn.net/img/view/2020/5/10/2345031.jpg,0,0.990789711,2117,0,3690,1508,1573,1508,pinkie pie
2345031.jpg,https://derpicdn.net/img/view/2020/5/10/2345031.jpg,1,0.979115844,136,141,1442,1447,1306,1306,pinkie pie
2346611.png,https://derpicdn.net/img/view/2020/5/12/2346611.png,0,0.994717419,286,0,2204,1658,1918,1658,pinkie pie
2347456.jpg,https://derpicdn.net/img/view/2020/5/13/2347456.jpg,0,0.982345104,0,0,779,837,779,837,pinkie pie
2347963.png,https://derpicdn.net/img/view/2020/5/14/2347963.png,0,0.990410149,812,0,2550,1592,1738,1592,pinkie pie
2351951.jpg,https://derpicdn.net/img/view/2020/5/18/2351951.jpg,0,0.989185691,290,130,2100,1940,1810,1810,pinkie pie
2354676.png,https://derpicdn.net/img/view/2020/5/21/2354676.png,0,0.9712798,179,40,843,704,664,664,pinkie pie
2356157.jpg,https://derpicdn.net/img/view/2020/5/23/2356157.jpg,0,0.933048904,155,31,363,239,208,208,pinkie pie
246452.png,https://derpicdn.net/img/view/2013/2/17/246452.png,0,0.953286529,91,0,539,434,448,434,pinkie pie
266534.jpg,https://derpicdn.net/img/view/2013/3/9/266534.jpg,0,0.980213821,198,30,778,610,580,580,pinkie pie
273822.png,https://derpicdn.net/img/view/2013/3/18/273822.png,0,0.956859529,41,35,719,713,678,678,pinkie pie
273870.png,https://derpicdn.net/img/view/2013/3/19/273870.png,0,0.97970134,1485,0,4141,2622,2656,2622,pinkie pie
27468.png,https://derpicdn.net/img/view/2012/7/1/27468.png,0,0.993577123,1486,663,2214,1391,728,728,pinkie pie
284326.png,https://derpicdn.net/img/view/2013/3/31/284326.png,0,0.946039796,356,0,868,506,512,506,pinkie pie
30480.png,https://derpicdn.net/img/view/2012/7/3/30480.png,0,0.961872101,212,0,586,342,374,342,pinkie pie
305705.png,https://derpicdn.net/img/view/2013/4/22/305705.png,0,0.901570082,545,102,861,418,316,316,pinkie pie
30598.jpg,https://derpicdn.net/img/view/2012/7/3/30598.jpg,0,0.968836188,243,45,597,399,354,354,pinkie pie
324845.png,https://derpicdn.net/img/view/2013/5/14/324845.png,0,0.902263701,395,68,1381,839,986,771,pinkie pie
330964.png,https://derpicdn.net/img/view/2013/5/22/330964.png,0,0.908659935,925,100,2000,1290,1075,1190,pinkie pie
339786.png,https://derpicdn.net/img/view/2013/6/3/339786.png,0,0.988119125,191,109,439,357,248,248,pinkie pie
343922.png,https://derpicdn.net/img/view/2013/6/9/343922.png,0,0.98796016,803,11,1853,1061,1050,1050,pinkie pie
349262.png,https://derpicdn.net/img/view/2013/6/15/349262.png,0,0.982868731,77,152,2982,3112,2905,2960,pinkie pie
349399.png,https://derpicdn.net/img/view/2013/6/15/349399.png,0,0.998063028,287,211,539,463,252,252,pinkie pie
359468.png,https://derpicdn.net/img/view/2013/6/28/359468.png,1,0.997454882,583,26,847,290,264,264,pinkie pie
359468.png,https://derpicdn.net/img/view/2013/6/28/359468.png,2,0.954465389,884,708,1200,1034,316,326,pinkie pie
365337.png,https://derpicdn.net/img/view/2013/7/5/365337.png,0,0.938894987,167,56,327,216,160,160,pinkie pie
365573.png,https://derpicdn.net/img/view/2013/7/6/365573.png,1,0.952728391,2,0,440,417,438,417,pinkie pie
366461.png,https://derpicdn.net/img/view/2013/7/7/366461.png,0,0.917186379,277,634,2617,2974,2340,2340,pinkie pie
369550.png,https://derpicdn.net/img/view/2013/7/10/369550.png,0,0.958054125,313,0,727,394,414,394,pinkie pie
37034.png,https://derpicdn.net/img/view/2012/7/8/37034.png,0,0.978580773,120,0,424,304,304,304,pinkie pie
374795.png,https://derpicdn.net/img/view/2013/7/15/374795.png,1,0.903718531,0,5,570,613,570,608,pinkie pie
388984.png,https://derpicdn.net/img/view/2013/8/2/388984.png,0,0.996349931,381,151,683,453,302,302,pinkie pie
388984.png,https://derpicdn.net/img/view/2013/8/2/388984.png,1,0.967555702,677,132,989,444,312,312,pinkie pie
388984.png,https://derpicdn.net/img/view/2013/8/2/388984.png,2,0.924250901,0,59,219,279,219,220,pinkie pie
39689.png,https://derpicdn.net/img/view/2012/7/10/39689.png,0,0.92773819,117,18,633,534,516,516,pinkie pie
409971.png,https://derpicdn.net/img/view/2013/8/25/409971.png,0,0.980048776,502,0,4594,4014,4092,4014,pinkie pie
41839.jpg,https://derpicdn.net/img/view/2012/7/12/41839.jpg,0,0.967021644,49,0,569,480,520,480,pinkie pie
425322.png,https://derpicdn.net/img/view/2013/9/11/425322.png,0,0.98243928,0,46,1439,1624,1439,1578,pinkie pie
429541.png,https://derpicdn.net/img/view/2013/9/17/429541.png,0,0.986600637,50,0,978,917,928,917,pinkie pie
442272.jpg,https://derpicdn.net/img/view/2013/10/5/442272.jpg,0,0.942126989,1122,402,1940,1220,818,818,pinkie pie
459100.png,https://derpicdn.net/img/view/2013/10/28/459100.png,0,0.989261568,158,0,734,545,576,545,pinkie pie
460445.jpg,https://derpicdn.net/img/view/2013/10/30/460445.jpg,0,0.959205389,563,237,1347,1021,784,784,pinkie pie
468143.png,https://derpicdn.net/img/view/2013/11/9/468143.png,0,0.965692103,0,0,455,409,455,409,pinkie pie
478965.jpg,https://derpicdn.net/img/view/2013/11/23/478965.jpg,0,0.950478375,0,0,762,763,762,763,pinkie pie
485327.png,https://derpicdn.net/img/view/2013/11/29/485327.png,0,0.995066762,0,6,226,238,226,232,pinkie pie
493976.png,https://derpicdn.net/img/view/2013/12/10/493976.png,0,0.999013066,179,0,485,280,306,280,pinkie pie
493976.png,https://derpicdn.net/img/view/2013/12/10/493976.png,1,0.996411085,504,51,786,333,282,282,pinkie pie
495385.png,https://derpicdn.net/img/view/2013/12/12/495385.png,0,0.902658761,133,0,1031,715,898,715,pinkie pie
497519.jpg,https://derpicdn.net/img/view/2013/12/15/497519.jpg,0,0.986860633,194,0,736,536,542,536,pinkie pie
498134.png,https://derpicdn.net/img/view/2013/12/15/498134.png,0,0.978501558,0,57,667,761,667,704,pinkie pie
502846.png,https://derpicdn.net/img/view/2013/12/21/502846.png,0,0.996168137,20,0,644,486,624,486,pinkie pie
502846.png,https://derpicdn.net/img/view/2013/12/21/502846.png,1,0.992103696,892,0,1444,440,552,440,pinkie pie
504221.png,https://derpicdn.net/img/view/2013/12/23/504221.png,0,0.932183862,3084,0,6000,3584,2916,3584,pinkie pie
506945.png,https://derpicdn.net/img/view/2013/12/26/506945.png,0,0.90776211,1067,0,3423,2311,2356,2311,pinkie pie
507603.jpg,https://derpicdn.net/img/view/2013/12/27/507603.jpg,0,0.915294111,940,435,1382,877,442,442,pinkie pie
511935.png,https://derpicdn.net/img/view/2014/1/1/511935.png,0,0.962825775,239,17,903,681,664,664,pinkie pie
515037.png,https://derpicdn.net/img/view/2014/1/4/515037.png,0,0.992199421,0,0,2227,2221,2227,2221,pinkie pie
515528.png,https://derpicdn.net/img/view/2014/1/5/515528.png,0,0.941945732,0,409,4500,5231,4500,4822,pinkie pie
534302.jpg,https://derpicdn.net/img/view/2014/1/25/534302.jpg,0,0.9642573,0,0,861,798,861,798,pinkie pie
536038.jpg,https://derpicdn.net/img/view/2014/1/27/536038.jpg,0,0.981380403,0,108,478,602,478,494,pinkie pie
536038.jpg,https://derpicdn.net/img/view/2014/1/27/536038.jpg,1,0.94948411,54,0,566,501,512,501,pinkie pie
540602.jpg,https://derpicdn.net/img/view/2014/2/1/540602.jpg,0,0.975573957,85,10,803,728,718,718,pinkie pie
544317.png,https://derpicdn.net/img/view/2014/2/5/544317.png,0,0.966056466,74,62,244,232,170,170,pinkie pie
547858.png,https://derpicdn.net/img/view/2014/2/9/547858.png,0,0.954464555,279,38,667,426,388,388,pinkie pie
548543.jpg,https://derpicdn.net/img/view/2014/2/10/548543.jpg,0,0.948762715,91,38,625,572,534,534,pinkie pie
551500.png,https://derpicdn.net/img/view/2014/2/14/551500.png,0,0.963260353,116,84,460,428,344,344,pinkie pie
567077.png,https://derpicdn.net/img/view/2014/3/5/567077.png,0,0.951093972,0,74,947,1112,947,1038,pinkie pie
567747.png,https://derpicdn.net/img/view/2014/3/6/567747.png,0,0.934795856,159,17,559,417,400,400,pinkie pie
577012.png,https://derpicdn.net/img/view/2014/3/16/577012.png,0,0.976059794,229,0,637,468,408,468,pinkie pie
581215.png,https://derpicdn.net/img/view/2014/3/21/581215.png,0,0.947575927,81,0,557,432,476,432,pinkie pie
585281.png,https://derpicdn.net/img/view/2014/3/26/585281.png,0,0.998889148,56,39,410,393,354,354,pinkie pie
589361.png,https://derpicdn.net/img/view/2014/3/31/589361.png,1,0.954898179,250,77,576,403,326,326,pinkie pie
589975.png,https://derpicdn.net/img/view/2014/3/31/589975.png,0,0.982175291,178,83,814,719,636,636,pinkie pie
592991.png,https://derpicdn.net/img/view/2014/4/5/592991.png,0,0.92422241,771,11,2305,1545,1534,1534,pinkie pie
594652.png,https://derpicdn.net/img/view/2014/4/6/594652.png,0,0.970744729,348,6,1636,1294,1288,1288,pinkie pie
595162.png,https://derpicdn.net/img/view/2014/4/7/595162.png,0,0.938214183,234,123,568,457,334,334,pinkie pie
603322.png,https://derpicdn.net/img/view/2014/4/18/603322.png,0,0.953467906,0,0,2670,2510,2670,2510,pinkie pie
611535.png,https://derpicdn.net/img/view/2014/4/27/611535.png,0,0.90872246,555,121,1057,623,502,502,pinkie pie
615237.png,https://derpicdn.net/img/view/2014/5/2/615237.png,0,0.989416718,4581,1776,8029,5224,3448,3448,pinkie pie
62465.jpg,https://derpicdn.net/img/view/2012/7/31/62465.jpg,0,0.996705294,495,192,685,382,190,190,pinkie pie
62465.jpg,https://derpicdn.net/img/view/2012/7/31/62465.jpg,1,0.981893361,350,37,600,287,250,250,pinkie pie
626282.png,https://derpicdn.net/img/view/2014/5/14/626282.png,0,0.932966173,304,0,704,353,400,353,pinkie pie
626583.jpg,https://derpicdn.net/img/view/2014/5/14/626583.jpg,0,0.975569069,27,0,445,406,418,406,pinkie pie
629616.png,https://derpicdn.net/img/view/2014/5/18/629616.png,0,0.968110383,368,41,830,503,462,462,pinkie pie
640821.png,https://derpicdn.net/img/view/2014/5/30/640821.png,0,0.99922961,521,146,1403,1028,882,882,pinkie pie
642244.png,https://derpicdn.net/img/view/2014/6/1/642244.png,0,0.964743972,98,0,830,700,732,700,pinkie pie
643121.png,https://derpicdn.net/img/view/2014/6/2/643121.png,0,0.999708235,1046,480,1816,1250,770,770,pinkie pie
647202.jpg,https://derpicdn.net/img/view/2014/6/7/647202.jpg,0,0.96051687,23,0,489,462,466,462,pinkie pie
67188.jpg,https://derpicdn.net/img/view/2012/8/5/67188.jpg,0,0.99668628,174,89,552,467,378,378,pinkie pie
686618.png,https://derpicdn.net/img/view/2014/7/30/686618.png,0,0.990448892,32,0,448,409,416,409,pinkie pie
68673.jpg,https://derpicdn.net/img/view/2012/8/6/68673.jpg,0,0.990975916,105,555,297,747,192,192,pinkie pie
68673.jpg,https://derpicdn.net/img/view/2012/8/6/68673.jpg,1,0.949816704,0,727,147,900,147,173,pinkie pie
693786.png,https://derpicdn.net/img/view/2014/8/7/693786.png,0,0.97677052,0,0,274,298,274,298,pinkie pie
694593.jpg,https://derpicdn.net/img/view/2014/8/8/694593.jpg,0,0.963795424,396,277,884,765,488,488,pinkie pie
696987.png,https://derpicdn.net/img/view/2014/8/11/696987.png,0,0.988631725,516,157,1246,887,730,730,pinkie pie
703407.png,https://derpicdn.net/img/view/2014/8/19/703407.png,0,0.905790448,75,0,495,387,420,387,pinkie pie
705393.png,https://derpicdn.net/img/view/2014/8/22/705393.png,0,0.998005688,486,20,1152,686,666,666,pinkie pie
707727.png,https://derpicdn.net/img/view/2014/8/25/707727.png,0,0.953496099,670,449,1082,861,412,412,pinkie pie
708592.png,https://derpicdn.net/img/view/2014/8/26/708592.png,0,0.999214053,748,38,1324,614,576,576,pinkie pie
710976.jpg,https://derpicdn.net/img/view/2014/8/30/710976.jpg,0,0.98036617,265,34,847,616,582,582,pinkie pie
718344.png,https://derpicdn.net/img/view/2014/9/9/718344.png,0,0.913578629,1073,549,2202,1689,1129,1140,pinkie pie
719578.png,https://derpicdn.net/img/view/2014/9/10/719578.png,0,0.995271027,707,323,1105,721,398,398,pinkie pie
720398.png,https://derpicdn.net/img/view/2014/9/12/720398.png,0,0.976731479,0,65,473,543,473,478,pinkie pie
726719.png,https://derpicdn.net/img/view/2014/9/21/726719.png,0,0.924799919,139,105,589,555,450,450,pinkie pie
740286.png,https://derpicdn.net/img/view/2014/10/10/740286.png,0,0.909401834,1572,1675,2518,2621,946,946,pinkie pie
741117.png,https://derpicdn.net/img/view/2014/10/12/741117.png,0,0.935862243,135,11,695,617,560,606,pinkie pie
750467.png,https://derpicdn.net/img/view/2014/10/25/750467.png,1,0.981917381,242,0,732,448,490,448,pinkie pie
754214.png,https://derpicdn.net/img/view/2014/10/30/754214.png,0,0.953982413,348,171,700,523,352,352,pinkie pie
759973.png,https://derpicdn.net/img/view/2014/11/7/759973.png,0,0.975688457,929,3,4019,3093,3090,3090,pinkie pie
768245.png,https://derpicdn.net/img/view/2014/11/20/768245.png,0,0.9508304,682,154,1304,776,622,622,pinkie pie
772606.png,https://derpicdn.net/img/view/2014/11/27/772606.png,0,0.940367162,110,0,644,506,534,506,pinkie pie
77589.png,https://derpicdn.net/img/view/2012/8/19/77589.png,0,0.991039038,2882,0,6000,3090,3118,3090,pinkie pie
78002.png,https://derpicdn.net/img/view/2012/8/19/78002.png,0,0.961503446,1007,389,1341,723,334,334,pinkie pie
782514.png,https://derpicdn.net/img/view/2014/12/11/782514.png,0,0.993927956,562,0,1362,694,800,694,pinkie pie
782514.png,https://derpicdn.net/img/view/2014/12/11/782514.png,1,0.941696942,664,518,1160,1014,496,496,pinkie pie
788613.jpg,https://derpicdn.net/img/view/2014/12/20/788613.jpg,0,0.936264098,320,0,784,453,464,453,pinkie pie
790307.png,https://derpicdn.net/img/view/2014/12/22/790307.png,0,0.995066464,2015,389,2877,1251,862,862,pinkie pie
799985.png,https://derpicdn.net/img/view/2015/1/5/799985.png,0,0.990243554,356,16,810,470,454,454,pinkie pie
800323.png,https://derpicdn.net/img/view/2015/1/5/800323.png,0,0.974272549,254,74,584,404,330,330,pinkie pie
801129.png,https://derpicdn.net/img/view/2015/1/7/801129.png,0,0.973476768,150,0,1136,985,986,985,pinkie pie
802313.png,https://derpicdn.net/img/view/2015/1/8/802313.png,0,0.999660611,316,266,1112,1062,796,796,pinkie pie
811286.png,https://derpicdn.net/img/view/2015/1/21/811286.png,0,0.979843497,500,0,1716,1172,1216,1172,pinkie pie
811807.png,https://derpicdn.net/img/view/2015/1/21/811807.png,0,0.994939268,72,56,230,214,158,158,pinkie pie
817909.png,https://derpicdn.net/img/view/2015/1/30/817909.png,0,0.998744488,201,437,813,1049,612,612,pinkie pie
817909.png,https://derpicdn.net/img/view/2015/1/30/817909.png,1,0.902237713,653,332,1253,932,600,600,pinkie pie
819736.png,https://derpicdn.net/img/view/2015/2/2/819736.png,0,0.970435739,1303,860,2265,1822,962,962,pinkie pie
825894.png,https://derpicdn.net/img/view/2015/2/11/825894.png,0,0.982863247,390,80,872,562,482,482,pinkie pie
828475.png,https://derpicdn.net/img/view/2015/2/14/828475.png,0,0.998873711,106,0,374,256,268,256,pinkie pie
831439.png,https://derpicdn.net/img/view/2015/2/17/831439.png,0,0.986530125,570,0,822,219,252,219,pinkie pie
831439.png,https://derpicdn.net/img/view/2015/2/17/831439.png,1,0.976555407,271,103,469,301,198,198,pinkie pie
831944.png,https://derpicdn.net/img/view/2015/2/18/831944.png,0,0.983485222,41,0,549,474,508,474,pinkie pie
832645.png,https://derpicdn.net/img/view/2015/2/19/832645.png,0,0.949505448,0,0,457,532,457,532,pinkie pie
834638.png,https://derpicdn.net/img/view/2015/2/22/834638.png,0,0.944472134,197,60,631,494,434,434,pinkie pie
836646.png,https://derpicdn.net/img/view/2015/2/24/836646.png,0,0.920295894,44,0,688,565,644,565,pinkie pie
836943.png,https://derpicdn.net/img/view/2015/2/25/836943.png,0,0.9981215,199,0,687,419,488,419,pinkie pie
839405.png,https://derpicdn.net/img/view/2015/2/28/839405.png,0,0.952896416,0,0,972,888,972,888,pinkie pie
840612.png,https://derpicdn.net/img/view/2015/3/2/840612.png,0,0.913192928,2617,0,3349,686,732,686,pinkie pie
840771.jpg,https://derpicdn.net/img/view/2015/3/2/840771.jpg,0,0.98477751,224,0,758,510,534,510,pinkie pie
841752.jpg,https://derpicdn.net/img/view/2015/3/3/841752.jpg,0,0.981123984,479,437,877,835,398,398,pinkie pie
845222.jpg,https://derpicdn.net/img/view/2015/3/8/845222.jpg,0,0.933686912,5,0,481,338,476,338,pinkie pie
8554.png,https://derpicdn.net/img/view/2012/6/18/8554.png,0,0.93574053,274,2,760,488,486,486,pinkie pie
855555.png,https://derpicdn.net/img/view/2015/3/23/855555.png,0,0.935658932,32,37,542,547,510,510,pinkie pie
8617.jpg,https://derpicdn.net/img/view/2012/6/18/8617.jpg,0,0.917783618,88,19,468,399,380,380,pinkie pie
872787.png,https://derpicdn.net/img/view/2015/4/12/872787.png,0,0.914242566,220,0,816,586,596,586,pinkie pie
874377.png,https://derpicdn.net/img/view/2015/4/15/874377.png,0,0.958522797,271,0,1021,731,750,731,pinkie pie
8770.png,https://derpicdn.net/img/view/2012/6/19/8770.png,0,0.93685025,94,125,426,457,332,332,pinkie pie
882705.png,https://derpicdn.net/img/view/2015/4/25/882705.png,0,0.990710139,437,258,745,566,308,308,pinkie pie
884439.png,https://derpicdn.net/img/view/2015/4/28/884439.png,0,0.908792973,119,37,697,615,578,578,pinkie pie
903432.png,https://derpicdn.net/img/view/2015/5/24/903432.png,0,0.989242911,181,0,1129,874,948,874,pinkie pie
904447.png,https://derpicdn.net/img/view/2015/5/26/904447.png,0,0.944151223,141,0,603,433,462,433,pinkie pie
906768.png,https://derpicdn.net/img/view/2015/5/30/906768.png,0,0.952412546,703,700,1175,1172,472,472,pinkie pie
908149.png,https://derpicdn.net/img/view/2015/6/1/908149.png,0,0.985598564,229,3,627,401,398,398,pinkie pie
912836.png,https://derpicdn.net/img/view/2015/6/8/912836.png,0,0.95003885,175,45,813,683,638,638,pinkie pie
914709.png,https://derpicdn.net/img/view/2015/6/11/914709.png,0,0.946349502,276,22,668,414,392,392,pinkie pie
918753.png,https://derpicdn.net/img/view/2015/6/17/918753.png,0,0.990783989,280,21,788,529,508,508,pinkie pie
919153.png,https://derpicdn.net/img/view/2015/6/18/919153.png,0,0.915825367,104,0,434,318,330,318,pinkie pie
919920.png,https://derpicdn.net/img/view/2015/6/19/919920.png,0,0.988974571,0,0,898,958,898,958,pinkie pie
928980.png,https://derpicdn.net/img/view/2015/7/3/928980.png,0,0.953960538,729,16,2123,1410,1394,1394,pinkie pie
93070.png,https://derpicdn.net/img/view/2012/9/9/93070.png,0,0.989498615,187,74,465,352,278,278,pinkie pie
938130.png,https://derpicdn.net/img/view/2015/7/16/938130.png,0,0.977746487,217,109,953,845,736,736,pinkie pie
944060.png,https://derpicdn.net/img/view/2015/7/26/944060.png,0,0.997361481,365,228,1143,1006,778,778,pinkie pie
948230.png,https://derpicdn.net/img/view/2015/8/1/948230.png,0,0.967397809,587,116,1339,868,752,752,pinkie pie
950492.png,https://derpicdn.net/img/view/2015/8/4/950492.png,0,0.990924954,181,35,700,569,519,534,pinkie pie
950653.png,https://derpicdn.net/img/view/2015/8/4/950653.png,0,0.973076999,35,0,493,445,458,445,pinkie pie
953545.jpg,https://derpicdn.net/img/view/2015/8/8/953545.jpg,0,0.911090076,464,0,1790,1319,1326,1319,pinkie pie
955196.png,https://derpicdn.net/img/view/2015/8/11/955196.png,0,0.996747255,160,207,618,665,458,458,pinkie pie
957893.png,https://derpicdn.net/img/view/2015/8/14/957893.png,0,0.987524033,63,22,265,224,202,202,pinkie pie
958629.png,https://derpicdn.net/img/view/2015/8/16/958629.png,0,0.974453807,873,0,2177,1037,1304,1037,pinkie pie
965794.png,https://derpicdn.net/img/view/2015/8/25/965794.png,0,0.97885561,1142,0,2190,1044,1048,1044,pinkie pie
967820.png,https://derpicdn.net/img/view/2015/8/29/967820.png,0,0.930269539,183,36,637,490,454,454,pinkie pie
968688.png,https://derpicdn.net/img/view/2015/8/30/968688.png,0,0.977568865,72,0,634,540,562,540,pinkie pie
982112.png,https://derpicdn.net/img/view/2015/9/18/982112.png,0,0.975426614,381,18,1297,934,916,916,pinkie pie
982610.jpg,https://derpicdn.net/img/view/2015/9/18/982610.jpg,0,0.952131808,427,96,1997,1666,1570,1570,pinkie pie
986181.jpg,https://derpicdn.net/img/view/2015/9/23/986181.jpg,0,0.991337895,146,0,474,311,328,311,pinkie pie
987157.png,https://derpicdn.net/img/view/2015/9/24/987157.png,0,0.9972049,61,0,1280,1277,1219,1277,pinkie pie
988911.png,https://derpicdn.net/img/view/2015/9/27/988911.png,1,0.920318007,737,51,1141,455,404,404,pinkie pie
990003.jpg,https://derpicdn.net/img/view/2015/9/28/990003.jpg,0,0.928986549,31,6,427,402,396,396,pinkie pie
990501.jpg,https://derpicdn.net/img/view/2015/9/29/990501.jpg,0,0.997445285,994,42,1624,672,630,630,pinkie pie
990961.png,https://derpicdn.net/img/view/2015/9/29/990961.png,0,0.985081196,651,0,1251,526,600,526,pinkie pie
990961.png,https://derpicdn.net/img/view/2015/9/29/990961.png,1,0.979424,245,0,815,488,570,488,pinkie pie
992781.jpg,https://derpicdn.net/img/view/2015/10/2/992781.jpg,0,0.953157485,36,46,480,490,444,444,pinkie pie
992989.png,https://derpicdn.net/img/view/2015/10/2/992989.png,0,0.957770824,89,33,611,555,522,522,pinkie pie
995603.png,https://derpicdn.net/img/view/2015/10/6/995603.png,0,0.956963062,383,287,685,589,302,302,pinkie pie
1003033.png,https://derpicdn.net/img/view/2015/10/16/1003033.png,0,0.994597495,722,117,1306,701,584,584,pinkie pie
1008.jpg,https://derpicdn.net/img/view/2012/1/20/1008.jpg,0,0.969137788,39,0,403,357,364,357,pinkie pie
1013787.png,https://derpicdn.net/img/view/2015/11/1/1013787.png,0,0.977547526,223,0,911,673,688,673,pinkie pie
1021251.png,https://derpicdn.net/img/view/2015/11/12/1021251.png,1,0.92240423,1132,92,1462,422,330,330,pinkie pie
1024437.png,https://derpicdn.net/img/view/2015/11/17/1024437.png,0,0.926421702,305,122,675,492,370,370,pinkie pie
1028918.png,https://derpicdn.net/img/view/2015/11/23/1028918.png,0,0.988732398,820,97,1598,875,778,778,pinkie pie
1032764.jpg,https://derpicdn.net/img/view/2015/11/29/1032764.jpg,0,0.931037962,20,0,277,278,257,278,pinkie pie
1037116.png,https://derpicdn.net/img/view/2015/12/5/1037116.png,0,0.988684714,179,2,381,204,202,202,pinkie pie
1039067.png,https://derpicdn.net/img/view/2015/12/7/1039067.png,0,0.996861875,290,72,932,714,642,642,pinkie pie
1041779.png,https://derpicdn.net/img/view/2015/12/11/1041779.png,0,0.974642992,18,0,614,587,596,587,pinkie pie
1043078.png,https://derpicdn.net/img/view/2015/12/13/1043078.png,0,0.986369908,380,0,872,462,492,462,pinkie pie
1060740.png,https://derpicdn.net/img/view/2016/1/6/1060740.png,0,0.988992631,93,516,939,1362,846,846,pinkie pie
1061999.png,https://derpicdn.net/img/view/2016/1/8/1061999.png,0,0.991874874,449,98,767,416,318,318,pinkie pie
1067876.png,https://derpicdn.net/img/view/2016/1/16/1067876.png,0,0.990761101,407,86,765,444,358,358,pinkie pie
1075443.png,https://derpicdn.net/img/view/2016/1/28/1075443.png,0,0.935676873,0,123,432,570,432,447,pinkie pie
1078176.png,https://derpicdn.net/img/view/2016/2/1/1078176.png,0,0.995171905,1043,373,3855,3185,2812,2812,pinkie pie
1078534.png,https://derpicdn.net/img/view/2016/2/2/1078534.png,0,0.997488022,1241,160,1859,778,618,618,pinkie pie
1078738.png,https://derpicdn.net/img/view/2016/2/2/1078738.png,0,0.996491432,872,0,1556,562,684,562,pinkie pie
1082087.png,https://derpicdn.net/img/view/2016/2/7/1082087.png,0,0.971991301,325,0,1000,680,675,680,pinkie pie
1101217.png,https://derpicdn.net/img/view/2016/3/3/1101217.png,0,0.982530832,2161,572,3177,1588,1016,1016,pinkie pie
1113742.png,https://derpicdn.net/img/view/2016/3/21/1113742.png,0,0.944923937,335,0,679,332,344,332,pinkie pie
111764.png,https://derpicdn.net/img/view/2012/10/2/111764.png,0,0.914358616,95,17,569,491,474,474,pinkie pie
1132471.png,https://derpicdn.net/img/view/2016/4/15/1132471.png,0,0.949277997,67,3,513,449,446,446,pinkie pie
115416.jpg,https://derpicdn.net/img/view/2012/10/6/115416.jpg,0,0.936963975,288,49,638,399,350,350,pinkie pie
1154868.png,https://derpicdn.net/img/view/2016/5/15/1154868.png,0,0.950600207,612,69,1470,927,858,858,pinkie pie
1168181.png,https://derpicdn.net/img/view/2016/6/1/1168181.png,0,0.985042036,211,66,1635,1490,1424,1424,pinkie pie
1172049.png,https://derpicdn.net/img/view/2016/6/6/1172049.png,0,0.96959424,46,10,510,474,464,464,pinkie pie
1173725.png,https://derpicdn.net/img/view/2016/6/8/1173725.png,0,0.980816662,705,0,1471,748,766,748,pinkie pie
1179272.png,https://derpicdn.net/img/view/2016/6/15/1179272.png,0,0.974477053,21,0,387,381,366,381,pinkie pie
11813.png,https://derpicdn.net/img/view/2012/6/20/11813.png,0,0.976340294,544,120,940,516,396,396,pinkie pie
1181897.png,https://derpicdn.net/img/view/2016/6/19/1181897.png,0,0.948413551,1,16,819,834,818,818,pinkie pie
1184765.png,https://derpicdn.net/img/view/2016/6/23/1184765.png,0,0.981713772,279,56,751,528,472,472,pinkie pie
1197208.png,https://derpicdn.net/img/view/2016/7/10/1197208.png,0,0.977372825,97,0,751,639,654,639,pinkie pie
1201.png,https://derpicdn.net/img/view/2012/1/22/1201.png,0,0.936512768,582,1576,904,1898,322,322,pinkie pie
1203956.png,https://derpicdn.net/img/view/2016/7/18/1203956.png,0,0.973478019,659,104,1125,570,466,466,pinkie pie
1207445.png,https://derpicdn.net/img/view/2016/7/23/1207445.png,1,0.994489074,320,32,592,304,272,272,pinkie pie
1207445.png,https://derpicdn.net/img/view/2016/7/23/1207445.png,2,0.969727814,652,389,1024,801,372,412,pinkie pie
1216330.png,https://derpicdn.net/img/view/2016/8/3/1216330.png,0,0.979362726,0,14,386,400,386,386,pinkie pie
1236168.png,https://derpicdn.net/img/view/2016/8/28/1236168.png,0,0.986432552,87,347,351,611,264,264,pinkie pie
1245437.png,https://derpicdn.net/img/view/2016/9/9/1245437.png,0,0.992167234,0,14,319,348,319,334,pinkie pie
1245593.png,https://derpicdn.net/img/view/2016/9/10/1245593.png,0,0.950494826,162,119,630,587,468,468,pinkie pie
1246162.png,https://derpicdn.net/img/view/2016/9/10/1246162.png,0,0.971850812,486,189,714,417,228,228,pinkie pie
1255430.png,https://derpicdn.net/img/view/2016/9/22/1255430.png,0,0.992674291,200,0,2539,2685,2339,2685,pinkie pie
1257400.png,https://derpicdn.net/img/view/2016/9/24/1257400.png,0,0.964087963,0,3,319,335,319,332,pinkie pie
1259029.png,https://derpicdn.net/img/view/2016/9/26/1259029.png,0,0.945011675,0,52,876,938,876,886,pinkie pie
1259288.png,https://derpicdn.net/img/view/2016/9/27/1259288.png,0,0.995598793,401,167,931,697,530,530,pinkie pie
1264763.png,https://derpicdn.net/img/view/2016/10/4/1264763.png,0,0.971833646,351,0,2122,1744,1771,1744,pinkie pie
1264763.png,https://derpicdn.net/img/view/2016/10/4/1264763.png,1,0.932010174,0,135,1697,2001,1697,1866,pinkie pie
1265837.png,https://derpicdn.net/img/view/2016/10/6/1265837.png,0,0.972200155,558,0,1866,1283,1308,1283,pinkie pie
1267916.png,https://derpicdn.net/img/view/2016/10/8/1267916.png,0,0.98747015,834,7,1978,1151,1144,1144,pinkie pie
1269437.png,https://derpicdn.net/img/view/2016/10/10/1269437.png,0,0.998840928,302,0,1022,709,720,709,pinkie pie
1284302.png,https://derpicdn.net/img/view/2016/10/29/1284302.png,0,0.941154957,31,230,2500,2760,2469,2530,pinkie pie
1284464.png,https://derpicdn.net/img/view/2016/10/30/1284464.png,0,0.972465217,0,105,1830,1991,1830,1886,pinkie pie
1293418.png,https://derpicdn.net/img/view/2016/11/11/1293418.png,0,0.979109049,59,492,441,874,382,382,pinkie pie
1293418.png,https://derpicdn.net/img/view/2016/11/11/1293418.png,1,0.926248074,524,20,922,418,398,398,pinkie pie
1294891.png,https://derpicdn.net/img/view/2016/11/13/1294891.png,0,0.924934864,52,0,272,203,220,203,pinkie pie
1301777.png,https://derpicdn.net/img/view/2016/11/23/1301777.png,0,0.934533238,20,0,2724,2654,2704,2654,pinkie pie
1309744.png,https://derpicdn.net/img/view/2016/12/4/1309744.png,0,0.996100426,442,0,1008,559,566,559,pinkie pie
1319235.png,https://derpicdn.net/img/view/2016/12/17/1319235.png,0,0.963128805,0,0,2663,3042,2663,3042,pinkie pie
1327589.png,https://derpicdn.net/img/view/2016/12/29/1327589.png,0,0.997884393,254,69,634,449,380,380,pinkie pie
1327851.png,https://derpicdn.net/img/view/2016/12/29/1327851.png,0,0.966105223,0,137,547,735,547,598,pinkie pie
1329665.png,https://derpicdn.net/img/view/2017/1/1/1329665.png,0,0.960781932,0,0,1000,1281,1000,1281,pinkie pie
1365007.png,https://derpicdn.net/img/view/2017/2/17/1365007.png,0,0.975462973,44,78,1396,1430,1352,1352,pinkie pie
1366139.png,https://derpicdn.net/img/view/2017/2/18/1366139.png,0,0.990097642,0,50,845,884,845,834,pinkie pie
1368062.png,https://derpicdn.net/img/view/2017/2/20/1368062.png,0,0.998421073,303,0,527,215,224,215,pinkie pie
1373842.png,https://derpicdn.net/img/view/2017/2/26/1373842.png,0,0.934571564,43,0,1267,768,1224,768,pinkie pie
1374786.png,https://derpicdn.net/img/view/2017/2/27/1374786.png,0,0.962513208,1792,523,3072,1803,1280,1280,pinkie pie
1377364.png,https://derpicdn.net/img/view/2017/3/2/1377364.png,0,0.96351552,574,0,1120,501,546,501,pinkie pie
1377868.png,https://derpicdn.net/img/view/2017/3/3/1377868.png,0,0.991450369,7,0,727,678,720,678,pinkie pie
1383072.png,https://derpicdn.net/img/view/2017/3/9/1383072.png,0,0.957371116,715,0,5161,4375,4446,4375,pinkie pie
1386555.png,https://derpicdn.net/img/view/2017/3/14/1386555.png,0,0.973136365,20,68,394,432,374,364,pinkie pie
1387678.png,https://derpicdn.net/img/view/2017/3/15/1387678.png,0,0.99291271,93,0,889,772,796,772,pinkie pie
1387819.png,https://derpicdn.net/img/view/2017/3/15/1387819.png,0,0.93054831,0,0,4399,4640,4399,4640,pinkie pie
1387910.png,https://derpicdn.net/img/view/2017/3/15/1387910.png,0,0.981657565,2,8,1020,1026,1018,1018,pinkie pie
1396686.png,https://derpicdn.net/img/view/2017/3/26/1396686.png,0,0.968639195,749,224,2439,1914,1690,1690,pinkie pie
1398070.png,https://derpicdn.net/img/view/2017/3/28/1398070.png,0,0.906897008,454,78,828,452,374,374,pinkie pie
1399609.png,https://derpicdn.net/img/view/2017/3/30/1399609.png,0,0.981328249,1473,728,2159,1414,686,686,pinkie pie
1402281.png,https://derpicdn.net/img/view/2017/4/2/1402281.png,0,0.998436511,626,0,1060,415,434,415,pinkie pie
1406092.png,https://derpicdn.net/img/view/2017/4/7/1406092.png,0,0.942908585,627,198,893,464,266,266,pinkie pie
1406865.png,https://derpicdn.net/img/view/2017/4/8/1406865.png,0,0.973293841,545,107,1231,793,686,686,pinkie pie
1408662.png,https://derpicdn.net/img/view/2017/4/11/1408662.png,0,0.967124403,106,0,906,739,800,739,pinkie pie
1413226.png,https://derpicdn.net/img/view/2017/4/16/1413226.png,0,0.953285158,19,0,443,410,424,410,pinkie pie
1418781.png,https://derpicdn.net/img/view/2017/4/22/1418781.png,0,0.977078378,33,14,359,340,326,326,pinkie pie
1418793.png,https://derpicdn.net/img/view/2017/4/22/1418793.png,0,0.977078378,33,14,359,340,326,326,pinkie pie
1423811.png,https://derpicdn.net/img/view/2017/4/28/1423811.png,0,0.966450095,250,25,1048,823,798,798,pinkie pie
1424278.png,https://derpicdn.net/img/view/2017/4/29/1424278.png,0,0.919993639,171,0,960,540,789,540,pinkie pie
1425416.png,https://derpicdn.net/img/view/2017/4/30/1425416.png,0,0.986469328,2177,0,3233,970,1056,970,pinkie pie
1426634.png,https://derpicdn.net/img/view/2017/5/1/1426634.png,0,0.965781212,30,0,1388,1288,1358,1288,pinkie pie
1427127.png,https://derpicdn.net/img/view/2017/5/2/1427127.png,0,0.986677945,43,0,393,340,350,340,pinkie pie
1428317.png,https://derpicdn.net/img/view/2017/5/4/1428317.png,0,0.987675488,674,254,1116,696,442,442,pinkie pie
1430354.png,https://derpicdn.net/img/view/2017/5/6/1430354.png,0,0.982571304,1271,532,1889,1150,618,618,pinkie pie
1436462.png,https://derpicdn.net/img/view/2017/5/14/1436462.png,0,0.982879579,218,0,1234,694,1016,694,pinkie pie
1437310.png,https://derpicdn.net/img/view/2017/5/15/1437310.png,0,0.921370685,349,0,1317,863,968,863,pinkie pie
1441539.png,https://derpicdn.net/img/view/2017/5/20/1441539.png,0,0.976256609,327,60,1287,1020,960,960,pinkie pie
1445946.png,https://derpicdn.net/img/view/2017/5/25/1445946.png,0,0.97533685,3164,0,4380,1192,1216,1192,pinkie pie
1448359.png,https://derpicdn.net/img/view/2017/5/28/1448359.png,0,0.968058527,0,0,1751,1673,1751,1673,pinkie pie
1451671.png,https://derpicdn.net/img/view/2017/6/1/1451671.png,0,0.978159785,0,95,1524,1839,1524,1744,pinkie pie
1451718.png,https://derpicdn.net/img/view/2017/6/1/1451718.png,0,0.92298156,230,275,576,621,346,346,pinkie pie
1452967.png,https://derpicdn.net/img/view/2017/6/3/1452967.png,0,0.979393184,727,294,1657,1224,930,930,pinkie pie
1453327.png,https://derpicdn.net/img/view/2017/6/3/1453327.png,0,0.96175915,30,0,1781,1852,1751,1852,pinkie pie
1454072.png,https://derpicdn.net/img/view/2017/6/4/1454072.png,0,0.984153628,40,9,368,337,328,328,pinkie pie
1457063.png,https://derpicdn.net/img/view/2017/6/8/1457063.png,0,0.930572271,186,680,692,1186,506,506,pinkie pie
1462294.png,https://derpicdn.net/img/view/2017/6/15/1462294.png,0,0.927599788,138,615,584,1061,446,446,pinkie pie
1463684.png,https://derpicdn.net/img/view/2017/6/17/1463684.png,0,0.931913733,407,480,753,826,346,346,pinkie pie
1463885.png,https://derpicdn.net/img/view/2017/6/17/1463885.png,0,0.972435653,154,140,690,676,536,536,pinkie pie
1470275.png,https://derpicdn.net/img/view/2017/6/24/1470275.png,0,0.978474319,0,0,4810,5002,4810,5002,pinkie pie
14720.jpg,https://derpicdn.net/img/view/2012/6/21/14720.jpg,0,0.979089379,845,0,1147,243,302,243,pinkie pie
1472802.png,https://derpicdn.net/img/view/2017/6/27/1472802.png,0,0.997161329,134,0,528,386,394,386,pinkie pie
1472885.png,https://derpicdn.net/img/view/2017/6/27/1472885.png,0,0.987574816,24,55,1022,1053,998,998,pinkie pie
1472916.png,https://derpicdn.net/img/view/2017/6/27/1472916.png,0,0.99670279,493,336,1393,1236,900,900,pinkie pie
1474655.png,https://derpicdn.net/img/view/2017/6/29/1474655.png,0,0.996891379,1076,801,1916,1641,840,840,pinkie pie
1475107.png,https://derpicdn.net/img/view/2017/6/30/1475107.png,0,0.988144398,89,0,521,415,432,415,pinkie pie
1475201.png,https://derpicdn.net/img/view/2017/6/30/1475201.png,0,0.952038944,0,0,675,609,675,609,pinkie pie
1477393.png,https://derpicdn.net/img/view/2017/7/3/1477393.png,0,0.966180563,447,0,1965,1256,1518,1256,pinkie pie
1478407.png,https://derpicdn.net/img/view/2017/7/4/1478407.png,0,0.996714711,425,158,2495,2228,2070,2070,pinkie pie
1484608.png,https://derpicdn.net/img/view/2017/7/12/1484608.png,0,0.934496462,49,239,621,811,572,572,pinkie pie
1486176.png,https://derpicdn.net/img/view/2017/7/14/1486176.png,0,0.952758253,118,28,1310,1220,1192,1192,pinkie pie
148826.jpg,https://derpicdn.net/img/view/2012/11/11/148826.jpg,0,0.997254729,20,0,362,309,342,309,pinkie pie
1493084.png,https://derpicdn.net/img/view/2017/7/23/1493084.png,0,0.988309979,559,0,1309,717,750,717,pinkie pie
1496276.png,https://derpicdn.net/img/view/2017/7/27/1496276.png,0,0.965535164,199,0,831,613,632,613,pinkie pie
1497.jpg,https://derpicdn.net/img/view/2012/1/22/1497.jpg,1,0.990131557,803,573,1243,1013,440,440,pinkie pie
1497.jpg,https://derpicdn.net/img/view/2012/1/22/1497.jpg,2,0.989643693,65,531,599,1050,534,519,pinkie pie
1497.jpg,https://derpicdn.net/img/view/2012/1/22/1497.jpg,4,0.970641315,640,0,1636,796,996,796,pinkie pie
1502084.png,https://derpicdn.net/img/view/2017/8/3/1502084.png,0,0.999627829,46,0,1306,1139,1260,1139,pinkie pie
1506279.png,https://derpicdn.net/img/view/2017/8/9/1506279.png,0,0.983769894,12,0,742,694,730,694,pinkie pie
1509670.png,https://derpicdn.net/img/view/2017/8/13/1509670.png,0,0.980611563,3450,396,6578,3524,3128,3128,pinkie pie
1509844.png,https://derpicdn.net/img/view/2017/8/13/1509844.png,0,0.948476136,0,0,6769,6725,6769,6725,pinkie pie
1518254.png,https://derpicdn.net/img/view/2017/8/23/1518254.png,0,0.926734328,1459,2047,2357,2945,898,898,pinkie pie
1519293.png,https://derpicdn.net/img/view/2017/8/25/1519293.png,0,0.954366505,337,92,877,632,540,540,pinkie pie
15241.png,https://derpicdn.net/img/view/2012/6/22/15241.png,0,0.991537392,545,14,1353,822,808,808,pinkie pie
15241.png,https://derpicdn.net/img/view/2012/6/22/15241.png,1,0.987602055,1235,590,2037,1392,802,802,pinkie pie
1524216.png,https://derpicdn.net/img/view/2017/8/31/1524216.png,0,0.999423206,150,41,1310,1201,1160,1160,pinkie pie
1525909.png,https://derpicdn.net/img/view/2017/9/2/1525909.png,0,0.914572895,374,104,1128,858,754,754,pinkie pie
1527045.png,https://derpicdn.net/img/view/2017/9/3/1527045.png,0,0.978740036,916,0,2634,1657,1718,1657,pinkie pie
1529146.png,https://derpicdn.net/img/view/2017/9/6/1529146.png,0,0.970193565,74,0,714,601,640,601,pinkie pie
1536880.png,https://derpicdn.net/img/view/2017/9/16/1536880.png,0,0.988069177,61,0,1121,937,1060,937,pinkie pie
1538661.png,https://derpicdn.net/img/view/2017/9/18/1538661.png,0,0.993092477,104,0,1472,1217,1368,1217,pinkie pie
1539087.png,https://derpicdn.net/img/view/2017/9/18/1539087.png,0,0.98081696,0,42,872,962,872,920,pinkie pie
1544381.png,https://derpicdn.net/img/view/2017/9/25/1544381.png,0,0.990904272,86,16,482,412,396,396,pinkie pie
1547.jpg,https://derpicdn.net/img/view/2012/1/23/1547.jpg,0,0.949954391,319,42,709,432,390,390,pinkie pie
1555190.png,https://derpicdn.net/img/view/2017/10/8/1555190.png,0,0.977647007,0,0,3452,3833,3452,3833,pinkie pie
156020.png,https://derpicdn.net/img/view/2012/11/18/156020.png,0,0.970357835,61,0,2799,2673,2738,2673,pinkie pie
1561151.png,https://derpicdn.net/img/view/2017/10/14/1561151.png,0,0.967612326,166,0,1920,1080,1754,1080,pinkie pie
1562168.png,https://derpicdn.net/img/view/2017/10/15/1562168.png,0,0.934559464,193,0,1280,1066,1087,1066,pinkie pie
1562674.png,https://derpicdn.net/img/view/2017/10/16/1562674.png,0,0.902065039,151,32,611,492,460,460,pinkie pie
156582.png,https://derpicdn.net/img/view/2012/11/18/156582.png,0,0.996218562,385,816,953,1384,568,568,pinkie pie
1568171.png,https://derpicdn.net/img/view/2017/10/23/1568171.png,0,0.992737055,467,150,1041,724,574,574,pinkie pie
1568171.png,https://derpicdn.net/img/view/2017/10/23/1568171.png,1,0.946725845,1114,229,1510,625,396,396,pinkie pie
1568460.png,https://derpicdn.net/img/view/2017/10/23/1568460.png,0,0.988988817,0,5,379,423,379,418,pinkie pie
1568778.png,https://derpicdn.net/img/view/2017/10/24/1568778.png,0,0.995040894,458,160,808,510,350,350,pinkie pie
1576478.png,https://derpicdn.net/img/view/2017/11/2/1576478.png,0,0.911750257,419,377,857,815,438,438,pinkie pie
1576951.png,https://derpicdn.net/img/view/2017/11/3/1576951.png,0,0.93512249,269,0,846,631,577,631,pinkie pie
1586899.png,https://derpicdn.net/img/view/2017/11/15/1586899.png,0,0.994484842,122,0,1064,901,942,901,pinkie pie
1597707.png,https://derpicdn.net/img/view/2017/11/30/1597707.png,0,0.988057792,733,75,2385,1727,1652,1652,pinkie pie
1600381.png,https://derpicdn.net/img/view/2017/12/4/1600381.png,0,0.992980301,0,0,329,315,329,315,pinkie pie
1602864.png,https://derpicdn.net/img/view/2017/12/8/1602864.png,0,0.974575222,370,90,1572,1292,1202,1202,pinkie pie
160594.png,https://derpicdn.net/img/view/2012/11/23/160594.png,0,0.99358362,956,0,2236,1259,1280,1259,pinkie pie
1609244.png,https://derpicdn.net/img/view/2017/12/16/1609244.png,0,0.900329769,1004,1112,2578,2686,1574,1574,pinkie pie
1611124.png,https://derpicdn.net/img/view/2017/12/19/1611124.png,0,0.94776237,197,0,565,357,368,357,pinkie pie
1622774.png,https://derpicdn.net/img/view/2018/1/3/1622774.png,0,0.984900296,154,0,3244,2854,3090,2854,pinkie pie
1624037.png,https://derpicdn.net/img/view/2018/1/4/1624037.png,0,0.982925713,1430,666,2626,1862,1196,1196,pinkie pie
1631442.png,https://derpicdn.net/img/view/2018/1/13/1631442.png,0,0.945966423,51,0,1301,1164,1250,1164,pinkie pie
1631624.png,https://derpicdn.net/img/view/2018/1/14/1631624.png,0,0.987821698,124,17,604,497,480,480,pinkie pie
1633524.png,https://derpicdn.net/img/view/2018/1/16/1633524.png,0,0.986189544,116,114,342,340,226,226,pinkie pie
1633735.png,https://derpicdn.net/img/view/2018/1/16/1633735.png,0,0.995806098,438,0,1088,611,650,611,pinkie pie
1639483.png,https://derpicdn.net/img/view/2018/1/24/1639483.png,0,0.933252513,98,0,872,813,774,813,pinkie pie
1646900.png,https://derpicdn.net/img/view/2018/2/2/1646900.png,0,0.999371052,146,0,1080,892,934,892,pinkie pie
1649941.png,https://derpicdn.net/img/view/2018/2/6/1649941.png,0,0.980482817,0,0,483,487,483,487,pinkie pie
1660496.png,https://derpicdn.net/img/view/2018/2/19/1660496.png,0,0.955014765,141,47,771,677,630,630,pinkie pie
1663826.png,https://derpicdn.net/img/view/2018/2/23/1663826.png,0,0.957519174,239,1792,1449,3002,1210,1210,pinkie pie
1674717.png,https://derpicdn.net/img/view/2018/3/8/1674717.png,0,0.960784733,2549,274,5341,3174,2792,2900,pinkie pie
1674746.png,https://derpicdn.net/img/view/2018/3/8/1674746.png,0,0.992345214,60,7,3552,3515,3492,3508,pinkie pie
1676302.png,https://derpicdn.net/img/view/2018/3/10/1676302.png,0,0.993653476,479,0,1000,477,521,477,pinkie pie
1677409.png,https://derpicdn.net/img/view/2018/3/11/1677409.png,0,0.962142885,161,0,1877,1638,1716,1638,pinkie pie
1677690.png,https://derpicdn.net/img/view/2018/3/11/1677690.png,0,0.995012105,194,0,438,189,244,189,pinkie pie
1680347.png,https://derpicdn.net/img/view/2018/3/14/1680347.png,0,0.994108558,0,0,874,720,874,720,pinkie pie
1685727.png,https://derpicdn.net/img/view/2018/3/20/1685727.png,0,0.985573292,226,0,690,466,464,466,pinkie pie
1694607.png,https://derpicdn.net/img/view/2018/3/30/1694607.png,0,0.996143639,619,45,1051,477,432,432,pinkie pie
1700381.png,https://derpicdn.net/img/view/2018/4/6/1700381.png,0,0.913582444,221,52,1213,1044,992,992,pinkie pie
1706489.png,https://derpicdn.net/img/view/2018/4/13/1706489.png,1,0.982126296,237,0,565,289,328,289,pinkie pie
1709604.png,https://derpicdn.net/img/view/2018/4/16/1709604.png,0,0.910194099,0,0,811,846,811,846,pinkie pie
1715840.png,https://derpicdn.net/img/view/2018/4/24/1715840.png,0,0.969522417,693,39,947,293,254,254,pinkie pie
1724828.png,https://derpicdn.net/img/view/2018/5/5/1724828.png,0,0.987914562,778,397,5000,4747,4222,4350,pinkie pie
1727815.png,https://derpicdn.net/img/view/2018/5/8/1727815.png,0,0.986737609,854,0,2580,1630,1726,1630,pinkie pie
172907.png,https://derpicdn.net/img/view/2012/12/5/172907.png,0,0.985514045,59,17,245,203,186,186,pinkie pie
172907.png,https://derpicdn.net/img/view/2012/12/5/172907.png,1,0.978514969,320,52,512,244,192,192,pinkie pie
1731387.png,https://derpicdn.net/img/view/2018/5/13/1731387.png,0,0.962044954,52,24,980,996,928,972,pinkie pie
1732384.png,https://derpicdn.net/img/view/2018/5/14/1732384.png,0,0.969163537,0,0,250,369,250,369,pinkie pie
173267.jpg,https://derpicdn.net/img/view/2012/12/5/173267.jpg,0,0.983519852,139,0,693,468,554,468,pinkie pie
1733035.png,https://derpicdn.net/img/view/2018/5/15/1733035.png,0,0.995850623,664,22,3102,2460,2438,2438,pinkie pie
1735537.png,https://derpicdn.net/img/view/2018/5/18/1735537.png,0,0.902490616,416,14,826,424,410,410,pinkie pie
1736099.png,https://derpicdn.net/img/view/2018/5/19/1736099.png,0,0.998608053,175,88,935,848,760,760,pinkie pie
1740392.png,https://derpicdn.net/img/view/2018/5/24/1740392.png,0,0.958307385,312,97,628,413,316,316,pinkie pie
1753233.png,https://derpicdn.net/img/view/2018/6/9/1753233.png,0,0.990997374,19,0,263,232,244,232,pinkie pie
1753848.png,https://derpicdn.net/img/view/2018/6/9/1753848.png,0,0.924206138,579,89,1451,961,872,872,pinkie pie
1760757.png,https://derpicdn.net/img/view/2018/6/18/1760757.png,0,0.96192497,89,17,357,285,268,268,pinkie pie
1763803.png,https://derpicdn.net/img/view/2018/6/22/1763803.png,0,0.906999946,0,36,718,800,718,764,pinkie pie
1767291.png,https://derpicdn.net/img/view/2018/6/27/1767291.png,0,0.965228915,0,0,298,271,298,271,pinkie pie
1768114.png,https://derpicdn.net/img/view/2018/6/28/1768114.png,0,0.97590822,460,0,1896,1341,1436,1341,pinkie pie
1769318.png,https://derpicdn.net/img/view/2018/6/30/1769318.png,0,0.994140923,69,0,645,553,576,553,pinkie pie
1779068.png,https://derpicdn.net/img/view/2018/7/12/1779068.png,0,0.991461754,418,0,1128,597,710,597,pinkie pie
1779129.png,https://derpicdn.net/img/view/2018/7/12/1779129.png,0,0.921392798,786,53,4276,3543,3490,3490,pinkie pie
1784582.png,https://derpicdn.net/img/view/2018/7/19/1784582.png,0,0.949430883,472,0,1514,764,1042,764,pinkie pie
1791336.png,https://derpicdn.net/img/view/2018/7/27/1791336.png,0,0.989830017,353,403,1015,1065,662,662,pinkie pie
1792800.png,https://derpicdn.net/img/view/2018/7/29/1792800.png,0,0.934935749,611,596,1293,1278,682,682,pinkie pie
1802375.png,https://derpicdn.net/img/view/2018/8/9/1802375.png,0,0.99459058,0,0,363,340,363,340,pinkie pie
1802747.png,https://derpicdn.net/img/view/2018/8/9/1802747.png,0,0.989786327,271,0,1121,663,850,663,pinkie pie
1808571.png,https://derpicdn.net/img/view/2018/8/16/1808571.png,0,0.968726873,34,0,279,244,245,244,pinkie pie
1835302.png,https://derpicdn.net/img/view/2018/9/18/1835302.png,0,0.987933218,100,0,710,537,610,537,pinkie pie
1841866.png,https://derpicdn.net/img/view/2018/9/26/1841866.png,0,0.998336792,3783,958,4983,2158,1200,1200,pinkie pie
1844655.png,https://derpicdn.net/img/view/2018/9/30/1844655.png,0,0.983298004,409,37,955,583,546,546,pinkie pie
1846049.png,https://derpicdn.net/img/view/2018/10/2/1846049.png,0,0.975793302,396,21,1286,911,890,890,pinkie pie
1849343.png,https://derpicdn.net/img/view/2018/10/6/1849343.png,0,0.954281867,105,0,761,645,656,645,pinkie pie
1856115.png,https://derpicdn.net/img/view/2018/10/14/1856115.png,0,0.909733355,0,0,306,301,306,301,pinkie pie
1858564.png,https://derpicdn.net/img/view/2018/10/17/1858564.png,0,0.911405563,60,30,478,448,418,418,pinkie pie
1869157.png,https://derpicdn.net/img/view/2018/10/29/1869157.png,0,0.996260285,251,379,449,577,198,198,pinkie pie
1871035.png,https://derpicdn.net/img/view/2018/10/31/1871035.png,0,0.956528425,384,760,1042,1418,658,658,pinkie pie
1871349.png,https://derpicdn.net/img/view/2018/10/31/1871349.png,0,0.95787394,143,48,513,418,370,370,pinkie pie
1879099.png,https://derpicdn.net/img/view/2018/11/10/1879099.png,0,0.973023891,353,0,815,442,462,442,pinkie pie
1880016.png,https://derpicdn.net/img/view/2018/11/11/1880016.png,0,0.997296214,645,306,993,654,348,348,pinkie pie
1883577.png,https://derpicdn.net/img/view/2018/11/16/1883577.png,0,0.98404789,34,8,458,432,424,424,pinkie pie
1886752.png,https://derpicdn.net/img/view/2018/11/20/1886752.png,0,0.98772049,1269,28,2437,1196,1168,1168,pinkie pie
1889452.png,https://derpicdn.net/img/view/2018/11/23/1889452.png,0,0.958539248,0,57,754,897,754,840,pinkie pie
1889490.png,https://derpicdn.net/img/view/2018/11/23/1889490.png,0,0.974943757,561,32,973,444,412,412,pinkie pie
1893879.png,https://derpicdn.net/img/view/2018/11/29/1893879.png,0,0.916371167,188,124,818,754,630,630,pinkie pie
1894951.png,https://derpicdn.net/img/view/2018/12/1/1894951.png,0,0.979166806,131,10,553,432,422,422,pinkie pie
1895445.png,https://derpicdn.net/img/view/2018/12/1/1895445.png,0,0.97485894,334,81,598,345,264,264,pinkie pie
189606.jpg,https://derpicdn.net/img/view/2012/12/21/189606.jpg,0,0.993966043,763,0,1619,842,856,842,pinkie pie
1896166.png,https://derpicdn.net/img/view/2018/12/2/1896166.png,0,0.992418706,0,60,1700,1772,1700,1712,pinkie pie
1898065.png,https://derpicdn.net/img/view/2018/12/4/1898065.png,0,0.997796535,203,0,813,584,610,584,pinkie pie
1901007.png,https://derpicdn.net/img/view/2018/12/7/1901007.png,0,0.967620611,114,4,1754,1722,1640,1718,pinkie pie
1903250.png,https://derpicdn.net/img/view/2018/12/9/1903250.png,0,0.989557505,1974,247,3256,1529,1282,1282,pinkie pie
1903272.png,https://derpicdn.net/img/view/2018/12/9/1903272.png,0,0.990444541,241,39,597,395,356,356,pinkie pie
1903315.png,https://derpicdn.net/img/view/2018/12/9/1903315.png,0,0.99944216,105,15,417,327,312,312,pinkie pie
1903333.png,https://derpicdn.net/img/view/2018/12/9/1903333.png,0,0.972930551,50,11,528,489,478,478,pinkie pie
1903334.png,https://derpicdn.net/img/view/2018/12/9/1903334.png,0,0.981750369,119,25,523,429,404,404,pinkie pie
1903340.png,https://derpicdn.net/img/view/2018/12/9/1903340.png,0,0.978720248,0,5,363,383,363,378,pinkie pie
1903773.png,https://derpicdn.net/img/view/2018/12/9/1903773.png,0,0.993192375,0,123,969,1093,969,970,pinkie pie
1915845.png,https://derpicdn.net/img/view/2018/12/22/1915845.png,0,0.926909029,667,126,1023,482,356,356,pinkie pie
1920889.png,https://derpicdn.net/img/view/2018/12/28/1920889.png,0,0.936906397,335,49,859,573,524,524,pinkie pie
1924588.png,https://derpicdn.net/img/view/2019/1/2/1924588.png,0,0.969951093,140,0,702,490,562,490,pinkie pie
1925645.png,https://derpicdn.net/img/view/2019/1/3/1925645.png,0,0.982460022,198,20,586,408,388,388,pinkie pie
1925925.png,https://derpicdn.net/img/view/2019/1/3/1925925.png,0,0.994696975,51,0,855,787,804,787,pinkie pie
1926907.png,https://derpicdn.net/img/view/2019/1/5/1926907.png,0,0.950419247,36,0,472,409,436,409,pinkie pie
1934044.png,https://derpicdn.net/img/view/2019/1/13/1934044.png,0,0.923368931,0,0,2655,2159,2655,2159,pinkie pie
1934969.png,https://derpicdn.net/img/view/2019/1/14/1934969.png,0,0.975933254,1348,246,2606,1504,1258,1258,pinkie pie
1940324.png,https://derpicdn.net/img/view/2019/1/20/1940324.png,0,0.978463292,366,0,928,530,562,530,pinkie pie
1942816.png,https://derpicdn.net/img/view/2019/1/23/1942816.png,0,0.997998595,476,206,932,662,456,456,pinkie pie
1960631.png,https://derpicdn.net/img/view/2019/2/13/1960631.png,0,0.979100108,43,0,1227,1183,1184,1183,pinkie pie
1960823.png,https://derpicdn.net/img/view/2019/2/13/1960823.png,0,0.942344725,31,0,1205,1088,1174,1088,pinkie pie
1962749.png,https://derpicdn.net/img/view/2019/2/15/1962749.png,0,0.997329414,621,0,1425,771,804,771,pinkie pie
1962898.png,https://derpicdn.net/img/view/2019/2/15/1962898.png,0,0.986773014,67,0,853,746,786,746,pinkie pie
1963029.png,https://derpicdn.net/img/view/2019/2/15/1963029.png,0,0.980114937,71,0,453,358,382,358,pinkie pie
1968359.png,https://derpicdn.net/img/view/2019/2/22/1968359.png,0,0.993800938,217,10,730,606,513,596,pinkie pie
1988719.png,https://derpicdn.net/img/view/2019/3/17/1988719.png,0,0.914118171,718,0,2436,1580,1718,1580,pinkie pie
1991707.png,https://derpicdn.net/img/view/2019/3/21/1991707.png,0,0.982894242,131,0,443,299,312,299,pinkie pie
1992.jpg,https://derpicdn.net/img/view/2012/1/24/1992.jpg,0,0.995934486,104,0,672,537,568,537,pinkie pie
1995251.png,https://derpicdn.net/img/view/2019/3/26/1995251.png,0,0.961636722,88,0,646,558,558,558,pinkie pie
2001680.png,https://derpicdn.net/img/view/2019/4/3/2001680.png,0,0.964572132,735,0,1257,490,522,490,pinkie pie
2010606.png,https://derpicdn.net/img/view/2019/4/13/2010606.png,0,0.990945518,350,945,1294,1889,944,944,pinkie pie
2010606.png,https://derpicdn.net/img/view/2019/4/13/2010606.png,1,0.934724808,390,0,1250,859,860,859,pinkie pie
2011923.png,https://derpicdn.net/img/view/2019/4/14/2011923.png,0,0.993305027,158,0,542,361,384,361,pinkie pie
2014808.png,https://derpicdn.net/img/view/2019/4/17/2014808.png,0,0.956781507,10,0,436,414,426,414,pinkie pie
2014942.png,https://derpicdn.net/img/view/2019/4/17/2014942.png,0,0.950771391,219,0,4051,3525,3832,3525,pinkie pie
2017417.png,https://derpicdn.net/img/view/2019/4/20/2017417.png,0,0.964947462,1548,0,3232,1643,1684,1643,pinkie pie
2019327.png,https://derpicdn.net/img/view/2019/4/21/2019327.png,0,0.99691397,364,245,652,533,288,288,pinkie pie
202091.png,https://derpicdn.net/img/view/2013/1/4/202091.png,0,0.917887866,297,0,711,361,414,361,pinkie pie
2024367.png,https://derpicdn.net/img/view/2019/4/27/2024367.png,0,0.988325834,1118,302,1708,892,590,590,pinkie pie
2026128.png,https://derpicdn.net/img/view/2019/4/29/2026128.png,0,0.992800415,513,0,975,452,462,452,pinkie pie
2032481.png,https://derpicdn.net/img/view/2019/5/6/2032481.png,0,0.963684916,45,0,357,298,312,298,pinkie pie
2037707.png,https://derpicdn.net/img/view/2019/5/13/2037707.png,0,0.997583926,0,277,441,789,441,512,pinkie pie
2039036.png,https://derpicdn.net/img/view/2019/5/14/2039036.png,0,0.933587074,16,0,1106,931,1090,931,pinkie pie
2043577.png,https://derpicdn.net/img/view/2019/5/19/2043577.png,0,0.971581578,430,100,850,520,420,420,pinkie pie
204716.png,https://derpicdn.net/img/view/2013/1/6/204716.png,0,0.995883465,236,262,386,412,150,150,pinkie pie
204716.png,https://derpicdn.net/img/view/2013/1/6/204716.png,1,0.946479321,758,178,950,370,192,192,pinkie pie
2048133.png,https://derpicdn.net/img/view/2019/5/25/2048133.png,0,0.987997413,193,85,551,443,358,358,pinkie pie
2050229.png,https://derpicdn.net/img/view/2019/5/27/2050229.png,0,0.909655273,0,106,1385,1592,1385,1486,pinkie pie
2057215.png,https://derpicdn.net/img/view/2019/6/3/2057215.png,0,0.945084095,123,0,343,216,220,216,pinkie pie
2059902.png,https://derpicdn.net/img/view/2019/6/7/2059902.png,0,0.976005733,55,272,453,670,398,398,pinkie pie
2061652.png,https://derpicdn.net/img/view/2019/6/9/2061652.png,0,0.988649905,0,0,579,562,579,562,pinkie pie
2068473.png,https://derpicdn.net/img/view/2019/6/18/2068473.png,0,0.978170097,0,69,882,993,882,924,pinkie pie
2074315.png,https://derpicdn.net/img/view/2019/6/24/2074315.png,0,0.9723593,16,87,1498,1569,1482,1482,pinkie pie
2076019.png,https://derpicdn.net/img/view/2019/6/26/2076019.png,0,0.972242951,47,0,841,756,794,756,pinkie pie
2078353.png,https://derpicdn.net/img/view/2019/6/29/2078353.png,0,0.963734269,0,0,815,773,815,773,pinkie pie
2080760.png,https://derpicdn.net/img/view/2019/7/1/2080760.png,0,0.932809949,960,0,2588,1559,1628,1559,pinkie pie
2082222.png,https://derpicdn.net/img/view/2019/7/3/2082222.png,0,0.99941498,0,0,1267,1118,1267,1118,pinkie pie
2082222.png,https://derpicdn.net/img/view/2019/7/3/2082222.png,1,0.975573123,1524,445,2576,1497,1052,1052,pinkie pie
2096787.png,https://derpicdn.net/img/view/2019/7/20/2096787.png,0,0.975429356,91,0,361,263,270,263,pinkie pie
2100641.png,https://derpicdn.net/img/view/2019/7/25/2100641.png,0,0.985916615,146,10,1958,1822,1812,1812,pinkie pie
2114510.png,https://derpicdn.net/img/view/2019/8/11/2114510.png,0,0.99071759,1316,0,3310,1881,1994,1881,pinkie pie
2114511.png,https://derpicdn.net/img/view/2019/8/11/2114511.png,0,0.953864753,1268,0,3522,1982,2254,1982,pinkie pie
211694.png,https://derpicdn.net/img/view/2013/1/13/211694.png,0,0.955170631,37,294,2355,2662,2318,2368,pinkie pie
2117774.png,https://derpicdn.net/img/view/2019/8/14/2117774.png,0,0.974979579,365,150,1400,1202,1035,1052,pinkie pie
2122820.png,https://derpicdn.net/img/view/2019/8/20/2122820.png,0,0.981253266,232,37,998,803,766,766,pinkie pie
2129796.png,https://derpicdn.net/img/view/2019/8/28/2129796.png,0,0.992666006,181,129,567,515,386,386,pinkie pie
2133801.png,https://derpicdn.net/img/view/2019/9/1/2133801.png,0,0.968888938,664,1989,1628,2953,964,964,pinkie pie
2137929.png,https://derpicdn.net/img/view/2019/9/6/2137929.png,0,0.982822955,210,0,1044,683,834,683,pinkie pie
2139585.png,https://derpicdn.net/img/view/2019/9/8/2139585.png,0,0.986316621,451,343,1375,1267,924,924,pinkie pie
2153750.png,https://derpicdn.net/img/view/2019/9/26/2153750.png,0,0.973856688,125,0,1281,768,1156,768,pinkie pie
2161118.png,https://derpicdn.net/img/view/2019/10/5/2161118.png,0,0.97267139,2494,0,5516,2894,3022,2894,pinkie pie
2171950.png,https://derpicdn.net/img/view/2019/10/17/2171950.png,0,0.962423444,344,932,520,1108,176,176,pinkie pie
2175177.png,https://derpicdn.net/img/view/2019/10/21/2175177.png,0,0.99308598,556,100,1720,1264,1164,1164,pinkie pie
2175225.png,https://derpicdn.net/img/view/2019/10/21/2175225.png,0,0.950222075,568,13,992,437,424,424,pinkie pie
2187821.png,https://derpicdn.net/img/view/2019/11/4/2187821.png,0,0.975019395,753,215,1337,799,584,584,pinkie pie
2191534.png,https://derpicdn.net/img/view/2019/11/9/2191534.png,0,0.956783354,0,0,771,843,771,843,pinkie pie
2198819.png,https://derpicdn.net/img/view/2019/11/17/2198819.png,0,0.98860091,0,0,3776,4211,3776,4211,pinkie pie
2199670.png,https://derpicdn.net/img/view/2019/11/18/2199670.png,0,0.946122169,35,126,1049,1140,1014,1014,pinkie pie
2206593.png,https://derpicdn.net/img/view/2019/11/27/2206593.png,0,0.991719067,93,6,794,712,701,706,pinkie pie
2207216.png,https://derpicdn.net/img/view/2019/11/27/2207216.png,0,0.912541509,93,0,682,593,589,593,pinkie pie
2208972.png,https://derpicdn.net/img/view/2019/11/30/2208972.png,0,0.903406203,151,0,823,668,672,668,pinkie pie
2211399.png,https://derpicdn.net/img/view/2019/12/3/2211399.png,0,0.987520337,0,119,393,543,393,424,pinkie pie
2212581.png,https://derpicdn.net/img/view/2019/12/4/2212581.png,0,0.961650014,199,0,1897,1601,1698,1601,pinkie pie
2216992.png,https://derpicdn.net/img/view/2019/12/10/2216992.png,0,0.992533982,753,11,2437,1695,1684,1684,pinkie pie
2220623.png,https://derpicdn.net/img/view/2019/12/14/2220623.png,0,0.91849792,107,12,641,546,534,534,pinkie pie
2230049.jpg,https://derpicdn.net/img/view/2019/12/25/2230049.jpg,0,0.921295643,165,112,655,602,490,490,pinkie pie
2230202.png,https://derpicdn.net/img/view/2019/12/26/2230202.png,0,0.924426377,188,0,1674,1460,1486,1460,pinkie pie
2232182.png,https://derpicdn.net/img/view/2019/12/28/2232182.png,1,0.930703342,23,0,259,264,236,264,pinkie pie
2239069.png,https://derpicdn.net/img/view/2020/1/5/2239069.png,0,0.958701134,256,0,1622,1205,1366,1205,pinkie pie
2239228.png,https://derpicdn.net/img/view/2020/1/5/2239228.png,0,0.987984121,14,0,960,917,946,917,pinkie pie
2239344.jpg,https://derpicdn.net/img/view/2020/1/5/2239344.jpg,0,0.935197771,165,175,1309,1319,1144,1144,pinkie pie
2240560.png,https://derpicdn.net/img/view/2020/1/6/2240560.png,0,0.929692388,64,0,852,728,788,728,pinkie pie
2246868.png,https://derpicdn.net/img/view/2020/1/14/2246868.png,0,0.976654649,0,0,256,261,256,261,pinkie pie
2250307.png,https://derpicdn.net/img/view/2020/1/18/2250307.png,0,0.974900663,980,1855,1868,2743,888,888,pinkie pie
2250307.png,https://derpicdn.net/img/view/2020/1/18/2250307.png,1,0.930072129,2093,1025,2937,1869,844,844,pinkie pie
2250308.png,https://derpicdn.net/img/view/2020/1/18/2250308.png,0,0.996859908,1736,1983,2610,2857,874,874,pinkie pie
2250649.png,https://derpicdn.net/img/view/2020/1/18/2250649.png,0,0.929232597,387,30,1135,778,748,748,pinkie pie
2250693.jpg,https://derpicdn.net/img/view/2020/1/18/2250693.jpg,0,0.997169733,0,0,705,695,705,695,pinkie pie
2253940.jpg,https://derpicdn.net/img/view/2020/1/22/2253940.jpg,0,0.979798496,451,441,753,743,302,302,pinkie pie
2256715.jpg,https://derpicdn.net/img/view/2020/1/25/2256715.jpg,0,0.993417621,2,0,1002,947,1000,947,pinkie pie
2256959.jpg,https://derpicdn.net/img/view/2020/1/25/2256959.jpg,0,0.911896765,49,0,1087,848,1038,848,pinkie pie
2263570.png,https://derpicdn.net/img/view/2020/2/2/2263570.png,0,0.914762139,758,91,1760,1113,1002,1022,pinkie pie
2268422.png,https://derpicdn.net/img/view/2020/2/8/2268422.png,0,0.96843195,179,0,1251,963,1072,963,pinkie pie
2272701.png,https://derpicdn.net/img/view/2020/2/13/2272701.png,0,0.991532266,1422,165,7003,6125,5581,5960,pinkie pie
2273072.png,https://derpicdn.net/img/view/2020/2/13/2273072.png,0,0.981880009,396,32,854,490,458,458,pinkie pie
2278465.png,https://derpicdn.net/img/view/2020/2/19/2278465.png,0,0.978975177,922,20,2380,1478,1458,1458,pinkie pie
2278513.jpg,https://derpicdn.net/img/view/2020/2/19/2278513.jpg,0,0.925798178,409,308,847,746,438,438,pinkie pie
228385.jpg,https://derpicdn.net/img/view/2013/1/30/228385.jpg,0,0.994647861,464,70,1240,846,776,776,pinkie pie
2290270.jpg,https://derpicdn.net/img/view/2020/3/5/2290270.jpg,0,0.924294353,106,0,502,375,396,375,pinkie pie
2290622.jpg,https://derpicdn.net/img/view/2020/3/5/2290622.jpg,0,0.995560944,185,129,1237,1181,1052,1052,pinkie pie
2293479.png,https://derpicdn.net/img/view/2020/3/9/2293479.png,0,0.959671199,0,0,594,658,594,658,pinkie pie
2295772.jpg,https://derpicdn.net/img/view/2020/3/12/2295772.jpg,0,0.971353233,0,170,626,796,626,626,pinkie pie
2298130.jpg,https://derpicdn.net/img/view/2020/3/15/2298130.jpg,0,0.985666513,176,37,866,727,690,690,pinkie pie
2301524.png,https://derpicdn.net/img/view/2020/3/20/2301524.png,0,0.927288473,2,34,510,542,508,508,pinkie pie
2301759.png,https://derpicdn.net/img/view/2020/3/20/2301759.png,0,0.916831851,0,0,385,392,385,392,pinkie pie
2302109.png,https://derpicdn.net/img/view/2020/3/20/2302109.png,0,0.969612539,164,0,1280,1119,1116,1119,pinkie pie
2305057.jpg,https://derpicdn.net/img/view/2020/3/24/2305057.jpg,0,0.982052445,66,0,970,793,904,793,pinkie pie
2314054.png,https://derpicdn.net/img/view/2020/4/4/2314054.png,0,0.979619205,435,0,1017,559,582,559,pinkie pie
2316589.png,https://derpicdn.net/img/view/2020/4/7/2316589.png,0,0.936972916,626,383,1634,1391,1008,1008,pinkie pie
2322487.png,https://derpicdn.net/img/view/2020/4/14/2322487.png,0,0.96721071,199,0,1619,1243,1420,1243,pinkie pie
2324798.jpg,https://derpicdn.net/img/view/2020/4/17/2324798.jpg,0,0.943407893,526,208,1252,934,726,726,pinkie pie
2326476.png,https://derpicdn.net/img/view/2020/4/19/2326476.png,0,0.96862483,1203,438,2343,1578,1140,1140,pinkie pie
2327602.png,https://derpicdn.net/img/view/2020/4/21/2327602.png,0,0.979443371,599,566,837,804,238,238,pinkie pie
2327602.png,https://derpicdn.net/img/view/2020/4/21/2327602.png,1,0.961576164,300,371,560,631,260,260,pinkie pie
2328141.png,https://derpicdn.net/img/view/2020/4/21/2328141.png,0,0.997370243,180,70,1786,1676,1606,1606,pinkie pie
2328805.jpg,https://derpicdn.net/img/view/2020/4/22/2328805.jpg,0,0.997680843,119,0,801,645,682,645,pinkie pie
2331635.png,https://derpicdn.net/img/view/2020/4/25/2331635.png,0,0.993532419,542,170,1976,1604,1434,1434,pinkie pie
2331851.png,https://derpicdn.net/img/view/2020/4/26/2331851.png,0,0.959993958,698,229,1532,1063,834,834,pinkie pie
2333210.png,https://derpicdn.net/img/view/2020/4/27/2333210.png,0,0.995919824,1542,384,2128,970,586,586,pinkie pie
2333210.png,https://derpicdn.net/img/view/2020/4/27/2333210.png,2,0.990882337,1061,428,1685,1052,624,624,pinkie pie
2333210.png,https://derpicdn.net/img/view/2020/4/27/2333210.png,3,0.974686921,661,820,1153,1312,492,492,pinkie pie
2333709.png,https://derpicdn.net/img/view/2020/4/28/2333709.png,0,0.98302722,80,0,712,568,632,568,pinkie pie
2334558.png,https://derpicdn.net/img/view/2020/4/29/2334558.png,0,0.994023561,120,0,888,718,768,718,pinkie pie
2339328.png,https://derpicdn.net/img/view/2020/5/4/2339328.png,0,0.982506752,411,57,2643,2289,2232,2232,pinkie pie
2344536.png,https://derpicdn.net/img/view/2020/5/10/2344536.png,0,0.937931359,513,75,1057,619,544,544,pinkie pie
2344667.png,https://derpicdn.net/img/view/2020/5/10/2344667.png,0,0.978313208,198,24,1000,924,802,900,pinkie pie
2347380.png,https://derpicdn.net/img/view/2020/5/13/2347380.png,0,0.997756422,63,37,1269,1243,1206,1206,pinkie pie
2347662.jpg,https://derpicdn.net/img/view/2020/5/13/2347662.jpg,0,0.939270198,974,0,2656,1393,1682,1393,pinkie pie
2349090.jpg,https://derpicdn.net/img/view/2020/5/15/2349090.jpg,0,0.991683722,475,325,871,721,396,396,pinkie pie
2353225.jpg,https://derpicdn.net/img/view/2020/5/20/2353225.jpg,0,0.936871171,466,280,1044,858,578,578,pinkie pie
2355489.png,https://derpicdn.net/img/view/2020/5/22/2355489.png,0,0.972380579,489,185,807,503,318,318,pinkie pie
2355489.png,https://derpicdn.net/img/view/2020/5/22/2355489.png,1,0.946416199,0,264,307,628,307,364,pinkie pie
238970.png,https://derpicdn.net/img/view/2013/2/10/238970.png,0,0.997215748,554,30,994,470,440,440,pinkie pie
244375.jpg,https://derpicdn.net/img/view/2013/2/15/244375.jpg,0,0.959229529,118,19,388,289,270,270,pinkie pie
246537.png,https://derpicdn.net/img/view/2013/2/17/246537.png,0,0.976921439,0,170,715,940,715,770,pinkie pie
254540.png,https://derpicdn.net/img/view/2013/2/25/254540.png,0,0.976771593,1,282,449,730,448,448,pinkie pie
255740.png,https://derpicdn.net/img/view/2013/2/26/255740.png,0,0.995571673,109,0,925,746,816,746,pinkie pie
257026.jpg,https://derpicdn.net/img/view/2013/2/27/257026.jpg,0,0.96174401,1954,1387,3084,2517,1130,1130,pinkie pie
265669.png,https://derpicdn.net/img/view/2013/3/8/265669.png,0,0.902402282,323,0,867,529,544,529,pinkie pie
28623.png,https://derpicdn.net/img/view/2012/7/2/28623.png,0,0.997021854,2695,1440,3371,2122,676,682,pinkie pie
29057.png,https://derpicdn.net/img/view/2012/7/2/29057.png,0,0.994532883,189,219,471,501,282,282,pinkie pie
303317.png,https://derpicdn.net/img/view/2013/4/20/303317.png,0,0.97071898,303,156,887,740,584,584,pinkie pie
306429.png,https://derpicdn.net/img/view/2013/4/23/306429.png,0,0.965093195,242,2321,2592,4671,2350,2350,pinkie pie
316723.png,https://derpicdn.net/img/view/2013/5/4/316723.png,0,0.984851539,91,0,980,945,889,945,pinkie pie
336917.png,https://derpicdn.net/img/view/2013/5/30/336917.png,0,0.974025249,1496,26,2930,1460,1434,1434,pinkie pie
339415.png,https://derpicdn.net/img/view/2013/6/2/339415.png,0,0.990276515,1734,143,2704,1113,970,970,pinkie pie
339415.png,https://derpicdn.net/img/view/2013/6/2/339415.png,1,0.921843231,13,638,975,1600,962,962,pinkie pie
347709.png,https://derpicdn.net/img/view/2013/6/13/347709.png,0,0.99889636,91,0,829,705,738,705,pinkie pie
347709.png,https://derpicdn.net/img/view/2013/6/13/347709.png,1,0.995156407,1054,136,1764,846,710,710,pinkie pie
348454.png,https://derpicdn.net/img/view/2013/6/14/348454.png,0,0.970488429,188,0,1024,823,836,823,pinkie pie
349961.jpg,https://derpicdn.net/img/view/2013/6/16/349961.jpg,1,0.977016032,247,355,419,527,172,172,pinkie pie
349961.jpg,https://derpicdn.net/img/view/2013/6/16/349961.jpg,2,0.968961716,11,128,207,324,196,196,pinkie pie
351265.png,https://derpicdn.net/img/view/2013/6/18/351265.png,0,0.985437214,96,0,800,671,704,671,pinkie pie
3651.png,https://derpicdn.net/img/view/2012/2/29/3651.png,0,0.94164896,109,37,321,249,212,212,pinkie pie
369795.png,https://derpicdn.net/img/view/2013/7/10/369795.png,0,0.983267307,598,294,1066,762,468,468,pinkie pie
370894.png,https://derpicdn.net/img/view/2013/7/12/370894.png,0,0.956812978,189,19,593,423,404,404,pinkie pie
376930.png,https://derpicdn.net/img/view/2013/7/17/376930.png,0,0.979493737,147,0,1690,1080,1543,1080,pinkie pie
377040.png,https://derpicdn.net/img/view/2013/7/18/377040.png,0,0.999363244,652,0,1430,767,778,767,pinkie pie
3817.png,https://derpicdn.net/img/view/2012/3/21/3817.png,0,0.969617844,1474,66,2530,1122,1056,1056,pinkie pie
382013.png,https://derpicdn.net/img/view/2013/7/23/382013.png,0,0.99049139,143,0,899,737,756,737,pinkie pie
382375.png,https://derpicdn.net/img/view/2013/7/24/382375.png,0,0.936371207,180,139,819,869,639,730,pinkie pie
384745.png,https://derpicdn.net/img/view/2013/7/29/384745.png,0,0.989752829,53,0,659,575,606,575,pinkie pie
390951.png,https://derpicdn.net/img/view/2013/8/4/390951.png,0,0.950745285,0,0,764,765,764,765,pinkie pie
416031.png,https://derpicdn.net/img/view/2013/9/1/416031.png,0,0.927343309,922,494,3948,3520,3026,3026,pinkie pie
428309.png,https://derpicdn.net/img/view/2013/9/15/428309.png,0,0.913559496,586,0,1162,550,576,550,pinkie pie
440587.png,https://derpicdn.net/img/view/2013/10/3/440587.png,0,0.949730814,570,434,960,824,390,390,pinkie pie
442195.jpg,https://derpicdn.net/img/view/2013/10/5/442195.jpg,0,0.967780828,794,0,1532,707,738,707,pinkie pie
442763.png,https://derpicdn.net/img/view/2013/10/6/442763.png,0,0.916260779,0,43,631,703,631,660,pinkie pie
442763.png,https://derpicdn.net/img/view/2013/10/6/442763.png,1,0.901206434,636,144,900,424,264,280,pinkie pie
45525.jpg,https://derpicdn.net/img/view/2012/7/15/45525.jpg,0,0.954600811,259,18,527,286,268,268,pinkie pie
465252.png,https://derpicdn.net/img/view/2013/11/5/465252.png,0,0.981186509,47,3,703,659,656,656,pinkie pie
471.png,https://derpicdn.net/img/view/2012/1/16/471.png,0,0.979897261,0,0,462,465,462,465,pinkie pie
479031.png,https://derpicdn.net/img/view/2013/11/23/479031.png,0,0.926306248,135,121,863,849,728,728,pinkie pie
490137.png,https://derpicdn.net/img/view/2013/12/5/490137.png,0,0.925603688,445,0,789,323,344,323,pinkie pie
4905.jpg,https://derpicdn.net/img/view/2012/6/17/4905.jpg,0,0.980392277,703,264,1033,594,330,330,pinkie pie
496090.png,https://derpicdn.net/img/view/2013/12/13/496090.png,0,0.995360553,88,40,360,312,272,272,pinkie pie
501037.png,https://derpicdn.net/img/view/2013/12/19/501037.png,0,0.993202031,113,271,339,497,226,226,pinkie pie
503403.png,https://derpicdn.net/img/view/2013/12/22/503403.png,0,0.996626675,82,19,356,293,274,274,pinkie pie
503456.jpg,https://derpicdn.net/img/view/2013/12/22/503456.jpg,0,0.987284005,154,136,788,770,634,634,pinkie pie
505666.png,https://derpicdn.net/img/view/2013/12/24/505666.png,0,0.988800287,0,529,2798,3515,2798,2986,pinkie pie
506896.png,https://derpicdn.net/img/view/2013/12/26/506896.png,0,0.989314556,1383,90,3059,1766,1676,1676,pinkie pie
514504.png,https://derpicdn.net/img/view/2014/1/4/514504.png,0,0.926108599,665,70,1411,866,746,796,pinkie pie
521104.png,https://derpicdn.net/img/view/2014/1/11/521104.png,0,0.948845446,41,24,675,658,634,634,pinkie pie
526192.png,https://derpicdn.net/img/view/2014/1/17/526192.png,0,0.989350438,4,0,614,489,610,489,pinkie pie
527459.png,https://derpicdn.net/img/view/2014/1/18/527459.png,0,0.98877418,183,0,601,324,418,324,pinkie pie
527459.png,https://derpicdn.net/img/view/2014/1/18/527459.png,1,0.94698745,0,0,470,324,470,324,pinkie pie
528937.png,https://derpicdn.net/img/view/2014/1/19/528937.png,0,0.930185795,20,0,418,397,398,397,pinkie pie
538614.png,https://derpicdn.net/img/view/2014/1/30/538614.png,0,0.966705501,10,0,290,262,280,262,pinkie pie
548844.png,https://derpicdn.net/img/view/2014/2/10/548844.png,0,0.932440758,443,91,877,525,434,434,pinkie pie
553607.png,https://derpicdn.net/img/view/2014/2/16/553607.png,0,0.934069633,264,23,692,451,428,428,pinkie pie
554592.jpg,https://derpicdn.net/img/view/2014/2/17/554592.jpg,0,0.989863038,293,0,1015,631,722,631,pinkie pie
562627.png,https://derpicdn.net/img/view/2014/2/27/562627.png,0,0.967001498,77,0,774,748,697,748,pinkie pie
562815.png,https://derpicdn.net/img/view/2014/2/27/562815.png,0,0.943906605,0,0,753,752,753,752,pinkie pie
566329.jpg,https://derpicdn.net/img/view/2014/3/4/566329.jpg,0,0.987975597,751,986,1007,1242,256,256,pinkie pie
586191.jpg,https://derpicdn.net/img/view/2014/3/27/586191.jpg,0,0.949010789,106,10,682,586,576,576,pinkie pie
599029.png,https://derpicdn.net/img/view/2014/4/13/599029.png,0,0.936596572,133,170,551,588,418,418,pinkie pie
603870.png,https://derpicdn.net/img/view/2014/4/18/603870.png,0,0.93316412,137,89,319,271,182,182,pinkie pie
604416.jpg,https://derpicdn.net/img/view/2014/4/19/604416.jpg,0,0.982917845,221,0,564,311,343,311,pinkie pie
615088.png,https://derpicdn.net/img/view/2014/5/2/615088.png,0,0.950740039,181,104,547,470,366,366,pinkie pie
619251.jpg,https://derpicdn.net/img/view/2014/5/6/619251.jpg,0,0.978102565,210,0,1102,778,892,778,pinkie pie
625116.png,https://derpicdn.net/img/view/2014/5/12/625116.png,0,0.944780648,41,102,549,610,508,508,pinkie pie
626841.jpg,https://derpicdn.net/img/view/2014/5/14/626841.jpg,0,0.994716763,1596,3038,2862,4304,1266,1266,pinkie pie
626841.jpg,https://derpicdn.net/img/view/2014/5/14/626841.jpg,1,0.981942177,399,2789,1759,4149,1360,1360,pinkie pie
631899.jpg,https://derpicdn.net/img/view/2014/5/20/631899.jpg,0,0.997051299,213,0,571,340,358,340,pinkie pie
640094.jpg,https://derpicdn.net/img/view/2014/5/29/640094.jpg,0,0.996359527,443,507,757,821,314,314,pinkie pie
667049.png,https://derpicdn.net/img/view/2014/7/4/667049.png,0,0.996483922,192,53,704,565,512,512,pinkie pie
668681.jpg,https://derpicdn.net/img/view/2014/7/6/668681.jpg,0,0.99345845,86,0,312,220,226,220,pinkie pie
669744.png,https://derpicdn.net/img/view/2014/7/7/669744.png,0,0.998431146,416,29,1800,1413,1384,1384,pinkie pie
671.jpg,https://derpicdn.net/img/view/2012/1/17/671.jpg,0,0.935346305,555,0,1100,536,545,536,pinkie pie
67569.png,https://derpicdn.net/img/view/2012/8/5/67569.png,0,0.981448591,26,0,516,482,490,482,pinkie pie
699739.png,https://derpicdn.net/img/view/2014/8/14/699739.png,0,0.964416742,1,0,365,357,364,357,pinkie pie
702722.png,https://derpicdn.net/img/view/2014/8/18/702722.png,0,0.978627145,192,369,858,1035,666,666,pinkie pie
705627.png,https://derpicdn.net/img/view/2014/8/22/705627.png,0,0.991894066,1050,138,2228,1316,1178,1178,pinkie pie
723512.png,https://derpicdn.net/img/view/2014/9/16/723512.png,0,0.964871347,565,965,1233,1633,668,668,pinkie pie
72979.png,https://derpicdn.net/img/view/2012/8/12/72979.png,0,0.999581575,2,0,304,290,302,290,pinkie pie
731250.jpg,https://derpicdn.net/img/view/2014/9/28/731250.jpg,0,0.969686389,42,0,386,329,344,329,pinkie pie
733275.png,https://derpicdn.net/img/view/2014/10/1/733275.png,0,0.946406841,195,18,1287,1110,1092,1092,pinkie pie
751079.png,https://derpicdn.net/img/view/2014/10/26/751079.png,0,0.998953164,0,168,441,622,441,454,pinkie pie
751079.png,https://derpicdn.net/img/view/2014/10/26/751079.png,1,0.983735085,430,100,1028,698,598,598,pinkie pie
75142.png,https://derpicdn.net/img/view/2012/8/15/75142.png,0,0.95397234,168,0,1154,957,986,957,pinkie pie
753089.png,https://derpicdn.net/img/view/2014/10/29/753089.png,0,0.924674034,0,0,578,551,578,551,pinkie pie
753243.jpg,https://derpicdn.net/img/view/2014/10/29/753243.jpg,0,0.97682935,43,48,585,590,542,542,pinkie pie
765941.jpg,https://derpicdn.net/img/view/2014/11/16/765941.jpg,0,0.994198322,1407,4,2667,1264,1260,1260,pinkie pie
770343.png,https://derpicdn.net/img/view/2014/11/23/770343.png,0,0.984379888,63,81,997,1015,934,934,pinkie pie
771067.png,https://derpicdn.net/img/view/2014/11/24/771067.png,0,0.988254726,583,134,935,486,352,352,pinkie pie
777498.png,https://derpicdn.net/img/view/2014/12/4/777498.png,0,0.999316871,1954,0,3525,1659,1571,1659,pinkie pie
777498.png,https://derpicdn.net/img/view/2014/12/4/777498.png,1,0.992718995,0,0,1539,1528,1539,1528,pinkie pie
778706.png,https://derpicdn.net/img/view/2014/12/5/778706.png,0,0.995666683,0,0,669,684,669,684,pinkie pie
781742.png,https://derpicdn.net/img/view/2014/12/9/781742.png,0,0.966583788,138,117,622,601,484,484,pinkie pie
795033.png,https://derpicdn.net/img/view/2014/12/29/795033.png,0,0.996423542,78,0,656,542,578,542,pinkie pie
806534.jpg,https://derpicdn.net/img/view/2015/1/14/806534.jpg,0,0.972653031,476,0,1572,999,1096,999,pinkie pie
815753.jpg,https://derpicdn.net/img/view/2015/1/27/815753.jpg,0,0.994348347,0,111,891,1043,891,932,pinkie pie
817498.png,https://derpicdn.net/img/view/2015/1/30/817498.png,0,0.990595162,326,0,686,334,360,334,pinkie pie
818859.png,https://derpicdn.net/img/view/2015/2/1/818859.png,0,0.969656706,325,233,827,735,502,502,pinkie pie
825748.png,https://derpicdn.net/img/view/2015/2/10/825748.png,0,0.998693705,446,118,1650,1322,1204,1204,pinkie pie
828466.png,https://derpicdn.net/img/view/2015/2/14/828466.png,0,0.956677616,117,0,511,357,394,357,pinkie pie
828965.png,https://derpicdn.net/img/view/2015/2/15/828965.png,0,0.995135069,917,26,2351,1460,1434,1434,pinkie pie
832671.png,https://derpicdn.net/img/view/2015/2/19/832671.png,0,0.962189138,338,0,1884,1485,1546,1485,pinkie pie
834561.png,https://derpicdn.net/img/view/2015/2/22/834561.png,0,0.976546526,34,0,960,890,926,890,pinkie pie
834857.png,https://derpicdn.net/img/view/2015/2/22/834857.png,0,0.963823795,67,0,445,370,378,370,pinkie pie
837417.jpg,https://derpicdn.net/img/view/2015/2/26/837417.jpg,0,0.994526207,945,0,1413,430,468,430,pinkie pie
837417.jpg,https://derpicdn.net/img/view/2015/2/26/837417.jpg,1,0.983238518,512,0,940,409,428,409,pinkie pie
837417.jpg,https://derpicdn.net/img/view/2015/2/26/837417.jpg,2,0.97466284,9,0,519,451,510,451,pinkie pie
845337.png,https://derpicdn.net/img/view/2015/3/8/845337.png,0,0.942585886,81,13,379,311,298,298,pinkie pie
865856.png,https://derpicdn.net/img/view/2015/4/5/865856.png,0,0.998065472,169,19,667,517,498,498,pinkie pie
8747.png,https://derpicdn.net/img/view/2012/6/19/8747.png,0,0.966953874,418,0,866,402,448,402,pinkie pie
879931.png,https://derpicdn.net/img/view/2015/4/22/879931.png,0,0.978978217,107,40,1121,1054,1014,1014,pinkie pie
901139.png,https://derpicdn.net/img/view/2015/5/21/901139.png,0,0.955797195,0,82,443,526,443,444,pinkie pie
901175.png,https://derpicdn.net/img/view/2015/5/21/901175.png,0,0.990322173,0,0,765,738,765,738,pinkie pie
903426.png,https://derpicdn.net/img/view/2015/5/24/903426.png,0,0.971052527,131,0,1195,935,1064,935,pinkie pie
903427.png,https://derpicdn.net/img/view/2015/5/24/903427.png,0,0.985655129,169,0,1145,892,976,892,pinkie pie
903434.png,https://derpicdn.net/img/view/2015/5/24/903434.png,0,0.990179777,126,0,1094,885,968,885,pinkie pie
912269.png,https://derpicdn.net/img/view/2015/6/7/912269.png,0,0.98795414,338,21,726,409,388,388,pinkie pie
912398.png,https://derpicdn.net/img/view/2015/6/7/912398.png,0,0.987319946,887,20,2023,1156,1136,1136,pinkie pie
913352.png,https://derpicdn.net/img/view/2015/6/9/913352.png,0,0.997421861,129,19,411,301,282,282,pinkie pie
932160.png,https://derpicdn.net/img/view/2015/7/7/932160.png,0,0.994491518,29,0,377,345,348,345,pinkie pie
932982.jpg,https://derpicdn.net/img/view/2015/7/8/932982.jpg,0,0.925186038,71,13,569,511,498,498,pinkie pie
936082.png,https://derpicdn.net/img/view/2015/7/13/936082.png,0,0.992893159,54,0,710,579,656,579,pinkie pie
940443.png,https://derpicdn.net/img/view/2015/7/20/940443.png,0,0.980676532,0,0,665,585,665,585,pinkie pie
947675.jpg,https://derpicdn.net/img/view/2015/7/31/947675.jpg,0,0.988000333,38,0,668,579,630,579,pinkie pie
961755.png,https://derpicdn.net/img/view/2015/8/20/961755.png,0,0.992869198,375,42,1071,738,696,696,pinkie pie
981880.png,https://derpicdn.net/img/view/2015/9/17/981880.png,0,0.981930792,249,51,895,697,646,646,pinkie pie
993814.png,https://derpicdn.net/img/view/2015/10/3/993814.png,0,0.953628302,25,399,351,725,326,326,pinkie pie
994222.png,https://derpicdn.net/img/view/2015/10/4/994222.png,0,0.997185946,110,0,420,295,310,295,pinkie pie
994914.png,https://derpicdn.net/img/view/2015/10/5/994914.png,0,0.993053854,0,0,1276,1024,1276,1024,pinkie pie
998554.png,https://derpicdn.net/img/view/2015/10/10/998554.png,0,0.91359067,279,216,721,658,442,442,pinkie pie
1003934.png,https://derpicdn.net/img/view/2015/10/17/1003934.png,0,0.982230484,300,99,674,473,374,374,pinkie pie
100491.png,https://derpicdn.net/img/view/2012/9/17/100491.png,0,0.986143351,142,0,524,366,382,366,pinkie pie
1009326.png,https://derpicdn.net/img/view/2015/10/25/1009326.png,1,0.989853024,123,424,337,638,214,214,pinkie pie
1045144.png,https://derpicdn.net/img/view/2015/12/15/1045144.png,0,0.984331965,678,264,1364,950,686,686,pinkie pie
1047772.png,https://derpicdn.net/img/view/2015/12/19/1047772.png,0,0.992316544,70,0,612,518,542,518,pinkie pie
1054671.png,https://derpicdn.net/img/view/2015/12/28/1054671.png,0,0.924919307,0,0,306,364,306,364,pinkie pie
1055789.jpg,https://derpicdn.net/img/view/2015/12/30/1055789.jpg,0,0.998153985,529,0,919,318,390,318,pinkie pie
1055789.jpg,https://derpicdn.net/img/view/2015/12/30/1055789.jpg,1,0.997041881,260,3,570,313,310,310,pinkie pie
1059212.jpg,https://derpicdn.net/img/view/2016/1/4/1059212.jpg,0,0.995557189,134,0,840,678,706,678,pinkie pie
1063399.png,https://derpicdn.net/img/view/2016/1/10/1063399.png,0,0.994177699,142,298,568,720,426,422,pinkie pie
1065204.png,https://derpicdn.net/img/view/2016/1/12/1065204.png,0,0.995696843,255,0,539,280,284,280,pinkie pie
1065617.png,https://derpicdn.net/img/view/2016/1/13/1065617.png,0,0.953106165,353,0,765,350,412,350,pinkie pie
1068984.png,https://derpicdn.net/img/view/2016/1/18/1068984.png,0,0.967049778,222,0,720,464,498,464,pinkie pie
1074380.png,https://derpicdn.net/img/view/2016/1/27/1074380.png,0,0.992250204,0,0,328,310,328,310,pinkie pie
107577.png,https://derpicdn.net/img/view/2012/9/27/107577.png,0,0.983697176,61,0,711,645,650,645,pinkie pie
1076921.png,https://derpicdn.net/img/view/2016/1/30/1076921.png,0,0.963602662,484,36,746,298,262,262,pinkie pie
1076921.png,https://derpicdn.net/img/view/2016/1/30/1076921.png,1,0.940914273,0,6,337,350,337,344,pinkie pie
10782.png,https://derpicdn.net/img/view/2012/6/19/10782.png,0,0.986764014,139,0,730,612,591,612,pinkie pie
1081082.png,https://derpicdn.net/img/view/2016/2/5/1081082.png,0,0.93279314,1808,27,3546,1765,1738,1738,pinkie pie
1083848.png,https://derpicdn.net/img/view/2016/2/9/1083848.png,0,0.969197989,316,179,738,601,422,422,pinkie pie
1084459.png,https://derpicdn.net/img/view/2016/2/10/1084459.png,0,0.944920957,48,84,836,872,788,788,pinkie pie
1086841.png,https://derpicdn.net/img/view/2016/2/13/1086841.png,0,0.993458211,895,173,2143,1421,1248,1248,pinkie pie
1098516.png,https://derpicdn.net/img/view/2016/2/28/1098516.png,0,0.99872452,924,571,1764,1411,840,840,pinkie pie
1133027.png,https://derpicdn.net/img/view/2016/4/16/1133027.png,0,0.987790525,0,0,2679,2597,2679,2597,pinkie pie
1149526.png,https://derpicdn.net/img/view/2016/5/8/1149526.png,0,0.963733077,68,10,354,296,286,286,pinkie pie
1152315.png,https://derpicdn.net/img/view/2016/5/12/1152315.png,0,0.964484632,415,16,1475,1076,1060,1060,pinkie pie
1159808.png,https://derpicdn.net/img/view/2016/5/21/1159808.png,0,0.925320089,141,39,383,281,242,242,pinkie pie
1174639.png,https://derpicdn.net/img/view/2016/6/10/1174639.png,0,0.999157965,436,11,1110,685,674,674,pinkie pie
1176514.png,https://derpicdn.net/img/view/2016/6/12/1176514.png,0,0.957331657,0,0,1957,2271,1957,2271,pinkie pie
1191340.png,https://derpicdn.net/img/view/2016/7/2/1191340.png,0,0.991942108,0,61,680,689,680,628,pinkie pie
1193669.png,https://derpicdn.net/img/view/2016/7/5/1193669.png,0,0.987344801,255,0,1161,901,906,901,pinkie pie
1200970.png,https://derpicdn.net/img/view/2016/7/14/1200970.png,0,0.997597218,346,0,1404,978,1058,978,pinkie pie
12059.jpg,https://derpicdn.net/img/view/2012/6/20/12059.jpg,0,0.996993184,594,398,1186,990,592,592,pinkie pie
1245458.png,https://derpicdn.net/img/view/2016/9/9/1245458.png,0,0.928084314,601,87,1285,771,684,684,pinkie pie
1248078.png,https://derpicdn.net/img/view/2016/9/13/1248078.png,0,0.976848781,2212,2176,3694,3658,1482,1482,pinkie pie
1255781.png,https://derpicdn.net/img/view/2016/9/22/1255781.png,0,0.983303905,361,15,1115,769,754,754,pinkie pie
1262587.png,https://derpicdn.net/img/view/2016/10/1/1262587.png,0,0.959307671,47,0,405,383,358,383,pinkie pie
1280140.png,https://derpicdn.net/img/view/2016/10/23/1280140.png,0,0.993058443,339,683,1011,1355,672,672,pinkie pie
1287359.png,https://derpicdn.net/img/view/2016/11/2/1287359.png,0,0.977325141,560,246,1222,908,662,662,pinkie pie
128855.jpg,https://derpicdn.net/img/view/2012/10/21/128855.jpg,0,0.97692585,0,0,613,566,613,566,pinkie pie
1292863.png,https://derpicdn.net/img/view/2016/11/10/1292863.png,0,0.961591303,514,8,1210,704,696,696,pinkie pie
1304594.png,https://derpicdn.net/img/view/2016/11/27/1304594.png,0,0.947350562,297,26,565,294,268,268,pinkie pie
1306644.png,https://derpicdn.net/img/view/2016/11/30/1306644.png,0,0.953373611,846,0,1386,538,540,538,pinkie pie
1315527.png,https://derpicdn.net/img/view/2016/12/12/1315527.png,0,0.973416865,763,406,1171,814,408,408,pinkie pie
1327241.png,https://derpicdn.net/img/view/2016/12/28/1327241.png,0,0.914782882,271,93,2415,2237,2144,2144,pinkie pie
1330011.png,https://derpicdn.net/img/view/2017/1/1/1330011.png,0,0.958715558,372,55,1788,1471,1416,1416,pinkie pie
1331572.png,https://derpicdn.net/img/view/2017/1/3/1331572.png,0,0.911839128,190,89,1292,1191,1102,1102,pinkie pie
1342892.png,https://derpicdn.net/img/view/2017/1/19/1342892.png,0,0.962315202,187,0,1227,730,1040,730,pinkie pie
1345718.png,https://derpicdn.net/img/view/2017/1/23/1345718.png,0,0.911173403,119,0,432,323,313,323,pinkie pie
1345743.png,https://derpicdn.net/img/view/2017/1/23/1345743.png,0,0.995374858,330,50,1058,778,728,728,pinkie pie
1354092.png,https://derpicdn.net/img/view/2017/2/3/1354092.png,0,0.97413969,34,0,590,512,556,512,pinkie pie
1358079.png,https://derpicdn.net/img/view/2017/2/8/1358079.png,0,0.985772133,76,6,980,910,904,904,pinkie pie
1368335.png,https://derpicdn.net/img/view/2017/2/20/1368335.png,0,0.999219,58,0,554,448,496,448,pinkie pie
1370671.png,https://derpicdn.net/img/view/2017/2/23/1370671.png,0,0.987448037,167,0,768,608,601,608,pinkie pie
1379117.png,https://derpicdn.net/img/view/2017/3/4/1379117.png,0,0.996460795,124,5,614,495,490,490,pinkie pie
1380168.png,https://derpicdn.net/img/view/2017/3/5/1380168.png,0,0.995481431,465,40,943,518,478,478,pinkie pie
138971.png,https://derpicdn.net/img/view/2012/11/1/138971.png,0,0.997373939,1421,0,3399,1919,1978,1919,pinkie pie
138972.png,https://derpicdn.net/img/view/2012/11/1/138972.png,0,0.987384498,182,148,3698,3664,3516,3516,pinkie pie
1393806.png,https://derpicdn.net/img/view/2017/3/22/1393806.png,0,0.953695834,168,96,1238,1137,1070,1041,pinkie pie
1399306.png,https://derpicdn.net/img/view/2017/3/29/1399306.png,0,0.993225217,152,42,754,644,602,602,pinkie pie
1406381.png,https://derpicdn.net/img/view/2017/4/7/1406381.png,0,0.958877802,35,0,477,415,442,415,pinkie pie
1406957.png,https://derpicdn.net/img/view/2017/4/8/1406957.png,0,0.980342031,0,12,387,468,387,456,pinkie pie
1407560.png,https://derpicdn.net/img/view/2017/4/9/1407560.png,0,0.938605785,28,0,418,334,390,334,pinkie pie
1414641.png,https://derpicdn.net/img/view/2017/4/18/1414641.png,0,0.989069581,287,0,1011,715,724,715,pinkie pie
1416728.png,https://derpicdn.net/img/view/2017/4/20/1416728.png,0,0.962372839,666,0,3268,2520,2602,2520,pinkie pie
1419984.png,https://derpicdn.net/img/view/2017/4/23/1419984.png,0,0.941461325,435,67,791,423,356,356,pinkie pie
1425224.png,https://derpicdn.net/img/view/2017/4/30/1425224.png,0,0.98754847,364,0,2070,1578,1706,1578,pinkie pie
1426324.png,https://derpicdn.net/img/view/2017/5/1/1426324.png,0,0.925028682,5160,259,10616,5787,5456,5528,pinkie pie
14265.png,https://derpicdn.net/img/view/2012/6/21/14265.png,0,0.978115201,39,0,763,719,724,719,pinkie pie
14269.png,https://derpicdn.net/img/view/2012/6/21/14269.png,0,0.988828719,78,78,788,788,710,710,pinkie pie
14279.png,https://derpicdn.net/img/view/2012/6/21/14279.png,0,0.983914196,130,89,900,899,770,810,pinkie pie
1428299.png,https://derpicdn.net/img/view/2017/5/4/1428299.png,0,0.913095593,0,0,949,908,949,908,pinkie pie
1429782.png,https://derpicdn.net/img/view/2017/5/6/1429782.png,0,0.903931081,1354,190,4312,3148,2958,2958,pinkie pie
1429829.png,https://derpicdn.net/img/view/2017/5/6/1429829.png,0,0.986577392,0,0,361,379,361,379,pinkie pie
1432144.png,https://derpicdn.net/img/view/2017/5/8/1432144.png,0,0.977540135,345,169,1169,993,824,824,pinkie pie
1432251.png,https://derpicdn.net/img/view/2017/5/9/1432251.png,0,0.930750847,135,54,971,890,836,836,pinkie pie
1432571.png,https://derpicdn.net/img/view/2017/5/9/1432571.png,0,0.996995568,177,0,761,558,584,558,pinkie pie
1432950.png,https://derpicdn.net/img/view/2017/5/10/1432950.png,0,0.948103786,122,0,604,474,482,474,pinkie pie
1433426.png,https://derpicdn.net/img/view/2017/5/10/1433426.png,0,0.979925931,298,127,2608,2308,2310,2181,pinkie pie
1433696.png,https://derpicdn.net/img/view/2017/5/11/1433696.png,0,0.958515227,13,14,323,324,310,310,pinkie pie
1436612.png,https://derpicdn.net/img/view/2017/5/14/1436612.png,0,0.958882868,217,32,489,304,272,272,pinkie pie
143822.jpg,https://derpicdn.net/img/view/2012/11/6/143822.jpg,0,0.973418295,625,0,1035,379,410,379,pinkie pie
143822.jpg,https://derpicdn.net/img/view/2012/11/6/143822.jpg,1,0.936932147,152,182,506,536,354,354,pinkie pie
1439991.png,https://derpicdn.net/img/view/2017/5/19/1439991.png,0,0.996670783,778,0,1962,1164,1184,1164,pinkie pie
1442357.png,https://derpicdn.net/img/view/2017/5/21/1442357.png,0,0.918697774,0,0,281,312,281,312,pinkie pie
1443677.png,https://derpicdn.net/img/view/2017/5/22/1443677.png,0,0.986251414,0,0,520,503,520,503,pinkie pie
1449315.png,https://derpicdn.net/img/view/2017/5/29/1449315.png,0,0.987006485,322,55,1600,1333,1278,1278,pinkie pie
1450144.png,https://derpicdn.net/img/view/2017/5/30/1450144.png,1,0.958322465,466,94,672,300,206,206,pinkie pie
1451978.png,https://derpicdn.net/img/view/2017/6/2/1451978.png,0,0.983511806,1533,559,2835,1861,1302,1302,pinkie pie
1456721.png,https://derpicdn.net/img/view/2017/6/8/1456721.png,0,0.978829503,979,195,2021,1237,1042,1042,pinkie pie
1460271.png,https://derpicdn.net/img/view/2017/6/12/1460271.png,0,0.941879153,191,32,883,724,692,692,pinkie pie
1460536.png,https://derpicdn.net/img/view/2017/6/13/1460536.png,0,0.965103865,214,373,3076,3235,2862,2862,pinkie pie
146340.jpg,https://derpicdn.net/img/view/2012/11/9/146340.jpg,0,0.994372666,168,59,668,559,500,500,pinkie pie
1463689.png,https://derpicdn.net/img/view/2017/6/17/1463689.png,0,0.980496705,180,0,690,471,510,471,pinkie pie
1464477.png,https://derpicdn.net/img/view/2017/6/18/1464477.png,0,0.90245527,1545,191,4910,4135,3365,3944,pinkie pie
146533.png,https://derpicdn.net/img/view/2012/11/9/146533.png,0,0.98686856,59,84,473,498,414,414,pinkie pie
1468362.png,https://derpicdn.net/img/view/2017/6/21/1468362.png,0,0.976595163,401,0,1263,807,862,807,pinkie pie
1470414.png,https://derpicdn.net/img/view/2017/6/24/1470414.png,0,0.980573297,767,583,3603,3829,2836,3246,pinkie pie
1473049.png,https://derpicdn.net/img/view/2017/6/27/1473049.png,0,0.965426862,509,599,1437,1527,928,928,pinkie pie
1475053.png,https://derpicdn.net/img/view/2017/6/30/1475053.png,0,0.959153712,324,0,1314,885,990,885,pinkie pie
1475893.png,https://derpicdn.net/img/view/2017/7/1/1475893.png,0,0.9751845,1,10,375,384,374,374,pinkie pie
1478095.png,https://derpicdn.net/img/view/2017/7/4/1478095.png,0,0.990730584,0,0,465,474,465,474,pinkie pie
1488163.png,https://derpicdn.net/img/view/2017/7/17/1488163.png,0,0.919178069,665,0,1165,478,500,478,pinkie pie
1491584.png,https://derpicdn.net/img/view/2017/7/21/1491584.png,0,0.997101307,609,214,2127,1732,1518,1518,pinkie pie
1494957.png,https://derpicdn.net/img/view/2017/7/25/1494957.png,0,0.926276088,278,114,1214,1050,936,936,pinkie pie
1496079.png,https://derpicdn.net/img/view/2017/7/27/1496079.png,0,0.915212095,198,0,1224,720,1026,720,pinkie pie
1498473.png,https://derpicdn.net/img/view/2017/7/30/1498473.png,0,0.972405791,624,30,1074,480,450,450,pinkie pie
1501114.png,https://derpicdn.net/img/view/2017/8/2/1501114.png,0,0.971278548,0,0,3000,3569,3000,3569,pinkie pie
1503394.png,https://derpicdn.net/img/view/2017/8/5/1503394.png,0,0.984668911,257,165,2149,2057,1892,1892,pinkie pie
1505962.png,https://derpicdn.net/img/view/2017/8/8/1505962.png,0,0.967703879,0,146,1264,1822,1264,1676,pinkie pie
1508413.png,https://derpicdn.net/img/view/2017/8/11/1508413.png,0,0.965778947,278,26,784,532,506,506,pinkie pie
1514263.png,https://derpicdn.net/img/view/2017/8/19/1514263.png,0,0.970413566,72,45,868,841,796,796,pinkie pie
1515289.png,https://derpicdn.net/img/view/2017/8/20/1515289.png,0,0.933316588,710,52,1000,342,290,290,pinkie pie
1516358.png,https://derpicdn.net/img/view/2017/8/21/1516358.png,0,0.91245985,737,551,2901,2715,2164,2164,pinkie pie
1520409.png,https://derpicdn.net/img/view/2017/8/26/1520409.png,0,0.96235013,728,0,1642,855,914,855,pinkie pie
1530478.png,https://derpicdn.net/img/view/2017/9/8/1530478.png,0,0.987760186,0,0,218,236,218,236,pinkie pie
1536913.png,https://derpicdn.net/img/view/2017/9/16/1536913.png,0,0.986862242,2,0,750,616,748,616,pinkie pie
1537546.png,https://derpicdn.net/img/view/2017/9/17/1537546.png,0,0.953514338,46,10,600,564,554,554,pinkie pie
1538282.png,https://derpicdn.net/img/view/2017/9/18/1538282.png,0,0.983359277,204,88,600,484,396,396,pinkie pie
1562531.png,https://derpicdn.net/img/view/2017/10/16/1562531.png,0,0.954866052,76,0,3370,3191,3294,3191,pinkie pie
1565390.png,https://derpicdn.net/img/view/2017/10/19/1565390.png,0,0.976678014,1241,215,2825,1799,1584,1584,pinkie pie
1569906.png,https://derpicdn.net/img/view/2017/10/25/1569906.png,0,0.99431324,3328,1200,4588,2460,1260,1260,pinkie pie
1569906.png,https://derpicdn.net/img/view/2017/10/25/1569906.png,1,0.939220846,1234,237,2722,1725,1488,1488,pinkie pie
1571722.png,https://derpicdn.net/img/view/2017/10/28/1571722.png,0,0.954730392,829,589,2553,2313,1724,1724,pinkie pie
1578230.png,https://derpicdn.net/img/view/2017/11/4/1578230.png,0,0.990765929,120,0,638,531,518,531,pinkie pie
1595580.png,https://derpicdn.net/img/view/2017/11/27/1595580.png,0,0.958254278,0,0,1222,1333,1222,1333,pinkie pie
1597196.png,https://derpicdn.net/img/view/2017/11/30/1597196.png,0,0.951281428,144,0,988,816,844,816,pinkie pie
1597600.png,https://derpicdn.net/img/view/2017/11/30/1597600.png,0,0.98374635,0,12,697,814,697,802,pinkie pie
1597840.png,https://derpicdn.net/img/view/2017/12/1/1597840.png,0,0.99818933,253,33,819,599,566,566,pinkie pie
1605991.png,https://derpicdn.net/img/view/2017/12/12/1605991.png,0,0.949636459,192,0,836,621,644,621,pinkie pie
1615497.png,https://derpicdn.net/img/view/2017/12/25/1615497.png,0,0.999442995,354,0,1822,1449,1468,1449,pinkie pie
1628051.png,https://derpicdn.net/img/view/2018/1/9/1628051.png,0,0.994500458,343,110,787,554,444,444,pinkie pie
1628294.png,https://derpicdn.net/img/view/2018/1/9/1628294.png,0,0.984330535,89,0,461,383,372,383,pinkie pie
1646672.png,https://derpicdn.net/img/view/2018/2/2/1646672.png,0,0.928824008,426,238,708,520,282,282,pinkie pie
1648807.png,https://derpicdn.net/img/view/2018/2/5/1648807.png,0,0.993846297,279,0,1661,1375,1382,1375,pinkie pie
1652469.png,https://derpicdn.net/img/view/2018/2/10/1652469.png,0,0.905612051,250,279,866,895,616,616,pinkie pie
1658043.png,https://derpicdn.net/img/view/2018/2/17/1658043.png,0,0.963912845,30,7,500,495,470,488,pinkie pie
1663286.png,https://derpicdn.net/img/view/2018/2/23/1663286.png,0,0.96822381,926,120,1796,990,870,870,pinkie pie
1664689.png,https://derpicdn.net/img/view/2018/2/24/1664689.png,0,0.957696497,1220,0,4074,2725,2854,2725,pinkie pie
1667910.png,https://derpicdn.net/img/view/2018/2/28/1667910.png,0,0.979558349,237,110,911,784,674,674,pinkie pie
1669907.png,https://derpicdn.net/img/view/2018/3/2/1669907.png,0,0.924328148,3606,1660,5238,3292,1632,1632,pinkie pie
1676377.png,https://derpicdn.net/img/view/2018/3/10/1676377.png,0,0.991071463,661,89,1295,723,634,634,pinkie pie
1677458.png,https://derpicdn.net/img/view/2018/3/11/1677458.png,0,0.988387167,618,0,2782,2066,2164,2066,pinkie pie
1677474.png,https://derpicdn.net/img/view/2018/3/11/1677474.png,0,0.99808383,35,0,419,381,384,381,pinkie pie
1679760.png,https://derpicdn.net/img/view/2018/3/14/1679760.png,1,0.983936965,1827,1700,2550,2432,723,732,pinkie pie
1679760.png,https://derpicdn.net/img/view/2018/3/14/1679760.png,3,0.966776907,175,1907,893,2625,718,718,pinkie pie
1682405.png,https://derpicdn.net/img/view/2018/3/16/1682405.png,0,0.961234689,330,80,2982,2732,2652,2652,pinkie pie
1689694.png,https://derpicdn.net/img/view/2018/3/25/1689694.png,0,0.953850567,662,19,1834,1191,1172,1172,pinkie pie
1689710.png,https://derpicdn.net/img/view/2018/3/25/1689710.png,0,0.943968713,1443,444,1861,862,418,418,pinkie pie
1690612.png,https://derpicdn.net/img/view/2018/3/25/1690612.png,1,0.914020538,433,253,819,639,386,386,pinkie pie
1695521.png,https://derpicdn.net/img/view/2018/3/31/1695521.png,0,0.982445657,67,898,813,1644,746,746,pinkie pie
1696149.png,https://derpicdn.net/img/view/2018/4/1/1696149.png,0,0.98820889,47,17,1119,1089,1072,1072,pinkie pie
1696289.png,https://derpicdn.net/img/view/2018/4/1/1696289.png,0,0.935654879,0,0,660,656,660,656,pinkie pie
1696903.png,https://derpicdn.net/img/view/2018/4/2/1696903.png,0,0.936675906,455,188,785,518,330,330,pinkie pie
1699797.png,https://derpicdn.net/img/view/2018/4/5/1699797.png,0,0.980897486,33,0,1697,1080,1664,1080,pinkie pie
1701538.png,https://derpicdn.net/img/view/2018/4/7/1701538.png,0,0.980337381,0,100,2974,3398,2974,3298,pinkie pie
1703292.png,https://derpicdn.net/img/view/2018/4/9/1703292.png,0,0.994838536,1300,35,1638,373,338,338,pinkie pie
1703292.png,https://derpicdn.net/img/view/2018/4/9/1703292.png,1,0.943883479,51,27,417,393,366,366,pinkie pie
1712574.png,https://derpicdn.net/img/view/2018/4/20/1712574.png,0,0.989403546,32,0,584,528,552,528,pinkie pie
1725917.png,https://derpicdn.net/img/view/2018/5/6/1725917.png,0,0.950998604,0,0,1313,1303,1313,1303,pinkie pie
172604.png,https://derpicdn.net/img/view/2012/12/4/172604.png,0,0.978820562,498,258,722,482,224,224,pinkie pie
172767.png,https://derpicdn.net/img/view/2012/12/4/172767.png,0,0.986345828,112,11,396,295,284,284,pinkie pie
1735495.png,https://derpicdn.net/img/view/2018/5/18/1735495.png,0,0.988126099,0,0,750,932,750,932,pinkie pie
1738739.png,https://derpicdn.net/img/view/2018/5/22/1738739.png,0,0.935105622,1327,0,2263,891,936,891,pinkie pie
1740856.png,https://derpicdn.net/img/view/2018/5/25/1740856.png,0,0.972379327,0,89,4656,4803,4656,4714,pinkie pie
1741378.png,https://derpicdn.net/img/view/2018/5/26/1741378.png,0,0.981745601,370,16,916,562,546,546,pinkie pie
1741892.png,https://derpicdn.net/img/view/2018/5/26/1741892.png,0,0.910095334,30,30,888,888,858,858,pinkie pie
1743557.png,https://derpicdn.net/img/view/2018/5/28/1743557.png,0,0.935910583,16,5,958,947,942,942,pinkie pie
174730.png,https://derpicdn.net/img/view/2012/12/7/174730.png,0,0.909536898,56,0,418,359,362,359,pinkie pie
1753364.png,https://derpicdn.net/img/view/2018/6/9/1753364.png,0,0.923238218,0,0,413,394,413,394,pinkie pie
1759624.png,https://derpicdn.net/img/view/2018/6/17/1759624.png,0,0.979387879,16,8,424,416,408,408,pinkie pie
1761235.png,https://derpicdn.net/img/view/2018/6/19/1761235.png,0,0.996458828,266,30,600,382,334,352,pinkie pie
1765478.png,https://derpicdn.net/img/view/2018/6/25/1765478.png,0,0.999265611,248,0,696,438,448,438,pinkie pie
1766489.png,https://derpicdn.net/img/view/2018/6/26/1766489.png,0,0.979493856,93,23,826,811,733,788,pinkie pie
1773410.png,https://derpicdn.net/img/view/2018/7/5/1773410.png,0,0.996910214,351,0,1243,854,892,854,pinkie pie
1776778.png,https://derpicdn.net/img/view/2018/7/9/1776778.png,0,0.97091198,0,0,547,550,547,550,pinkie pie
1777045.png,https://derpicdn.net/img/view/2018/7/9/1777045.png,0,0.979863584,0,7,582,647,582,640,pinkie pie
1778172.png,https://derpicdn.net/img/view/2018/7/11/1778172.png,0,0.996859252,811,48,1135,372,324,324,pinkie pie
1778379.png,https://derpicdn.net/img/view/2018/7/11/1778379.png,0,0.931800663,654,172,966,484,312,312,pinkie pie
1785403.png,https://derpicdn.net/img/view/2018/7/20/1785403.png,0,0.911605775,24,0,410,367,386,367,pinkie pie
1785653.png,https://derpicdn.net/img/view/2018/7/20/1785653.png,0,0.998057842,429,228,1155,954,726,726,pinkie pie
1786382.png,https://derpicdn.net/img/view/2018/7/21/1786382.png,0,0.955597401,796,1467,1362,2033,566,566,pinkie pie
1786845.png,https://derpicdn.net/img/view/2018/7/22/1786845.png,0,0.9842453,90,90,552,552,462,462,pinkie pie
1789900.png,https://derpicdn.net/img/view/2018/7/26/1789900.png,0,0.982313514,187,64,609,486,422,422,pinkie pie
1793221.png,https://derpicdn.net/img/view/2018/7/30/1793221.png,0,0.993586361,1100,39,2466,1405,1366,1366,pinkie pie
1796524.png,https://derpicdn.net/img/view/2018/8/3/1796524.png,0,0.96082145,32,0,1270,784,1238,784,pinkie pie
1797252.png,https://derpicdn.net/img/view/2018/8/3/1797252.png,0,0.97025311,0,0,1470,1535,1470,1535,pinkie pie
1797443.png,https://derpicdn.net/img/view/2018/8/4/1797443.png,0,0.99928838,525,15,943,433,418,418,pinkie pie
1799563.png,https://derpicdn.net/img/view/2018/8/6/1799563.png,0,0.997739971,109,0,561,399,452,399,pinkie pie
1801576.png,https://derpicdn.net/img/view/2018/8/8/1801576.png,0,0.990922332,236,0,700,455,464,455,pinkie pie
1808554.png,https://derpicdn.net/img/view/2018/8/16/1808554.png,0,0.949681878,0,4,170,188,170,184,pinkie pie
1813873.png,https://derpicdn.net/img/view/2018/8/23/1813873.png,0,0.931477547,260,172,2584,2496,2324,2324,pinkie pie
1816917.png,https://derpicdn.net/img/view/2018/8/26/1816917.png,2,0.979451358,361,415,1085,1139,724,724,pinkie pie
1817648.png,https://derpicdn.net/img/view/2018/8/27/1817648.png,0,0.980176389,0,6,857,864,857,858,pinkie pie
1817962.png,https://derpicdn.net/img/view/2018/8/27/1817962.png,0,0.999375582,1585,62,3177,1654,1592,1592,pinkie pie
1818979.png,https://derpicdn.net/img/view/2018/8/28/1818979.png,0,0.989880264,171,145,595,569,424,424,pinkie pie
1826976.png,https://derpicdn.net/img/view/2018/9/7/1826976.png,0,0.987642467,325,36,997,708,672,672,pinkie pie
1827615.png,https://derpicdn.net/img/view/2018/9/8/1827615.png,0,0.964406967,199,96,519,416,320,320,pinkie pie
18279.png,https://derpicdn.net/img/view/2012/6/24/18279.png,0,0.984814823,106,0,502,381,396,381,pinkie pie
1830761.png,https://derpicdn.net/img/view/2018/9/12/1830761.png,0,0.987831831,0,3,441,471,441,468,pinkie pie
1831456.png,https://derpicdn.net/img/view/2018/9/13/1831456.png,0,0.981620729,1453,12,1819,378,366,366,pinkie pie
1831456.png,https://derpicdn.net/img/view/2018/9/13/1831456.png,1,0.973528504,68,19,392,343,324,324,pinkie pie
1847776.png,https://derpicdn.net/img/view/2018/10/4/1847776.png,0,0.922694027,1610,237,2872,1499,1262,1262,pinkie pie
1848443.png,https://derpicdn.net/img/view/2018/10/5/1848443.png,0,0.955775201,818,334,1794,1310,976,976,pinkie pie
1850263.png,https://derpicdn.net/img/view/2018/10/7/1850263.png,0,0.964279056,621,18,1695,1092,1074,1074,pinkie pie
1852694.png,https://derpicdn.net/img/view/2018/10/10/1852694.png,0,0.993409336,93,9,343,259,250,250,pinkie pie
1857793.png,https://derpicdn.net/img/view/2018/10/16/1857793.png,0,0.955757141,72,0,452,366,380,366,pinkie pie
1858180.png,https://derpicdn.net/img/view/2018/10/16/1858180.png,0,0.963946283,0,103,849,997,849,894,pinkie pie
1862008.png,https://derpicdn.net/img/view/2018/10/21/1862008.png,0,0.930813909,0,0,6736,6805,6736,6805,pinkie pie
1867668.png,https://derpicdn.net/img/view/2018/10/27/1867668.png,0,0.987193942,362,0,1920,1080,1558,1080,pinkie pie
1867721.png,https://derpicdn.net/img/view/2018/10/27/1867721.png,0,0.909239948,24,0,1532,1080,1508,1080,pinkie pie
1890023.png,https://derpicdn.net/img/view/2018/11/24/1890023.png,0,0.965423524,1271,295,2085,1109,814,814,pinkie pie
1892455.png,https://derpicdn.net/img/view/2018/11/27/1892455.png,0,0.97773087,378,0,2916,2201,2538,2201,pinkie pie
1898672.png,https://derpicdn.net/img/view/2018/12/5/1898672.png,0,0.906123281,45,16,516,544,471,528,pinkie pie
1903302.png,https://derpicdn.net/img/view/2018/12/9/1903302.png,0,0.990908265,207,0,739,506,532,506,pinkie pie
1904134.png,https://derpicdn.net/img/view/2018/12/10/1904134.png,0,0.962599456,0,0,2122,2305,2122,2305,pinkie pie
1907368.png,https://derpicdn.net/img/view/2018/12/13/1907368.png,0,0.985650778,60,0,668,598,608,598,pinkie pie
1923958.png,https://derpicdn.net/img/view/2019/1/1/1923958.png,0,0.918242395,70,60,500,490,430,430,pinkie pie
1926917.png,https://derpicdn.net/img/view/2019/1/5/1926917.png,0,0.926214516,132,21,1450,1339,1318,1318,pinkie pie
1928732.png,https://derpicdn.net/img/view/2019/1/7/1928732.png,0,0.94793272,384,52,948,616,564,564,pinkie pie
1928813.png,https://derpicdn.net/img/view/2019/1/7/1928813.png,0,0.906891942,1295,977,1815,1497,520,520,pinkie pie
1933529.png,https://derpicdn.net/img/view/2019/1/12/1933529.png,0,0.998531818,267,0,1423,1153,1156,1153,pinkie pie
1933851.png,https://derpicdn.net/img/view/2019/1/13/1933851.png,0,0.990416229,9,0,638,613,629,613,pinkie pie
1936741.png,https://derpicdn.net/img/view/2019/1/16/1936741.png,0,0.998077393,117,12,477,372,360,360,pinkie pie
1947615.png,https://derpicdn.net/img/view/2019/1/29/1947615.png,0,0.930434585,22,0,502,473,480,473,pinkie pie
194872.png,https://derpicdn.net/img/view/2012/12/27/194872.png,0,0.980588078,1004,369,3564,2929,2560,2560,pinkie pie
1949376.png,https://derpicdn.net/img/view/2019/1/31/1949376.png,0,0.928677559,0,28,466,518,466,490,pinkie pie
1953783.png,https://derpicdn.net/img/view/2019/2/5/1953783.png,0,0.960842073,299,0,3833,3411,3534,3411,pinkie pie
1956368.png,https://derpicdn.net/img/view/2019/2/8/1956368.png,0,0.997643709,387,0,1027,633,640,633,pinkie pie
1960809.png,https://derpicdn.net/img/view/2019/2/13/1960809.png,0,0.946067512,0,0,366,380,366,380,pinkie pie
1961457.png,https://derpicdn.net/img/view/2019/2/14/1961457.png,0,0.985814095,15,0,1005,914,990,914,pinkie pie
1964917.png,https://derpicdn.net/img/view/2019/2/18/1964917.png,0,0.968990862,160,0,550,373,390,373,pinkie pie
1965817.png,https://derpicdn.net/img/view/2019/2/19/1965817.png,0,0.964380503,990,0,1134,138,144,138,pinkie pie
1972809.png,https://derpicdn.net/img/view/2019/2/27/1972809.png,0,0.967929661,0,0,1135,1081,1135,1081,pinkie pie
1981044.png,https://derpicdn.net/img/view/2019/3/9/1981044.png,0,0.998536527,1390,0,3074,1537,1684,1537,pinkie pie
1982744.png,https://derpicdn.net/img/view/2019/3/11/1982744.png,0,0.962473512,41,0,475,431,434,431,pinkie pie
1990582.png,https://derpicdn.net/img/view/2019/3/20/1990582.png,0,0.996110201,22,0,466,405,444,405,pinkie pie
1997162.png,https://derpicdn.net/img/view/2019/3/29/1997162.png,0,0.94191128,420,0,1070,593,650,593,pinkie pie
2011361.png,https://derpicdn.net/img/view/2019/4/13/2011361.png,0,0.988145113,14,0,684,631,670,631,pinkie pie
2014840.png,https://derpicdn.net/img/view/2019/4/17/2014840.png,0,0.974003196,343,653,923,1233,580,580,pinkie pie
2014840.png,https://derpicdn.net/img/view/2019/4/17/2014840.png,1,0.967888653,99,939,451,1291,352,352,pinkie pie
2016089.png,https://derpicdn.net/img/view/2019/4/18/2016089.png,0,0.981421947,1971,2342,3313,3684,1342,1342,pinkie pie
2016473.png,https://derpicdn.net/img/view/2019/4/19/2016473.png,0,0.920069039,272,0,1228,911,956,911,pinkie pie
2017924.png,https://derpicdn.net/img/view/2019/4/20/2017924.png,0,0.946041048,0,0,729,840,729,840,pinkie pie
2031019.png,https://derpicdn.net/img/view/2019/5/5/2031019.png,0,0.947857499,170,52,880,762,710,710,pinkie pie
2034556.png,https://derpicdn.net/img/view/2019/5/9/2034556.png,0,0.982273161,41,27,603,589,562,562,pinkie pie
2040683.png,https://derpicdn.net/img/view/2019/5/16/2040683.png,0,0.988401771,1555,833,3095,2373,1540,1540,pinkie pie
2047332.png,https://derpicdn.net/img/view/2019/5/24/2047332.png,0,0.995409489,454,253,706,505,252,252,pinkie pie
2047332.png,https://derpicdn.net/img/view/2019/5/24/2047332.png,1,0.988843501,286,0,570,284,284,284,pinkie pie
2048947.png,https://derpicdn.net/img/view/2019/5/25/2048947.png,0,0.925430238,72,163,4868,4959,4796,4796,pinkie pie
2052880.png,https://derpicdn.net/img/view/2019/5/29/2052880.png,0,0.962415814,44,0,692,625,648,625,pinkie pie
2054055.png,https://derpicdn.net/img/view/2019/5/31/2054055.png,0,0.990362823,108,0,1110,943,1002,943,pinkie pie
2058067.png,https://derpicdn.net/img/view/2019/6/4/2058067.png,0,0.932416439,64,0,418,347,354,347,pinkie pie
2063867.png,https://derpicdn.net/img/view/2019/6/12/2063867.png,0,0.97285974,0,0,2067,2465,2067,2465,pinkie pie
2064226.png,https://derpicdn.net/img/view/2019/6/13/2064226.png,0,0.993824184,45,0,469,367,424,367,pinkie pie
2072371.png,https://derpicdn.net/img/view/2019/6/22/2072371.png,0,0.970163643,0,0,384,369,384,369,pinkie pie
2072380.png,https://derpicdn.net/img/view/2019/6/22/2072380.png,0,0.993610024,339,21,585,267,246,246,pinkie pie
2076140.png,https://derpicdn.net/img/view/2019/6/26/2076140.png,0,0.984343708,632,0,2532,1877,1900,1877,pinkie pie
2078287.png,https://derpicdn.net/img/view/2019/6/29/2078287.png,0,0.979758024,24,0,385,365,361,365,pinkie pie
2080750.png,https://derpicdn.net/img/view/2019/7/1/2080750.png,0,0.994098961,1016,0,2600,1377,1584,1377,pinkie pie
2082260.png,https://derpicdn.net/img/view/2019/7/3/2082260.png,0,0.969397366,409,373,1280,1280,871,907,pinkie pie
2087282.png,https://derpicdn.net/img/view/2019/7/9/2087282.png,0,0.937549055,1595,343,2637,1385,1042,1042,pinkie pie
2088211.png,https://derpicdn.net/img/view/2019/7/10/2088211.png,0,0.98995167,1299,1227,1709,1637,410,410,pinkie pie
2088211.png,https://derpicdn.net/img/view/2019/7/10/2088211.png,1,0.98552388,483,359,961,837,478,478,pinkie pie
2088211.png,https://derpicdn.net/img/view/2019/7/10/2088211.png,2,0.912785053,1301,440,1701,840,400,400,pinkie pie
2099141.png,https://derpicdn.net/img/view/2019/7/23/2099141.png,0,0.997236609,758,0,2430,1626,1672,1626,pinkie pie
2102997.png,https://derpicdn.net/img/view/2019/7/28/2102997.png,0,0.990633488,115,22,577,484,462,462,pinkie pie
21053.jpg,https://derpicdn.net/img/view/2012/6/26/21053.jpg,0,0.974600792,361,256,693,588,332,332,pinkie pie
2108854.png,https://derpicdn.net/img/view/2019/8/4/2108854.png,0,0.991158307,0,0,1370,1349,1370,1349,pinkie pie
2110317.png,https://derpicdn.net/img/view/2019/8/6/2110317.png,0,0.936695933,92,0,1000,1083,908,1083,pinkie pie
2110533.png,https://derpicdn.net/img/view/2019/8/6/2110533.png,0,0.946869791,113,0,2189,2063,2076,2063,pinkie pie
2113914.png,https://derpicdn.net/img/view/2019/8/10/2113914.png,0,0.926914454,42,98,884,940,842,842,pinkie pie
2118202.png,https://derpicdn.net/img/view/2019/8/14/2118202.png,0,0.997674465,101,23,875,797,774,774,pinkie pie
2120510.png,https://derpicdn.net/img/view/2019/8/17/2120510.png,0,0.960333407,39,0,353,296,314,296,pinkie pie
2128591.png,https://derpicdn.net/img/view/2019/8/26/2128591.png,0,0.998325288,158,0,1912,1579,1754,1579,pinkie pie
212929.png,https://derpicdn.net/img/view/2013/1/15/212929.png,0,0.954209447,533,152,1599,1218,1066,1066,pinkie pie
2132619.png,https://derpicdn.net/img/view/2019/8/31/2132619.png,0,0.966248572,308,15,804,511,496,496,pinkie pie
2135964.png,https://derpicdn.net/img/view/2019/9/4/2135964.png,0,0.914063931,1394,868,3634,3108,2240,2240,pinkie pie
2137093.png,https://derpicdn.net/img/view/2019/9/5/2137093.png,1,0.963231981,173,1442,863,2132,690,690,pinkie pie
2138123.png,https://derpicdn.net/img/view/2019/9/7/2138123.png,0,0.988675535,113,0,1057,790,944,790,pinkie pie
2138362.png,https://derpicdn.net/img/view/2019/9/7/2138362.png,0,0.964214265,5,0,593,516,588,516,pinkie pie
2138910.png,https://derpicdn.net/img/view/2019/9/7/2138910.png,0,0.952464104,37,0,1137,1026,1100,1026,pinkie pie
2139294.png,https://derpicdn.net/img/view/2019/9/8/2139294.png,0,0.956546545,189,157,757,725,568,568,pinkie pie
2141569.png,https://derpicdn.net/img/view/2019/9/11/2141569.png,0,0.977168083,110,0,1814,1381,1704,1381,pinkie pie
2151470.png,https://derpicdn.net/img/view/2019/9/23/2151470.png,0,0.978722572,10,0,471,452,461,452,pinkie pie
2151473.png,https://derpicdn.net/img/view/2019/9/23/2151473.png,0,0.969904244,164,0,726,553,562,553,pinkie pie
2154509.png,https://derpicdn.net/img/view/2019/9/27/2154509.png,0,0.933856726,16,0,1106,931,1090,931,pinkie pie
2168110.png,https://derpicdn.net/img/view/2019/10/13/2168110.png,0,0.91585356,224,0,1000,795,776,795,pinkie pie
2169092.png,https://derpicdn.net/img/view/2019/10/14/2169092.png,0,0.981447279,264,22,704,462,440,440,pinkie pie
2171464.png,https://derpicdn.net/img/view/2019/10/17/2171464.png,0,0.976717591,2148,990,4318,3160,2170,2170,pinkie pie
2172413.png,https://derpicdn.net/img/view/2019/10/18/2172413.png,0,0.980762661,27,36,951,960,924,924,pinkie pie
2172935.png,https://derpicdn.net/img/view/2019/10/18/2172935.png,0,0.998928726,322,383,1170,1231,848,848,pinkie pie
2174143.png,https://derpicdn.net/img/view/2019/10/20/2174143.png,0,0.985918999,2327,919,3389,1981,1062,1062,pinkie pie
2176599.png,https://derpicdn.net/img/view/2019/10/23/2176599.png,0,0.982616723,188,171,556,539,368,368,pinkie pie
2181928.png,https://derpicdn.net/img/view/2019/10/29/2181928.png,0,0.928718746,279,97,960,839,681,742,pinkie pie
2198844.png,https://derpicdn.net/img/view/2019/11/17/2198844.png,0,0.980250537,0,0,592,582,592,582,pinkie pie
2198988.png,https://derpicdn.net/img/view/2019/11/17/2198988.png,0,0.99330616,83,0,3735,3450,3652,3450,pinkie pie
2199013.png,https://derpicdn.net/img/view/2019/11/17/2199013.png,0,0.988554001,348,0,2204,1654,1856,1654,pinkie pie
2202292.png,https://derpicdn.net/img/view/2019/11/21/2202292.png,0,0.976117969,471,0,3721,2950,3250,2950,pinkie pie
2203185.png,https://derpicdn.net/img/view/2019/11/23/2203185.png,0,0.998303175,790,225,1290,725,500,500,pinkie pie
2205859.png,https://derpicdn.net/img/view/2019/11/26/2205859.png,0,0.905612171,30,0,430,352,400,352,pinkie pie
2210203.png,https://derpicdn.net/img/view/2019/12/1/2210203.png,0,0.907776773,965,223,1691,949,726,726,pinkie pie
2215835.png,https://derpicdn.net/img/view/2019/12/8/2215835.png,0,0.965539098,2091,0,9281,7015,7190,7015,pinkie pie
2216645.png,https://derpicdn.net/img/view/2019/12/9/2216645.png,0,0.982406735,62,0,1094,889,1032,889,pinkie pie
2218768.png,https://derpicdn.net/img/view/2019/12/12/2218768.png,0,0.998691916,29,0,421,338,392,338,pinkie pie
2218768.png,https://derpicdn.net/img/view/2019/12/12/2218768.png,1,0.992834687,873,0,1271,337,398,337,pinkie pie
2218768.png,https://derpicdn.net/img/view/2019/12/12/2218768.png,2,0.99024719,187,445,551,809,364,364,pinkie pie
2218768.png,https://derpicdn.net/img/view/2019/12/12/2218768.png,3,0.985886216,605,516,953,864,348,348,pinkie pie
2226518.png,https://derpicdn.net/img/view/2019/12/21/2226518.png,0,0.982130766,20,0,500,501,480,501,pinkie pie
2227998.jpg,https://derpicdn.net/img/view/2019/12/23/2227998.jpg,0,0.995938063,214,6,878,670,664,664,pinkie pie
2228058.png,https://derpicdn.net/img/view/2019/12/23/2228058.png,0,0.977731407,46,3,276,233,230,230,pinkie pie
2234384.png,https://derpicdn.net/img/view/2019/12/31/2234384.png,0,0.998595119,24,63,274,313,250,250,pinkie pie
2237306.png,https://derpicdn.net/img/view/2020/1/3/2237306.png,0,0.983474672,40,0,996,955,956,955,pinkie pie
2238971.png,https://derpicdn.net/img/view/2020/1/4/2238971.png,0,0.983176649,7,0,243,233,236,233,pinkie pie
22392.png,https://derpicdn.net/img/view/2012/6/27/22392.png,0,0.907387912,72,5,382,315,310,310,pinkie pie
2245453.jpg,https://derpicdn.net/img/view/2020/1/12/2245453.jpg,0,0.974140048,0,0,1945,2038,1945,2038,pinkie pie
2248322.jpg,https://derpicdn.net/img/view/2020/1/15/2248322.jpg,0,0.992441654,338,41,1232,935,894,894,pinkie pie
2249128.png,https://derpicdn.net/img/view/2020/1/16/2249128.png,0,0.992562294,395,0,1011,576,616,576,pinkie pie
2257956.jpg,https://derpicdn.net/img/view/2020/1/26/2257956.jpg,0,0.985824108,251,1115,517,1381,266,266,pinkie pie
2259083.jpg,https://derpicdn.net/img/view/2020/1/28/2259083.jpg,0,0.959364772,1693,196,2969,1472,1276,1276,pinkie pie
2260783.jpg,https://derpicdn.net/img/view/2020/1/30/2260783.jpg,0,0.986517429,248,55,932,739,684,684,pinkie pie
2261031.png,https://derpicdn.net/img/view/2020/1/30/2261031.png,0,0.92374754,31,0,589,516,558,516,pinkie pie
2262335.jpg,https://derpicdn.net/img/view/2020/2/1/2262335.jpg,0,0.941486657,75,21,325,271,250,250,pinkie pie
2262355.jpg,https://derpicdn.net/img/view/2020/2/1/2262355.jpg,0,0.973480821,128,0,1374,1194,1246,1194,pinkie pie
2263448.png,https://derpicdn.net/img/view/2020/2/2/2263448.png,0,0.988652408,0,13,778,867,778,854,pinkie pie
2263652.png,https://derpicdn.net/img/view/2020/2/2/2263652.png,0,0.953357816,37,0,433,390,396,390,pinkie pie
2270402.jpg,https://derpicdn.net/img/view/2020/2/10/2270402.jpg,1,0.985769749,329,17,641,329,312,312,pinkie pie
2271362.png,https://derpicdn.net/img/view/2020/2/11/2271362.png,0,0.91923815,724,940,2452,2668,1728,1728,pinkie pie
2272224.png,https://derpicdn.net/img/view/2020/2/12/2272224.png,0,0.924404442,0,3,799,939,799,936,pinkie pie
2275605.png,https://derpicdn.net/img/view/2020/2/16/2275605.png,0,0.932570994,80,0,1236,1147,1156,1147,pinkie pie
2286447.png,https://derpicdn.net/img/view/2020/2/29/2286447.png,0,0.990911484,189,2,1145,958,956,956,pinkie pie
2289742.jpg,https://derpicdn.net/img/view/2020/3/4/2289742.jpg,0,0.945815086,232,715,694,1177,462,462,pinkie pie
2300907.png,https://derpicdn.net/img/view/2020/3/19/2300907.png,0,0.982886434,210,59,632,481,422,422,pinkie pie
2304756.jpg,https://derpicdn.net/img/view/2020/3/24/2304756.jpg,0,0.996647596,13,0,501,428,488,428,pinkie pie
2304756.jpg,https://derpicdn.net/img/view/2020/3/24/2304756.jpg,3,0.985229135,1153,0,1579,404,426,404,pinkie pie
2304756.jpg,https://derpicdn.net/img/view/2020/3/24/2304756.jpg,4,0.949189663,8,473,596,1061,588,588,pinkie pie
2304880.jpg,https://derpicdn.net/img/view/2020/3/24/2304880.jpg,0,0.934282005,30,0,594,556,564,556,pinkie pie
2305929.jpg,https://derpicdn.net/img/view/2020/3/25/2305929.jpg,0,0.981336474,107,0,1139,720,1032,720,pinkie pie
2307507.png,https://derpicdn.net/img/view/2020/3/27/2307507.png,0,0.911868751,66,0,606,526,540,526,pinkie pie
2314438.jpg,https://derpicdn.net/img/view/2020/4/5/2314438.jpg,0,0.984949768,0,0,3024,3323,3024,3323,pinkie pie
2314811.png,https://derpicdn.net/img/view/2020/4/5/2314811.png,0,0.993730545,2968,2562,3566,3160,598,598,pinkie pie
2318508.png,https://derpicdn.net/img/view/2020/4/10/2318508.png,0,0.998251855,885,787,1345,1247,460,460,pinkie pie
2318508.png,https://derpicdn.net/img/view/2020/4/10/2318508.png,1,0.994664192,681,30,1293,642,612,612,pinkie pie
2322597.jpg,https://derpicdn.net/img/view/2020/4/14/2322597.jpg,0,0.923814178,204,16,662,474,458,458,pinkie pie
2324678.png,https://derpicdn.net/img/view/2020/4/17/2324678.png,0,0.98278749,0,23,595,709,595,686,pinkie pie
2326172.png,https://derpicdn.net/img/view/2020/4/19/2326172.png,0,0.971001148,546,385,1462,1301,916,916,pinkie pie
2327391.png,https://derpicdn.net/img/view/2020/4/20/2327391.png,0,0.997128427,3137,155,6125,3143,2988,2988,pinkie pie
2327495.jpg,https://derpicdn.net/img/view/2020/4/20/2327495.jpg,0,0.990111291,700,0,1986,1103,1286,1103,pinkie pie
2331528.png,https://derpicdn.net/img/view/2020/4/25/2331528.png,0,0.927701712,0,0,1242,1059,1242,1059,pinkie pie
2338595.png,https://derpicdn.net/img/view/2020/5/3/2338595.png,0,0.976445198,0,0,572,596,572,596,pinkie pie
2339452.png,https://derpicdn.net/img/view/2020/5/4/2339452.png,0,0.958390236,125,0,617,481,492,481,pinkie pie
2342029.png,https://derpicdn.net/img/view/2020/5/7/2342029.png,0,0.969980538,315,98,723,506,408,408,pinkie pie
2348548.jpg,https://derpicdn.net/img/view/2020/5/14/2348548.jpg,0,0.90813601,442,879,1680,2117,1238,1238,pinkie pie
2350821.png,https://derpicdn.net/img/view/2020/5/17/2350821.png,0,0.916449845,640,191,1638,1189,998,998,pinkie pie
2352184.png,https://derpicdn.net/img/view/2020/5/18/2352184.png,0,0.983159304,0,0,2236,2000,2236,2000,pinkie pie
2352515.jpg,https://derpicdn.net/img/view/2020/5/19/2352515.jpg,0,0.918452144,51,0,939,883,888,883,pinkie pie
2356172.png,https://derpicdn.net/img/view/2020/5/23/2356172.png,0,0.999195933,198,0,770,548,572,548,pinkie pie
246539.png,https://derpicdn.net/img/view/2013/2/17/246539.png,0,0.993457794,0,59,718,899,718,840,pinkie pie
262286.png,https://derpicdn.net/img/view/2013/3/4/262286.png,0,0.914172649,275,0,1281,1000,1006,1000,pinkie pie
270783.jpg,https://derpicdn.net/img/view/2013/3/15/270783.jpg,0,0.960510015,83,6,497,420,414,414,pinkie pie
27467.png,https://derpicdn.net/img/view/2012/7/1/27467.png,0,0.989994109,1113,497,1663,1047,550,550,pinkie pie
282460.png,https://derpicdn.net/img/view/2013/3/29/282460.png,0,0.975652099,110,0,520,406,410,406,pinkie pie
283012.png,https://derpicdn.net/img/view/2013/3/30/283012.png,0,0.920377195,0,0,2178,2547,2178,2547,pinkie pie
284281.jpg,https://derpicdn.net/img/view/2013/3/31/284281.jpg,0,0.93025142,147,310,387,550,240,240,pinkie pie
286873.png,https://derpicdn.net/img/view/2013/4/3/286873.png,0,0.986635506,341,0,841,440,500,440,pinkie pie
299765.png,https://derpicdn.net/img/view/2013/4/16/299765.png,0,0.995616138,155,0,555,353,400,353,pinkie pie
299846.png,https://derpicdn.net/img/view/2013/4/16/299846.png,0,0.979542732,32,0,1194,1115,1162,1115,pinkie pie
306247.jpg,https://derpicdn.net/img/view/2013/4/23/306247.jpg,0,0.975094378,245,16,721,492,476,476,pinkie pie
309376.png,https://derpicdn.net/img/view/2013/4/27/309376.png,0,0.924582124,20,16,240,236,220,220,pinkie pie
31423.png,https://derpicdn.net/img/view/2012/7/4/31423.png,0,0.988999248,20,53,810,812,790,759,pinkie pie
322828.png,https://derpicdn.net/img/view/2013/5/12/322828.png,0,0.99002558,26,69,660,750,634,681,pinkie pie
330822.png,https://derpicdn.net/img/view/2013/5/21/330822.png,0,0.975781381,262,27,574,339,312,312,pinkie pie
342109.png,https://derpicdn.net/img/view/2013/6/7/342109.png,0,0.944354594,95,73,451,429,356,356,pinkie pie
342470.png,https://derpicdn.net/img/view/2013/6/7/342470.png,0,0.937410593,142,215,1000,1073,858,858,pinkie pie
353726.jpg,https://derpicdn.net/img/view/2013/6/21/353726.jpg,0,0.975451767,125,0,489,355,364,355,pinkie pie
357873.png,https://derpicdn.net/img/view/2013/6/26/357873.png,0,0.981390536,0,109,1280,1841,1280,1732,pinkie pie
358680.png,https://derpicdn.net/img/view/2013/6/27/358680.png,0,0.996901214,837,415,1575,1153,738,738,pinkie pie
3652.png,https://derpicdn.net/img/view/2012/2/29/3652.png,0,0.906376183,730,43,1252,565,522,522,pinkie pie
368039.png,https://derpicdn.net/img/view/2013/7/9/368039.png,0,0.923709631,344,50,898,604,554,554,pinkie pie
385601.jpg,https://derpicdn.net/img/view/2013/7/30/385601.jpg,0,0.928490639,153,4,479,330,326,326,pinkie pie
394319.jpg,https://derpicdn.net/img/view/2013/8/8/394319.jpg,0,0.97830373,17,30,361,374,344,344,pinkie pie
411130.jpg,https://derpicdn.net/img/view/2013/8/26/411130.jpg,0,0.984672308,106,0,884,747,778,747,pinkie pie
425018.jpg,https://derpicdn.net/img/view/2013/9/11/425018.jpg,0,0.986812174,0,0,307,286,307,286,pinkie pie
425412.png,https://derpicdn.net/img/view/2013/9/11/425412.png,0,0.997725904,196,0,474,266,278,266,pinkie pie
429601.png,https://derpicdn.net/img/view/2013/9/17/429601.png,0,0.998277903,161,8,487,334,326,326,pinkie pie
430158.png,https://derpicdn.net/img/view/2013/9/18/430158.png,1,0.988844693,373,4,765,396,392,392,pinkie pie
4387.jpg,https://derpicdn.net/img/view/2012/6/6/4387.jpg,0,0.962101758,2451,804,3367,1720,916,916,pinkie pie
439421.png,https://derpicdn.net/img/view/2013/10/1/439421.png,0,0.938561082,494,25,1572,1103,1078,1078,pinkie pie
454612.png,https://derpicdn.net/img/view/2013/10/23/454612.png,0,0.907012343,402,4370,1048,5016,646,646,pinkie pie
460601.png,https://derpicdn.net/img/view/2013/10/30/460601.png,0,0.977440536,117,0,795,664,678,664,pinkie pie
4658.jpg,https://derpicdn.net/img/view/2012/6/17/4658.jpg,0,0.945234358,342,5,628,291,286,286,pinkie pie
482495.png,https://derpicdn.net/img/view/2013/11/26/482495.png,0,0.908936203,570,42,1200,672,630,630,pinkie pie
506175.jpg,https://derpicdn.net/img/view/2013/12/25/506175.jpg,0,0.96326375,1351,566,1673,888,322,322,pinkie pie
507529.jpg,https://derpicdn.net/img/view/2013/12/27/507529.jpg,0,0.996043503,106,0,740,606,634,606,pinkie pie
53929.png,https://derpicdn.net/img/view/2012/7/23/53929.png,0,0.996430933,671,265,1353,947,682,682,pinkie pie
551680.png,https://derpicdn.net/img/view/2014/2/14/551680.png,0,0.988574147,130,0,696,541,566,541,pinkie pie
561854.png,https://derpicdn.net/img/view/2014/2/26/561854.png,0,0.912619174,258,0,742,481,484,481,pinkie pie
562799.png,https://derpicdn.net/img/view/2014/2/27/562799.png,0,0.972032905,427,193,807,573,380,380,pinkie pie
563328.jpg,https://derpicdn.net/img/view/2014/2/28/563328.jpg,0,0.953133881,2,11,282,291,280,280,pinkie pie
563830.png,https://derpicdn.net/img/view/2014/3/1/563830.png,0,0.985101402,0,0,562,568,562,568,pinkie pie
56552.png,https://derpicdn.net/img/view/2012/7/25/56552.png,0,0.950987518,20,0,916,778,896,778,pinkie pie
570911.png,https://derpicdn.net/img/view/2014/3/9/570911.png,0,0.992386162,175,0,461,270,286,270,pinkie pie
575636.png,https://derpicdn.net/img/view/2014/3/15/575636.png,0,0.965367854,38,103,1528,1593,1490,1490,pinkie pie
598307.png,https://derpicdn.net/img/view/2014/4/12/598307.png,0,0.953511238,0,0,2244,2252,2244,2252,pinkie pie
599796.png,https://derpicdn.net/img/view/2014/4/13/599796.png,0,0.974165142,98,0,564,419,466,419,pinkie pie
602865.png,https://derpicdn.net/img/view/2014/4/17/602865.png,0,0.942576587,485,0,1574,996,1089,996,pinkie pie
605844.jpg,https://derpicdn.net/img/view/2014/4/20/605844.jpg,0,0.998623729,1495,0,2713,1040,1218,1040,pinkie pie
610198.png,https://derpicdn.net/img/view/2014/4/26/610198.png,0,0.938105822,1545,0,3461,1897,1916,1897,pinkie pie
610255.png,https://derpicdn.net/img/view/2014/4/26/610255.png,0,0.997358739,1712,0,4628,2591,2916,2591,pinkie pie
637366.png,https://derpicdn.net/img/view/2014/5/26/637366.png,0,0.998742342,49,0,305,245,256,245,pinkie pie
639528.png,https://derpicdn.net/img/view/2014/5/29/639528.png,0,0.999362648,85,941,655,1511,570,570,pinkie pie
643106.png,https://derpicdn.net/img/view/2014/6/2/643106.png,0,0.974308133,0,35,454,543,454,508,pinkie pie
652638.png,https://derpicdn.net/img/view/2014/6/14/652638.png,0,0.9886325,0,0,469,455,469,455,pinkie pie
664815.png,https://derpicdn.net/img/view/2014/6/30/664815.png,0,0.99390465,34,0,518,463,484,463,pinkie pie
672399.png,https://derpicdn.net/img/view/2014/7/11/672399.png,0,0.931797266,573,216,985,628,412,412,pinkie pie
674771.jpg,https://derpicdn.net/img/view/2014/7/14/674771.jpg,0,0.957971513,373,19,891,537,518,518,pinkie pie
679186.jpg,https://derpicdn.net/img/view/2014/7/20/679186.jpg,0,0.996419132,147,0,481,333,334,333,pinkie pie
684.jpg,https://derpicdn.net/img/view/2012/1/17/684.jpg,0,0.977841616,0,0,576,587,576,587,pinkie pie
700820.png,https://derpicdn.net/img/view/2014/8/16/700820.png,0,0.952970624,67,0,665,562,598,562,pinkie pie
703044.png,https://derpicdn.net/img/view/2014/8/19/703044.png,0,0.945172668,10,0,468,416,458,416,pinkie pie
705690.png,https://derpicdn.net/img/view/2014/8/22/705690.png,0,0.985434473,655,242,1045,632,390,390,pinkie pie
728528.png,https://derpicdn.net/img/view/2014/9/24/728528.png,0,0.99012357,810,227,1590,1007,780,780,pinkie pie
738052.png,https://derpicdn.net/img/view/2014/10/7/738052.png,0,0.922444046,114,408,452,746,338,338,pinkie pie
740825.jpg,https://derpicdn.net/img/view/2014/10/11/740825.jpg,0,0.998964608,16,22,494,500,478,478,pinkie pie
742535.png,https://derpicdn.net/img/view/2014/10/14/742535.png,0,0.947083652,390,98,766,474,376,376,pinkie pie
74747.jpg,https://derpicdn.net/img/view/2012/8/14/74747.jpg,0,0.996957004,51,0,429,315,378,315,pinkie pie
748242.jpg,https://derpicdn.net/img/view/2014/10/22/748242.jpg,0,0.993376493,71,0,339,260,268,260,pinkie pie
761066.png,https://derpicdn.net/img/view/2014/11/9/761066.png,0,0.901486754,215,0,567,336,352,336,pinkie pie
762863.png,https://derpicdn.net/img/view/2014/11/12/762863.png,0,0.987763882,0,0,2445,2479,2445,2479,pinkie pie
768365.png,https://derpicdn.net/img/view/2014/11/20/768365.png,0,0.921819508,127,0,581,431,454,431,pinkie pie
770368.png,https://derpicdn.net/img/view/2014/11/23/770368.png,0,0.985481739,0,5,549,669,549,664,pinkie pie
773177.png,https://derpicdn.net/img/view/2014/11/27/773177.png,0,0.996893227,107,0,659,528,552,528,pinkie pie
776993.png,https://derpicdn.net/img/view/2014/12/3/776993.png,0,0.981334388,343,212,693,562,350,350,pinkie pie
780255.png,https://derpicdn.net/img/view/2014/12/7/780255.png,0,0.910237312,958,524,2212,1778,1254,1254,pinkie pie
789095.jpg,https://derpicdn.net/img/view/2014/12/20/789095.jpg,0,0.986217201,471,182,850,592,379,410,pinkie pie
795032.png,https://derpicdn.net/img/view/2014/12/29/795032.png,0,0.997994304,92,0,638,529,546,529,pinkie pie
805592.png,https://derpicdn.net/img/view/2015/1/13/805592.png,0,0.975288153,307,0,799,487,492,487,pinkie pie
806345.png,https://derpicdn.net/img/view/2015/1/14/806345.png,0,0.928922653,1019,799,5000,5000,3981,4201,pinkie pie
818530.jpg,https://derpicdn.net/img/view/2015/1/31/818530.jpg,0,0.993307531,410,0,1150,630,740,630,pinkie pie
827004.png,https://derpicdn.net/img/view/2015/2/12/827004.png,0,0.923614204,129,0,839,682,710,682,pinkie pie
828507.png,https://derpicdn.net/img/view/2015/2/14/828507.png,0,0.987958252,145,0,919,767,774,767,pinkie pie
833382.png,https://derpicdn.net/img/view/2015/2/20/833382.png,0,0.959425151,328,2,560,234,232,232,pinkie pie
834566.png,https://derpicdn.net/img/view/2015/2/22/834566.png,0,0.985552073,0,2,3842,4062,3842,4060,pinkie pie
837418.jpg,https://derpicdn.net/img/view/2015/2/26/837418.jpg,0,0.988786519,944,0,1416,435,472,435,pinkie pie
837418.jpg,https://derpicdn.net/img/view/2015/2/26/837418.jpg,1,0.982298076,508,0,944,413,436,413,pinkie pie
837418.jpg,https://derpicdn.net/img/view/2015/2/26/837418.jpg,2,0.970860362,11,0,521,450,510,450,pinkie pie
849879.jpg,https://derpicdn.net/img/view/2015/3/15/849879.jpg,0,0.928286433,123,174,570,689,447,515,pinkie pie
861330.png,https://derpicdn.net/img/view/2015/3/31/861330.png,0,0.988400936,955,212,1721,978,766,766,pinkie pie
861662.png,https://derpicdn.net/img/view/2015/3/31/861662.png,0,0.983579159,0,0,1759,1791,1759,1791,pinkie pie
863653.png,https://derpicdn.net/img/view/2015/4/3/863653.png,0,0.994045854,93,14,331,252,238,238,pinkie pie
866431.png,https://derpicdn.net/img/view/2015/4/6/866431.png,0,0.999845743,707,52,1189,534,482,482,pinkie pie
867320.png,https://derpicdn.net/img/view/2015/4/6/867320.png,0,0.939003885,1227,131,1691,595,464,464,pinkie pie
867320.png,https://derpicdn.net/img/view/2015/4/6/867320.png,1,0.936091125,185,22,861,698,676,676,pinkie pie
884015.png,https://derpicdn.net/img/view/2015/4/27/884015.png,0,0.983397424,107,43,541,477,434,434,pinkie pie
884050.png,https://derpicdn.net/img/view/2015/4/27/884050.png,0,0.962689519,18,0,318,327,300,327,pinkie pie
884050.png,https://derpicdn.net/img/view/2015/4/27/884050.png,1,0.948167324,0,1,260,287,260,286,pinkie pie
890573.png,https://derpicdn.net/img/view/2015/5/6/890573.png,0,0.996595919,35,0,669,599,634,599,pinkie pie
893801.png,https://derpicdn.net/img/view/2015/5/11/893801.png,0,0.996653318,398,93,696,391,298,298,pinkie pie
895883.png,https://derpicdn.net/img/view/2015/5/14/895883.png,0,0.989957392,140,48,586,494,446,446,pinkie pie
931694.png,https://derpicdn.net/img/view/2015/7/7/931694.png,0,0.99783814,273,64,641,432,368,368,pinkie pie
938053.png,https://derpicdn.net/img/view/2015/7/16/938053.png,0,0.985660851,58,24,928,894,870,870,pinkie pie
939769.png,https://derpicdn.net/img/view/2015/7/19/939769.png,0,0.906302989,432,345,1198,1111,766,766,pinkie pie
940358.jpg,https://derpicdn.net/img/view/2015/7/20/940358.jpg,0,0.99493736,558,256,1094,792,536,536,pinkie pie
976423.png,https://derpicdn.net/img/view/2015/9/10/976423.png,0,0.998973727,431,86,1005,660,574,574,pinkie pie
980448.png,https://derpicdn.net/img/view/2015/9/15/980448.png,0,0.942454815,241,0,989,613,748,613,pinkie pie
1001729.jpeg,https://derpicdn.net/img/view/2015/10/14/1001729.jpeg,0,0.995510399,683,0,1471,772,788,772,pinkie pie
1002157.jpeg,https://derpicdn.net/img/view/2015/10/14/1002157.jpeg,0,0.997046471,686,0,1472,772,786,772,pinkie pie
1004461.jpeg,https://derpicdn.net/img/view/2015/10/17/1004461.jpeg,0,0.981386483,150,16,840,706,690,690,pinkie pie
1006926.jpeg,https://derpicdn.net/img/view/2015/10/21/1006926.jpeg,0,0.972474873,209,53,483,327,274,274,pinkie pie
1010587.jpeg,https://derpicdn.net/img/view/2015/10/28/1010587.jpeg,0,0.990537524,171,0,547,327,376,327,pinkie pie
1011314.jpeg,https://derpicdn.net/img/view/2015/10/28/1011314.jpeg,0,0.950308561,259,45,1295,1081,1036,1036,pinkie pie
1029174.jpeg,https://derpicdn.net/img/view/2015/11/24/1029174.jpeg,0,0.993088782,312,169,664,521,352,352,pinkie pie
1029336.jpeg,https://derpicdn.net/img/view/2015/11/24/1029336.jpeg,0,0.986567378,137,223,547,633,410,410,pinkie pie
1029982.jpeg,https://derpicdn.net/img/view/2015/11/25/1029982.jpeg,0,0.931055546,108,0,728,554,620,554,pinkie pie
1029991.jpeg,https://derpicdn.net/img/view/2015/11/25/1029991.jpeg,0,0.991651297,295,514,927,1146,632,632,pinkie pie
1043587.jpeg,https://derpicdn.net/img/view/2015/12/13/1043587.jpeg,0,0.965574145,118,0,596,460,478,460,pinkie pie
1044661.jpeg,https://derpicdn.net/img/view/2015/12/15/1044661.jpeg,0,0.987952173,352,44,914,606,562,562,pinkie pie
1050303.jpeg,https://derpicdn.net/img/view/2015/12/22/1050303.jpeg,0,0.930860996,228,234,1700,1706,1472,1472,pinkie pie
1053020.jpeg,https://derpicdn.net/img/view/2015/12/26/1053020.jpeg,0,0.985447645,256,0,670,411,414,411,pinkie pie
1056274.jpeg,https://derpicdn.net/img/view/2015/12/31/1056274.jpeg,0,0.989424527,142,7,492,357,350,350,pinkie pie
1056578.jpeg,https://derpicdn.net/img/view/2015/12/31/1056578.jpeg,0,0.9601686,91,168,483,560,392,392,pinkie pie
1068987.jpeg,https://derpicdn.net/img/view/2016/1/18/1068987.jpeg,0,0.983840168,259,1,611,353,352,352,pinkie pie
1073051.jpeg,https://derpicdn.net/img/view/2016/1/24/1073051.jpeg,0,0.935140073,80,64,558,542,478,478,pinkie pie
1081693.jpeg,https://derpicdn.net/img/view/2016/2/6/1081693.jpeg,0,0.992372453,792,119,2536,1863,1744,1744,pinkie pie
1085298.jpeg,https://derpicdn.net/img/view/2016/2/11/1085298.jpeg,0,0.976704359,0,0,959,943,959,943,pinkie pie
1088062.jpeg,https://derpicdn.net/img/view/2016/2/14/1088062.jpeg,0,0.980246305,0,0,519,486,519,486,pinkie pie
1093341.jpeg,https://derpicdn.net/img/view/2016/2/21/1093341.jpeg,0,0.983416975,160,25,546,411,386,386,pinkie pie
1094126.jpeg,https://derpicdn.net/img/view/2016/2/22/1094126.jpeg,0,0.944090605,250,0,710,456,460,456,pinkie pie
1108324.jpeg,https://derpicdn.net/img/view/2016/3/13/1108324.jpeg,0,0.983131945,121,81,693,653,572,572,pinkie pie
1112275.jpeg,https://derpicdn.net/img/view/2016/3/19/1112275.jpeg,0,0.932559133,354,206,616,468,262,262,pinkie pie
1122303.jpeg,https://derpicdn.net/img/view/2016/4/2/1122303.jpeg,0,0.988652468,352,24,774,446,422,422,pinkie pie
1123458.jpeg,https://derpicdn.net/img/view/2016/4/3/1123458.jpeg,0,0.999238193,194,0,780,542,586,542,pinkie pie
1125363.jpeg,https://derpicdn.net/img/view/2016/4/5/1125363.jpeg,0,0.999246299,464,0,836,357,372,357,pinkie pie
1135519.jpeg,https://derpicdn.net/img/view/2016/4/19/1135519.jpeg,0,0.997556031,53,0,933,849,880,849,pinkie pie
1138337.jpeg,https://derpicdn.net/img/view/2016/4/23/1138337.jpeg,0,0.982035995,913,416,2715,2218,1802,1802,pinkie pie
1140128.jpeg,https://derpicdn.net/img/view/2016/4/26/1140128.jpeg,0,0.958441079,400,129,940,669,540,540,pinkie pie
1150802.jpeg,https://derpicdn.net/img/view/2016/5/10/1150802.jpeg,0,0.990934551,561,0,1167,483,606,483,pinkie pie
1178702.jpeg,https://derpicdn.net/img/view/2016/6/15/1178702.jpeg,0,0.985567212,464,0,1276,779,812,779,pinkie pie
1184106.jpeg,https://derpicdn.net/img/view/2016/6/22/1184106.jpeg,0,0.980434477,483,0,879,392,396,392,pinkie pie
1196241.jpeg,https://derpicdn.net/img/view/2016/7/8/1196241.jpeg,0,0.977320731,396,67,1214,885,818,818,pinkie pie
1196255.jpeg,https://derpicdn.net/img/view/2016/7/8/1196255.jpeg,0,0.994922161,115,48,673,606,558,558,pinkie pie
1197766.jpeg,https://derpicdn.net/img/view/2016/7/10/1197766.jpeg,0,0.970655322,444,303,768,627,324,324,pinkie pie
1207330.jpeg,https://derpicdn.net/img/view/2016/7/23/1207330.jpeg,0,0.992273688,431,0,1531,1088,1100,1088,pinkie pie
1212820.jpeg,https://derpicdn.net/img/view/2016/7/30/1212820.jpeg,0,0.993796825,95,31,453,389,358,358,pinkie pie
1216013.jpeg,https://derpicdn.net/img/view/2016/8/3/1216013.jpeg,0,0.96705097,0,0,479,468,479,468,pinkie pie
1225895.jpeg,https://derpicdn.net/img/view/2016/8/15/1225895.jpeg,0,0.99928683,423,0,1069,607,646,607,pinkie pie
1226114.jpeg,https://derpicdn.net/img/view/2016/8/15/1226114.jpeg,0,0.988564253,474,0,1086,582,612,582,pinkie pie
1239107.jpeg,https://derpicdn.net/img/view/2016/9/1/1239107.jpeg,0,0.994676054,748,175,2068,1495,1320,1320,pinkie pie
1244962.jpeg,https://derpicdn.net/img/view/2016/9/8/1244962.jpeg,0,0.987883747,728,342,1034,648,306,306,pinkie pie
1249891.jpeg,https://derpicdn.net/img/view/2016/9/15/1249891.jpeg,0,0.994235516,111,0,439,325,328,325,pinkie pie
1251616.jpeg,https://derpicdn.net/img/view/2016/9/17/1251616.jpeg,0,0.975304365,10,0,602,572,592,572,pinkie pie
1259788.jpeg,https://derpicdn.net/img/view/2016/9/27/1259788.jpeg,0,0.97900933,0,0,954,909,954,909,pinkie pie
1272192.jpeg,https://derpicdn.net/img/view/2016/10/13/1272192.jpeg,0,0.927730858,414,125,1966,1677,1552,1552,pinkie pie
1278795.jpeg,https://derpicdn.net/img/view/2016/10/22/1278795.jpeg,0,0.990974128,785,0,1623,834,838,834,pinkie pie
1280636.jpeg,https://derpicdn.net/img/view/2016/10/24/1280636.jpeg,0,0.901530325,281,283,841,843,560,560,pinkie pie
1282050.jpeg,https://derpicdn.net/img/view/2016/10/26/1282050.jpeg,0,0.989064395,60,3,300,243,240,240,pinkie pie
1286234.jpeg,https://derpicdn.net/img/view/2016/11/1/1286234.jpeg,0,0.963039994,716,0,998,215,282,215,pinkie pie
1286316.jpeg,https://derpicdn.net/img/view/2016/11/1/1286316.jpeg,0,0.996008575,122,0,606,474,484,474,pinkie pie
1286316.jpeg,https://derpicdn.net/img/view/2016/11/1/1286316.jpeg,1,0.987063408,532,27,1076,571,544,544,pinkie pie
1292578.jpeg,https://derpicdn.net/img/view/2016/11/10/1292578.jpeg,0,0.990737677,56,18,392,354,336,336,pinkie pie
1293389.jpeg,https://derpicdn.net/img/view/2016/11/11/1293389.jpeg,0,0.988709092,69,42,223,196,154,154,pinkie pie
1301145.jpeg,https://derpicdn.net/img/view/2016/11/22/1301145.jpeg,0,0.998376667,428,187,970,729,542,542,pinkie pie
1302669.jpeg,https://derpicdn.net/img/view/2016/11/24/1302669.jpeg,0,0.940070868,211,362,1391,1542,1180,1180,pinkie pie
1303898.jpeg,https://derpicdn.net/img/view/2016/11/26/1303898.jpeg,0,0.95124191,0,121,1301,1491,1301,1370,pinkie pie
1317631.jpeg,https://derpicdn.net/img/view/2016/12/14/1317631.jpeg,0,0.99918133,223,0,669,426,446,426,pinkie pie
1317631.jpeg,https://derpicdn.net/img/view/2016/12/14/1317631.jpeg,1,0.997340024,0,154,301,466,301,312,pinkie pie
1318846.jpeg,https://derpicdn.net/img/view/2016/12/16/1318846.jpeg,0,0.93817842,528,285,756,513,228,228,pinkie pie
1319613.jpeg,https://derpicdn.net/img/view/2016/12/17/1319613.jpeg,1,0.974340856,406,281,638,513,232,232,pinkie pie
1322840.jpeg,https://derpicdn.net/img/view/2016/12/22/1322840.jpeg,0,0.999449968,469,0,835,352,366,352,pinkie pie
1325677.jpeg,https://derpicdn.net/img/view/2016/12/26/1325677.jpeg,0,0.968230784,351,145,1471,1265,1120,1120,pinkie pie
1333776.jpeg,https://derpicdn.net/img/view/2017/1/7/1333776.jpeg,0,0.995381951,195,75,1241,1121,1046,1046,pinkie pie
1337591.jpeg,https://derpicdn.net/img/view/2017/1/12/1337591.jpeg,0,0.981506467,295,327,647,679,352,352,pinkie pie
1338568.jpeg,https://derpicdn.net/img/view/2017/1/13/1338568.jpeg,0,0.996364474,141,10,501,370,360,360,pinkie pie
1338568.jpeg,https://derpicdn.net/img/view/2017/1/13/1338568.jpeg,1,0.910608828,434,14,776,356,342,342,pinkie pie
1348982.jpeg,https://derpicdn.net/img/view/2017/1/27/1348982.jpeg,0,0.998972893,627,0,1493,853,866,853,pinkie pie
1349572.jpeg,https://derpicdn.net/img/view/2017/1/28/1349572.jpeg,0,0.996265113,323,0,750,467,427,467,pinkie pie
1350470.jpeg,https://derpicdn.net/img/view/2017/1/29/1350470.jpeg,0,0.993489802,0,0,575,568,575,568,pinkie pie
1350744.jpeg,https://derpicdn.net/img/view/2017/1/29/1350744.jpeg,0,0.941643298,147,0,877,611,730,611,pinkie pie
1354195.jpeg,https://derpicdn.net/img/view/2017/2/3/1354195.jpeg,0,0.918474615,13,75,879,941,866,866,pinkie pie
1354897.jpeg,https://derpicdn.net/img/view/2017/2/4/1354897.jpeg,0,0.905385792,54,89,658,693,604,604,pinkie pie
1356358.jpeg,https://derpicdn.net/img/view/2017/2/6/1356358.jpeg,0,0.990946651,96,40,812,756,716,716,pinkie pie
1356940.jpeg,https://derpicdn.net/img/view/2017/2/6/1356940.jpeg,0,0.962317109,435,0,1799,1238,1364,1238,pinkie pie
1357388.jpeg,https://derpicdn.net/img/view/2017/2/7/1357388.jpeg,0,0.96721983,1073,303,1763,993,690,690,pinkie pie
1357388.jpeg,https://derpicdn.net/img/view/2017/2/7/1357388.jpeg,1,0.963682771,325,0,1293,876,968,876,pinkie pie
1358404.jpeg,https://derpicdn.net/img/view/2017/2/9/1358404.jpeg,0,0.945810676,1632,0,3264,1507,1632,1507,pinkie pie
1358685.jpeg,https://derpicdn.net/img/view/2017/2/9/1358685.jpeg,0,0.977603793,999,290,2301,1592,1302,1302,pinkie pie
1360562.jpeg,https://derpicdn.net/img/view/2017/2/12/1360562.jpeg,0,0.979783714,3,0,533,352,530,352,pinkie pie
1368550.jpeg,https://derpicdn.net/img/view/2017/2/20/1368550.jpeg,0,0.969187498,99,0,920,883,821,883,pinkie pie
1371144.jpeg,https://derpicdn.net/img/view/2017/2/23/1371144.jpeg,0,0.983007848,294,181,662,549,368,368,pinkie pie
1371690.jpeg,https://derpicdn.net/img/view/2017/2/24/1371690.jpeg,0,0.997032642,99,0,655,549,556,549,pinkie pie
1375515.jpeg,https://derpicdn.net/img/view/2017/2/28/1375515.jpeg,0,0.901735127,1392,340,2136,1084,744,744,pinkie pie
1378984.jpeg,https://derpicdn.net/img/view/2017/3/4/1378984.jpeg,0,0.964914918,91,0,777,646,686,646,pinkie pie
1380781.jpeg,https://derpicdn.net/img/view/2017/3/6/1380781.jpeg,0,0.966149867,479,0,1109,605,630,605,pinkie pie
1381701.jpeg,https://derpicdn.net/img/view/2017/3/7/1381701.jpeg,0,0.999405861,368,450,904,986,536,536,pinkie pie
1382113.jpeg,https://derpicdn.net/img/view/2017/3/8/1382113.jpeg,0,0.926529229,375,384,557,566,182,182,pinkie pie
1382997.jpeg,https://derpicdn.net/img/view/2017/3/9/1382997.jpeg,0,0.998340487,0,0,1248,1207,1248,1207,pinkie pie
1382997.jpeg,https://derpicdn.net/img/view/2017/3/9/1382997.jpeg,1,0.993460834,1334,18,2416,1100,1082,1082,pinkie pie
1387422.jpeg,https://derpicdn.net/img/view/2017/3/15/1387422.jpeg,0,0.962372005,982,510,2160,1688,1178,1178,pinkie pie
1392148.jpeg,https://derpicdn.net/img/view/2017/3/20/1392148.jpeg,0,0.969386995,0,71,277,413,277,342,pinkie pie
1394302.jpeg,https://derpicdn.net/img/view/2017/3/23/1394302.jpeg,0,0.999027133,160,22,574,436,414,414,pinkie pie
1395909.jpeg,https://derpicdn.net/img/view/2017/3/25/1395909.jpeg,0,0.901453495,0,42,399,470,399,428,pinkie pie
1398632.jpeg,https://derpicdn.net/img/view/2017/3/28/1398632.jpeg,0,0.97197175,0,14,468,502,468,488,pinkie pie
1401683.jpeg,https://derpicdn.net/img/view/2017/4/1/1401683.jpeg,0,0.989988267,125,71,709,655,584,584,pinkie pie
1402166.jpeg,https://derpicdn.net/img/view/2017/4/2/1402166.jpeg,0,0.94519037,1118,47,2508,1437,1390,1390,pinkie pie
1403685.jpeg,https://derpicdn.net/img/view/2017/4/4/1403685.jpeg,0,0.987586617,449,239,913,703,464,464,pinkie pie
1404390.jpeg,https://derpicdn.net/img/view/2017/4/5/1404390.jpeg,0,0.942753971,0,0,993,998,993,998,pinkie pie
1404459.jpeg,https://derpicdn.net/img/view/2017/4/5/1404459.jpeg,0,0.998265266,248,0,814,549,566,549,pinkie pie
1406664.jpeg,https://derpicdn.net/img/view/2017/4/8/1406664.jpeg,0,0.997159779,165,0,695,529,530,529,pinkie pie
1406759.jpeg,https://derpicdn.net/img/view/2017/4/8/1406759.jpeg,0,0.987535655,42,0,776,726,734,726,pinkie pie
1408174.jpeg,https://derpicdn.net/img/view/2017/4/10/1408174.jpeg,0,0.940327168,34,80,1092,1138,1058,1058,pinkie pie
1422656.jpeg,https://derpicdn.net/img/view/2017/4/27/1422656.jpeg,0,0.966149926,194,0,1224,792,1030,792,pinkie pie
1422890.jpeg,https://derpicdn.net/img/view/2017/4/27/1422890.jpeg,0,0.993953347,159,59,515,415,356,356,pinkie pie
1424344.jpeg,https://derpicdn.net/img/view/2017/4/29/1424344.jpeg,0,0.953710735,449,329,977,857,528,528,pinkie pie
1425491.jpeg,https://derpicdn.net/img/view/2017/4/30/1425491.jpeg,0,0.928292096,1215,43,1655,483,440,440,pinkie pie
1426666.jpeg,https://derpicdn.net/img/view/2017/5/1/1426666.jpeg,0,0.964308023,38,243,462,667,424,424,pinkie pie
1428500.jpeg,https://derpicdn.net/img/view/2017/5/4/1428500.jpeg,0,0.907931089,0,0,691,717,691,717,pinkie pie
1434797.jpeg,https://derpicdn.net/img/view/2017/5/12/1434797.jpeg,0,0.968270779,0,343,1146,1497,1146,1154,pinkie pie
1441790.jpeg,https://derpicdn.net/img/view/2017/5/21/1441790.jpeg,0,0.955449402,494,0,996,447,502,447,pinkie pie
1444416.jpeg,https://derpicdn.net/img/view/2017/5/23/1444416.jpeg,0,0.990594745,145,106,1775,1736,1630,1630,pinkie pie
1445249.jpeg,https://derpicdn.net/img/view/2017/5/25/1445249.jpeg,0,0.993063867,210,0,2272,1599,2062,1599,pinkie pie
1445258.jpeg,https://derpicdn.net/img/view/2017/5/25/1445258.jpeg,0,0.989714503,126,0,658,495,532,495,pinkie pie
1449000.jpeg,https://derpicdn.net/img/view/2017/5/29/1449000.jpeg,0,0.971115291,20,0,400,378,380,378,pinkie pie
1449342.jpeg,https://derpicdn.net/img/view/2017/5/29/1449342.jpeg,0,0.943990529,20,0,1828,1759,1808,1759,pinkie pie
1454472.jpeg,https://derpicdn.net/img/view/2017/6/5/1454472.jpeg,0,0.994620442,125,0,555,400,430,400,pinkie pie
1456336.jpeg,https://derpicdn.net/img/view/2017/6/7/1456336.jpeg,0,0.987764418,285,419,1665,1799,1380,1380,pinkie pie
1457654.jpeg,https://derpicdn.net/img/view/2017/6/9/1457654.jpeg,1,0.991149306,1848,208,2628,988,780,780,pinkie pie
1464220.jpeg,https://derpicdn.net/img/view/2017/6/17/1464220.jpeg,0,0.941663027,190,239,454,503,264,264,pinkie pie
1465322.jpeg,https://derpicdn.net/img/view/2017/6/18/1465322.jpeg,0,0.996500254,311,25,997,711,686,686,pinkie pie
1465675.jpeg,https://derpicdn.net/img/view/2017/6/19/1465675.jpeg,0,0.977267087,515,0,959,403,444,403,pinkie pie
1465675.jpeg,https://derpicdn.net/img/view/2017/6/19/1465675.jpeg,1,0.907396138,98,0,566,465,468,465,pinkie pie
1469158.jpeg,https://derpicdn.net/img/view/2017/6/22/1469158.jpeg,0,0.990637541,42,0,600,529,558,529,pinkie pie
1472122.jpeg,https://derpicdn.net/img/view/2017/6/26/1472122.jpeg,0,0.942666531,62,0,836,645,774,645,pinkie pie
1473569.jpeg,https://derpicdn.net/img/view/2017/6/28/1473569.jpeg,0,0.973972678,0,43,581,633,581,590,pinkie pie
1473852.jpeg,https://derpicdn.net/img/view/2017/6/29/1473852.jpeg,0,0.982656419,49,0,805,711,756,711,pinkie pie
1474775.jpeg,https://derpicdn.net/img/view/2017/6/29/1474775.jpeg,0,0.938180506,40,0,437,305,397,305,pinkie pie
1476298.jpeg,https://derpicdn.net/img/view/2017/7/1/1476298.jpeg,0,0.978174806,665,38,1801,1174,1136,1136,pinkie pie
1477542.jpeg,https://derpicdn.net/img/view/2017/7/3/1477542.jpeg,0,0.917299092,64,136,1772,1844,1708,1708,pinkie pie
1477653.jpeg,https://derpicdn.net/img/view/2017/7/3/1477653.jpeg,0,0.994032443,209,62,1019,872,810,810,pinkie pie
1478214.jpeg,https://derpicdn.net/img/view/2017/7/4/1478214.jpeg,0,0.999671042,439,0,959,513,520,513,pinkie pie
1478234.jpeg,https://derpicdn.net/img/view/2017/7/4/1478234.jpeg,0,0.975643694,83,0,531,443,448,443,pinkie pie
1478235.jpeg,https://derpicdn.net/img/view/2017/7/4/1478235.jpeg,0,0.972937226,0,0,750,926,750,926,pinkie pie
1483547.jpeg,https://derpicdn.net/img/view/2017/7/11/1483547.jpeg,0,0.972887039,0,0,239,160,239,160,pinkie pie
1485533.jpeg,https://derpicdn.net/img/view/2017/7/13/1485533.jpeg,0,0.996863008,70,33,426,389,356,356,pinkie pie
1485533.jpeg,https://derpicdn.net/img/view/2017/7/13/1485533.jpeg,1,0.992790818,383,164,633,414,250,250,pinkie pie
1485534.jpeg,https://derpicdn.net/img/view/2017/7/13/1485534.jpeg,0,0.991261661,0,3,698,737,698,734,pinkie pie
1485749.jpeg,https://derpicdn.net/img/view/2017/7/14/1485749.jpeg,0,0.970028639,94,0,1378,1274,1284,1274,pinkie pie
1491073.jpeg,https://derpicdn.net/img/view/2017/7/21/1491073.jpeg,0,0.9275226,156,218,544,606,388,388,pinkie pie
1492966.jpeg,https://derpicdn.net/img/view/2017/7/23/1492966.jpeg,0,0.989317954,931,131,2081,1281,1150,1150,pinkie pie
1493279.jpeg,https://derpicdn.net/img/view/2017/7/23/1493279.jpeg,0,0.980378807,138,0,592,449,454,449,pinkie pie
1493942.jpeg,https://derpicdn.net/img/view/2017/7/24/1493942.jpeg,0,0.925559402,302,245,868,811,566,566,pinkie pie
1497607.jpeg,https://derpicdn.net/img/view/2017/7/29/1497607.jpeg,0,0.985989213,194,0,444,232,250,232,pinkie pie
1499638.jpeg,https://derpicdn.net/img/view/2017/7/31/1499638.jpeg,0,0.994344532,88,719,1108,1739,1020,1020,pinkie pie
1503142.jpeg,https://derpicdn.net/img/view/2017/8/5/1503142.jpeg,0,0.926858842,535,77,855,397,320,320,pinkie pie
1503734.jpeg,https://derpicdn.net/img/view/2017/8/5/1503734.jpeg,0,0.995831013,424,8,1702,1286,1278,1278,pinkie pie
1504726.jpeg,https://derpicdn.net/img/view/2017/8/6/1504726.jpeg,0,0.975267291,198,21,586,409,388,388,pinkie pie
1505422.jpeg,https://derpicdn.net/img/view/2017/8/7/1505422.jpeg,0,0.995735407,552,25,868,341,316,316,pinkie pie
1505851.jpeg,https://derpicdn.net/img/view/2017/8/8/1505851.jpeg,0,0.950270534,0,0,768,921,768,921,pinkie pie
1508113.jpeg,https://derpicdn.net/img/view/2017/8/11/1508113.jpeg,1,0.947622776,237,78,991,832,754,754,pinkie pie
1511284.jpeg,https://derpicdn.net/img/view/2017/8/15/1511284.jpeg,0,0.997984827,687,217,1443,973,756,756,pinkie pie
1511284.jpeg,https://derpicdn.net/img/view/2017/8/15/1511284.jpeg,1,0.976066649,1926,132,2798,1004,872,872,pinkie pie
1513004.jpeg,https://derpicdn.net/img/view/2017/8/17/1513004.jpeg,0,0.998602152,226,127,550,451,324,324,pinkie pie
1513890.jpeg,https://derpicdn.net/img/view/2017/8/18/1513890.jpeg,0,0.983859897,53,0,851,762,798,762,pinkie pie
1517348.jpeg,https://derpicdn.net/img/view/2017/8/22/1517348.jpeg,0,0.957296729,784,86,1476,778,692,692,pinkie pie
1517373.jpeg,https://derpicdn.net/img/view/2017/8/22/1517373.jpeg,0,0.958051682,49,5,993,949,944,944,pinkie pie
1517377.jpeg,https://derpicdn.net/img/view/2017/8/22/1517377.jpeg,0,0.935376585,94,0,1288,1140,1194,1140,pinkie pie
1518575.jpeg,https://derpicdn.net/img/view/2017/8/24/1518575.jpeg,0,0.99641633,841,25,1633,817,792,792,pinkie pie
1520924.jpeg,https://derpicdn.net/img/view/2017/8/27/1520924.jpeg,0,0.916638613,0,25,549,593,549,568,pinkie pie
1524982.jpeg,https://derpicdn.net/img/view/2017/9/1/1524982.jpeg,0,0.956755698,735,93,1499,857,764,764,pinkie pie
1526258.jpeg,https://derpicdn.net/img/view/2017/9/2/1526258.jpeg,0,0.99528724,122,5,698,581,576,576,pinkie pie
1528227.jpeg,https://derpicdn.net/img/view/2017/9/5/1528227.jpeg,0,0.99569273,85,0,683,595,598,595,pinkie pie
1534589.jpeg,https://derpicdn.net/img/view/2017/9/13/1534589.jpeg,0,0.999435365,328,184,828,684,500,500,pinkie pie
1536955.jpeg,https://derpicdn.net/img/view/2017/9/16/1536955.jpeg,0,0.980820119,773,365,1093,685,320,320,pinkie pie
1537641.jpeg,https://derpicdn.net/img/view/2017/9/17/1537641.jpeg,0,0.986102939,139,0,2507,2000,2368,2000,pinkie pie
1540303.jpeg,https://derpicdn.net/img/view/2017/9/20/1540303.jpeg,0,0.918596685,356,44,3438,3126,3082,3082,pinkie pie
1541970.jpeg,https://derpicdn.net/img/view/2017/9/22/1541970.jpeg,0,0.957242906,634,1699,2032,3097,1398,1398,pinkie pie
1547402.jpeg,https://derpicdn.net/img/view/2017/9/29/1547402.jpeg,0,0.985272944,300,70,788,558,488,488,pinkie pie
1547595.jpeg,https://derpicdn.net/img/view/2017/9/29/1547595.jpeg,0,0.972555399,199,29,619,449,420,420,pinkie pie
1552670.jpeg,https://derpicdn.net/img/view/2017/10/5/1552670.jpeg,0,0.986610949,7,50,649,692,642,642,pinkie pie
1553076.jpeg,https://derpicdn.net/img/view/2017/10/6/1553076.jpeg,0,0.93718195,483,41,713,271,230,230,pinkie pie
1553292.jpeg,https://derpicdn.net/img/view/2017/10/6/1553292.jpeg,0,0.978362083,86,0,922,806,836,806,pinkie pie
1556085.jpeg,https://derpicdn.net/img/view/2017/10/9/1556085.jpeg,0,0.999495804,222,34,676,488,454,454,pinkie pie
1561371.jpeg,https://derpicdn.net/img/view/2017/10/14/1561371.jpeg,0,0.982836485,612,0,1938,1305,1326,1305,pinkie pie
1561848.jpeg,https://derpicdn.net/img/view/2017/10/15/1561848.jpeg,0,0.953270137,511,166,1207,862,696,696,pinkie pie
1566533.jpeg,https://derpicdn.net/img/view/2017/10/21/1566533.jpeg,0,0.993994057,365,10,679,324,314,314,pinkie pie
1570960.jpeg,https://derpicdn.net/img/view/2017/10/27/1570960.jpeg,0,0.972738147,287,0,2847,2483,2560,2483,pinkie pie
1570996.jpeg,https://derpicdn.net/img/view/2017/10/27/1570996.jpeg,0,0.991986156,1148,489,2274,1615,1126,1126,pinkie pie
1571679.jpeg,https://derpicdn.net/img/view/2017/10/28/1571679.jpeg,0,0.955191672,247,0,1073,740,826,740,pinkie pie
1572726.jpeg,https://derpicdn.net/img/view/2017/10/29/1572726.jpeg,0,0.989823103,152,60,330,238,178,178,pinkie pie
1572726.jpeg,https://derpicdn.net/img/view/2017/10/29/1572726.jpeg,1,0.949032366,366,485,532,651,166,166,pinkie pie
1578647.jpeg,https://derpicdn.net/img/view/2017/11/5/1578647.jpeg,0,0.975972891,1416,0,3854,2137,2438,2137,pinkie pie
1582055.jpeg,https://derpicdn.net/img/view/2017/11/9/1582055.jpeg,0,0.977265358,101,0,647,525,546,525,pinkie pie
1584408.jpeg,https://derpicdn.net/img/view/2017/11/12/1584408.jpeg,0,0.978637278,0,0,2117,2358,2117,2358,pinkie pie
1584475.jpeg,https://derpicdn.net/img/view/2017/11/12/1584475.jpeg,0,0.94770956,372,0,878,478,506,478,pinkie pie
1585268.jpeg,https://derpicdn.net/img/view/2017/11/13/1585268.jpeg,0,0.991532326,321,0,1081,668,760,668,pinkie pie
1587842.jpeg,https://derpicdn.net/img/view/2017/11/16/1587842.jpeg,0,0.965000451,98,0,1806,1600,1708,1600,pinkie pie
1588903.jpeg,https://derpicdn.net/img/view/2017/11/18/1588903.jpeg,0,0.932759881,0,0,698,801,698,801,pinkie pie
1589835.jpeg,https://derpicdn.net/img/view/2017/11/19/1589835.jpeg,0,0.985916615,1640,130,3452,1942,1812,1812,pinkie pie
1589841.jpeg,https://derpicdn.net/img/view/2017/11/19/1589841.jpeg,0,0.967863679,961,151,2000,1321,1039,1170,pinkie pie
1589843.jpeg,https://derpicdn.net/img/view/2017/11/19/1589843.jpeg,0,0.947313607,566,396,1132,962,566,566,pinkie pie
1590053.jpeg,https://derpicdn.net/img/view/2017/11/19/1590053.jpeg,0,0.912407398,246,0,756,480,510,480,pinkie pie
1590290.jpeg,https://derpicdn.net/img/view/2017/11/19/1590290.jpeg,0,0.978389084,485,0,1613,1035,1128,1035,pinkie pie
1590411.jpeg,https://derpicdn.net/img/view/2017/11/20/1590411.jpeg,0,0.931586862,658,0,1496,798,838,798,pinkie pie
1591749.jpeg,https://derpicdn.net/img/view/2017/11/22/1591749.jpeg,0,0.9663921,212,0,548,319,336,319,pinkie pie
1592472.jpeg,https://derpicdn.net/img/view/2017/11/23/1592472.jpeg,0,0.971763432,0,250,648,954,648,704,pinkie pie
1593222.jpeg,https://derpicdn.net/img/view/2017/11/24/1593222.jpeg,0,0.939445078,432,0,1598,1073,1166,1073,pinkie pie
1596258.jpeg,https://derpicdn.net/img/view/2017/11/28/1596258.jpeg,0,0.916065931,235,0,1321,1042,1086,1042,pinkie pie
1597194.jpeg,https://derpicdn.net/img/view/2017/11/29/1597194.jpeg,0,0.971779943,371,0,2411,2016,2040,2016,pinkie pie
1598287.jpeg,https://derpicdn.net/img/view/2017/12/1/1598287.jpeg,0,0.968056917,187,25,619,457,432,432,pinkie pie
1600253.jpeg,https://derpicdn.net/img/view/2017/12/4/1600253.jpeg,0,0.985274076,418,0,1096,653,678,653,pinkie pie
1600394.jpeg,https://derpicdn.net/img/view/2017/12/4/1600394.jpeg,0,0.996988595,550,2,930,382,380,380,pinkie pie
1600394.jpeg,https://derpicdn.net/img/view/2017/12/4/1600394.jpeg,2,0.984500647,650,626,1000,984,350,358,pinkie pie
1600405.jpeg,https://derpicdn.net/img/view/2017/12/4/1600405.jpeg,0,0.987408519,113,0,1877,1080,1764,1080,pinkie pie
1601098.jpeg,https://derpicdn.net/img/view/2017/12/5/1601098.jpeg,0,0.984933674,53,0,931,774,878,774,pinkie pie
1601915.jpeg,https://derpicdn.net/img/view/2017/12/6/1601915.jpeg,0,0.992012382,30,69,496,514,466,445,pinkie pie
1603246.jpeg,https://derpicdn.net/img/view/2017/12/8/1603246.jpeg,0,0.974060714,23,213,849,1000,826,787,pinkie pie
1611982.jpeg,https://derpicdn.net/img/view/2017/12/20/1611982.jpeg,0,0.927582383,250,214,2414,2378,2164,2164,pinkie pie
1612896.jpeg,https://derpicdn.net/img/view/2017/12/21/1612896.jpeg,0,0.980846584,272,0,2026,1675,1754,1675,pinkie pie
1614430.jpeg,https://derpicdn.net/img/view/2017/12/23/1614430.jpeg,0,0.926947057,722,302,1616,1196,894,894,pinkie pie
1622928.jpeg,https://derpicdn.net/img/view/2018/1/3/1622928.jpeg,0,0.941831589,0,0,1005,1087,1005,1087,pinkie pie
1623332.jpeg,https://derpicdn.net/img/view/2018/1/3/1623332.jpeg,0,0.987074316,328,0,1132,661,804,661,pinkie pie
1624116.jpeg,https://derpicdn.net/img/view/2018/1/4/1624116.jpeg,0,0.937454402,821,635,1749,1563,928,928,pinkie pie
1626047.jpeg,https://derpicdn.net/img/view/2018/1/7/1626047.jpeg,0,0.998121858,0,0,705,776,705,776,pinkie pie
1633567.jpeg,https://derpicdn.net/img/view/2018/1/16/1633567.jpeg,0,0.993309379,14,0,502,484,488,484,pinkie pie
1637605.jpeg,https://derpicdn.net/img/view/2018/1/21/1637605.jpeg,0,0.977512896,459,0,1041,556,582,556,pinkie pie
1638062.jpeg,https://derpicdn.net/img/view/2018/1/22/1638062.jpeg,0,0.995891333,400,145,826,571,426,426,pinkie pie
1638182.jpeg,https://derpicdn.net/img/view/2018/1/22/1638182.jpeg,0,0.939896643,0,0,1329,1488,1329,1488,pinkie pie
1638649.jpeg,https://derpicdn.net/img/view/2018/1/23/1638649.jpeg,0,0.968052626,0,0,1394,1483,1394,1483,pinkie pie
1638985.jpeg,https://derpicdn.net/img/view/2018/1/23/1638985.jpeg,0,0.997220397,0,0,1443,1540,1443,1540,pinkie pie
1639029.jpeg,https://derpicdn.net/img/view/2018/1/23/1639029.jpeg,0,0.992424846,31,0,573,509,542,509,pinkie pie
1641040.jpeg,https://derpicdn.net/img/view/2018/1/26/1641040.jpeg,0,0.998158693,65,232,969,1136,904,904,pinkie pie
1643045.jpeg,https://derpicdn.net/img/view/2018/1/28/1643045.jpeg,0,0.990788043,457,90,753,386,296,296,pinkie pie
1643737.jpeg,https://derpicdn.net/img/view/2018/1/29/1643737.jpeg,0,0.985618174,154,0,498,335,344,335,pinkie pie
1645889.jpeg,https://derpicdn.net/img/view/2018/2/1/1645889.jpeg,0,0.989037693,223,49,509,335,286,286,pinkie pie
1648053.jpeg,https://derpicdn.net/img/view/2018/2/4/1648053.jpeg,0,0.994528651,124,177,618,671,494,494,pinkie pie
1648111.jpeg,https://derpicdn.net/img/view/2018/2/4/1648111.jpeg,0,0.988878012,0,50,720,792,720,742,pinkie pie
1649213.jpeg,https://derpicdn.net/img/view/2018/2/5/1649213.jpeg,0,0.997216463,274,15,1188,929,914,914,pinkie pie
1652208.jpeg,https://derpicdn.net/img/view/2018/2/10/1652208.jpeg,0,0.946227133,597,0,1645,1047,1048,1047,pinkie pie
1652226.jpeg,https://derpicdn.net/img/view/2018/2/10/1652226.jpeg,0,0.982911944,638,0,1542,782,904,782,pinkie pie
1657782.jpeg,https://derpicdn.net/img/view/2018/2/16/1657782.jpeg,0,0.989646077,2154,231,3448,1525,1294,1294,pinkie pie
1660419.jpeg,https://derpicdn.net/img/view/2018/2/19/1660419.jpeg,0,0.980225503,0,37,870,947,870,910,pinkie pie
1663216.jpeg,https://derpicdn.net/img/view/2018/2/23/1663216.jpeg,0,0.98731792,228,11,574,357,346,346,pinkie pie
1663218.jpeg,https://derpicdn.net/img/view/2018/2/23/1663218.jpeg,0,0.9884004,226,9,574,357,348,348,pinkie pie
1663251.jpeg,https://derpicdn.net/img/view/2018/2/23/1663251.jpeg,0,0.979717195,40,0,792,714,752,714,pinkie pie
1664140.jpeg,https://derpicdn.net/img/view/2018/2/24/1664140.jpeg,0,0.985606372,133,250,469,586,336,336,pinkie pie
1665176.jpeg,https://derpicdn.net/img/view/2018/2/25/1665176.jpeg,0,0.987643719,0,55,549,621,549,566,pinkie pie
1665282.jpeg,https://derpicdn.net/img/view/2018/2/25/1665282.jpeg,0,0.959418297,27,65,909,947,882,882,pinkie pie
1665563.jpeg,https://derpicdn.net/img/view/2018/2/25/1665563.jpeg,0,0.968341887,14,0,770,670,756,670,pinkie pie
1665897.jpeg,https://derpicdn.net/img/view/2018/2/25/1665897.jpeg,0,0.98147136,55,0,871,703,816,703,pinkie pie
1666140.jpeg,https://derpicdn.net/img/view/2018/2/26/1666140.jpeg,0,0.992843449,77,0,1309,1113,1232,1113,pinkie pie
1666145.jpeg,https://derpicdn.net/img/view/2018/2/26/1666145.jpeg,0,0.996421337,502,70,770,338,268,268,pinkie pie
1666152.jpeg,https://derpicdn.net/img/view/2018/2/26/1666152.jpeg,0,0.986381173,0,0,1022,985,1022,985,pinkie pie
1666152.jpeg,https://derpicdn.net/img/view/2018/2/26/1666152.jpeg,1,0.983468533,987,0,2039,1091,1052,1091,pinkie pie
1666156.jpeg,https://derpicdn.net/img/view/2018/2/26/1666156.jpeg,0,0.93689543,136,0,2322,2091,2186,2091,pinkie pie
1666506.jpeg,https://derpicdn.net/img/view/2018/2/26/1666506.jpeg,0,0.960577965,233,285,1467,1519,1234,1234,pinkie pie
1666513.jpeg,https://derpicdn.net/img/view/2018/2/26/1666513.jpeg,0,0.960157514,83,0,1234,1175,1151,1175,pinkie pie
1666664.jpeg,https://derpicdn.net/img/view/2018/2/26/1666664.jpeg,0,0.996041834,224,113,622,511,398,398,pinkie pie
1666667.jpeg,https://derpicdn.net/img/view/2018/2/26/1666667.jpeg,0,0.996254385,639,95,867,323,228,228,pinkie pie
1667075.jpeg,https://derpicdn.net/img/view/2018/2/27/1667075.jpeg,0,0.935657799,339,0,793,439,454,439,pinkie pie
1667950.jpeg,https://derpicdn.net/img/view/2018/2/28/1667950.jpeg,0,0.993059397,118,0,648,444,530,444,pinkie pie
1667957.jpeg,https://derpicdn.net/img/view/2018/2/28/1667957.jpeg,0,0.935622633,178,0,748,582,570,582,pinkie pie
1668386.jpeg,https://derpicdn.net/img/view/2018/2/28/1668386.jpeg,0,0.956928432,257,0,855,587,598,587,pinkie pie
1668498.jpeg,https://derpicdn.net/img/view/2018/2/28/1668498.jpeg,0,0.961216033,82,0,888,762,806,762,pinkie pie
1669518.jpeg,https://derpicdn.net/img/view/2018/3/2/1669518.jpeg,0,0.993450105,43,0,729,672,686,672,pinkie pie
1670499.jpeg,https://derpicdn.net/img/view/2018/3/3/1670499.jpeg,0,0.997868896,228,0,850,583,622,583,pinkie pie
1670506.jpeg,https://derpicdn.net/img/view/2018/3/3/1670506.jpeg,0,0.927049458,169,0,768,619,599,619,pinkie pie
1670876.jpeg,https://derpicdn.net/img/view/2018/3/3/1670876.jpeg,0,0.981131136,46,7,497,464,451,457,pinkie pie
1670992.jpeg,https://derpicdn.net/img/view/2018/3/3/1670992.jpeg,0,0.91884762,367,394,1777,1804,1410,1410,pinkie pie
1671389.jpeg,https://derpicdn.net/img/view/2018/3/4/1671389.jpeg,0,0.99236536,42,0,1032,852,990,852,pinkie pie
1671692.jpeg,https://derpicdn.net/img/view/2018/3/4/1671692.jpeg,0,0.998021245,1625,271,3397,2043,1772,1772,pinkie pie
1672579.jpeg,https://derpicdn.net/img/view/2018/3/5/1672579.jpeg,0,0.927387476,962,28,1946,1012,984,984,pinkie pie
1672812.jpeg,https://derpicdn.net/img/view/2018/3/6/1672812.jpeg,0,0.992038488,218,222,946,950,728,728,pinkie pie
1673970.jpeg,https://derpicdn.net/img/view/2018/3/7/1673970.jpeg,0,0.996188581,104,0,720,598,616,598,pinkie pie
1674537.jpeg,https://derpicdn.net/img/view/2018/3/8/1674537.jpeg,0,0.994249284,298,27,1148,877,850,850,pinkie pie
1674573.jpeg,https://derpicdn.net/img/view/2018/3/8/1674573.jpeg,0,0.982611656,108,311,1500,1703,1392,1392,pinkie pie
1677028.jpeg,https://derpicdn.net/img/view/2018/3/11/1677028.jpeg,0,0.956650317,213,9,1179,983,966,974,pinkie pie
1677441.jpeg,https://derpicdn.net/img/view/2018/3/11/1677441.jpeg,0,0.938614309,542,7,1279,753,737,746,pinkie pie
1678991.jpeg,https://derpicdn.net/img/view/2018/3/13/1678991.jpeg,0,0.97728312,400,102,722,424,322,322,pinkie pie
1679070.jpeg,https://derpicdn.net/img/view/2018/3/13/1679070.jpeg,0,0.914511859,145,0,707,529,562,529,pinkie pie
1679219.jpeg,https://derpicdn.net/img/view/2018/3/13/1679219.jpeg,0,0.996546149,624,99,1000,491,376,392,pinkie pie
1679220.jpeg,https://derpicdn.net/img/view/2018/3/13/1679220.jpeg,0,0.996787786,622,97,1000,493,378,396,pinkie pie
1679221.jpeg,https://derpicdn.net/img/view/2018/3/13/1679221.jpeg,0,0.99678123,622,97,1000,493,378,396,pinkie pie
1679590.jpeg,https://derpicdn.net/img/view/2018/3/14/1679590.jpeg,0,0.984198809,323,0,1222,892,899,892,pinkie pie
1680290.jpeg,https://derpicdn.net/img/view/2018/3/14/1680290.jpeg,0,0.994318008,31,0,777,690,746,690,pinkie pie
1681532.jpeg,https://derpicdn.net/img/view/2018/3/15/1681532.jpeg,0,0.970838428,256,6,978,728,722,722,pinkie pie
1684702.jpeg,https://derpicdn.net/img/view/2018/3/19/1684702.jpeg,0,0.99612844,149,0,695,522,546,522,pinkie pie
1687754.jpeg,https://derpicdn.net/img/view/2018/3/22/1687754.jpeg,0,0.996495485,142,151,372,381,230,230,pinkie pie
1688011.jpeg,https://derpicdn.net/img/view/2018/3/23/1688011.jpeg,0,0.989711821,153,161,645,653,492,492,pinkie pie
1695317.jpeg,https://derpicdn.net/img/view/2018/3/31/1695317.jpeg,1,0.977185726,637,189,1035,587,398,398,pinkie pie
1695792.jpeg,https://derpicdn.net/img/view/2018/4/1/1695792.jpeg,0,0.949301302,2106,335,3106,1443,1000,1108,pinkie pie
1696362.jpeg,https://derpicdn.net/img/view/2018/4/1/1696362.jpeg,0,0.98699826,28,0,1128,1075,1100,1075,pinkie pie
1696392.jpeg,https://derpicdn.net/img/view/2018/4/1/1696392.jpeg,0,0.982851446,19,48,647,676,628,628,pinkie pie
1697825.jpeg,https://derpicdn.net/img/view/2018/4/3/1697825.jpeg,0,0.959741712,395,593,653,851,258,258,pinkie pie
1697825.jpeg,https://derpicdn.net/img/view/2018/4/3/1697825.jpeg,1,0.936819315,413,13,809,409,396,396,pinkie pie
1697825.jpeg,https://derpicdn.net/img/view/2018/4/3/1697825.jpeg,2,0.924652696,117,66,447,396,330,330,pinkie pie
1700164.jpeg,https://derpicdn.net/img/view/2018/4/5/1700164.jpeg,0,0.998100638,598,247,1820,1469,1222,1222,pinkie pie
1702522.jpeg,https://derpicdn.net/img/view/2018/4/8/1702522.jpeg,0,0.912472606,224,0,940,687,716,687,pinkie pie
1702926.jpeg,https://derpicdn.net/img/view/2018/4/8/1702926.jpeg,0,0.989146292,199,192,573,566,374,374,pinkie pie
1702926.jpeg,https://derpicdn.net/img/view/2018/4/8/1702926.jpeg,1,0.938490629,539,237,865,563,326,326,pinkie pie
1703999.jpeg,https://derpicdn.net/img/view/2018/4/10/1703999.jpeg,0,0.902845442,224,152,1412,1340,1188,1188,pinkie pie
1707252.jpeg,https://derpicdn.net/img/view/2018/4/14/1707252.jpeg,0,0.997278214,952,119,1280,449,328,330,pinkie pie
1707252.jpeg,https://derpicdn.net/img/view/2018/4/14/1707252.jpeg,1,0.980189979,552,70,888,406,336,336,pinkie pie
1709891.jpeg,https://derpicdn.net/img/view/2018/4/17/1709891.jpeg,0,0.999898553,803,0,1249,378,446,378,pinkie pie
1709933.jpeg,https://derpicdn.net/img/view/2018/4/17/1709933.jpeg,0,0.986427367,2415,945,3248,1885,833,940,pinkie pie
1710799.jpeg,https://derpicdn.net/img/view/2018/4/18/1710799.jpeg,0,0.991439104,1335,0,2459,1045,1124,1045,pinkie pie
1711709.jpeg,https://derpicdn.net/img/view/2018/4/19/1711709.jpeg,0,0.988337278,580,101,1364,885,784,784,pinkie pie
1714079.jpeg,https://derpicdn.net/img/view/2018/4/22/1714079.jpeg,0,0.993007839,397,0,2511,2005,2114,2005,pinkie pie
1716264.jpeg,https://derpicdn.net/img/view/2018/4/24/1716264.jpeg,0,0.985345304,0,9,2476,2513,2476,2504,pinkie pie
1717852.jpeg,https://derpicdn.net/img/view/2018/4/26/1717852.jpeg,0,0.997340143,143,55,881,793,738,738,pinkie pie
1718228.jpeg,https://derpicdn.net/img/view/2018/4/27/1718228.jpeg,0,0.945836365,114,0,582,413,468,413,pinkie pie
1722961.jpeg,https://derpicdn.net/img/view/2018/5/3/1722961.jpeg,0,0.916884303,458,799,1834,2175,1376,1376,pinkie pie
1724023.jpeg,https://derpicdn.net/img/view/2018/5/4/1724023.jpeg,0,0.997689664,406,9,800,449,394,440,pinkie pie
1733574.jpeg,https://derpicdn.net/img/view/2018/5/15/1733574.jpeg,0,0.901421726,0,0,2256,2331,2256,2331,pinkie pie
1735595.jpeg,https://derpicdn.net/img/view/2018/5/18/1735595.jpeg,0,0.980362475,164,102,508,446,344,344,pinkie pie
1735935.jpeg,https://derpicdn.net/img/view/2018/5/18/1735935.jpeg,0,0.993421733,617,0,1741,965,1124,965,pinkie pie
1736080.jpeg,https://derpicdn.net/img/view/2018/5/19/1736080.jpeg,0,0.982618988,895,0,1920,1039,1025,1039,pinkie pie
1740372.jpeg,https://derpicdn.net/img/view/2018/5/24/1740372.jpeg,0,0.933542311,41,0,341,280,300,280,pinkie pie
1740677.jpeg,https://derpicdn.net/img/view/2018/5/25/1740677.jpeg,0,0.992766201,611,0,1536,903,925,903,pinkie pie
1740679.jpeg,https://derpicdn.net/img/view/2018/5/25/1740679.jpeg,0,0.994342625,80,0,1898,1536,1818,1536,pinkie pie
1742322.jpeg,https://derpicdn.net/img/view/2018/5/27/1742322.jpeg,0,0.900696993,245,0,743,484,498,484,pinkie pie
1743526.jpeg,https://derpicdn.net/img/view/2018/5/28/1743526.jpeg,0,0.979190707,0,0,1908,2219,1908,2219,pinkie pie
1744890.jpeg,https://derpicdn.net/img/view/2018/5/29/1744890.jpeg,0,0.992093623,1103,0,1905,716,802,716,pinkie pie
1748849.jpeg,https://derpicdn.net/img/view/2018/6/3/1748849.jpeg,0,0.967088521,957,25,2383,1451,1426,1426,pinkie pie
1750670.jpeg,https://derpicdn.net/img/view/2018/6/5/1750670.jpeg,0,0.979494035,782,245,1744,1207,962,962,pinkie pie
1752522.jpeg,https://derpicdn.net/img/view/2018/6/8/1752522.jpeg,0,0.967301071,350,336,1036,1022,686,686,pinkie pie
1752644.jpeg,https://derpicdn.net/img/view/2018/6/8/1752644.jpeg,0,0.997117698,1231,0,1985,696,754,696,pinkie pie
1753584.jpeg,https://derpicdn.net/img/view/2018/6/9/1753584.jpeg,0,0.985667229,22,65,602,548,580,483,pinkie pie
1756216.jpeg,https://derpicdn.net/img/view/2018/6/12/1756216.jpeg,0,0.978219807,890,217,2048,1375,1158,1158,pinkie pie
1757196.jpeg,https://derpicdn.net/img/view/2018/6/14/1757196.jpeg,0,0.942904949,0,0,685,678,685,678,pinkie pie
1764340.jpeg,https://derpicdn.net/img/view/2018/6/23/1764340.jpeg,0,0.994488001,121,0,783,659,662,659,pinkie pie
1764742.jpeg,https://derpicdn.net/img/view/2018/6/24/1764742.jpeg,0,0.932519615,0,0,624,681,624,681,pinkie pie
1767870.jpeg,https://derpicdn.net/img/view/2018/6/28/1767870.jpeg,0,0.950343907,361,68,809,516,448,448,pinkie pie
1769555.jpeg,https://derpicdn.net/img/view/2018/6/30/1769555.jpeg,0,0.955463707,40,14,320,294,280,280,pinkie pie
1772762.jpeg,https://derpicdn.net/img/view/2018/7/4/1772762.jpeg,0,0.910926819,52,568,1326,1800,1274,1232,pinkie pie
1773130.jpeg,https://derpicdn.net/img/view/2018/7/5/1773130.jpeg,0,0.994260669,449,0,2119,1646,1670,1646,pinkie pie
1773373.jpeg,https://derpicdn.net/img/view/2018/7/5/1773373.jpeg,0,0.949510813,429,21,695,287,266,266,pinkie pie
1773624.jpeg,https://derpicdn.net/img/view/2018/7/5/1773624.jpeg,0,0.993381739,69,41,708,763,639,722,pinkie pie
1776268.jpeg,https://derpicdn.net/img/view/2018/7/8/1776268.jpeg,0,0.928171694,749,43,1429,723,680,680,pinkie pie
1776993.jpeg,https://derpicdn.net/img/view/2018/7/9/1776993.jpeg,0,0.985342324,488,46,1292,850,804,804,pinkie pie
1777255.jpeg,https://derpicdn.net/img/view/2018/7/10/1777255.jpeg,0,0.94191283,58,19,1536,1505,1478,1486,pinkie pie
1778055.jpeg,https://derpicdn.net/img/view/2018/7/11/1778055.jpeg,0,0.99045068,827,299,1979,1451,1152,1152,pinkie pie
1778096.jpeg,https://derpicdn.net/img/view/2018/7/11/1778096.jpeg,0,0.988684177,0,0,1813,1743,1813,1743,pinkie pie
1778236.jpeg,https://derpicdn.net/img/view/2018/7/11/1778236.jpeg,0,0.989866674,250,0,1239,930,989,930,pinkie pie
1780785.jpeg,https://derpicdn.net/img/view/2018/7/14/1780785.jpeg,0,0.978018701,325,0,1763,1250,1438,1250,pinkie pie
1781460.jpeg,https://derpicdn.net/img/view/2018/7/15/1781460.jpeg,0,0.973001659,87,0,905,761,818,761,pinkie pie
1782121.jpeg,https://derpicdn.net/img/view/2018/7/16/1782121.jpeg,0,0.981904328,18,0,242,214,224,214,pinkie pie
1782317.jpeg,https://derpicdn.net/img/view/2018/7/16/1782317.jpeg,0,0.94475019,76,50,651,676,575,626,pinkie pie
1782531.jpeg,https://derpicdn.net/img/view/2018/7/16/1782531.jpeg,0,0.983425736,112,0,1628,1484,1516,1484,pinkie pie
1782531.jpeg,https://derpicdn.net/img/view/2018/7/16/1782531.jpeg,1,0.976925075,1387,3,2861,1477,1474,1474,pinkie pie
1783065.jpeg,https://derpicdn.net/img/view/2018/7/17/1783065.jpeg,0,0.996970713,774,731,1022,979,248,248,pinkie pie
1783065.jpeg,https://derpicdn.net/img/view/2018/7/17/1783065.jpeg,1,0.995496571,70,737,312,979,242,242,pinkie pie
1783065.jpeg,https://derpicdn.net/img/view/2018/7/17/1783065.jpeg,2,0.989649892,780,7,1028,255,248,248,pinkie pie
1783065.jpeg,https://derpicdn.net/img/view/2018/7/17/1783065.jpeg,3,0.983376801,774,370,1018,614,244,244,pinkie pie
1783065.jpeg,https://derpicdn.net/img/view/2018/7/17/1783065.jpeg,4,0.943047643,398,726,666,994,268,268,pinkie pie
1783945.jpeg,https://derpicdn.net/img/view/2018/7/18/1783945.jpeg,0,0.939858079,129,44,720,640,591,596,pinkie pie
1784730.jpeg,https://derpicdn.net/img/view/2018/7/19/1784730.jpeg,0,0.991635203,102,0,776,541,674,541,pinkie pie
1785696.jpeg,https://derpicdn.net/img/view/2018/7/20/1785696.jpeg,0,0.997241497,245,98,625,478,380,380,pinkie pie
1787497.jpeg,https://derpicdn.net/img/view/2018/7/23/1787497.jpeg,0,0.945998013,0,39,700,773,700,734,pinkie pie
1788890.jpeg,https://derpicdn.net/img/view/2018/7/24/1788890.jpeg,0,0.997157395,219,5,605,391,386,386,pinkie pie
1789430.jpeg,https://derpicdn.net/img/view/2018/7/25/1789430.jpeg,0,0.961012542,90,0,706,539,616,539,pinkie pie
1789437.jpeg,https://derpicdn.net/img/view/2018/7/25/1789437.jpeg,0,0.998819768,182,0,494,294,312,294,pinkie pie
1789438.jpeg,https://derpicdn.net/img/view/2018/7/25/1789438.jpeg,0,0.936157882,74,0,642,540,568,540,pinkie pie
1789439.jpeg,https://derpicdn.net/img/view/2018/7/25/1789439.jpeg,0,0.950875461,22,0,398,363,376,363,pinkie pie
1789441.jpeg,https://derpicdn.net/img/view/2018/7/25/1789441.jpeg,0,0.995663226,20,0,502,437,482,437,pinkie pie
1789442.jpeg,https://derpicdn.net/img/view/2018/7/25/1789442.jpeg,0,0.924664617,62,0,632,520,570,520,pinkie pie
1789448.jpeg,https://derpicdn.net/img/view/2018/7/25/1789448.jpeg,0,0.959338069,0,0,583,566,583,566,pinkie pie
1789450.jpeg,https://derpicdn.net/img/view/2018/7/25/1789450.jpeg,0,0.937378883,43,0,619,538,576,538,pinkie pie
1789452.jpeg,https://derpicdn.net/img/view/2018/7/25/1789452.jpeg,0,0.961972535,194,0,1206,938,1012,938,pinkie pie
1789453.jpeg,https://derpicdn.net/img/view/2018/7/25/1789453.jpeg,0,0.98380667,0,0,1229,1176,1229,1176,pinkie pie
1789454.jpeg,https://derpicdn.net/img/view/2018/7/25/1789454.jpeg,0,0.976737738,72,0,1042,835,970,835,pinkie pie
1790097.jpeg,https://derpicdn.net/img/view/2018/7/26/1790097.jpeg,0,0.966604829,0,0,1182,1177,1182,1177,pinkie pie
1793047.jpeg,https://derpicdn.net/img/view/2018/7/29/1793047.jpeg,0,0.919606209,107,47,1009,949,902,902,pinkie pie
1794186.jpeg,https://derpicdn.net/img/view/2018/7/31/1794186.jpeg,0,0.990132749,288,184,1862,1758,1574,1574,pinkie pie
1795030.jpeg,https://derpicdn.net/img/view/2018/8/1/1795030.jpeg,0,0.917410672,268,20,742,494,474,474,pinkie pie
1795384.jpeg,https://derpicdn.net/img/view/2018/8/1/1795384.jpeg,0,0.920715392,349,243,1379,1273,1030,1030,pinkie pie
1797902.jpeg,https://derpicdn.net/img/view/2018/8/4/1797902.jpeg,0,0.92731297,519,304,1263,1048,744,744,pinkie pie
1800957.jpeg,https://derpicdn.net/img/view/2018/8/7/1800957.jpeg,0,0.982213259,128,0,588,437,460,437,pinkie pie
1802351.jpeg,https://derpicdn.net/img/view/2018/8/9/1802351.jpeg,0,0.958187163,345,34,1149,838,804,804,pinkie pie
1805539.jpeg,https://derpicdn.net/img/view/2018/8/13/1805539.jpeg,0,0.98186177,121,78,409,366,288,288,pinkie pie
1805676.jpeg,https://derpicdn.net/img/view/2018/8/13/1805676.jpeg,0,0.994623125,46,14,798,766,752,752,pinkie pie
1807733.jpeg,https://derpicdn.net/img/view/2018/8/15/1807733.jpeg,0,0.94999665,0,0,722,847,722,847,pinkie pie
1808076.jpeg,https://derpicdn.net/img/view/2018/8/16/1808076.jpeg,0,0.99974376,103,2,645,544,542,542,pinkie pie
1809506.jpeg,https://derpicdn.net/img/view/2018/8/17/1809506.jpeg,0,0.962350667,1577,1,1920,347,343,346,pinkie pie
1810445.jpeg,https://derpicdn.net/img/view/2018/8/19/1810445.jpeg,0,0.994449079,314,0,568,223,254,223,pinkie pie
1813359.jpeg,https://derpicdn.net/img/view/2018/8/22/1813359.jpeg,0,0.973992705,0,0,491,473,491,473,pinkie pie
1813730.jpeg,https://derpicdn.net/img/view/2018/8/22/1813730.jpeg,0,0.925153673,0,40,911,1002,911,962,pinkie pie
1817627.jpeg,https://derpicdn.net/img/view/2018/8/27/1817627.jpeg,0,0.993926644,385,76,995,686,610,610,pinkie pie
1818346.jpeg,https://derpicdn.net/img/view/2018/8/28/1818346.jpeg,1,0.994515479,2297,625,2833,1161,536,536,pinkie pie
1818346.jpeg,https://derpicdn.net/img/view/2018/8/28/1818346.jpeg,2,0.980818868,784,321,1314,851,530,530,pinkie pie
1818346.jpeg,https://derpicdn.net/img/view/2018/8/28/1818346.jpeg,3,0.979741454,2269,2916,2793,3440,524,524,pinkie pie
1818346.jpeg,https://derpicdn.net/img/view/2018/8/28/1818346.jpeg,5,0.968504786,1864,796,2458,1390,594,594,pinkie pie
1818346.jpeg,https://derpicdn.net/img/view/2018/8/28/1818346.jpeg,6,0.937296927,1261,2344,1791,2874,530,530,pinkie pie
1820594.jpeg,https://derpicdn.net/img/view/2018/8/30/1820594.jpeg,0,0.978041291,14,0,770,723,756,723,pinkie pie
1821206.jpeg,https://derpicdn.net/img/view/2018/8/31/1821206.jpeg,0,0.997218966,107,17,543,453,436,436,pinkie pie
1824137.jpeg,https://derpicdn.net/img/view/2018/9/3/1824137.jpeg,0,0.906823635,469,118,881,530,412,412,pinkie pie
1825845.jpeg,https://derpicdn.net/img/view/2018/9/5/1825845.jpeg,0,0.96247977,135,279,1833,1977,1698,1698,pinkie pie
1825906.jpeg,https://derpicdn.net/img/view/2018/9/6/1825906.jpeg,0,0.977857888,0,56,867,986,867,930,pinkie pie
1827908.jpeg,https://derpicdn.net/img/view/2018/9/8/1827908.jpeg,0,0.97738719,63,78,809,824,746,746,pinkie pie
1829276.jpeg,https://derpicdn.net/img/view/2018/9/10/1829276.jpeg,0,0.974866211,0,23,605,649,605,626,pinkie pie
1829382.jpeg,https://derpicdn.net/img/view/2018/9/10/1829382.jpeg,0,0.988007367,277,0,967,615,690,615,pinkie pie
1831058.jpeg,https://derpicdn.net/img/view/2018/9/12/1831058.jpeg,0,0.986690998,55,0,1015,800,960,800,pinkie pie
1831596.jpeg,https://derpicdn.net/img/view/2018/9/13/1831596.jpeg,0,0.985226572,407,26,1047,666,640,640,pinkie pie
1831906.jpeg,https://derpicdn.net/img/view/2018/9/13/1831906.jpeg,0,0.958839297,504,61,1284,841,780,780,pinkie pie
1832413.jpeg,https://derpicdn.net/img/view/2018/9/14/1832413.jpeg,0,0.934433341,358,139,1080,945,722,806,pinkie pie
1832493.jpeg,https://derpicdn.net/img/view/2018/9/14/1832493.jpeg,0,0.935624897,211,122,1231,1142,1020,1020,pinkie pie
1833951.jpeg,https://derpicdn.net/img/view/2018/9/16/1833951.jpeg,0,0.972827375,165,0,1323,1083,1158,1083,pinkie pie
1837464.jpeg,https://derpicdn.net/img/view/2018/9/21/1837464.jpeg,0,0.992249787,30,693,598,1261,568,568,pinkie pie
1838556.jpeg,https://derpicdn.net/img/view/2018/9/22/1838556.jpeg,0,0.986026466,9,15,385,335,376,320,pinkie pie
1838785.jpeg,https://derpicdn.net/img/view/2018/9/22/1838785.jpeg,0,0.988742113,280,0,932,633,652,633,pinkie pie
1843617.jpeg,https://derpicdn.net/img/view/2018/9/29/1843617.jpeg,0,0.980966806,91,2,335,246,244,244,pinkie pie
1843802.jpeg,https://derpicdn.net/img/view/2018/9/29/1843802.jpeg,0,0.957238138,152,195,726,769,574,574,pinkie pie
1843838.jpeg,https://derpicdn.net/img/view/2018/9/29/1843838.jpeg,0,0.939381301,658,0,2258,1544,1600,1544,pinkie pie
1843873.jpeg,https://derpicdn.net/img/view/2018/9/29/1843873.jpeg,0,0.99922061,25,0,545,501,520,501,pinkie pie
1843873.jpeg,https://derpicdn.net/img/view/2018/9/29/1843873.jpeg,1,0.933630168,0,593,616,1229,616,636,pinkie pie
1847142.jpeg,https://derpicdn.net/img/view/2018/10/3/1847142.jpeg,0,0.998268008,228,43,906,721,678,678,pinkie pie
1849626.jpeg,https://derpicdn.net/img/view/2018/10/6/1849626.jpeg,0,0.995849848,326,9,620,303,294,294,pinkie pie
1849633.jpeg,https://derpicdn.net/img/view/2018/10/6/1849633.jpeg,0,0.990469515,984,0,2893,1768,1909,1768,pinkie pie
1849638.jpeg,https://derpicdn.net/img/view/2018/10/6/1849638.jpeg,0,0.999648333,28,0,588,553,560,553,pinkie pie
1849730.jpeg,https://derpicdn.net/img/view/2018/10/6/1849730.jpeg,0,0.979846418,0,57,324,399,324,342,pinkie pie
1851443.jpeg,https://derpicdn.net/img/view/2018/10/8/1851443.jpeg,0,0.986133277,665,296,1429,1060,764,764,pinkie pie
1852383.jpeg,https://derpicdn.net/img/view/2018/10/9/1852383.jpeg,0,0.978166938,233,68,575,410,342,342,pinkie pie
1852972.jpeg,https://derpicdn.net/img/view/2018/10/10/1852972.jpeg,0,0.996990979,20,27,448,455,428,428,pinkie pie
1853001.jpeg,https://derpicdn.net/img/view/2018/10/10/1853001.jpeg,0,0.911446869,48,13,408,373,360,360,pinkie pie
1853353.jpeg,https://derpicdn.net/img/view/2018/10/10/1853353.jpeg,0,0.957325757,788,666,1736,1614,948,948,pinkie pie
1853353.jpeg,https://derpicdn.net/img/view/2018/10/10/1853353.jpeg,1,0.944954574,2084,634,3158,1708,1074,1074,pinkie pie
1853854.jpeg,https://derpicdn.net/img/view/2018/10/11/1853854.jpeg,0,0.973174453,347,0,1481,928,1134,928,pinkie pie
1854025.jpeg,https://derpicdn.net/img/view/2018/10/11/1854025.jpeg,0,0.947823048,439,487,775,823,336,336,pinkie pie
1855011.jpeg,https://derpicdn.net/img/view/2018/10/13/1855011.jpeg,0,0.92243135,0,96,844,956,844,860,pinkie pie
1855094.jpeg,https://derpicdn.net/img/view/2018/10/13/1855094.jpeg,0,0.943675518,753,0,3285,2038,2532,2038,pinkie pie
1856140.jpeg,https://derpicdn.net/img/view/2018/10/14/1856140.jpeg,0,0.991811156,0,0,1057,1020,1057,1020,pinkie pie
1859334.jpeg,https://derpicdn.net/img/view/2018/10/18/1859334.jpeg,0,0.982602239,0,0,502,483,502,483,pinkie pie
1859337.jpeg,https://derpicdn.net/img/view/2018/10/18/1859337.jpeg,0,0.963025093,13,0,535,467,522,467,pinkie pie
1859338.jpeg,https://derpicdn.net/img/view/2018/10/18/1859338.jpeg,0,0.906639636,49,163,664,795,615,632,pinkie pie
1860867.jpeg,https://derpicdn.net/img/view/2018/10/19/1860867.jpeg,0,0.945389092,53,0,659,511,606,511,pinkie pie
1861009.jpeg,https://derpicdn.net/img/view/2018/10/20/1861009.jpeg,0,0.983688056,400,25,2050,1675,1650,1650,pinkie pie
1864970.jpeg,https://derpicdn.net/img/view/2018/10/24/1864970.jpeg,0,0.935254633,55,4,385,334,330,330,pinkie pie
1865797.jpeg,https://derpicdn.net/img/view/2018/10/25/1865797.jpeg,0,0.993590891,766,584,1122,940,356,356,pinkie pie
1865797.jpeg,https://derpicdn.net/img/view/2018/10/25/1865797.jpeg,1,0.978455961,1142,400,1440,698,298,298,pinkie pie
1865797.jpeg,https://derpicdn.net/img/view/2018/10/25/1865797.jpeg,3,0.917316675,364,1,690,327,326,326,pinkie pie
1869075.jpeg,https://derpicdn.net/img/view/2018/10/29/1869075.jpeg,0,0.990390241,333,71,719,457,386,386,pinkie pie
1869488.jpeg,https://derpicdn.net/img/view/2018/10/29/1869488.jpeg,0,0.978616774,919,33,1271,385,352,352,pinkie pie
1869488.jpeg,https://derpicdn.net/img/view/2018/10/29/1869488.jpeg,1,0.923859,595,1241,975,1621,380,380,pinkie pie
1869489.jpeg,https://derpicdn.net/img/view/2018/10/29/1869489.jpeg,0,0.965694726,460,3,1368,911,908,908,pinkie pie
1869490.jpeg,https://derpicdn.net/img/view/2018/10/29/1869490.jpeg,0,0.988227844,51,0,597,505,546,505,pinkie pie
1869893.jpeg,https://derpicdn.net/img/view/2018/10/29/1869893.jpeg,0,0.965105712,31,0,1363,1279,1332,1279,pinkie pie
1870190.jpeg,https://derpicdn.net/img/view/2018/10/30/1870190.jpeg,0,0.995655954,256,37,760,541,504,504,pinkie pie
1870328.jpeg,https://derpicdn.net/img/view/2018/10/30/1870328.jpeg,0,0.995253801,244,0,1950,1694,1706,1694,pinkie pie
1870741.jpeg,https://derpicdn.net/img/view/2018/10/30/1870741.jpeg,0,0.99786365,272,15,948,691,676,676,pinkie pie
1871397.jpeg,https://derpicdn.net/img/view/2018/10/31/1871397.jpeg,0,0.948974788,0,0,611,654,611,654,pinkie pie
1871990.jpeg,https://derpicdn.net/img/view/2018/11/1/1871990.jpeg,0,0.979669213,760,280,1420,940,660,660,pinkie pie
1873037.jpeg,https://derpicdn.net/img/view/2018/11/2/1873037.jpeg,0,0.975904107,122,0,880,604,758,604,pinkie pie
1873044.jpeg,https://derpicdn.net/img/view/2018/11/2/1873044.jpeg,0,0.95635128,132,0,748,570,616,570,pinkie pie
1874007.jpeg,https://derpicdn.net/img/view/2018/11/3/1874007.jpeg,0,0.972601295,92,0,704,531,612,531,pinkie pie
1875205.jpeg,https://derpicdn.net/img/view/2018/11/4/1875205.jpeg,0,0.994347751,42,52,926,936,884,884,pinkie pie
1875923.jpeg,https://derpicdn.net/img/view/2018/11/5/1875923.jpeg,0,0.967462063,144,0,700,550,556,550,pinkie pie
1877115.jpeg,https://derpicdn.net/img/view/2018/11/7/1877115.jpeg,0,0.996774793,121,220,681,780,560,560,pinkie pie
1877904.jpeg,https://derpicdn.net/img/view/2018/11/8/1877904.jpeg,0,0.992598057,41,0,567,486,526,486,pinkie pie
1878057.jpeg,https://derpicdn.net/img/view/2018/11/9/1878057.jpeg,0,0.999416173,166,0,648,462,482,462,pinkie pie
1879312.jpeg,https://derpicdn.net/img/view/2018/11/10/1879312.jpeg,0,0.931351542,248,68,856,676,608,608,pinkie pie
1880845.jpeg,https://derpicdn.net/img/view/2018/11/12/1880845.jpeg,0,0.946849823,553,23,923,393,370,370,pinkie pie
1884275.jpeg,https://derpicdn.net/img/view/2018/11/17/1884275.jpeg,0,0.990176976,17,0,427,402,410,402,pinkie pie
1884800.jpeg,https://derpicdn.net/img/view/2018/11/18/1884800.jpeg,0,0.905660927,144,59,702,617,558,558,pinkie pie
1885612.jpeg,https://derpicdn.net/img/view/2018/11/19/1885612.jpeg,0,0.990211129,1,25,591,615,590,590,pinkie pie
1885975.jpeg,https://derpicdn.net/img/view/2018/11/19/1885975.jpeg,0,0.942937315,87,63,707,683,620,620,pinkie pie
1886715.jpeg,https://derpicdn.net/img/view/2018/11/20/1886715.jpeg,0,0.996028244,172,0,822,583,650,583,pinkie pie
1887234.jpeg,https://derpicdn.net/img/view/2018/11/21/1887234.jpeg,0,0.996832609,15,0,625,525,610,525,pinkie pie
1887659.jpeg,https://derpicdn.net/img/view/2018/11/21/1887659.jpeg,0,0.985562027,0,0,367,400,367,400,pinkie pie
1888076.jpeg,https://derpicdn.net/img/view/2018/11/22/1888076.jpeg,1,0.970335126,646,0,1542,853,896,853,pinkie pie
1888382.jpeg,https://derpicdn.net/img/view/2018/11/22/1888382.jpeg,0,0.978202105,70,7,952,889,882,882,pinkie pie
1888969.jpeg,https://derpicdn.net/img/view/2018/11/23/1888969.jpeg,0,0.930690944,79,33,1361,1315,1282,1282,pinkie pie
1889231.jpeg,https://derpicdn.net/img/view/2018/11/23/1889231.jpeg,0,0.999091983,15,0,1359,1228,1344,1228,pinkie pie
1890506.jpeg,https://derpicdn.net/img/view/2018/11/25/1890506.jpeg,0,0.982314467,574,0,1200,597,626,597,pinkie pie
1890506.jpeg,https://derpicdn.net/img/view/2018/11/25/1890506.jpeg,1,0.90549469,22,0,674,592,652,592,pinkie pie
1891434.jpeg,https://derpicdn.net/img/view/2018/11/26/1891434.jpeg,0,0.980260849,69,0,625,532,556,532,pinkie pie
1892222.jpeg,https://derpicdn.net/img/view/2018/11/27/1892222.jpeg,0,0.979477465,0,102,365,476,365,374,pinkie pie
1893255.jpeg,https://derpicdn.net/img/view/2018/11/28/1893255.jpeg,0,0.95828402,0,331,1132,1475,1132,1144,pinkie pie
1894654.jpeg,https://derpicdn.net/img/view/2018/11/30/1894654.jpeg,0,0.973184466,165,18,657,510,492,492,pinkie pie
1894655.jpeg,https://derpicdn.net/img/view/2018/11/30/1894655.jpeg,0,0.917195082,227,0,683,443,456,443,pinkie pie
1895055.jpeg,https://derpicdn.net/img/view/2018/12/1/1895055.jpeg,0,0.996947527,308,0,966,652,658,652,pinkie pie
1895258.jpeg,https://derpicdn.net/img/view/2018/12/1/1895258.jpeg,0,0.995127857,175,0,547,354,372,354,pinkie pie
1895809.jpeg,https://derpicdn.net/img/view/2018/12/1/1895809.jpeg,0,0.96540004,20,0,556,529,536,529,pinkie pie
1896224.jpeg,https://derpicdn.net/img/view/2018/12/2/1896224.jpeg,0,0.951007664,67,0,981,906,914,906,pinkie pie
1896396.jpeg,https://derpicdn.net/img/view/2018/12/2/1896396.jpeg,0,0.963444114,295,99,547,351,252,252,pinkie pie
1896404.jpeg,https://derpicdn.net/img/view/2018/12/2/1896404.jpeg,0,0.927941859,67,21,1091,1045,1024,1024,pinkie pie
1896455.jpeg,https://derpicdn.net/img/view/2018/12/2/1896455.jpeg,0,0.977165759,42,0,1482,1415,1440,1415,pinkie pie
1896936.jpeg,https://derpicdn.net/img/view/2018/12/3/1896936.jpeg,0,0.950386584,116,106,874,864,758,758,pinkie pie
1897849.jpeg,https://derpicdn.net/img/view/2018/12/4/1897849.jpeg,0,0.985869944,0,10,553,602,553,592,pinkie pie
1899063.jpeg,https://derpicdn.net/img/view/2018/12/5/1899063.jpeg,0,0.980684102,58,0,582,464,524,464,pinkie pie
1899180.jpeg,https://derpicdn.net/img/view/2018/12/5/1899180.jpeg,0,0.99342674,2119,661,2779,1321,660,660,pinkie pie
1899180.jpeg,https://derpicdn.net/img/view/2018/12/5/1899180.jpeg,1,0.987741172,3355,741,4003,1389,648,648,pinkie pie
1900695.jpeg,https://derpicdn.net/img/view/2018/12/7/1900695.jpeg,0,0.998563111,27,0,541,503,514,503,pinkie pie
1902466.jpeg,https://derpicdn.net/img/view/2018/12/8/1902466.jpeg,0,0.96233511,313,0,909,545,596,545,pinkie pie
1902615.jpeg,https://derpicdn.net/img/view/2018/12/8/1902615.jpeg,0,0.938292563,66,38,1048,1020,982,982,pinkie pie
1903614.jpeg,https://derpicdn.net/img/view/2018/12/9/1903614.jpeg,0,0.996213317,718,0,2698,1974,1980,1974,pinkie pie
1903924.jpeg,https://derpicdn.net/img/view/2018/12/9/1903924.jpeg,0,0.992156506,389,39,921,571,532,532,pinkie pie
1903969.jpeg,https://derpicdn.net/img/view/2018/12/9/1903969.jpeg,0,0.991167963,139,187,343,391,204,204,pinkie pie
1904907.jpeg,https://derpicdn.net/img/view/2018/12/10/1904907.jpeg,0,0.974119127,66,441,1156,1531,1090,1090,pinkie pie
1905166.jpeg,https://derpicdn.net/img/view/2018/12/11/1905166.jpeg,0,0.996041119,0,0,777,706,777,706,pinkie pie
1905990.jpeg,https://derpicdn.net/img/view/2018/12/12/1905990.jpeg,0,0.956936598,409,288,1749,1628,1340,1340,pinkie pie
1906055.jpeg,https://derpicdn.net/img/view/2018/12/12/1906055.jpeg,0,0.991640329,547,0,1403,818,856,818,pinkie pie
1907836.jpeg,https://derpicdn.net/img/view/2018/12/14/1907836.jpeg,0,0.981175125,25,0,565,508,540,508,pinkie pie
1908104.jpeg,https://derpicdn.net/img/view/2018/12/14/1908104.jpeg,0,0.966067672,376,70,1236,930,860,860,pinkie pie
1908505.jpeg,https://derpicdn.net/img/view/2018/12/14/1908505.jpeg,0,0.967655003,307,55,685,433,378,378,pinkie pie
1909954.jpeg,https://derpicdn.net/img/view/2018/12/16/1909954.jpeg,0,0.973324358,264,0,2402,1798,2138,1798,pinkie pie
1910087.jpeg,https://derpicdn.net/img/view/2018/12/16/1910087.jpeg,0,0.976557434,178,41,636,499,458,458,pinkie pie
1910087.jpeg,https://derpicdn.net/img/view/2018/12/16/1910087.jpeg,1,0.975429475,703,26,1223,546,520,520,pinkie pie
1911610.jpeg,https://derpicdn.net/img/view/2018/12/17/1911610.jpeg,0,0.96136111,0,0,715,671,715,671,pinkie pie
1913005.jpeg,https://derpicdn.net/img/view/2018/12/19/1913005.jpeg,0,0.98951751,0,35,1363,1411,1363,1376,pinkie pie
1913799.jpeg,https://derpicdn.net/img/view/2018/12/20/1913799.jpeg,0,0.991774201,63,0,571,441,508,441,pinkie pie
1914332.jpeg,https://derpicdn.net/img/view/2018/12/21/1914332.jpeg,0,0.991205573,257,0,886,655,629,655,pinkie pie
1915503.jpeg,https://derpicdn.net/img/view/2018/12/22/1915503.jpeg,0,0.969781995,357,0,1031,598,674,598,pinkie pie
1916140.jpeg,https://derpicdn.net/img/view/2018/12/23/1916140.jpeg,0,0.996939778,126,0,560,403,434,403,pinkie pie
1916291.jpeg,https://derpicdn.net/img/view/2018/12/23/1916291.jpeg,0,0.966591716,0,0,661,682,661,682,pinkie pie
1918339.jpeg,https://derpicdn.net/img/view/2018/12/25/1918339.jpeg,0,0.990698218,104,0,644,523,540,523,pinkie pie
1919514.jpeg,https://derpicdn.net/img/view/2018/12/26/1919514.jpeg,0,0.994595647,276,43,944,711,668,668,pinkie pie
1920157.jpeg,https://derpicdn.net/img/view/2018/12/27/1920157.jpeg,0,0.992628217,100,85,802,787,702,702,pinkie pie
1922077.jpeg,https://derpicdn.net/img/view/2018/12/30/1922077.jpeg,0,0.973299444,150,26,586,462,436,436,pinkie pie
1922518.jpeg,https://derpicdn.net/img/view/2018/12/30/1922518.jpeg,0,0.990155041,503,0,1335,800,832,800,pinkie pie
1922771.jpeg,https://derpicdn.net/img/view/2018/12/31/1922771.jpeg,0,0.997526824,171,0,633,437,462,437,pinkie pie
1922828.jpeg,https://derpicdn.net/img/view/2018/12/31/1922828.jpeg,0,0.985128582,120,518,500,898,380,380,pinkie pie
1923189.jpeg,https://derpicdn.net/img/view/2018/12/31/1923189.jpeg,0,0.990725994,141,0,835,582,694,582,pinkie pie
1923735.jpeg,https://derpicdn.net/img/view/2019/1/1/1923735.jpeg,0,0.997003019,496,173,1296,973,800,800,pinkie pie
1924556.jpeg,https://derpicdn.net/img/view/2019/1/2/1924556.jpeg,0,0.974229991,128,0,1428,1171,1300,1171,pinkie pie
1924893.jpeg,https://derpicdn.net/img/view/2019/1/2/1924893.jpeg,0,0.995015144,42,0,610,558,568,558,pinkie pie
1925881.jpeg,https://derpicdn.net/img/view/2019/1/3/1925881.jpeg,0,0.990791082,35,0,951,808,916,808,pinkie pie
1926494.jpeg,https://derpicdn.net/img/view/2019/1/4/1926494.jpeg,0,0.918564677,328,45,1000,743,672,698,pinkie pie
1926646.jpeg,https://derpicdn.net/img/view/2019/1/4/1926646.jpeg,0,0.99005878,97,0,1024,910,927,910,pinkie pie
1928146.jpeg,https://derpicdn.net/img/view/2019/1/6/1928146.jpeg,0,0.908914685,449,26,1073,650,624,624,pinkie pie
1928182.jpeg,https://derpicdn.net/img/view/2019/1/6/1928182.jpeg,0,0.948327065,689,871,1199,1381,510,510,pinkie pie
1928194.jpeg,https://derpicdn.net/img/view/2019/1/6/1928194.jpeg,0,0.979323745,0,250,477,734,477,484,pinkie pie
1928194.jpeg,https://derpicdn.net/img/view/2019/1/6/1928194.jpeg,1,0.963290274,1028,661,1490,1123,462,462,pinkie pie
1928618.jpeg,https://derpicdn.net/img/view/2019/1/6/1928618.jpeg,0,0.925338149,209,105,685,581,476,476,pinkie pie
1928618.jpeg,https://derpicdn.net/img/view/2019/1/6/1928618.jpeg,2,0.904572904,1027,1709,1567,2249,540,540,pinkie pie
1929282.jpeg,https://derpicdn.net/img/view/2019/1/7/1929282.jpeg,0,0.916252971,306,117,1254,1065,948,948,pinkie pie
1929417.jpeg,https://derpicdn.net/img/view/2019/1/8/1929417.jpeg,0,0.976879478,87,9,743,665,656,656,pinkie pie
1929447.jpeg,https://derpicdn.net/img/view/2019/1/8/1929447.jpeg,0,0.970408797,235,45,1008,812,773,767,pinkie pie
1929929.jpeg,https://derpicdn.net/img/view/2019/1/8/1929929.jpeg,0,0.931822121,140,0,932,757,792,757,pinkie pie
1930048.jpeg,https://derpicdn.net/img/view/2019/1/8/1930048.jpeg,0,0.96612972,261,0,1089,731,828,731,pinkie pie
1930564.jpeg,https://derpicdn.net/img/view/2019/1/9/1930564.jpeg,0,0.946482182,125,38,761,688,636,650,pinkie pie
1931902.jpeg,https://derpicdn.net/img/view/2019/1/10/1931902.jpeg,0,0.94045943,65,10,791,882,726,872,pinkie pie
1932537.jpeg,https://derpicdn.net/img/view/2019/1/11/1932537.jpeg,0,0.967255175,136,0,1306,1026,1170,1026,pinkie pie
1932727.jpeg,https://derpicdn.net/img/view/2019/1/12/1932727.jpeg,0,0.995346189,0,0,590,543,590,543,pinkie pie
1937072.jpeg,https://derpicdn.net/img/view/2019/1/16/1937072.jpeg,0,0.998452365,305,170,745,610,440,440,pinkie pie
1937233.jpeg,https://derpicdn.net/img/view/2019/1/17/1937233.jpeg,0,0.991829038,625,75,1123,573,498,498,pinkie pie
1938157.jpeg,https://derpicdn.net/img/view/2019/1/18/1938157.jpeg,0,0.943089128,140,0,988,804,848,804,pinkie pie
1939276.jpeg,https://derpicdn.net/img/view/2019/1/19/1939276.jpeg,0,0.988196433,148,0,948,775,800,775,pinkie pie
1939277.jpeg,https://derpicdn.net/img/view/2019/1/19/1939277.jpeg,0,0.991895199,196,0,1180,874,984,874,pinkie pie
1939340.jpeg,https://derpicdn.net/img/view/2019/1/19/1939340.jpeg,0,0.971515,439,11,1171,743,732,732,pinkie pie
1941274.jpeg,https://derpicdn.net/img/view/2019/1/21/1941274.jpeg,0,0.942032695,307,11,803,507,496,496,pinkie pie
1941468.jpeg,https://derpicdn.net/img/view/2019/1/22/1941468.jpeg,0,0.996188045,62,0,606,499,544,499,pinkie pie
1942586.jpeg,https://derpicdn.net/img/view/2019/1/23/1942586.jpeg,0,0.983722389,148,0,680,511,532,511,pinkie pie
1942856.jpeg,https://derpicdn.net/img/view/2019/1/23/1942856.jpeg,0,0.972551405,3,0,935,814,932,814,pinkie pie
1943368.jpeg,https://derpicdn.net/img/view/2019/1/24/1943368.jpeg,0,0.992426038,323,0,847,477,524,477,pinkie pie
1943611.jpeg,https://derpicdn.net/img/view/2019/1/24/1943611.jpeg,0,0.983809888,383,42,1161,820,778,778,pinkie pie
1944829.jpeg,https://derpicdn.net/img/view/2019/1/26/1944829.jpeg,0,0.961996555,0,0,816,819,816,819,pinkie pie
1945520.jpeg,https://derpicdn.net/img/view/2019/1/27/1945520.jpeg,0,0.933343112,108,0,662,522,554,522,pinkie pie
1946161.jpeg,https://derpicdn.net/img/view/2019/1/27/1946161.jpeg,0,0.969592929,26,0,1498,1422,1472,1422,pinkie pie
1946264.jpeg,https://derpicdn.net/img/view/2019/1/27/1946264.jpeg,0,0.901679993,347,772,887,1312,540,540,pinkie pie
1946669.jpeg,https://derpicdn.net/img/view/2019/1/28/1946669.jpeg,0,0.994477928,196,0,840,629,644,629,pinkie pie
1946671.jpeg,https://derpicdn.net/img/view/2019/1/28/1946671.jpeg,0,0.962389588,449,85,1145,781,696,696,pinkie pie
1946856.jpeg,https://derpicdn.net/img/view/2019/1/28/1946856.jpeg,0,0.969463944,214,0,768,578,554,578,pinkie pie
1946865.jpeg,https://derpicdn.net/img/view/2019/1/28/1946865.jpeg,0,0.955519259,128,44,714,630,586,586,pinkie pie
1947850.jpeg,https://derpicdn.net/img/view/2019/1/29/1947850.jpeg,0,0.959279597,388,14,786,412,398,398,pinkie pie
1949019.jpeg,https://derpicdn.net/img/view/2019/1/30/1949019.jpeg,0,0.974311769,214,0,970,739,756,739,pinkie pie
1949174.jpeg,https://derpicdn.net/img/view/2019/1/31/1949174.jpeg,0,0.972754478,73,0,913,784,840,784,pinkie pie
1949951.jpeg,https://derpicdn.net/img/view/2019/2/1/1949951.jpeg,0,0.994314313,436,0,1338,896,902,896,pinkie pie
1950494.jpeg,https://derpicdn.net/img/view/2019/2/1/1950494.jpeg,0,0.965873718,2,0,666,667,664,667,pinkie pie
1951343.jpeg,https://derpicdn.net/img/view/2019/2/2/1951343.jpeg,0,0.988547444,45,0,725,609,680,609,pinkie pie
1951669.jpeg,https://derpicdn.net/img/view/2019/2/3/1951669.jpeg,0,0.984912813,130,8,1698,1576,1568,1568,pinkie pie
1951670.jpeg,https://derpicdn.net/img/view/2019/2/3/1951670.jpeg,0,0.94152236,34,0,1064,1027,1030,1027,pinkie pie
1951691.jpeg,https://derpicdn.net/img/view/2019/2/3/1951691.jpeg,0,0.956273019,281,0,795,491,514,491,pinkie pie
1951698.jpeg,https://derpicdn.net/img/view/2019/2/3/1951698.jpeg,0,0.932964444,52,147,1684,1779,1632,1632,pinkie pie
1952272.jpeg,https://derpicdn.net/img/view/2019/2/3/1952272.jpeg,0,0.967140794,339,0,867,484,528,484,pinkie pie
1952547.jpeg,https://derpicdn.net/img/view/2019/2/3/1952547.jpeg,0,0.986850917,183,64,905,786,722,722,pinkie pie
1952554.jpeg,https://derpicdn.net/img/view/2019/2/3/1952554.jpeg,0,0.9904809,103,14,927,838,824,824,pinkie pie
1952876.jpeg,https://derpicdn.net/img/view/2019/2/4/1952876.jpeg,0,0.985113859,471,0,1915,1379,1444,1379,pinkie pie
1953272.jpeg,https://derpicdn.net/img/view/2019/2/4/1953272.jpeg,0,0.973909676,222,1564,564,1906,342,342,pinkie pie
1953362.jpeg,https://derpicdn.net/img/view/2019/2/4/1953362.jpeg,0,0.999474108,1656,572,3120,2036,1464,1464,pinkie pie
1953368.jpeg,https://derpicdn.net/img/view/2019/2/4/1953368.jpeg,0,0.990709066,1984,432,3254,1702,1270,1270,pinkie pie
1953598.jpeg,https://derpicdn.net/img/view/2019/2/4/1953598.jpeg,0,0.961222768,134,71,448,385,314,314,pinkie pie
1955079.jpeg,https://derpicdn.net/img/view/2019/2/6/1955079.jpeg,0,0.993746698,416,56,972,612,556,556,pinkie pie
1955894.jpeg,https://derpicdn.net/img/view/2019/2/7/1955894.jpeg,0,0.984189868,0,0,618,554,618,554,pinkie pie
1956689.jpeg,https://derpicdn.net/img/view/2019/2/8/1956689.jpeg,0,0.978929996,19,40,601,622,582,582,pinkie pie
1957448.jpeg,https://derpicdn.net/img/view/2019/2/9/1957448.jpeg,0,0.908760726,0,0,457,453,457,453,pinkie pie
1958475.jpeg,https://derpicdn.net/img/view/2019/2/10/1958475.jpeg,0,0.998811483,226,104,474,352,248,248,pinkie pie
1960093.jpeg,https://derpicdn.net/img/view/2019/2/12/1960093.jpeg,0,0.992259562,7,0,621,599,614,599,pinkie pie
1961325.jpeg,https://derpicdn.net/img/view/2019/2/14/1961325.jpeg,0,0.945169389,769,125,1283,639,514,514,pinkie pie
1961374.jpeg,https://derpicdn.net/img/view/2019/2/14/1961374.jpeg,0,0.916955888,0,0,800,936,800,936,pinkie pie
1961628.jpeg,https://derpicdn.net/img/view/2019/2/14/1961628.jpeg,0,0.991796494,189,80,431,322,242,242,pinkie pie
1961752.jpeg,https://derpicdn.net/img/view/2019/2/14/1961752.jpeg,0,0.956363976,2843,487,3781,1425,938,938,pinkie pie
1961819.jpeg,https://derpicdn.net/img/view/2019/2/14/1961819.jpeg,0,0.973002315,313,51,945,683,632,632,pinkie pie
1963071.jpeg,https://derpicdn.net/img/view/2019/2/15/1963071.jpeg,0,0.981251657,90,0,696,599,606,599,pinkie pie
1963208.jpeg,https://derpicdn.net/img/view/2019/2/16/1963208.jpeg,0,0.983963966,231,0,1489,1186,1258,1186,pinkie pie
1964588.jpeg,https://derpicdn.net/img/view/2019/2/17/1964588.jpeg,0,0.998742938,542,152,968,578,426,426,pinkie pie
1965156.jpeg,https://derpicdn.net/img/view/2019/2/18/1965156.jpeg,0,0.972846746,472,0,926,396,454,396,pinkie pie
1965316.jpeg,https://derpicdn.net/img/view/2019/2/18/1965316.jpeg,0,0.949740112,471,89,1743,1361,1272,1272,pinkie pie
1966980.jpeg,https://derpicdn.net/img/view/2019/2/20/1966980.jpeg,0,0.986951411,259,89,769,599,510,510,pinkie pie
1970177.jpeg,https://derpicdn.net/img/view/2019/2/24/1970177.jpeg,0,0.985397995,453,542,2041,2130,1588,1588,pinkie pie
1970421.jpeg,https://derpicdn.net/img/view/2019/2/24/1970421.jpeg,0,0.969944894,150,0,666,480,516,480,pinkie pie
1971453.jpeg,https://derpicdn.net/img/view/2019/2/25/1971453.jpeg,0,0.998302937,312,0,954,581,642,581,pinkie pie
1974599.jpeg,https://derpicdn.net/img/view/2019/3/1/1974599.jpeg,0,0.962022901,204,83,1012,891,808,808,pinkie pie
1974895.jpeg,https://derpicdn.net/img/view/2019/3/1/1974895.jpeg,0,0.959168792,131,0,1171,1034,1040,1034,pinkie pie
1975112.jpeg,https://derpicdn.net/img/view/2019/3/2/1975112.jpeg,0,0.967588246,0,44,711,1048,711,1004,pinkie pie
197518.jpeg,https://derpicdn.net/img/view/2012/12/30/197518.jpeg,0,0.919374406,0,50,490,550,490,500,pinkie pie
1975288.jpeg,https://derpicdn.net/img/view/2019/3/2/1975288.jpeg,0,0.988928318,343,0,947,549,604,549,pinkie pie
1976540.jpeg,https://derpicdn.net/img/view/2019/3/3/1976540.jpeg,0,0.996421695,328,47,996,715,668,668,pinkie pie
1978093.jpeg,https://derpicdn.net/img/view/2019/3/5/1978093.jpeg,0,0.997339427,716,16,1778,1078,1062,1062,pinkie pie
1979150.jpeg,https://derpicdn.net/img/view/2019/3/7/1979150.jpeg,0,0.997894287,400,0,1504,1052,1104,1052,pinkie pie
1979219.jpeg,https://derpicdn.net/img/view/2019/3/7/1979219.jpeg,0,0.947863162,7,0,365,343,358,343,pinkie pie
1979318.jpeg,https://derpicdn.net/img/view/2019/3/7/1979318.jpeg,0,0.988616347,0,0,278,268,278,268,pinkie pie
197957.jpeg,https://derpicdn.net/img/view/2012/12/30/197957.jpeg,0,0.990159333,560,471,980,891,420,420,pinkie pie
1979886.jpeg,https://derpicdn.net/img/view/2019/3/7/1979886.jpeg,0,0.990151823,115,0,1369,1129,1254,1129,pinkie pie
1983110.jpeg,https://derpicdn.net/img/view/2019/3/11/1983110.jpeg,0,0.946706951,221,62,1541,1382,1320,1320,pinkie pie
1983212.jpeg,https://derpicdn.net/img/view/2019/3/11/1983212.jpeg,0,0.95973444,393,2,612,226,219,224,pinkie pie
1983543.jpeg,https://derpicdn.net/img/view/2019/3/12/1983543.jpeg,0,0.985036135,225,1,505,281,280,280,pinkie pie
1984509.jpeg,https://derpicdn.net/img/view/2019/3/13/1984509.jpeg,0,0.943828046,0,0,649,656,649,656,pinkie pie
1985209.jpeg,https://derpicdn.net/img/view/2019/3/14/1985209.jpeg,0,0.986147702,327,0,1221,741,894,741,pinkie pie
1989094.jpeg,https://derpicdn.net/img/view/2019/3/18/1989094.jpeg,0,0.980145693,112,0,834,631,722,631,pinkie pie
1990064.jpeg,https://derpicdn.net/img/view/2019/3/19/1990064.jpeg,0,0.972717345,207,0,729,509,522,509,pinkie pie
1990065.jpeg,https://derpicdn.net/img/view/2019/3/19/1990065.jpeg,0,0.99988091,585,39,999,453,414,414,pinkie pie
1990921.jpeg,https://derpicdn.net/img/view/2019/3/20/1990921.jpeg,0,0.960833192,0,129,606,720,606,591,pinkie pie
1991681.jpeg,https://derpicdn.net/img/view/2019/3/21/1991681.jpeg,0,0.929400325,0,0,1076,1098,1076,1098,pinkie pie
1992148.jpeg,https://derpicdn.net/img/view/2019/3/22/1992148.jpeg,0,0.982356131,113,54,1367,1308,1254,1254,pinkie pie
1992555.jpeg,https://derpicdn.net/img/view/2019/3/23/1992555.jpeg,0,0.963283658,0,93,1345,1503,1345,1410,pinkie pie
199331.jpeg,https://derpicdn.net/img/view/2013/1/1/199331.jpeg,0,0.996043563,107,0,495,371,388,371,pinkie pie
1994378.jpeg,https://derpicdn.net/img/view/2019/3/25/1994378.jpeg,0,0.943618059,530,339,740,549,210,210,pinkie pie
1994414.jpeg,https://derpicdn.net/img/view/2019/3/25/1994414.jpeg,0,0.918525338,81,101,435,455,354,354,pinkie pie
1995310.jpeg,https://derpicdn.net/img/view/2019/3/26/1995310.jpeg,0,0.994626343,29,35,1255,1261,1226,1226,pinkie pie
1999264.jpeg,https://derpicdn.net/img/view/2019/3/31/1999264.jpeg,0,0.996039569,64,0,592,508,528,508,pinkie pie
2001777.jpeg,https://derpicdn.net/img/view/2019/4/3/2001777.jpeg,0,0.972837329,294,35,576,317,282,282,pinkie pie
2005393.jpeg,https://derpicdn.net/img/view/2019/4/7/2005393.jpeg,0,0.971236348,679,88,1303,712,624,624,pinkie pie
2005563.jpeg,https://derpicdn.net/img/view/2019/4/7/2005563.jpeg,0,0.922258794,323,0,1655,1052,1332,1052,pinkie pie
2006877.jpeg,https://derpicdn.net/img/view/2019/4/8/2006877.jpeg,0,0.966368139,0,421,1534,2045,1534,1624,pinkie pie
2009883.jpeg,https://derpicdn.net/img/view/2019/4/12/2009883.jpeg,0,0.937816679,181,15,1647,1481,1466,1466,pinkie pie
2010324.jpeg,https://derpicdn.net/img/view/2019/4/13/2010324.jpeg,0,0.991065264,108,0,744,608,636,608,pinkie pie
2011563.jpeg,https://derpicdn.net/img/view/2019/4/14/2011563.jpeg,0,0.979433298,211,0,1910,1280,1699,1280,pinkie pie
2012310.jpeg,https://derpicdn.net/img/view/2019/4/14/2012310.jpeg,0,0.905459762,605,235,971,601,366,366,pinkie pie
2016251.jpeg,https://derpicdn.net/img/view/2019/4/18/2016251.jpeg,0,0.998847544,374,0,824,446,450,446,pinkie pie
2023085.jpeg,https://derpicdn.net/img/view/2019/4/26/2023085.jpeg,0,0.987663388,148,9,832,693,684,684,pinkie pie
2026897.jpeg,https://derpicdn.net/img/view/2019/4/29/2026897.jpeg,0,0.950166643,52,6,934,888,882,882,pinkie pie
2027330.jpeg,https://derpicdn.net/img/view/2019/4/30/2027330.jpeg,0,0.955600858,511,0,1337,811,826,811,pinkie pie
2028100.jpeg,https://derpicdn.net/img/view/2019/5/1/2028100.jpeg,0,0.9947685,218,0,746,512,528,512,pinkie pie
2029013.jpeg,https://derpicdn.net/img/view/2019/5/2/2029013.jpeg,0,0.997398376,162,0,710,529,548,529,pinkie pie
2029120.jpeg,https://derpicdn.net/img/view/2019/5/2/2029120.jpeg,0,0.947706878,330,0,1362,894,1032,894,pinkie pie
2029166.jpeg,https://derpicdn.net/img/view/2019/5/2/2029166.jpeg,0,0.938624859,170,41,764,635,594,594,pinkie pie
2029297.jpeg,https://derpicdn.net/img/view/2019/5/2/2029297.jpeg,0,0.998868346,488,155,1364,1031,876,876,pinkie pie
2029952.jpeg,https://derpicdn.net/img/view/2019/5/3/2029952.jpeg,0,0.91567111,260,0,1430,1043,1170,1043,pinkie pie
2030049.jpeg,https://derpicdn.net/img/view/2019/5/3/2030049.jpeg,0,0.995333076,17,0,1259,1188,1242,1188,pinkie pie
2031808.jpeg,https://derpicdn.net/img/view/2019/5/5/2031808.jpeg,0,0.998966694,150,28,590,468,440,440,pinkie pie
2032864.jpeg,https://derpicdn.net/img/view/2019/5/7/2032864.jpeg,0,0.97761333,371,250,1207,1086,836,836,pinkie pie
2033893.jpeg,https://derpicdn.net/img/view/2019/5/8/2033893.jpeg,0,0.990929425,119,15,933,829,814,814,pinkie pie
2036500.jpeg,https://derpicdn.net/img/view/2019/5/11/2036500.jpeg,0,0.994511008,180,0,1050,856,870,856,pinkie pie
2037341.jpeg,https://derpicdn.net/img/view/2019/5/12/2037341.jpeg,0,0.982200086,813,89,1545,821,732,732,pinkie pie
2038519.jpeg,https://derpicdn.net/img/view/2019/5/14/2038519.jpeg,0,0.951904833,46,0,486,414,440,414,pinkie pie
2038941.jpeg,https://derpicdn.net/img/view/2019/5/14/2038941.jpeg,0,0.960305333,61,70,627,636,566,566,pinkie pie
2048891.jpeg,https://derpicdn.net/img/view/2019/5/25/2048891.jpeg,0,0.999868989,632,0,3384,2419,2752,2419,pinkie pie
2048913.jpeg,https://derpicdn.net/img/view/2019/5/25/2048913.jpeg,0,0.976795852,89,0,969,768,880,768,pinkie pie
2050093.jpeg,https://derpicdn.net/img/view/2019/5/26/2050093.jpeg,0,0.983224571,0,98,852,905,852,807,pinkie pie
2050694.jpeg,https://derpicdn.net/img/view/2019/5/27/2050694.jpeg,1,0.97473377,840,270,1296,726,456,456,pinkie pie
2052231.jpeg,https://derpicdn.net/img/view/2019/5/29/2052231.jpeg,0,0.960180521,31,0,939,867,908,867,pinkie pie
2054720.jpeg,https://derpicdn.net/img/view/2019/6/1/2054720.jpeg,0,0.962340474,182,249,418,485,236,236,pinkie pie
2056191.jpeg,https://derpicdn.net/img/view/2019/6/2/2056191.jpeg,0,0.96535337,435,532,2687,2784,2252,2252,pinkie pie
2060361.jpeg,https://derpicdn.net/img/view/2019/6/8/2060361.jpeg,0,0.985096812,0,0,1150,1261,1150,1261,pinkie pie
2060951.jpeg,https://derpicdn.net/img/view/2019/6/8/2060951.jpeg,0,0.991972029,547,394,887,734,340,340,pinkie pie
2062475.jpeg,https://derpicdn.net/img/view/2019/6/10/2062475.jpeg,0,0.938158631,463,19,1800,1381,1337,1362,pinkie pie
2063740.jpeg,https://derpicdn.net/img/view/2019/6/12/2063740.jpeg,0,0.99833262,23,0,899,848,876,848,pinkie pie
2066100.jpeg,https://derpicdn.net/img/view/2019/6/15/2066100.jpeg,0,0.979126453,149,0,949,785,800,785,pinkie pie
2067321.jpeg,https://derpicdn.net/img/view/2019/6/16/2067321.jpeg,0,0.984020472,275,0,1487,1169,1212,1169,pinkie pie
2069844.jpeg,https://derpicdn.net/img/view/2019/6/19/2069844.jpeg,0,0.944080591,124,34,660,570,536,536,pinkie pie
2070211.jpeg,https://derpicdn.net/img/view/2019/6/20/2070211.jpeg,0,0.91928798,413,192,957,736,544,544,pinkie pie
2071306.jpeg,https://derpicdn.net/img/view/2019/6/21/2071306.jpeg,0,0.946839273,0,6,1305,1398,1305,1392,pinkie pie
2074587.jpeg,https://derpicdn.net/img/view/2019/6/24/2074587.jpeg,0,0.994152904,63,16,651,604,588,588,pinkie pie
2074588.jpeg,https://derpicdn.net/img/view/2019/6/24/2074588.jpeg,0,0.963338077,168,118,636,586,468,468,pinkie pie
2074599.jpeg,https://derpicdn.net/img/view/2019/6/25/2074599.jpeg,0,0.961455166,0,0,680,534,680,534,pinkie pie
2074852.jpeg,https://derpicdn.net/img/view/2019/6/25/2074852.jpeg,0,0.991132736,42,75,356,389,314,314,pinkie pie
2077630.jpeg,https://derpicdn.net/img/view/2019/6/28/2077630.jpeg,0,0.998652041,435,0,1113,624,678,624,pinkie pie
2077630.jpeg,https://derpicdn.net/img/view/2019/6/28/2077630.jpeg,1,0.991544724,1028,0,1600,558,572,558,pinkie pie
2078399.jpeg,https://derpicdn.net/img/view/2019/6/29/2078399.jpeg,0,0.909789324,235,0,1285,1011,1050,1011,pinkie pie
2079569.jpeg,https://derpicdn.net/img/view/2019/6/30/2079569.jpeg,0,0.973152161,329,333,1255,1259,926,926,pinkie pie
2081117.jpeg,https://derpicdn.net/img/view/2019/7/2/2081117.jpeg,0,0.995639563,245,0,940,659,695,659,pinkie pie
2081121.jpeg,https://derpicdn.net/img/view/2019/7/2/2081121.jpeg,0,0.995085359,284,0,814,512,530,512,pinkie pie
2082263.jpeg,https://derpicdn.net/img/view/2019/7/3/2082263.jpeg,0,0.988306582,368,414,852,898,484,484,pinkie pie
2082267.jpeg,https://derpicdn.net/img/view/2019/7/3/2082267.jpeg,0,0.938085973,0,46,597,712,597,666,pinkie pie
2083586.jpeg,https://derpicdn.net/img/view/2019/7/5/2083586.jpeg,0,0.98660779,220,0,998,767,778,767,pinkie pie
2084753.jpeg,https://derpicdn.net/img/view/2019/7/6/2084753.jpeg,0,0.97307843,24,52,339,349,315,297,pinkie pie
2085696.jpeg,https://derpicdn.net/img/view/2019/7/8/2085696.jpeg,0,0.976238608,458,731,1290,1563,832,832,pinkie pie
2086560.jpeg,https://derpicdn.net/img/view/2019/7/8/2086560.jpeg,0,0.975633562,498,345,1306,1153,808,808,pinkie pie
2086694.jpeg,https://derpicdn.net/img/view/2019/7/8/2086694.jpeg,0,0.988525748,113,0,663,490,550,490,pinkie pie
2086936.jpeg,https://derpicdn.net/img/view/2019/7/9/2086936.jpeg,0,0.999158859,789,0,1600,713,811,713,pinkie pie
2087212.jpeg,https://derpicdn.net/img/view/2019/7/9/2087212.jpeg,0,0.95928508,271,0,743,465,472,465,pinkie pie
2087632.jpeg,https://derpicdn.net/img/view/2019/7/10/2087632.jpeg,0,0.997381091,85,26,645,586,560,560,pinkie pie
2088666.jpeg,https://derpicdn.net/img/view/2019/7/11/2088666.jpeg,0,0.98585093,21,0,739,693,718,693,pinkie pie
2090085.jpeg,https://derpicdn.net/img/view/2019/7/12/2090085.jpeg,0,0.986419916,120,26,396,302,276,276,pinkie pie
2090283.jpeg,https://derpicdn.net/img/view/2019/7/13/2090283.jpeg,0,0.948191583,164,0,1158,980,994,980,pinkie pie
2091183.jpeg,https://derpicdn.net/img/view/2019/7/14/2091183.jpeg,0,0.996275544,314,0,696,369,382,369,pinkie pie
2093703.jpeg,https://derpicdn.net/img/view/2019/7/16/2093703.jpeg,0,0.984962285,54,0,650,562,596,562,pinkie pie
2093747.jpeg,https://derpicdn.net/img/view/2019/7/16/2093747.jpeg,0,0.972804248,44,16,500,472,456,456,pinkie pie
2094329.jpeg,https://derpicdn.net/img/view/2019/7/17/2094329.jpeg,0,0.966750622,186,0,1000,795,814,795,pinkie pie
2094354.jpeg,https://derpicdn.net/img/view/2019/7/17/2094354.jpeg,0,0.987815082,88,17,536,465,448,448,pinkie pie
2095190.jpeg,https://derpicdn.net/img/view/2019/7/18/2095190.jpeg,0,0.97932601,0,51,1000,1091,1000,1040,pinkie pie
2095358.jpeg,https://derpicdn.net/img/view/2019/7/18/2095358.jpeg,0,0.916380107,562,4,1074,516,512,512,pinkie pie
2096780.jpeg,https://derpicdn.net/img/view/2019/7/20/2096780.jpeg,0,0.986459374,203,0,1111,840,908,840,pinkie pie
2097097.jpeg,https://derpicdn.net/img/view/2019/7/20/2097097.jpeg,0,0.964187384,65,1,639,575,574,574,pinkie pie
2099254.jpeg,https://derpicdn.net/img/view/2019/7/23/2099254.jpeg,0,0.996495545,151,0,1163,990,1012,990,pinkie pie
2099778.jpeg,https://derpicdn.net/img/view/2019/7/24/2099778.jpeg,1,0.907706201,1172,989,1512,1329,340,340,pinkie pie
2101777.jpeg,https://derpicdn.net/img/view/2019/7/26/2101777.jpeg,0,0.949172676,138,275,1664,1801,1526,1526,pinkie pie
2102341.jpeg,https://derpicdn.net/img/view/2019/7/27/2102341.jpeg,0,0.999082804,130,23,758,651,628,628,pinkie pie
2103854.jpeg,https://derpicdn.net/img/view/2019/7/29/2103854.jpeg,0,0.976982653,0,0,1431,1465,1431,1465,pinkie pie
2104839.jpeg,https://derpicdn.net/img/view/2019/7/30/2104839.jpeg,0,0.997004926,1683,0,2919,1181,1236,1181,pinkie pie
2104839.jpeg,https://derpicdn.net/img/view/2019/7/30/2104839.jpeg,3,0.910605788,2558,152,3760,1354,1202,1202,pinkie pie
2106588.jpeg,https://derpicdn.net/img/view/2019/8/1/2106588.jpeg,0,0.973823488,56,0,508,447,452,447,pinkie pie
2108420.jpeg,https://derpicdn.net/img/view/2019/8/4/2108420.jpeg,0,0.991344154,212,0,906,660,694,660,pinkie pie
2109639.jpeg,https://derpicdn.net/img/view/2019/8/5/2109639.jpeg,0,0.998681426,168,13,658,503,490,490,pinkie pie
2110175.jpeg,https://derpicdn.net/img/view/2019/8/6/2110175.jpeg,0,0.994677842,2605,0,4327,1541,1722,1541,pinkie pie
2110175.jpeg,https://derpicdn.net/img/view/2019/8/6/2110175.jpeg,1,0.987859786,392,446,1206,1260,814,814,pinkie pie
2110175.jpeg,https://derpicdn.net/img/view/2019/8/6/2110175.jpeg,2,0.906008542,1183,31,2387,1235,1204,1204,pinkie pie
2110940.jpeg,https://derpicdn.net/img/view/2019/8/7/2110940.jpeg,0,0.985236108,337,0,727,373,390,373,pinkie pie
2113003.jpeg,https://derpicdn.net/img/view/2019/8/9/2113003.jpeg,0,0.944958925,335,0,785,421,450,421,pinkie pie
2114948.jpeg,https://derpicdn.net/img/view/2019/8/11/2114948.jpeg,0,0.940750718,605,74,941,410,336,336,pinkie pie
2116059.jpeg,https://derpicdn.net/img/view/2019/8/12/2116059.jpeg,0,0.988963306,18,0,552,528,534,528,pinkie pie
2116096.jpeg,https://derpicdn.net/img/view/2019/8/12/2116096.jpeg,0,0.981829941,112,0,634,486,522,486,pinkie pie
2122054.jpeg,https://derpicdn.net/img/view/2019/8/19/2122054.jpeg,0,0.989476085,81,0,1393,1225,1312,1225,pinkie pie
2122444.jpeg,https://derpicdn.net/img/view/2019/8/19/2122444.jpeg,0,0.974893272,395,107,1145,857,750,750,pinkie pie
2123811.jpeg,https://derpicdn.net/img/view/2019/8/21/2123811.jpeg,0,0.979408741,104,0,680,555,576,555,pinkie pie
2123828.jpeg,https://derpicdn.net/img/view/2019/8/21/2123828.jpeg,0,0.981931984,0,31,444,523,444,492,pinkie pie
2123846.jpeg,https://derpicdn.net/img/view/2019/8/21/2123846.jpeg,0,0.974444985,0,0,423,430,423,430,pinkie pie
2123846.jpeg,https://derpicdn.net/img/view/2019/8/21/2123846.jpeg,1,0.959057748,399,32,798,434,399,402,pinkie pie
2127357.jpeg,https://derpicdn.net/img/view/2019/8/25/2127357.jpeg,0,0.949967742,52,0,610,557,558,557,pinkie pie
2128837.jpeg,https://derpicdn.net/img/view/2019/8/27/2128837.jpeg,0,0.980313599,238,0,1536,1128,1298,1128,pinkie pie
2128838.jpeg,https://derpicdn.net/img/view/2019/8/27/2128838.jpeg,0,0.967604339,424,37,1272,885,848,848,pinkie pie
2128841.jpeg,https://derpicdn.net/img/view/2019/8/27/2128841.jpeg,0,0.978180766,24,0,1126,973,1102,973,pinkie pie
2129052.jpeg,https://derpicdn.net/img/view/2019/8/27/2129052.jpeg,0,0.974556386,88,42,1606,1764,1518,1722,pinkie pie
2134011.jpeg,https://derpicdn.net/img/view/2019/9/2/2134011.jpeg,0,0.967169225,184,0,1176,924,992,924,pinkie pie
2136024.jpeg,https://derpicdn.net/img/view/2019/9/4/2136024.jpeg,0,0.966932535,316,0,1596,1183,1280,1183,pinkie pie
2137429.jpeg,https://derpicdn.net/img/view/2019/9/5/2137429.jpeg,0,0.995258629,175,0,711,512,536,512,pinkie pie
2138004.jpeg,https://derpicdn.net/img/view/2019/9/6/2138004.jpeg,0,0.957684457,68,0,852,774,784,774,pinkie pie
2138737.jpeg,https://derpicdn.net/img/view/2019/9/7/2138737.jpeg,0,0.941926122,142,22,964,844,822,822,pinkie pie
2139594.jpeg,https://derpicdn.net/img/view/2019/9/8/2139594.jpeg,0,0.957244098,0,0,513,496,513,496,pinkie pie
2141821.jpeg,https://derpicdn.net/img/view/2019/9/11/2141821.jpeg,0,0.989822507,0,0,711,604,711,604,pinkie pie
2141821.jpeg,https://derpicdn.net/img/view/2019/9/11/2141821.jpeg,2,0.949238241,598,226,1570,1198,972,972,pinkie pie
2142783.jpeg,https://derpicdn.net/img/view/2019/9/13/2142783.jpeg,0,0.960878611,200,0,760,520,560,520,pinkie pie
2142786.jpeg,https://derpicdn.net/img/view/2019/9/13/2142786.jpeg,0,0.989208996,59,0,1159,1063,1100,1063,pinkie pie
2148283.jpeg,https://derpicdn.net/img/view/2019/9/20/2148283.jpeg,0,0.992462873,3596,3156,4096,3658,500,502,pinkie pie
2148695.jpeg,https://derpicdn.net/img/view/2019/9/20/2148695.jpeg,0,0.988624156,9,0,564,546,555,546,pinkie pie
2148815.jpeg,https://derpicdn.net/img/view/2019/9/20/2148815.jpeg,0,0.939674854,214,76,706,568,492,492,pinkie pie
2151389.jpeg,https://derpicdn.net/img/view/2019/9/23/2151389.jpeg,0,0.980623603,193,32,667,506,474,474,pinkie pie
2153387.jpeg,https://derpicdn.net/img/view/2019/9/26/2153387.jpeg,0,0.906530917,36,0,316,299,280,299,pinkie pie
2153798.jpeg,https://derpicdn.net/img/view/2019/9/26/2153798.jpeg,0,0.988713384,208,0,1236,951,1028,951,pinkie pie
2154146.jpeg,https://derpicdn.net/img/view/2019/9/27/2154146.jpeg,0,0.986358106,525,102,1369,946,844,844,pinkie pie
2154849.jpeg,https://derpicdn.net/img/view/2019/9/28/2154849.jpeg,0,0.965085208,0,45,1617,1733,1617,1688,pinkie pie
2155749.jpeg,https://derpicdn.net/img/view/2019/9/29/2155749.jpeg,0,0.934265494,34,14,504,484,470,470,pinkie pie
2158812.jpeg,https://derpicdn.net/img/view/2019/10/3/2158812.jpeg,0,0.993867218,57,0,679,598,622,598,pinkie pie
2159091.jpeg,https://derpicdn.net/img/view/2019/10/3/2159091.jpeg,0,0.975358188,25,18,601,594,576,576,pinkie pie
2161230.jpeg,https://derpicdn.net/img/view/2019/10/6/2161230.jpeg,0,0.991106689,190,20,1114,944,924,924,pinkie pie
2161772.jpeg,https://derpicdn.net/img/view/2019/10/6/2161772.jpeg,0,0.996559858,0,53,506,607,506,554,pinkie pie
2163657.jpeg,https://derpicdn.net/img/view/2019/10/9/2163657.jpeg,0,0.97247237,837,421,1805,1389,968,968,pinkie pie
2163888.jpeg,https://derpicdn.net/img/view/2019/10/9/2163888.jpeg,0,0.989629924,485,0,1087,585,602,585,pinkie pie
2164487.jpeg,https://derpicdn.net/img/view/2019/10/10/2164487.jpeg,0,0.965111852,646,6,1372,732,726,726,pinkie pie
2164514.jpeg,https://derpicdn.net/img/view/2019/10/10/2164514.jpeg,0,0.979045153,279,70,597,388,318,318,pinkie pie
2165224.jpeg,https://derpicdn.net/img/view/2019/10/11/2165224.jpeg,0,0.986683607,219,0,1221,720,1002,720,pinkie pie
2165746.jpeg,https://derpicdn.net/img/view/2019/10/11/2165746.jpeg,0,0.976958632,175,40,993,858,818,818,pinkie pie
2165982.jpeg,https://derpicdn.net/img/view/2019/10/12/2165982.jpeg,0,0.944849312,0,0,1280,1452,1280,1452,pinkie pie
2167138.jpeg,https://derpicdn.net/img/view/2019/10/13/2167138.jpeg,0,0.96301049,122,0,1622,942,1500,942,pinkie pie
2168179.jpeg,https://derpicdn.net/img/view/2019/10/14/2168179.jpeg,0,0.985921085,616,191,1192,767,576,576,pinkie pie
2168275.jpeg,https://derpicdn.net/img/view/2019/10/14/2168275.jpeg,0,0.990566015,113,99,791,777,678,678,pinkie pie
2168281.jpeg,https://derpicdn.net/img/view/2019/10/14/2168281.jpeg,0,0.97428292,809,3,1865,1059,1056,1056,pinkie pie
2168284.jpeg,https://derpicdn.net/img/view/2019/10/14/2168284.jpeg,0,0.905297399,223,0,1667,1404,1444,1404,pinkie pie
2169028.jpeg,https://derpicdn.net/img/view/2019/10/14/2169028.jpeg,0,0.9285748,13,0,809,791,796,791,pinkie pie
2170016.jpeg,https://derpicdn.net/img/view/2019/10/15/2170016.jpeg,0,0.940580964,143,329,455,641,312,312,pinkie pie
2170485.jpeg,https://derpicdn.net/img/view/2019/10/16/2170485.jpeg,0,0.939961612,91,3,643,555,552,552,pinkie pie
2171206.jpeg,https://derpicdn.net/img/view/2019/10/17/2171206.jpeg,0,0.916214883,199,71,559,431,360,360,pinkie pie
217144.jpeg,https://derpicdn.net/img/view/2013/1/19/217144.jpeg,0,0.980906129,377,5,883,511,506,506,pinkie pie
2173136.jpeg,https://derpicdn.net/img/view/2019/10/18/2173136.jpeg,0,0.99559468,127,0,1185,1019,1058,1019,pinkie pie
2173938.jpeg,https://derpicdn.net/img/view/2019/10/19/2173938.jpeg,0,0.937411249,84,0,900,801,816,801,pinkie pie
2175375.jpeg,https://derpicdn.net/img/view/2019/10/21/2175375.jpeg,0,0.907971263,1013,1043,1407,1437,394,394,pinkie pie
2176864.jpeg,https://derpicdn.net/img/view/2019/10/23/2176864.jpeg,0,0.931226611,230,0,1536,1285,1306,1285,pinkie pie
2177285.jpeg,https://derpicdn.net/img/view/2019/10/24/2177285.jpeg,0,0.967135489,118,14,650,546,532,532,pinkie pie
2178052.jpeg,https://derpicdn.net/img/view/2019/10/24/2178052.jpeg,0,0.983744979,106,318,536,748,430,430,pinkie pie
2178115.jpeg,https://derpicdn.net/img/view/2019/10/24/2178115.jpeg,0,0.931093216,400,0,1500,984,1100,984,pinkie pie
2178829.jpeg,https://derpicdn.net/img/view/2019/10/25/2178829.jpeg,0,0.99636972,264,0,908,632,644,632,pinkie pie
2178881.jpeg,https://derpicdn.net/img/view/2019/10/25/2178881.jpeg,0,0.905476332,156,0,688,495,532,495,pinkie pie
2180023.jpeg,https://derpicdn.net/img/view/2019/10/27/2180023.jpeg,0,0.909843206,107,0,845,676,738,676,pinkie pie
2180046.jpeg,https://derpicdn.net/img/view/2019/10/27/2180046.jpeg,0,0.965217829,147,0,1183,954,1036,954,pinkie pie
2180218.jpeg,https://derpicdn.net/img/view/2019/10/27/2180218.jpeg,0,0.991131425,154,0,1148,871,994,871,pinkie pie
2180835.jpeg,https://derpicdn.net/img/view/2019/10/28/2180835.jpeg,0,0.937272191,17,0,541,478,524,478,pinkie pie
2180838.jpeg,https://derpicdn.net/img/view/2019/10/28/2180838.jpeg,0,0.961579502,41,0,911,855,870,855,pinkie pie
2180968.jpeg,https://derpicdn.net/img/view/2019/10/28/2180968.jpeg,0,0.961073637,45,8,1167,1130,1122,1122,pinkie pie
2181406.jpeg,https://derpicdn.net/img/view/2019/10/28/2181406.jpeg,0,0.951863348,437,0,1739,1181,1302,1181,pinkie pie
2181636.jpeg,https://derpicdn.net/img/view/2019/10/29/2181636.jpeg,0,0.971122742,0,61,925,989,925,928,pinkie pie
2182416.jpeg,https://derpicdn.net/img/view/2019/10/29/2182416.jpeg,0,0.97009331,87,70,1157,1140,1070,1070,pinkie pie
2185248.jpeg,https://derpicdn.net/img/view/2019/11/2/2185248.jpeg,0,0.996893704,392,2,1020,630,628,628,pinkie pie
2185764.jpeg,https://derpicdn.net/img/view/2019/11/2/2185764.jpeg,0,0.980066061,633,33,1657,1057,1024,1024,pinkie pie
2187702.jpeg,https://derpicdn.net/img/view/2019/11/4/2187702.jpeg,0,0.991584778,721,130,1585,994,864,864,pinkie pie
2189931.jpeg,https://derpicdn.net/img/view/2019/11/7/2189931.jpeg,0,0.991336465,352,3,1606,1257,1254,1254,pinkie pie
2190504.jpeg,https://derpicdn.net/img/view/2019/11/8/2190504.jpeg,0,0.970402122,560,193,1290,923,730,730,pinkie pie
2191852.jpeg,https://derpicdn.net/img/view/2019/11/10/2191852.jpeg,0,0.90427959,2225,1702,3171,2648,946,946,pinkie pie
2192812.jpeg,https://derpicdn.net/img/view/2019/11/11/2192812.jpeg,0,0.966308892,273,0,1325,1052,1052,1052,pinkie pie
2193188.jpeg,https://derpicdn.net/img/view/2019/11/11/2193188.jpeg,0,0.988360524,0,0,959,1049,959,1049,pinkie pie
2193535.jpeg,https://derpicdn.net/img/view/2019/11/11/2193535.jpeg,0,0.994054794,28,0,304,255,276,255,pinkie pie
2193562.jpeg,https://derpicdn.net/img/view/2019/11/11/2193562.jpeg,0,0.981386781,572,0,1590,917,1018,917,pinkie pie
2194355.jpeg,https://derpicdn.net/img/view/2019/11/13/2194355.jpeg,0,0.919180393,130,0,1192,1054,1062,1054,pinkie pie
2196359.jpeg,https://derpicdn.net/img/view/2019/11/15/2196359.jpeg,0,0.994796216,171,0,1277,997,1106,997,pinkie pie
2196440.jpeg,https://derpicdn.net/img/view/2019/11/15/2196440.jpeg,0,0.987393916,74,0,1086,966,1012,966,pinkie pie
2197237.jpeg,https://derpicdn.net/img/view/2019/11/16/2197237.jpeg,0,0.98040694,29,0,1233,904,1204,904,pinkie pie
2197657.jpeg,https://derpicdn.net/img/view/2019/11/16/2197657.jpeg,0,0.994310498,354,0,886,494,532,494,pinkie pie
2198802.jpeg,https://derpicdn.net/img/view/2019/11/17/2198802.jpeg,0,0.987059534,340,9,886,555,546,546,pinkie pie
2199645.jpeg,https://derpicdn.net/img/view/2019/11/18/2199645.jpeg,0,0.96177572,128,0,644,486,516,486,pinkie pie
2200785.jpeg,https://derpicdn.net/img/view/2019/11/20/2200785.jpeg,0,0.996972919,366,52,1136,822,770,770,pinkie pie
2200848.jpeg,https://derpicdn.net/img/view/2019/11/20/2200848.jpeg,0,0.932203948,613,568,1451,1406,838,838,pinkie pie
2201948.jpeg,https://derpicdn.net/img/view/2019/11/21/2201948.jpeg,0,0.967896938,1512,140,2398,1026,886,886,pinkie pie
2202935.jpeg,https://derpicdn.net/img/view/2019/11/22/2202935.jpeg,0,0.993582726,86,26,496,436,410,410,pinkie pie
2203091.jpeg,https://derpicdn.net/img/view/2019/11/22/2203091.jpeg,0,0.947860897,573,4,1587,1018,1014,1014,pinkie pie
2203226.jpeg,https://derpicdn.net/img/view/2019/11/23/2203226.jpeg,0,0.979628682,752,10,3442,2700,2690,2690,pinkie pie
2203410.jpeg,https://derpicdn.net/img/view/2019/11/23/2203410.jpeg,0,0.987626731,276,155,882,761,606,606,pinkie pie
2203467.jpeg,https://derpicdn.net/img/view/2019/11/23/2203467.jpeg,0,0.940183461,104,0,1052,918,948,918,pinkie pie
2203951.jpeg,https://derpicdn.net/img/view/2019/11/23/2203951.jpeg,0,0.993231833,51,0,500,443,449,443,pinkie pie
2204436.jpeg,https://derpicdn.net/img/view/2019/11/24/2204436.jpeg,0,0.99108398,216,0,1222,989,1006,989,pinkie pie
2204917.jpeg,https://derpicdn.net/img/view/2019/11/25/2204917.jpeg,0,0.982471943,46,0,830,766,784,766,pinkie pie
2205319.jpeg,https://derpicdn.net/img/view/2019/11/25/2205319.jpeg,0,0.989095569,15,164,929,1078,914,914,pinkie pie
2206303.jpeg,https://derpicdn.net/img/view/2019/11/26/2206303.jpeg,0,0.983682334,0,0,935,921,935,921,pinkie pie
220686.jpeg,https://derpicdn.net/img/view/2013/1/22/220686.jpeg,0,0.940667748,0,0,887,921,887,921,pinkie pie
2208136.jpeg,https://derpicdn.net/img/view/2019/11/29/2208136.jpeg,0,0.959112585,0,0,1947,1958,1947,1958,pinkie pie
2208933.jpeg,https://derpicdn.net/img/view/2019/11/30/2208933.jpeg,0,0.992307365,219,0,1247,1007,1028,1007,pinkie pie
2209694.jpeg,https://derpicdn.net/img/view/2019/12/1/2209694.jpeg,0,0.907451987,0,6,549,566,549,560,pinkie pie
2210029.jpeg,https://derpicdn.net/img/view/2019/12/1/2210029.jpeg,0,0.99477762,614,0,1694,1019,1080,1019,pinkie pie
2211285.jpeg,https://derpicdn.net/img/view/2019/12/3/2211285.jpeg,0,0.908612311,227,0,1499,1245,1272,1245,pinkie pie
2212781.jpeg,https://derpicdn.net/img/view/2019/12/5/2212781.jpeg,0,0.964985967,33,0,991,952,958,952,pinkie pie
2213024.jpeg,https://derpicdn.net/img/view/2019/12/5/2213024.jpeg,0,0.991134286,735,114,1123,502,388,388,pinkie pie
2215400.jpeg,https://derpicdn.net/img/view/2019/12/8/2215400.jpeg,0,0.988044798,51,0,1409,1194,1358,1194,pinkie pie
2216065.jpeg,https://derpicdn.net/img/view/2019/12/8/2216065.jpeg,0,0.974295974,1055,60,1619,624,564,564,pinkie pie
2216670.jpeg,https://derpicdn.net/img/view/2019/12/9/2216670.jpeg,0,0.992948711,0,0,972,1038,972,1038,pinkie pie
2216767.jpeg,https://derpicdn.net/img/view/2019/12/9/2216767.jpeg,0,0.924140215,26,12,702,688,676,676,pinkie pie
2217752.jpeg,https://derpicdn.net/img/view/2019/12/10/2217752.jpeg,1,0.981010079,295,663,1159,1527,864,864,pinkie pie
2218495.jpeg,https://derpicdn.net/img/view/2019/12/12/2218495.jpeg,0,0.967783093,12,4,200,192,188,188,pinkie pie
2219227.jpeg,https://derpicdn.net/img/view/2019/12/12/2219227.jpeg,0,0.972412765,150,0,1430,1256,1280,1256,pinkie pie
2219243.jpeg,https://derpicdn.net/img/view/2019/12/13/2219243.jpeg,0,0.922716379,173,0,1169,914,996,914,pinkie pie
2220471.jpeg,https://derpicdn.net/img/view/2019/12/14/2220471.jpeg,0,0.973667145,0,0,1652,1613,1652,1613,pinkie pie
2222047.jpeg,https://derpicdn.net/img/view/2019/12/16/2222047.jpeg,0,0.985086679,0,0,688,669,688,669,pinkie pie
2222269.jpeg,https://derpicdn.net/img/view/2019/12/16/2222269.jpeg,0,0.98665899,289,22,1080,866,791,844,pinkie pie
2222475.jpeg,https://derpicdn.net/img/view/2019/12/16/2222475.jpeg,0,0.976942778,36,0,1114,929,1078,929,pinkie pie
2222566.jpeg,https://derpicdn.net/img/view/2019/12/17/2222566.jpeg,0,0.974201024,438,5,1528,1095,1090,1090,pinkie pie
2223385.jpeg,https://derpicdn.net/img/view/2019/12/18/2223385.jpeg,0,0.985169172,245,48,901,704,656,656,pinkie pie
2224117.jpeg,https://derpicdn.net/img/view/2019/12/19/2224117.jpeg,0,0.95564878,348,226,606,484,258,258,pinkie pie
254596.jpeg,https://derpicdn.net/img/view/2013/2/25/254596.jpeg,0,0.919536769,0,0,500,572,500,572,pinkie pie
257180.jpeg,https://derpicdn.net/img/view/2013/2/27/257180.jpeg,0,0.989386797,85,11,287,213,202,202,pinkie pie
261656.jpeg,https://derpicdn.net/img/view/2013/3/3/261656.jpeg,0,0.99373281,470,0,1432,957,962,957,pinkie pie
286839.jpeg,https://derpicdn.net/img/view/2013/4/3/286839.jpeg,0,0.968573689,185,0,725,521,540,521,pinkie pie
299577.jpeg,https://derpicdn.net/img/view/2013/4/16/299577.jpeg,0,0.9102844,165,3,825,663,660,660,pinkie pie
299801.jpeg,https://derpicdn.net/img/view/2013/4/16/299801.jpeg,0,0.976005435,1813,418,3855,2460,2042,2042,pinkie pie
299967.jpeg,https://derpicdn.net/img/view/2013/4/16/299967.jpeg,0,0.932858706,190,60,866,736,676,676,pinkie pie
304880.jpeg,https://derpicdn.net/img/view/2013/4/21/304880.jpeg,0,0.978081465,1053,578,2609,2134,1556,1556,pinkie pie
307882.jpeg,https://derpicdn.net/img/view/2013/4/25/307882.jpeg,0,0.98868674,271,249,513,491,242,242,pinkie pie
308547.jpeg,https://derpicdn.net/img/view/2013/4/26/308547.jpeg,0,0.984000444,0,0,450,431,450,431,pinkie pie
313541.jpeg,https://derpicdn.net/img/view/2013/5/1/313541.jpeg,0,0.999140501,427,0,1463,903,1036,903,pinkie pie
313668.jpeg,https://derpicdn.net/img/view/2013/5/1/313668.jpeg,0,0.991225243,977,120,1391,534,414,414,pinkie pie
317335.jpeg,https://derpicdn.net/img/view/2013/5/5/317335.jpeg,0,0.979641497,82,0,832,746,750,746,pinkie pie
318871.jpeg,https://derpicdn.net/img/view/2013/5/7/318871.jpeg,0,0.98448348,78,0,540,444,462,444,pinkie pie
327681.jpeg,https://derpicdn.net/img/view/2013/5/18/327681.jpeg,0,0.991632521,80,0,1054,838,974,838,pinkie pie
333201.jpeg,https://derpicdn.net/img/view/2013/5/25/333201.jpeg,1,0.984940529,1191,0,1755,508,564,508,pinkie pie
336129.jpeg,https://derpicdn.net/img/view/2013/5/29/336129.jpeg,0,0.965819895,492,5,770,283,278,278,pinkie pie
336129.jpeg,https://derpicdn.net/img/view/2013/5/29/336129.jpeg,1,0.912809074,175,5,487,317,312,312,pinkie pie
337854.jpeg,https://derpicdn.net/img/view/2013/5/31/337854.jpeg,0,0.926480293,301,83,507,289,206,206,pinkie pie
337859.jpeg,https://derpicdn.net/img/view/2013/5/31/337859.jpeg,1,0.91036284,0,56,340,396,340,340,pinkie pie
359132.jpeg,https://derpicdn.net/img/view/2013/6/28/359132.jpeg,0,0.999682903,382,181,848,647,466,466,pinkie pie
362863.jpeg,https://derpicdn.net/img/view/2013/7/2/362863.jpeg,0,0.982057691,92,13,436,357,344,344,pinkie pie
364315.jpeg,https://derpicdn.net/img/view/2013/7/4/364315.jpeg,0,0.977480233,0,0,1975,1851,1975,1851,pinkie pie
384107.jpeg,https://derpicdn.net/img/view/2013/7/29/384107.jpeg,0,0.989831507,29,25,717,713,688,688,pinkie pie
391966.jpeg,https://derpicdn.net/img/view/2013/8/5/391966.jpeg,0,0.995857179,631,253,1489,1111,858,858,pinkie pie
405854.jpeg,https://derpicdn.net/img/view/2013/8/21/405854.jpeg,0,0.993618071,26,0,394,347,368,347,pinkie pie
405854.jpeg,https://derpicdn.net/img/view/2013/8/21/405854.jpeg,1,0.982843518,459,182,671,394,212,212,pinkie pie
409356.jpeg,https://derpicdn.net/img/view/2013/8/24/409356.jpeg,0,0.934729993,294,68,908,682,614,614,pinkie pie
411510.jpeg,https://derpicdn.net/img/view/2013/8/26/411510.jpeg,0,0.991773963,576,0,1584,987,1008,987,pinkie pie
419797.jpeg,https://derpicdn.net/img/view/2013/9/5/419797.jpeg,0,0.991419911,627,635,969,977,342,342,pinkie pie
419797.jpeg,https://derpicdn.net/img/view/2013/9/5/419797.jpeg,1,0.991151989,267,607,641,981,374,374,pinkie pie
419880.jpeg,https://derpicdn.net/img/view/2013/9/5/419880.jpeg,0,0.986099124,105,0,423,271,318,271,pinkie pie
423333.jpeg,https://derpicdn.net/img/view/2013/9/9/423333.jpeg,0,0.922514617,339,0,811,451,472,451,pinkie pie
434495.jpeg,https://derpicdn.net/img/view/2013/9/25/434495.jpeg,0,0.984168887,265,65,753,553,488,488,pinkie pie
435211.jpeg,https://derpicdn.net/img/view/2013/9/26/435211.jpeg,0,0.994446516,1048,43,1408,403,360,360,pinkie pie
443313.jpeg,https://derpicdn.net/img/view/2013/10/6/443313.jpeg,0,0.989667475,246,0,642,385,396,385,pinkie pie
448425.jpeg,https://derpicdn.net/img/view/2013/10/14/448425.jpeg,0,0.948427081,312,26,568,282,256,256,pinkie pie
455356.jpeg,https://derpicdn.net/img/view/2013/10/24/455356.jpeg,0,0.945544422,314,0,640,280,326,280,pinkie pie
459007.jpeg,https://derpicdn.net/img/view/2013/10/28/459007.jpeg,0,0.968319416,535,361,769,595,234,234,pinkie pie
480838.jpeg,https://derpicdn.net/img/view/2013/11/25/480838.jpeg,0,0.935421169,337,11,685,359,348,348,pinkie pie
487528.jpeg,https://derpicdn.net/img/view/2013/12/2/487528.jpeg,0,0.900871158,205,151,737,683,532,532,pinkie pie
487841.jpeg,https://derpicdn.net/img/view/2013/12/2/487841.jpeg,0,0.98161298,192,0,722,518,530,518,pinkie pie
516218.jpeg,https://derpicdn.net/img/view/2014/1/5/516218.jpeg,0,0.982495487,172,84,392,304,220,220,pinkie pie
516456.jpeg,https://derpicdn.net/img/view/2014/1/5/516456.jpeg,0,0.910903335,1301,0,2039,750,738,750,pinkie pie
524516.jpeg,https://derpicdn.net/img/view/2014/1/14/524516.jpeg,0,0.991601646,55,0,421,322,366,322,pinkie pie
529420.jpeg,https://derpicdn.net/img/view/2014/1/20/529420.jpeg,0,0.970426857,104,50,720,666,616,616,pinkie pie
529542.jpeg,https://derpicdn.net/img/view/2014/1/20/529542.jpeg,0,0.986569226,308,19,664,375,356,356,pinkie pie
533667.jpeg,https://derpicdn.net/img/view/2014/1/25/533667.jpeg,0,0.989541471,165,0,547,346,382,346,pinkie pie
536955.jpeg,https://derpicdn.net/img/view/2014/1/28/536955.jpeg,0,0.987994015,698,85,1052,439,354,354,pinkie pie
537302.jpeg,https://derpicdn.net/img/view/2014/1/28/537302.jpeg,0,0.981773138,0,0,783,767,783,767,pinkie pie
538950.jpeg,https://derpicdn.net/img/view/2014/1/30/538950.jpeg,0,0.982542098,106,0,382,259,276,259,pinkie pie
553345.jpeg,https://derpicdn.net/img/view/2014/2/16/553345.jpeg,0,0.999544203,577,0,1200,600,623,600,pinkie pie
558524.jpeg,https://derpicdn.net/img/view/2014/2/22/558524.jpeg,0,0.978367686,64,275,1694,1905,1630,1630,pinkie pie
558524.jpeg,https://derpicdn.net/img/view/2014/2/22/558524.jpeg,1,0.935667515,362,112,2000,2000,1638,1888,pinkie pie
567602.jpeg,https://derpicdn.net/img/view/2014/3/5/567602.jpeg,0,0.989798307,1062,67,1746,751,684,684,pinkie pie
571834.jpeg,https://derpicdn.net/img/view/2014/3/11/571834.jpeg,0,0.988422275,365,211,1767,1613,1402,1402,pinkie pie
572016.jpeg,https://derpicdn.net/img/view/2014/3/11/572016.jpeg,0,0.958773792,129,50,1093,1014,964,964,pinkie pie
575785.jpeg,https://derpicdn.net/img/view/2014/3/15/575785.jpeg,0,0.957516015,0,68,213,292,213,224,pinkie pie
575877.jpeg,https://derpicdn.net/img/view/2014/3/15/575877.jpeg,0,0.998098254,454,22,774,342,320,320,pinkie pie
575877.jpeg,https://derpicdn.net/img/view/2014/3/15/575877.jpeg,2,0.931198359,653,721,1021,1101,368,380,pinkie pie
577844.jpeg,https://derpicdn.net/img/view/2014/3/17/577844.jpeg,0,0.97274518,137,132,919,914,782,782,pinkie pie
578402.jpeg,https://derpicdn.net/img/view/2014/3/18/578402.jpeg,1,0.993652761,239,465,591,817,352,352,pinkie pie
579469.jpeg,https://derpicdn.net/img/view/2014/3/19/579469.jpeg,0,0.936165869,476,0,1140,629,664,629,pinkie pie
599114.jpeg,https://derpicdn.net/img/view/2014/4/13/599114.jpeg,0,0.928192735,164,8,980,824,816,816,pinkie pie
604424.jpeg,https://derpicdn.net/img/view/2014/4/19/604424.jpeg,0,0.983895838,183,62,765,722,582,660,pinkie pie
606498.jpeg,https://derpicdn.net/img/view/2014/4/21/606498.jpeg,0,0.989196002,58,21,852,815,794,794,pinkie pie
609837.jpeg,https://derpicdn.net/img/view/2014/4/25/609837.jpeg,0,0.995887458,405,224,2749,2568,2344,2344,pinkie pie
615872.jpeg,https://derpicdn.net/img/view/2014/5/3/615872.jpeg,0,0.983558893,72,0,554,446,482,446,pinkie pie
630825.jpeg,https://derpicdn.net/img/view/2014/5/19/630825.jpeg,0,0.95253551,666,38,966,338,300,300,pinkie pie
647954.jpeg,https://derpicdn.net/img/view/2014/6/8/647954.jpeg,0,0.979528964,226,40,666,480,440,440,pinkie pie
659214.jpeg,https://derpicdn.net/img/view/2014/6/22/659214.jpeg,0,0.99327302,155,0,1921,1698,1766,1698,pinkie pie
666751.jpeg,https://derpicdn.net/img/view/2014/7/3/666751.jpeg,0,0.962786317,87,374,411,698,324,324,pinkie pie
667849.jpeg,https://derpicdn.net/img/view/2014/7/5/667849.jpeg,0,0.906926751,1765,370,2349,954,584,584,pinkie pie
671751.jpeg,https://derpicdn.net/img/view/2014/7/10/671751.jpeg,0,0.905845761,66,155,232,321,166,166,pinkie pie
676483.jpeg,https://derpicdn.net/img/view/2014/7/16/676483.jpeg,0,0.990634084,171,0,553,380,382,380,pinkie pie
677484.jpeg,https://derpicdn.net/img/view/2014/7/18/677484.jpeg,0,0.96816963,304,0,1530,1171,1226,1171,pinkie pie
683139.jpeg,https://derpicdn.net/img/view/2014/7/25/683139.jpeg,0,0.959522605,34,0,806,689,772,689,pinkie pie
701756.jpeg,https://derpicdn.net/img/view/2014/8/17/701756.jpeg,0,0.972725868,0,66,1024,1134,1024,1068,pinkie pie
714334.jpeg,https://derpicdn.net/img/view/2014/9/3/714334.jpeg,0,0.985627055,447,0,1001,525,554,525,pinkie pie
717295.jpeg,https://derpicdn.net/img/view/2014/9/7/717295.jpeg,0,0.991296053,1161,626,1795,1260,634,634,pinkie pie
719205.jpeg,https://derpicdn.net/img/view/2014/9/10/719205.jpeg,0,0.975922704,762,247,972,457,210,210,pinkie pie
722787.jpeg,https://derpicdn.net/img/view/2014/9/15/722787.jpeg,0,0.942043424,521,0,1875,1328,1354,1328,pinkie pie
728898.jpeg,https://derpicdn.net/img/view/2014/9/25/728898.jpeg,0,0.909451783,530,0,2250,1642,1720,1642,pinkie pie
729338.jpeg,https://derpicdn.net/img/view/2014/9/25/729338.jpeg,0,0.90947336,189,0,1361,962,1172,962,pinkie pie
758953.jpeg,https://derpicdn.net/img/view/2014/11/6/758953.jpeg,0,0.999781191,443,10,871,438,428,428,pinkie pie
768769.jpeg,https://derpicdn.net/img/view/2014/11/21/768769.jpeg,0,0.991176963,0,25,722,785,722,760,pinkie pie
769213.jpeg,https://derpicdn.net/img/view/2014/11/22/769213.jpeg,0,0.988325357,95,10,687,602,592,592,pinkie pie
772020.jpeg,https://derpicdn.net/img/view/2014/11/26/772020.jpeg,0,0.901520073,120,0,1804,1644,1684,1644,pinkie pie
774120.jpeg,https://derpicdn.net/img/view/2014/11/29/774120.jpeg,0,0.920250714,727,298,1125,696,398,398,pinkie pie
775736.jpeg,https://derpicdn.net/img/view/2014/12/1/775736.jpeg,0,0.916151047,331,98,639,406,308,308,pinkie pie
776469.jpeg,https://derpicdn.net/img/view/2014/12/2/776469.jpeg,0,0.995303929,163,0,357,179,194,179,pinkie pie
780158.jpeg,https://derpicdn.net/img/view/2014/12/7/780158.jpeg,0,0.953053534,346,44,740,438,394,394,pinkie pie
794138.jpeg,https://derpicdn.net/img/view/2014/12/28/794138.jpeg,0,0.986146688,279,5,749,475,470,470,pinkie pie
803173.jpeg,https://derpicdn.net/img/view/2015/1/10/803173.jpeg,0,0.982325017,296,0,832,522,536,522,pinkie pie
803360.jpeg,https://derpicdn.net/img/view/2015/1/10/803360.jpeg,0,0.981272876,0,0,752,774,752,774,pinkie pie
805772.jpeg,https://derpicdn.net/img/view/2015/1/13/805772.jpeg,0,0.992664993,505,0,791,262,286,262,pinkie pie
805989.jpeg,https://derpicdn.net/img/view/2015/1/14/805989.jpeg,0,0.994870484,155,19,379,243,224,224,pinkie pie
805990.jpeg,https://derpicdn.net/img/view/2015/1/14/805990.jpeg,0,0.968439341,259,5,653,399,394,394,pinkie pie
811606.jpeg,https://derpicdn.net/img/view/2015/1/21/811606.jpeg,0,0.998358607,635,0,1063,415,428,415,pinkie pie
811606.jpeg,https://derpicdn.net/img/view/2015/1/21/811606.jpeg,1,0.99227947,153,0,711,488,558,488,pinkie pie
814467.jpeg,https://derpicdn.net/img/view/2015/1/25/814467.jpeg,0,0.995766401,507,0,825,304,318,304,pinkie pie
814467.jpeg,https://derpicdn.net/img/view/2015/1/25/814467.jpeg,1,0.986486197,70,0,400,323,330,323,pinkie pie
818188.jpeg,https://derpicdn.net/img/view/2015/1/31/818188.jpeg,0,0.991319954,129,129,515,515,386,386,pinkie pie
818759.jpeg,https://derpicdn.net/img/view/2015/1/31/818759.jpeg,0,0.976798773,0,0,683,730,683,730,pinkie pie
827033.jpeg,https://derpicdn.net/img/view/2015/2/12/827033.jpeg,0,0.945411623,257,192,547,482,290,290,pinkie pie
830201.jpeg,https://derpicdn.net/img/view/2015/2/16/830201.jpeg,0,0.995588243,556,232,1596,1272,1040,1040,pinkie pie
836347.jpeg,https://derpicdn.net/img/view/2015/2/24/836347.jpeg,0,0.987360775,189,0,579,381,390,381,pinkie pie
839535.jpeg,https://derpicdn.net/img/view/2015/3/1/839535.jpeg,0,0.998780906,452,15,778,341,326,326,pinkie pie
839727.jpeg,https://derpicdn.net/img/view/2015/3/1/839727.jpeg,0,0.945896387,84,47,982,945,898,898,pinkie pie
846826.jpeg,https://derpicdn.net/img/view/2015/3/10/846826.jpeg,0,0.982542157,14,0,456,414,442,414,pinkie pie
848339.jpeg,https://derpicdn.net/img/view/2015/3/13/848339.jpeg,0,0.992833495,216,0,1236,998,1020,998,pinkie pie
855311.jpeg,https://derpicdn.net/img/view/2015/3/23/855311.jpeg,0,0.995124936,373,39,600,287,227,248,pinkie pie
855638.jpeg,https://derpicdn.net/img/view/2015/3/23/855638.jpeg,0,0.900007308,581,364,853,636,272,272,pinkie pie
855779.jpeg,https://derpicdn.net/img/view/2015/3/23/855779.jpeg,0,0.999018431,838,145,1292,599,454,454,pinkie pie
855779.jpeg,https://derpicdn.net/img/view/2015/3/23/855779.jpeg,1,0.991432011,274,181,704,611,430,430,pinkie pie
856289.jpeg,https://derpicdn.net/img/view/2015/3/24/856289.jpeg,0,0.997897565,393,100,951,658,558,558,pinkie pie
857688.jpeg,https://derpicdn.net/img/view/2015/3/26/857688.jpeg,0,0.970553577,0,0,839,990,839,990,pinkie pie
857688.jpeg,https://derpicdn.net/img/view/2015/3/26/857688.jpeg,1,0.941544056,0,145,872,1261,872,1116,pinkie pie
861860.jpeg,https://derpicdn.net/img/view/2015/4/1/861860.jpeg,0,0.991607845,1018,0,1720,698,702,698,pinkie pie
861860.jpeg,https://derpicdn.net/img/view/2015/4/1/861860.jpeg,1,0.971455932,1723,0,2400,721,677,721,pinkie pie
874338.jpeg,https://derpicdn.net/img/view/2015/4/15/874338.jpeg,0,0.908630133,526,338,1026,838,500,500,pinkie pie
880988.jpeg,https://derpicdn.net/img/view/2015/4/23/880988.jpeg,0,0.992745697,648,244,1282,878,634,634,pinkie pie
884707.jpeg,https://derpicdn.net/img/view/2015/4/28/884707.jpeg,0,0.960096538,766,87,1484,805,718,718,pinkie pie
890181.jpeg,https://derpicdn.net/img/view/2015/5/6/890181.jpeg,0,0.988277614,0,0,707,747,707,747,pinkie pie
907991.jpeg,https://derpicdn.net/img/view/2015/6/1/907991.jpeg,0,0.987980843,0,0,455,437,455,437,pinkie pie
909933.jpeg,https://derpicdn.net/img/view/2015/6/4/909933.jpeg,0,0.991241157,0,13,413,467,413,454,pinkie pie
911668.jpeg,https://derpicdn.net/img/view/2015/6/6/911668.jpeg,0,0.947434008,244,49,574,379,330,330,pinkie pie
913959.jpeg,https://derpicdn.net/img/view/2015/6/10/913959.jpeg,0,0.997402132,226,0,714,486,488,486,pinkie pie
918124.jpeg,https://derpicdn.net/img/view/2015/6/16/918124.jpeg,0,0.975137055,143,118,2053,2028,1910,1910,pinkie pie
918752.jpeg,https://derpicdn.net/img/view/2015/6/17/918752.jpeg,0,0.988025844,130,28,500,398,370,370,pinkie pie
919642.jpeg,https://derpicdn.net/img/view/2015/6/19/919642.jpeg,0,0.969970524,53,0,739,627,686,627,pinkie pie
937970.jpeg,https://derpicdn.net/img/view/2015/7/16/937970.jpeg,0,0.998576581,447,24,975,552,528,528,pinkie pie
942492.jpeg,https://derpicdn.net/img/view/2015/7/23/942492.jpeg,0,0.936858416,0,0,1111,909,1111,909,pinkie pie
951053.jpeg,https://derpicdn.net/img/view/2015/8/5/951053.jpeg,0,0.997748911,570,357,1382,1169,812,812,pinkie pie
951226.jpeg,https://derpicdn.net/img/view/2015/8/5/951226.jpeg,0,0.965431511,365,171,631,437,266,266,pinkie pie
958906.jpeg,https://derpicdn.net/img/view/2015/8/16/958906.jpeg,0,0.991731882,468,0,1094,624,626,624,pinkie pie
962745.jpeg,https://derpicdn.net/img/view/2015/8/21/962745.jpeg,0,0.999326408,336,46,1314,1024,978,978,pinkie pie
966220.jpeg,https://derpicdn.net/img/view/2015/8/26/966220.jpeg,0,0.999327719,310,7,744,441,434,434,pinkie pie
971884.jpeg,https://derpicdn.net/img/view/2015/9/3/971884.jpeg,0,0.901186824,59,0,817,740,758,740,pinkie pie
985565.jpeg,https://derpicdn.net/img/view/2015/9/22/985565.jpeg,0,0.955335021,32,0,920,660,888,660,pinkie pie
990148.jpeg,https://derpicdn.net/img/view/2015/9/28/990148.jpeg,0,0.977365673,648,0,1582,905,934,905,pinkie pie
993941.jpeg,https://derpicdn.net/img/view/2015/10/3/993941.jpeg,0,0.984642804,253,0,801,501,548,501,pinkie pie
997003.jpeg,https://derpicdn.net/img/view/2015/10/8/997003.jpeg,0,0.981195092,243,41,1295,1093,1052,1052,pinkie pie
998046.jpeg,https://derpicdn.net/img/view/2015/10/9/998046.jpeg,0,0.9800331,715,0,1017,257,302,257,pinkie pie
1000973.png,https://derpicdn.net/img/view/2015/10/13/1000973.png,0,0.97754395,317,10,1101,794,784,784,rainbow dash
1000973.png,https://derpicdn.net/img/view/2015/10/13/1000973.png,0,0.97754395,292,0,1124,819,832,819,rainbow dash
1000973.png,https://derpicdn.net/img/view/2015/10/13/1000973.png,0,0.97754395,292,0,1124,819,832,819,rainbow dash
1001740.png,https://derpicdn.net/img/view/2015/10/14/1001740.png,0,0.999450326,153,0,1591,1427,1438,1427,rainbow dash
1001740.png,https://derpicdn.net/img/view/2015/10/14/1001740.png,0,0.999450326,218,53,1526,1361,1308,1308,rainbow dash
1001740.png,https://derpicdn.net/img/view/2015/10/14/1001740.png,0,0.999450326,218,53,1526,1361,1308,1308,rainbow dash
1004376.png,https://derpicdn.net/img/view/2015/10/17/1004376.png,0,0.981786728,22,0,1206,852,1184,852,rainbow dash
1004376.png,https://derpicdn.net/img/view/2015/10/17/1004376.png,0,0.981786728,75,0,1153,852,1078,852,rainbow dash
1004376.png,https://derpicdn.net/img/view/2015/10/17/1004376.png,0,0.981786728,75,0,1153,852,1078,852,rainbow dash
1005956.png,https://derpicdn.net/img/view/2015/10/19/1005956.png,0,0.998399556,0,0,903,867,903,867,rainbow dash
1005956.png,https://derpicdn.net/img/view/2015/10/19/1005956.png,0,0.998399556,0,0,860,823,860,823,rainbow dash
1005956.png,https://derpicdn.net/img/view/2015/10/19/1005956.png,0,0.998399556,0,0,860,823,860,823,rainbow dash
1009149.png,https://derpicdn.net/img/view/2015/10/24/1009149.png,0,0.949391544,96,0,826,629,730,629,rainbow dash
1009149.png,https://derpicdn.net/img/view/2015/10/24/1009149.png,0,0.949391544,129,0,793,596,664,596,rainbow dash
1009149.png,https://derpicdn.net/img/view/2015/10/24/1009149.png,0,0.949391544,129,0,793,596,664,596,rainbow dash
1010877.jpg,https://derpicdn.net/img/view/2015/10/28/1010877.jpg,0,0.986431837,443,0,757,289,314,289,rainbow dash
1010877.jpg,https://derpicdn.net/img/view/2015/10/28/1010877.jpg,0,0.986431837,459,0,741,269,282,269,rainbow dash
1010877.jpg,https://derpicdn.net/img/view/2015/10/28/1010877.jpg,0,0.986431837,459,0,741,269,282,269,rainbow dash
1011096.png,https://derpicdn.net/img/view/2015/10/28/1011096.png,0,0.99908644,188,0,786,597,598,597,rainbow dash
1011096.png,https://derpicdn.net/img/view/2015/10/28/1011096.png,0,0.99908644,215,26,759,570,544,544,rainbow dash
1011096.png,https://derpicdn.net/img/view/2015/10/28/1011096.png,0,0.99908644,215,26,759,570,544,544,rainbow dash
1011103.png,https://derpicdn.net/img/view/2015/10/28/1011103.png,0,0.999075115,130,15,692,577,562,562,rainbow dash
1011103.png,https://derpicdn.net/img/view/2015/10/28/1011103.png,0,0.999075115,155,40,667,552,512,512,rainbow dash
1011103.png,https://derpicdn.net/img/view/2015/10/28/1011103.png,0,0.999075115,155,40,667,552,512,512,rainbow dash
1012549.png,https://derpicdn.net/img/view/2015/10/30/1012549.png,0,0.987259328,0,0,300,337,300,337,rainbow dash
1012549.png,https://derpicdn.net/img/view/2015/10/30/1012549.png,0,0.987259328,0,0,290,321,290,321,rainbow dash
1012549.png,https://derpicdn.net/img/view/2015/10/30/1012549.png,0,0.987259328,0,0,290,321,290,321,rainbow dash
1014336.jpg,https://derpicdn.net/img/view/2015/11/1/1014336.jpg,0,0.921353281,1070,0,2582,1503,1512,1503,rainbow dash
1014336.jpg,https://derpicdn.net/img/view/2015/11/1/1014336.jpg,0,0.921353281,1141,63,2511,1433,1370,1370,rainbow dash
1014336.jpg,https://derpicdn.net/img/view/2015/11/1/1014336.jpg,0,0.921353281,1141,63,2511,1433,1370,1370,rainbow dash
1014535.png,https://derpicdn.net/img/view/2015/11/2/1014535.png,0,0.919973731,315,102,959,746,644,644,rainbow dash
1014535.png,https://derpicdn.net/img/view/2015/11/2/1014535.png,0,0.919973731,345,131,929,715,584,584,rainbow dash
1014535.png,https://derpicdn.net/img/view/2015/11/2/1014535.png,0,0.919973731,345,131,929,715,584,584,rainbow dash
1016082.png,https://derpicdn.net/img/view/2015/11/4/1016082.png,0,0.97702378,297,102,543,348,246,246,rainbow dash
1016082.png,https://derpicdn.net/img/view/2015/11/4/1016082.png,0,0.97702378,309,113,533,337,224,224,rainbow dash
1016082.png,https://derpicdn.net/img/view/2015/11/4/1016082.png,0,0.97702378,309,113,533,337,224,224,rainbow dash
1016350.png,https://derpicdn.net/img/view/2015/11/5/1016350.png,0,0.995219469,658,0,2374,1402,1716,1402,rainbow dash
1016350.png,https://derpicdn.net/img/view/2015/11/5/1016350.png,0,0.995219469,739,0,2297,1325,1558,1325,rainbow dash
1016350.png,https://derpicdn.net/img/view/2015/11/5/1016350.png,0,0.995219469,739,0,2297,1325,1558,1325,rainbow dash
1019004.png,https://derpicdn.net/img/view/2015/11/8/1019004.png,0,0.991412461,95,281,2843,2854,2748,2573,rainbow dash
1019004.png,https://derpicdn.net/img/view/2015/11/8/1019004.png,0,0.991412461,221,434,2721,2854,2500,2420,rainbow dash
1019004.png,https://derpicdn.net/img/view/2015/11/8/1019004.png,0,0.991412461,221,434,2721,2854,2500,2420,rainbow dash
1019457.png,https://derpicdn.net/img/view/2015/11/9/1019457.png,0,0.999226213,485,0,2137,1578,1652,1578,rainbow dash
1019457.png,https://derpicdn.net/img/view/2015/11/9/1019457.png,0,0.999226213,543,0,2079,1504,1536,1504,rainbow dash
1019457.png,https://derpicdn.net/img/view/2015/11/9/1019457.png,0,0.999226213,543,0,2079,1504,1536,1504,rainbow dash
1019537.png,https://derpicdn.net/img/view/2015/11/9/1019537.png,0,0.966022193,198,16,2300,2184,2102,2168,rainbow dash
1019537.png,https://derpicdn.net/img/view/2015/11/9/1019537.png,0,0.966022193,297,115,2267,2085,1970,1970,rainbow dash
1019537.png,https://derpicdn.net/img/view/2015/11/9/1019537.png,0,0.966022193,297,115,2267,2085,1970,1970,rainbow dash
102092.jpg,https://derpicdn.net/img/view/2012/9/19/102092.jpg,0,0.999016166,88,0,478,371,390,371,rainbow dash
102092.jpg,https://derpicdn.net/img/view/2012/9/19/102092.jpg,0,0.999016166,105,0,461,354,356,354,rainbow dash
102092.jpg,https://derpicdn.net/img/view/2012/9/19/102092.jpg,0,0.999016166,105,0,461,354,356,354,rainbow dash
1020955.png,https://derpicdn.net/img/view/2015/11/11/1020955.png,0,0.982687891,0,155,707,871,707,716,rainbow dash
1020955.png,https://derpicdn.net/img/view/2015/11/11/1020955.png,0,0.982687891,24,187,674,837,650,650,rainbow dash
1020955.png,https://derpicdn.net/img/view/2015/11/11/1020955.png,0,0.982687891,24,187,674,837,650,650,rainbow dash
1023496.png,https://derpicdn.net/img/view/2015/11/15/1023496.png,0,0.99831605,127,16,659,548,532,532,rainbow dash
1023496.png,https://derpicdn.net/img/view/2015/11/15/1023496.png,0,0.99831605,151,40,635,524,484,484,rainbow dash
1023496.png,https://derpicdn.net/img/view/2015/11/15/1023496.png,0,0.99831605,151,40,635,524,484,484,rainbow dash
1023783.png,https://derpicdn.net/img/view/2015/11/16/1023783.png,0,0.928203166,159,118,2313,2272,2154,2154,rainbow dash
1023783.png,https://derpicdn.net/img/view/2015/11/16/1023783.png,0,0.928203166,257,216,2217,2176,1960,1960,rainbow dash
1023783.png,https://derpicdn.net/img/view/2015/11/16/1023783.png,0,0.928203166,257,216,2217,2176,1960,1960,rainbow dash
102461.png,https://derpicdn.net/img/view/2012/9/20/102461.png,0,0.988976061,349,48,965,664,616,616,rainbow dash
102461.png,https://derpicdn.net/img/view/2012/9/20/102461.png,0,0.988976061,376,76,936,636,560,560,rainbow dash
102461.png,https://derpicdn.net/img/view/2012/9/20/102461.png,0,0.988976061,376,76,936,636,560,560,rainbow dash
1026502.png,https://derpicdn.net/img/view/2015/11/20/1026502.png,0,0.998901248,309,22,695,408,386,386,rainbow dash
1026502.png,https://derpicdn.net/img/view/2015/11/20/1026502.png,0,0.998901248,281,0,723,436,442,436,rainbow dash
1026502.png,https://derpicdn.net/img/view/2015/11/20/1026502.png,0,0.998901248,281,0,723,436,442,436,rainbow dash
1027453.png,https://derpicdn.net/img/view/2015/11/21/1027453.png,0,0.999272883,61,0,1125,961,1064,961,rainbow dash
1027453.png,https://derpicdn.net/img/view/2015/11/21/1027453.png,0,0.999272883,110,0,1076,891,966,891,rainbow dash
1027453.png,https://derpicdn.net/img/view/2015/11/21/1027453.png,0,0.999272883,110,0,1076,891,966,891,rainbow dash
1032043.png,https://derpicdn.net/img/view/2015/11/28/1032043.png,0,0.975030541,0,0,2466,2435,2466,2435,rainbow dash
1032550.png,https://derpicdn.net/img/view/2015/11/29/1032550.png,0,0.973602116,46,51,570,575,524,524,rainbow dash
1032646.png,https://derpicdn.net/img/view/2015/11/29/1032646.png,0,0.986783862,0,0,757,750,757,750,rainbow dash
1033428.png,https://derpicdn.net/img/view/2015/11/29/1033428.png,0,0.96167326,0,0,800,888,800,888,rainbow dash
1033973.png,https://derpicdn.net/img/view/2015/11/30/1033973.png,0,0.901608109,351,20,841,510,490,490,rainbow dash
1034271.jpg,https://derpicdn.net/img/view/2015/12/1/1034271.jpg,0,0.996046841,226,0,662,405,436,405,rainbow dash
1034648.png,https://derpicdn.net/img/view/2015/12/1/1034648.png,0,0.972474277,0,0,1644,1575,1644,1575,rainbow dash
1035057.png,https://derpicdn.net/img/view/2015/12/2/1035057.png,0,0.956372321,253,161,2623,2531,2370,2370,rainbow dash
103591.jpg,https://derpicdn.net/img/view/2012/9/21/103591.jpg,0,0.999618888,93,0,303,208,210,208,rainbow dash
1036579.png,https://derpicdn.net/img/view/2015/12/4/1036579.png,0,0.960277557,21,0,469,429,448,429,rainbow dash
1037641.png,https://derpicdn.net/img/view/2015/12/5/1037641.png,0,0.900210857,119,0,751,629,632,629,rainbow dash
1041437.png,https://derpicdn.net/img/view/2015/12/10/1041437.png,0,0.995571077,57,0,709,649,652,649,rainbow dash
1042092.png,https://derpicdn.net/img/view/2015/12/11/1042092.png,0,0.982775033,364,30,644,310,280,280,rainbow dash
1044163.png,https://derpicdn.net/img/view/2015/12/14/1044163.png,0,0.999831796,1293,7,1785,503,492,496,rainbow dash
1044163.png,https://derpicdn.net/img/view/2015/12/14/1044163.png,2,0.996085703,474,68,860,454,386,386,rainbow dash
1044163.png,https://derpicdn.net/img/view/2015/12/14/1044163.png,3,0.993802428,453,475,931,953,478,478,rainbow dash
1044163.png,https://derpicdn.net/img/view/2015/12/14/1044163.png,5,0.970467508,48,598,408,958,360,360,rainbow dash
1044373.png,https://derpicdn.net/img/view/2015/12/14/1044373.png,2,0.994921446,17,50,305,338,288,288,rainbow dash
1044373.png,https://derpicdn.net/img/view/2015/12/14/1044373.png,5,0.960137844,325,393,647,715,322,322,rainbow dash
1045515.png,https://derpicdn.net/img/view/2015/12/16/1045515.png,0,0.909630597,215,19,985,789,770,770,rainbow dash
1046523.png,https://derpicdn.net/img/view/2015/12/17/1046523.png,0,0.998005152,0,57,297,367,297,310,rainbow dash
1052940.png,https://derpicdn.net/img/view/2015/12/26/1052940.png,0,0.911943913,199,73,713,587,514,514,rainbow dash
1053478.png,https://derpicdn.net/img/view/2015/12/27/1053478.png,0,0.998774529,98,31,1154,1087,1056,1056,rainbow dash
1053527.png,https://derpicdn.net/img/view/2015/12/27/1053527.png,0,0.998604476,468,0,998,508,530,508,rainbow dash
1054314.png,https://derpicdn.net/img/view/2015/12/28/1054314.png,0,0.944309533,0,0,805,736,805,736,rainbow dash
1058502.png,https://derpicdn.net/img/view/2016/1/3/1058502.png,0,0.9888255,0,67,1122,1213,1122,1146,rainbow dash
1059197.png,https://derpicdn.net/img/view/2016/1/4/1059197.png,0,0.969788849,501,124,1409,1032,908,908,rainbow dash
1061114.png,https://derpicdn.net/img/view/2016/1/6/1061114.png,0,0.997909784,152,7,672,527,520,520,rainbow dash
1062184.png,https://derpicdn.net/img/view/2016/1/8/1062184.png,0,0.998745084,2214,0,4008,1633,1794,1633,rainbow dash
1064613.png,https://derpicdn.net/img/view/2016/1/11/1064613.png,0,0.909442186,1025,0,2027,953,1002,953,rainbow dash
1064639.jpg,https://derpicdn.net/img/view/2016/1/11/1064639.jpg,0,0.921031296,668,636,1252,1220,584,584,rainbow dash
1065541.png,https://derpicdn.net/img/view/2016/1/13/1065541.png,0,0.97107631,60,96,462,498,402,402,rainbow dash
1065614.png,https://derpicdn.net/img/view/2016/1/13/1065614.png,0,0.99813211,20,2,444,426,424,424,rainbow dash
1067418.png,https://derpicdn.net/img/view/2016/1/16/1067418.png,0,0.999212444,302,0,868,562,566,562,rainbow dash
1067891.png,https://derpicdn.net/img/view/2016/1/16/1067891.png,0,0.912781835,1458,1425,2488,2455,1030,1030,rainbow dash
1068065.jpg,https://derpicdn.net/img/view/2016/1/17/1068065.jpg,0,0.99775213,380,14,820,454,440,440,rainbow dash
1070996.png,https://derpicdn.net/img/view/2016/1/21/1070996.png,0,0.955257595,1062,494,2712,2144,1650,1650,rainbow dash
1071955.png,https://derpicdn.net/img/view/2016/1/23/1071955.png,0,0.999417782,311,31,757,477,446,446,rainbow dash
1071955.png,https://derpicdn.net/img/view/2016/1/23/1071955.png,1,0.998458743,1188,6,1690,508,502,502,rainbow dash
1073291.png,https://derpicdn.net/img/view/2016/1/25/1073291.png,0,0.999831676,916,0,1682,663,766,663,rainbow dash
1073366.png,https://derpicdn.net/img/view/2016/1/25/1073366.png,0,0.993715584,148,23,626,501,478,478,rainbow dash
1073372.png,https://derpicdn.net/img/view/2016/1/25/1073372.png,0,0.993594766,148,24,626,502,478,478,rainbow dash
1075846.png,https://derpicdn.net/img/view/2016/1/29/1075846.png,0,0.97292912,164,0,750,580,586,580,rainbow dash
1076639.png,https://derpicdn.net/img/view/2016/1/30/1076639.png,0,0.988048613,1159,0,2187,1017,1028,1017,rainbow dash
1079327.png,https://derpicdn.net/img/view/2016/2/3/1079327.png,0,0.939550579,79,0,293,140,214,140,rainbow dash
1079327.png,https://derpicdn.net/img/view/2016/2/3/1079327.png,1,0.916928411,0,0,261,140,261,140,rainbow dash
1080977.png,https://derpicdn.net/img/view/2016/2/5/1080977.png,0,0.996814251,1026,0,2020,958,994,958,rainbow dash
1083876.png,https://derpicdn.net/img/view/2016/2/9/1083876.png,0,0.956782281,40,124,610,694,570,570,rainbow dash
1083979.png,https://derpicdn.net/img/view/2016/2/9/1083979.png,0,0.999821544,779,0,1375,560,596,560,rainbow dash
1084262.png,https://derpicdn.net/img/view/2016/2/10/1084262.png,0,0.997670591,321,206,1023,908,702,702,rainbow dash
1087160.png,https://derpicdn.net/img/view/2016/2/13/1087160.png,0,0.969557285,617,96,1235,714,618,618,rainbow dash
1091038.png,https://derpicdn.net/img/view/2016/2/18/1091038.png,1,0.916661918,23,123,313,413,290,290,rainbow dash
1091667.png,https://derpicdn.net/img/view/2016/2/19/1091667.png,0,0.989974976,382,0,1782,1380,1400,1380,rainbow dash
1094304.png,https://derpicdn.net/img/view/2016/2/22/1094304.png,0,0.995749772,49,0,775,638,726,638,rainbow dash
1098129.png,https://derpicdn.net/img/view/2016/2/27/1098129.png,0,0.957796156,791,0,3097,2202,2306,2202,rainbow dash
1098664.png,https://derpicdn.net/img/view/2016/2/28/1098664.png,0,0.997728586,1518,973,1972,1427,454,454,rainbow dash
1098664.png,https://derpicdn.net/img/view/2016/2/28/1098664.png,1,0.995794058,1325,0,1759,421,434,421,rainbow dash
1098664.png,https://derpicdn.net/img/view/2016/2/28/1098664.png,3,0.991705656,1926,21,2384,479,458,458,rainbow dash
1098664.png,https://derpicdn.net/img/view/2016/2/28/1098664.png,4,0.990779042,856,1494,1370,2008,514,514,rainbow dash
1098664.png,https://derpicdn.net/img/view/2016/2/28/1098664.png,5,0.951023817,868,427,1736,1295,868,868,rainbow dash
1098664.png,https://derpicdn.net/img/view/2016/2/28/1098664.png,6,0.929554045,1235,1444,1749,1958,514,514,rainbow dash
1099550.png,https://derpicdn.net/img/view/2016/2/29/1099550.png,0,0.997994363,437,3,1280,927,843,924,rainbow dash
1099783.png,https://derpicdn.net/img/view/2016/3/1/1099783.png,0,0.998674393,438,0,1280,924,842,924,rainbow dash
1100844.png,https://derpicdn.net/img/view/2016/3/2/1100844.png,0,0.978714943,0,12,887,982,887,970,rainbow dash
1106368.png,https://derpicdn.net/img/view/2016/3/11/1106368.png,0,0.993993402,98,0,456,335,358,335,rainbow dash
1111967.png,https://derpicdn.net/img/view/2016/3/19/1111967.png,0,0.968800664,0,0,1617,1648,1617,1648,rainbow dash
1113077.jpg,https://derpicdn.net/img/view/2016/3/20/1113077.jpg,0,0.995802224,143,0,615,435,472,435,rainbow dash
1113325.png,https://derpicdn.net/img/view/2016/3/20/1113325.png,0,0.991758466,30,28,1022,1020,992,992,rainbow dash
1115590.png,https://derpicdn.net/img/view/2016/3/24/1115590.png,0,0.992351413,243,0,791,475,548,475,rainbow dash
1116258.png,https://derpicdn.net/img/view/2016/3/25/1116258.png,0,0.994545579,508,0,1708,1185,1200,1185,rainbow dash
1116990.png,https://derpicdn.net/img/view/2016/3/26/1116990.png,0,0.996798813,111,0,2007,1721,1896,1721,rainbow dash
1118746.png,https://derpicdn.net/img/view/2016/3/28/1118746.png,0,0.968405485,118,143,2216,2241,2098,2098,rainbow dash
1119906.png,https://derpicdn.net/img/view/2016/3/29/1119906.png,0,0.999416411,122,10,552,440,430,430,rainbow dash
1121524.png,https://derpicdn.net/img/view/2016/4/1/1121524.png,0,0.982789993,131,107,2211,2100,2080,1993,rainbow dash
1127320.png,https://derpicdn.net/img/view/2016/4/8/1127320.png,0,0.997489214,1284,444,2124,1284,840,840,rainbow dash
1127320.png,https://derpicdn.net/img/view/2016/4/8/1127320.png,1,0.978619874,2757,66,3671,980,914,914,rainbow dash
11277.png,https://derpicdn.net/img/view/2012/6/20/11277.png,0,0.984455884,155,0,1069,884,914,884,rainbow dash
1131534.jpg,https://derpicdn.net/img/view/2016/4/14/1131534.jpg,0,0.999878287,355,85,899,629,544,544,rainbow dash
1134083.jpg,https://derpicdn.net/img/view/2016/4/17/1134083.jpg,0,0.970900416,385,38,1245,898,860,860,rainbow dash
1135422.png,https://derpicdn.net/img/view/2016/4/19/1135422.png,0,0.987923384,69,0,591,485,522,485,rainbow dash
1143950.png,https://derpicdn.net/img/view/2016/5/1/1143950.png,0,0.999249756,968,0,2372,1359,1404,1359,rainbow dash
1144078.jpg,https://derpicdn.net/img/view/2016/5/1/1144078.jpg,0,0.944108307,424,0,1218,742,794,742,rainbow dash
1145851.png,https://derpicdn.net/img/view/2016/5/3/1145851.png,0,0.989016354,37,222,2073,2258,2036,2036,rainbow dash
1148838.png,https://derpicdn.net/img/view/2016/5/7/1148838.png,0,0.999070525,356,12,978,634,622,622,rainbow dash
1148953.png,https://derpicdn.net/img/view/2016/5/8/1148953.png,0,0.923594713,13,0,687,603,674,603,rainbow dash
1149028.png,https://derpicdn.net/img/view/2016/5/8/1149028.png,0,0.964976668,52,84,744,776,692,692,rainbow dash
1150110.jpg,https://derpicdn.net/img/view/2016/5/9/1150110.jpg,0,0.932960033,527,32,971,476,444,444,rainbow dash
1151445.png,https://derpicdn.net/img/view/2016/5/11/1151445.png,0,0.977844298,509,140,1045,676,536,536,rainbow dash
1152110.png,https://derpicdn.net/img/view/2016/5/12/1152110.png,0,0.998520732,124,0,1352,1088,1228,1088,rainbow dash
1152419.png,https://derpicdn.net/img/view/2016/5/12/1152419.png,0,0.998869359,85,16,557,488,472,472,rainbow dash
1152880.png,https://derpicdn.net/img/view/2016/5/13/1152880.png,0,0.999241292,39,0,635,559,596,559,rainbow dash
1153883.jpg,https://derpicdn.net/img/view/2016/5/14/1153883.jpg,0,0.97713697,88,6,1100,1054,1012,1048,rainbow dash
1155005.png,https://derpicdn.net/img/view/2016/5/15/1155005.png,0,0.907279611,199,69,497,367,298,298,rainbow dash
1164293.png,https://derpicdn.net/img/view/2016/5/27/1164293.png,0,0.990241587,4,57,800,891,796,834,rainbow dash
1165964.png,https://derpicdn.net/img/view/2016/5/29/1165964.png,0,0.997449636,1526,0,3312,1774,1786,1774,rainbow dash
1166160.jpg,https://derpicdn.net/img/view/2016/5/30/1166160.jpg,0,0.945320129,52,10,516,474,464,464,rainbow dash
1166339.png,https://derpicdn.net/img/view/2016/5/30/1166339.png,0,0.984413624,2850,216,4152,1518,1302,1302,rainbow dash
1166652.png,https://derpicdn.net/img/view/2016/5/30/1166652.png,0,0.986268401,876,564,1978,1666,1102,1102,rainbow dash
1167747.png,https://derpicdn.net/img/view/2016/6/1/1167747.png,0,0.996787012,555,94,1757,1296,1202,1202,rainbow dash
1169742.jpg,https://derpicdn.net/img/view/2016/6/4/1169742.jpg,0,0.988291144,174,0,1414,1026,1240,1026,rainbow dash
1171521.png,https://derpicdn.net/img/view/2016/6/6/1171521.png,0,0.983997405,86,0,609,467,523,467,rainbow dash
1172316.png,https://derpicdn.net/img/view/2016/6/7/1172316.png,0,0.998402655,423,4,723,304,300,300,rainbow dash
1175042.png,https://derpicdn.net/img/view/2016/6/10/1175042.png,0,0.998439133,1037,0,2081,972,1044,972,rainbow dash
1177590.png,https://derpicdn.net/img/view/2016/6/13/1177590.png,0,0.999017119,309,5,1691,1387,1382,1382,rainbow dash
1178396.png,https://derpicdn.net/img/view/2016/6/14/1178396.png,0,0.934252381,1339,242,2271,1174,932,932,rainbow dash
1184226.png,https://derpicdn.net/img/view/2016/6/22/1184226.png,0,0.996390998,0,0,675,684,675,684,rainbow dash
1185770.png,https://derpicdn.net/img/view/2016/6/24/1185770.png,0,0.96694386,129,68,1121,1060,992,992,rainbow dash
1185955.png,https://derpicdn.net/img/view/2016/6/24/1185955.png,0,0.95336163,353,136,1833,1616,1480,1480,rainbow dash
1186109.jpg,https://derpicdn.net/img/view/2016/6/25/1186109.jpg,0,0.998638868,479,40,1027,588,548,548,rainbow dash
1187847.png,https://derpicdn.net/img/view/2016/6/27/1187847.png,0,0.998511255,633,0,1719,1053,1086,1053,rainbow dash
1187877.png,https://derpicdn.net/img/view/2016/6/27/1187877.png,0,0.99693954,302,0,746,429,444,429,rainbow dash
1188578.png,https://derpicdn.net/img/view/2016/6/28/1188578.png,0,0.971280813,0,0,407,435,407,435,rainbow dash
1189517.png,https://derpicdn.net/img/view/2016/6/29/1189517.png,0,0.995314777,284,0,950,658,666,658,rainbow dash
1189549.png,https://derpicdn.net/img/view/2016/6/29/1189549.png,0,0.977823496,484,46,1024,592,540,546,rainbow dash
1194090.png,https://derpicdn.net/img/view/2016/7/5/1194090.png,0,0.976722836,116,267,1646,1797,1530,1530,rainbow dash
1195597.png,https://derpicdn.net/img/view/2016/7/7/1195597.png,0,0.999368548,556,95,1090,629,534,534,rainbow dash
1199894.png,https://derpicdn.net/img/view/2016/7/13/1199894.png,0,0.967797577,201,68,1497,1364,1296,1296,rainbow dash
1201501.png,https://derpicdn.net/img/view/2016/7/15/1201501.png,0,0.999160111,784,0,1592,776,808,776,rainbow dash
1202569.png,https://derpicdn.net/img/view/2016/7/16/1202569.png,0,0.9984653,1807,205,2805,1203,998,998,rainbow dash
1207143.png,https://derpicdn.net/img/view/2016/7/23/1207143.png,0,0.975684822,122,0,878,724,756,724,rainbow dash
1208790.png,https://derpicdn.net/img/view/2016/7/25/1208790.png,0,0.924203813,405,0,1285,820,880,820,rainbow dash
1212722.png,https://derpicdn.net/img/view/2016/7/30/1212722.png,0,0.99608016,907,106,1945,1144,1038,1038,rainbow dash
1216850.png,https://derpicdn.net/img/view/2016/8/4/1216850.png,0,0.956567764,0,0,1160,1127,1160,1127,rainbow dash
1217116.png,https://derpicdn.net/img/view/2016/8/4/1217116.png,0,0.96808964,128,345,804,964,676,619,rainbow dash
1217259.png,https://derpicdn.net/img/view/2016/8/5/1217259.png,0,0.99824363,1106,507,2180,1581,1074,1074,rainbow dash
1218562.png,https://derpicdn.net/img/view/2016/8/6/1218562.png,0,0.974750936,0,0,359,426,359,426,rainbow dash
1222460.png,https://derpicdn.net/img/view/2016/8/11/1222460.png,0,0.999892592,482,55,1202,775,720,720,rainbow dash
1224955.png,https://derpicdn.net/img/view/2016/8/14/1224955.png,0,0.901010573,370,0,1632,1245,1262,1245,rainbow dash
1229331.png,https://derpicdn.net/img/view/2016/8/20/1229331.png,0,0.998941839,142,0,782,581,640,581,rainbow dash
1231663.png,https://derpicdn.net/img/view/2016/8/23/1231663.png,0,0.929281235,1419,0,2607,1151,1188,1151,rainbow dash
1236162.png,https://derpicdn.net/img/view/2016/8/28/1236162.png,0,0.948378086,0,0,660,705,660,705,rainbow dash
1247493.png,https://derpicdn.net/img/view/2016/9/12/1247493.png,0,0.993021786,945,0,1627,608,682,608,rainbow dash
1249901.png,https://derpicdn.net/img/view/2016/9/15/1249901.png,0,0.999633074,344,0,660,288,316,288,rainbow dash
1250830.png,https://derpicdn.net/img/view/2016/9/17/1250830.png,0,0.968624115,613,4,1165,556,552,552,rainbow dash
1260032.png,https://derpicdn.net/img/view/2016/9/28/1260032.png,0,0.998719752,30,0,630,587,600,587,rainbow dash
1260951.png,https://derpicdn.net/img/view/2016/9/29/1260951.png,0,0.976936221,618,104,1548,1034,930,930,rainbow dash
1261813.png,https://derpicdn.net/img/view/2016/9/30/1261813.png,0,0.99820751,2106,0,5214,2827,3108,2827,rainbow dash
1262617.png,https://derpicdn.net/img/view/2016/10/1/1262617.png,0,0.996961057,459,174,1159,874,700,700,rainbow dash
1263527.png,https://derpicdn.net/img/view/2016/10/2/1263527.png,0,0.992916048,161,0,669,451,508,451,rainbow dash
1264710.png,https://derpicdn.net/img/view/2016/10/4/1264710.png,0,0.992358387,90,0,746,619,656,619,rainbow dash
1269541.png,https://derpicdn.net/img/view/2016/10/10/1269541.png,0,0.997602463,1560,98,2488,1026,928,928,rainbow dash
1269823.png,https://derpicdn.net/img/view/2016/10/10/1269823.png,0,0.999402225,353,51,1017,715,664,664,rainbow dash
1273143.png,https://derpicdn.net/img/view/2016/10/15/1273143.png,0,0.994915426,0,0,1148,978,1148,978,rainbow dash
1276874.jpg,https://derpicdn.net/img/view/2016/10/19/1276874.jpg,0,0.996795237,231,73,683,525,452,452,rainbow dash
1279205.png,https://derpicdn.net/img/view/2016/10/22/1279205.png,0,0.997683644,1182,609,1926,1353,744,744,rainbow dash
1279586.png,https://derpicdn.net/img/view/2016/10/23/1279586.png,0,0.995709419,63,0,1369,1084,1306,1084,rainbow dash
1280824.png,https://derpicdn.net/img/view/2016/10/24/1280824.png,0,0.999720633,516,0,1440,860,924,860,rainbow dash
1286307.png,https://derpicdn.net/img/view/2016/11/1/1286307.png,0,0.988713026,47,48,1491,1492,1444,1444,rainbow dash
1287343.png,https://derpicdn.net/img/view/2016/11/2/1287343.png,0,0.982978404,0,27,775,897,775,870,rainbow dash
1290894.png,https://derpicdn.net/img/view/2016/11/7/1290894.png,0,0.990463078,167,122,925,880,758,758,rainbow dash
1298361.png,https://derpicdn.net/img/view/2016/11/18/1298361.png,0,0.997938991,341,0,759,404,418,404,rainbow dash
1299934.png,https://derpicdn.net/img/view/2016/11/20/1299934.png,0,0.971733391,628,0,1728,1031,1100,1031,rainbow dash
1300431.png,https://derpicdn.net/img/view/2016/11/21/1300431.png,0,0.975201726,47,0,635,564,588,564,rainbow dash
1300929.png,https://derpicdn.net/img/view/2016/11/22/1300929.png,0,0.977051973,59,0,1387,897,1328,897,rainbow dash
1304084.png,https://derpicdn.net/img/view/2016/11/26/1304084.png,0,0.98682797,31,0,503,461,472,461,rainbow dash
130421.jpg,https://derpicdn.net/img/view/2012/10/24/130421.jpg,0,0.96667695,0,0,510,522,510,522,rainbow dash
1304980.png,https://derpicdn.net/img/view/2016/11/27/1304980.png,0,0.993365169,641,0,2409,1550,1768,1550,rainbow dash
1305296.png,https://derpicdn.net/img/view/2016/11/28/1305296.png,0,0.990295053,12,0,2090,1940,2078,1940,rainbow dash
1309883.png,https://derpicdn.net/img/view/2016/12/4/1309883.png,0,0.976065397,343,0,1349,865,1006,865,rainbow dash
1311050.png,https://derpicdn.net/img/view/2016/12/6/1311050.png,0,0.958575308,114,340,1776,2000,1662,1660,rainbow dash
1315911.png,https://derpicdn.net/img/view/2016/12/12/1315911.png,0,0.998864412,918,123,1674,879,756,756,rainbow dash
1315911.png,https://derpicdn.net/img/view/2016/12/12/1315911.png,1,0.986510992,253,244,919,910,666,666,rainbow dash
1320338.png,https://derpicdn.net/img/view/2016/12/18/1320338.png,0,0.989394188,245,535,1745,2035,1500,1500,rainbow dash
1320341.png,https://derpicdn.net/img/view/2016/12/18/1320341.png,0,0.997076631,227,501,1807,2081,1580,1580,rainbow dash
1327879.png,https://derpicdn.net/img/view/2016/12/29/1327879.png,0,0.999284863,643,0,1479,829,836,829,rainbow dash
1330377.png,https://derpicdn.net/img/view/2017/1/2/1330377.png,0,0.994037569,123,0,1757,1561,1634,1561,rainbow dash
1332478.png,https://derpicdn.net/img/view/2017/1/5/1332478.png,0,0.995665252,447,490,800,916,353,426,rainbow dash
1333612.png,https://derpicdn.net/img/view/2017/1/6/1333612.png,0,0.967955172,400,0,1896,1290,1496,1290,rainbow dash
1334926.png,https://derpicdn.net/img/view/2017/1/8/1334926.png,0,0.998760641,532,0,1364,748,832,748,rainbow dash
1335460.png,https://derpicdn.net/img/view/2017/1/9/1335460.png,0,0.954853475,288,81,1432,1225,1144,1144,rainbow dash
1336740.png,https://derpicdn.net/img/view/2017/1/10/1336740.png,0,0.997893274,145,4,873,732,728,728,rainbow dash
1337208.png,https://derpicdn.net/img/view/2017/1/11/1337208.png,0,0.944080293,3038,28,6000,3002,2962,2974,rainbow dash
133732.png,https://derpicdn.net/img/view/2012/10/27/133732.png,0,0.998489201,336,104,1574,1342,1238,1238,rainbow dash
1337801.png,https://derpicdn.net/img/view/2017/1/12/1337801.png,0,0.987190306,32,0,494,432,462,432,rainbow dash
1338093.png,https://derpicdn.net/img/view/2017/1/12/1338093.png,0,0.996985078,743,120,2391,1768,1648,1648,rainbow dash
1338738.png,https://derpicdn.net/img/view/2017/1/13/1338738.png,0,0.985534608,1277,0,3840,2321,2563,2321,rainbow dash
1340043.png,https://derpicdn.net/img/view/2017/1/15/1340043.png,0,0.919055402,430,54,1050,674,620,620,rainbow dash
1340759.png,https://derpicdn.net/img/view/2017/1/16/1340759.png,0,0.983881831,210,4,846,640,636,636,rainbow dash
1341458.png,https://derpicdn.net/img/view/2017/1/17/1341458.png,0,0.995542943,1256,177,1724,645,468,468,rainbow dash
1346902.png,https://derpicdn.net/img/view/2017/1/24/1346902.png,0,0.98342365,44,29,400,385,356,356,rainbow dash
1347082.png,https://derpicdn.net/img/view/2017/1/24/1347082.png,0,0.9760741,0,0,1189,1251,1189,1251,rainbow dash
1347649.png,https://derpicdn.net/img/view/2017/1/25/1347649.png,0,0.996662974,218,131,936,849,718,718,rainbow dash
1347650.png,https://derpicdn.net/img/view/2017/1/25/1347650.png,0,0.999264479,148,0,1062,904,914,904,rainbow dash
1353981.png,https://derpicdn.net/img/view/2017/2/3/1353981.png,0,0.996214092,195,0,1399,1115,1204,1115,rainbow dash
1354577.png,https://derpicdn.net/img/view/2017/2/3/1354577.png,0,0.977512717,557,0,1837,1237,1280,1237,rainbow dash
1356842.png,https://derpicdn.net/img/view/2017/2/6/1356842.png,0,0.978415787,376,169,1264,1057,888,888,rainbow dash
1358114.png,https://derpicdn.net/img/view/2017/2/8/1358114.png,0,0.964806497,335,0,1015,666,680,666,rainbow dash
1360384.png,https://derpicdn.net/img/view/2017/2/11/1360384.png,0,0.996425152,45,0,579,528,534,528,rainbow dash
1362316.png,https://derpicdn.net/img/view/2017/2/14/1362316.png,0,0.994171023,328,1,1714,1387,1386,1386,rainbow dash
1362323.png,https://derpicdn.net/img/view/2017/2/14/1362323.png,0,0.986651003,191,0,1999,1719,1808,1719,rainbow dash
1363242.png,https://derpicdn.net/img/view/2017/2/15/1363242.png,0,0.996178865,95,0,1427,1212,1332,1212,rainbow dash
1363403.png,https://derpicdn.net/img/view/2017/2/15/1363403.png,0,0.956395745,0,70,550,658,550,588,rainbow dash
1363403.png,https://derpicdn.net/img/view/2017/2/15/1363403.png,1,0.91148442,230,50,750,570,520,520,rainbow dash
1363721.png,https://derpicdn.net/img/view/2017/2/15/1363721.png,0,0.989142716,11,0,611,514,600,514,rainbow dash
1363786.png,https://derpicdn.net/img/view/2017/2/15/1363786.png,0,0.999513686,877,0,2660,1641,1783,1641,rainbow dash
1378874.png,https://derpicdn.net/img/view/2017/3/4/1378874.png,0,0.988263905,288,188,2160,2060,1872,1872,rainbow dash
1379306.png,https://derpicdn.net/img/view/2017/3/4/1379306.png,0,0.998866677,626,0,2092,1447,1466,1447,rainbow dash
1382802.png,https://derpicdn.net/img/view/2017/3/9/1382802.png,0,0.993812144,845,46,2500,1714,1655,1668,rainbow dash
1383784.png,https://derpicdn.net/img/view/2017/3/10/1383784.png,0,0.977649152,374,0,2646,2071,2272,2071,rainbow dash
1385470.png,https://derpicdn.net/img/view/2017/3/12/1385470.png,0,0.964469433,479,0,1281,794,802,794,rainbow dash
1386790.png,https://derpicdn.net/img/view/2017/3/14/1386790.png,0,0.998812437,270,36,850,616,580,580,rainbow dash
1386795.png,https://derpicdn.net/img/view/2017/3/14/1386795.png,0,0.97149092,613,0,1389,587,776,587,rainbow dash
139389.png,https://derpicdn.net/img/view/2012/11/2/139389.png,0,0.967409968,1498,971,2244,1717,746,746,rainbow dash
1393943.png,https://derpicdn.net/img/view/2017/3/22/1393943.png,0,0.98519516,0,0,1097,993,1097,993,rainbow dash
1394257.png,https://derpicdn.net/img/view/2017/3/23/1394257.png,0,0.994754553,308,0,1038,714,730,714,rainbow dash
1394704.png,https://derpicdn.net/img/view/2017/3/23/1394704.png,0,0.963512838,378,0,962,542,584,542,rainbow dash
1398949.png,https://derpicdn.net/img/view/2017/3/29/1398949.png,0,0.994906664,708,90,1040,422,332,332,rainbow dash
1400470.png,https://derpicdn.net/img/view/2017/3/31/1400470.png,0,0.998931587,474,13,1278,817,804,804,rainbow dash
1403413.png,https://derpicdn.net/img/view/2017/4/3/1403413.png,0,0.99360162,1471,1669,2071,2269,600,600,rainbow dash
1403413.png,https://derpicdn.net/img/view/2017/4/3/1403413.png,1,0.992721856,330,1944,898,2512,568,568,rainbow dash
1403413.png,https://derpicdn.net/img/view/2017/4/3/1403413.png,2,0.990182877,919,1179,1427,1687,508,508,rainbow dash
1403414.png,https://derpicdn.net/img/view/2017/4/3/1403414.png,0,0.993690193,262,0,1090,825,828,825,rainbow dash
1405396.png,https://derpicdn.net/img/view/2017/4/6/1405396.png,0,0.998755276,69,0,447,356,378,356,rainbow dash
1407864.png,https://derpicdn.net/img/view/2017/4/9/1407864.png,0,0.999541581,280,27,1072,819,792,792,rainbow dash
1413017.png,https://derpicdn.net/img/view/2017/4/16/1413017.png,0,0.972607017,9,35,2005,2273,1996,2238,rainbow dash
1415244.png,https://derpicdn.net/img/view/2017/4/18/1415244.png,0,0.985931814,44,0,1280,1281,1236,1281,rainbow dash
1419147.png,https://derpicdn.net/img/view/2017/4/23/1419147.png,0,0.99916625,302,65,712,475,410,410,rainbow dash
1420227.png,https://derpicdn.net/img/view/2017/4/24/1420227.png,0,0.977295041,136,50,978,892,842,842,rainbow dash
1421555.png,https://derpicdn.net/img/view/2017/4/25/1421555.png,0,0.982632875,0,0,2000,2444,2000,2444,rainbow dash
1423303.png,https://derpicdn.net/img/view/2017/4/28/1423303.png,0,0.98392278,1289,77,2417,1205,1128,1128,rainbow dash
1429618.png,https://derpicdn.net/img/view/2017/5/6/1429618.png,0,0.999367237,513,0,1121,580,608,580,rainbow dash
1434476.png,https://derpicdn.net/img/view/2017/5/12/1434476.png,0,0.908919096,43,0,689,612,646,612,rainbow dash
1435539.png,https://derpicdn.net/img/view/2017/5/13/1435539.png,0,0.926426232,168,0,800,552,632,552,rainbow dash
1438390.png,https://derpicdn.net/img/view/2017/5/17/1438390.png,0,0.984144568,56,18,412,374,356,356,rainbow dash
1440992.png,https://derpicdn.net/img/view/2017/5/20/1440992.png,0,0.988195539,255,0,873,590,618,590,rainbow dash
1441408.png,https://derpicdn.net/img/view/2017/5/20/1441408.png,0,0.97913748,315,0,1115,661,800,661,rainbow dash
1441805.png,https://derpicdn.net/img/view/2017/5/21/1441805.png,0,0.996834457,1279,437,2129,1287,850,850,rainbow dash
1441805.png,https://derpicdn.net/img/view/2017/5/21/1441805.png,1,0.979010284,2762,71,3660,969,898,898,rainbow dash
1442157.png,https://derpicdn.net/img/view/2017/5/21/1442157.png,0,0.976200461,45,0,621,565,576,565,rainbow dash
1445577.png,https://derpicdn.net/img/view/2017/5/25/1445577.png,0,0.966130555,224,0,700,467,476,467,rainbow dash
145.png,https://derpicdn.net/img/view/2012/1/11/145.png,0,0.978326797,0,24,224,264,224,240,rainbow dash
1450208.png,https://derpicdn.net/img/view/2017/5/30/1450208.png,0,0.998492718,185,139,539,493,354,354,rainbow dash
1450724.png,https://derpicdn.net/img/view/2017/5/31/1450724.png,0,0.900508463,0,0,455,466,455,466,rainbow dash
1452869.png,https://derpicdn.net/img/view/2017/6/3/1452869.png,0,0.999128282,418,230,1028,840,610,610,rainbow dash
145389.jpg,https://derpicdn.net/img/view/2012/11/7/145389.jpg,0,0.988170087,341,0,779,413,438,413,rainbow dash
1455044.png,https://derpicdn.net/img/view/2017/6/6/1455044.png,0,0.907127619,278,0,2740,2408,2462,2408,rainbow dash
1456773.png,https://derpicdn.net/img/view/2017/6/8/1456773.png,0,0.927605867,261,319,1803,1861,1542,1542,rainbow dash
1464287.png,https://derpicdn.net/img/view/2017/6/17/1464287.png,0,0.985696375,561,120,1041,600,480,480,rainbow dash
1465027.png,https://derpicdn.net/img/view/2017/6/18/1465027.png,0,0.94890666,371,159,693,481,322,322,rainbow dash
1472419.png,https://derpicdn.net/img/view/2017/6/26/1472419.png,0,0.994042754,257,24,1439,1206,1182,1182,rainbow dash
1475034.png,https://derpicdn.net/img/view/2017/6/30/1475034.png,0,0.992408633,613,298,875,590,262,292,rainbow dash
1476589.png,https://derpicdn.net/img/view/2017/7/2/1476589.png,0,0.977415621,1202,7,2120,925,918,918,rainbow dash
1477588.png,https://derpicdn.net/img/view/2017/7/3/1477588.png,0,0.903507888,352,153,2588,2389,2236,2236,rainbow dash
1477726.png,https://derpicdn.net/img/view/2017/7/3/1477726.png,0,0.997823894,364,34,2084,1754,1720,1720,rainbow dash
1478361.png,https://derpicdn.net/img/view/2017/7/4/1478361.png,0,0.956753492,226,12,444,230,218,218,rainbow dash
1478627.png,https://derpicdn.net/img/view/2017/7/4/1478627.png,0,0.980232298,2100,219,4390,2509,2290,2290,rainbow dash
1480288.png,https://derpicdn.net/img/view/2017/7/6/1480288.png,0,0.928082168,577,0,1403,884,826,884,rainbow dash
1480915.png,https://derpicdn.net/img/view/2017/7/7/1480915.png,0,0.999331474,0,11,789,871,789,860,rainbow dash
1483137.png,https://derpicdn.net/img/view/2017/7/10/1483137.png,0,0.937055469,86,0,708,620,622,620,rainbow dash
1486156.png,https://derpicdn.net/img/view/2017/7/14/1486156.png,0,0.992657721,608,0,1574,829,966,829,rainbow dash
1486337.png,https://derpicdn.net/img/view/2017/7/14/1486337.png,1,0.973311722,987,211,1459,683,472,472,rainbow dash
1486473.png,https://derpicdn.net/img/view/2017/7/15/1486473.png,0,0.968594611,0,0,800,783,800,783,rainbow dash
1497357.png,https://derpicdn.net/img/view/2017/7/29/1497357.png,0,0.990634441,20,0,330,297,310,297,rainbow dash
1500277.png,https://derpicdn.net/img/view/2017/8/1/1500277.png,0,0.925530016,94,0,336,218,242,218,rainbow dash
1501048.png,https://derpicdn.net/img/view/2017/8/2/1501048.png,0,0.947839677,0,0,907,1006,907,1006,rainbow dash
1508396.png,https://derpicdn.net/img/view/2017/8/11/1508396.png,0,0.998288751,556,0,1190,595,634,595,rainbow dash
1511330.png,https://derpicdn.net/img/view/2017/8/15/1511330.png,0,0.997291327,505,9,951,455,446,446,rainbow dash
1512660.png,https://derpicdn.net/img/view/2017/8/17/1512660.png,0,0.997852564,1737,63,3593,1919,1856,1856,rainbow dash
1514160.png,https://derpicdn.net/img/view/2017/8/19/1514160.png,0,0.935886323,502,52,938,488,436,436,rainbow dash
1515360.png,https://derpicdn.net/img/view/2017/8/20/1515360.png,0,0.979759097,81,0,1065,940,984,940,rainbow dash
1520853.png,https://derpicdn.net/img/view/2017/8/27/1520853.png,0,0.999604762,1027,7,1703,683,676,676,rainbow dash
1523512.png,https://derpicdn.net/img/view/2017/8/30/1523512.png,0,0.913907826,1824,42,3158,1376,1334,1334,rainbow dash
1529055.png,https://derpicdn.net/img/view/2017/9/6/1529055.png,0,0.998391688,797,326,2663,2192,1866,1866,rainbow dash
1531573.png,https://derpicdn.net/img/view/2017/9/9/1531573.png,0,0.92142427,2085,124,2695,734,610,610,rainbow dash
1535837.png,https://derpicdn.net/img/view/2017/9/15/1535837.png,0,0.986802697,0,9,2547,2651,2547,2642,rainbow dash
1535896.png,https://derpicdn.net/img/view/2017/9/15/1535896.png,0,0.989839256,630,414,1440,1224,810,810,rainbow dash
1537237.png,https://derpicdn.net/img/view/2017/9/17/1537237.png,0,0.996797085,132,24,550,452,418,428,rainbow dash
1537720.png,https://derpicdn.net/img/view/2017/9/17/1537720.png,0,0.997940421,867,0,3193,2247,2326,2247,rainbow dash
1538171.png,https://derpicdn.net/img/view/2017/9/17/1538171.png,0,0.975569904,644,31,2080,1467,1436,1436,rainbow dash
1541939.png,https://derpicdn.net/img/view/2017/9/22/1541939.png,0,0.921210587,0,0,3324,3354,3324,3354,rainbow dash
15430.jpg,https://derpicdn.net/img/view/2012/6/22/15430.jpg,0,0.979806304,29,0,783,669,754,669,rainbow dash
1549350.png,https://derpicdn.net/img/view/2017/10/1/1549350.png,0,0.979300022,82,64,458,440,376,376,rainbow dash
1550498.png,https://derpicdn.net/img/view/2017/10/2/1550498.png,0,0.990130782,443,0,1501,844,1058,844,rainbow dash
1556724.png,https://derpicdn.net/img/view/2017/10/9/1556724.png,0,0.972096384,1465,399,2400,1389,935,990,rainbow dash
15588.png,https://derpicdn.net/img/view/2012/6/22/15588.png,0,0.972900152,391,0,931,551,540,551,rainbow dash
1559490.png,https://derpicdn.net/img/view/2017/10/12/1559490.png,0,0.964131057,1143,302,2261,1420,1118,1118,rainbow dash
1559858.png,https://derpicdn.net/img/view/2017/10/13/1559858.png,0,0.986213624,190,161,2914,2600,2724,2439,rainbow dash
1560078.png,https://derpicdn.net/img/view/2017/10/13/1560078.png,0,0.978689492,177,0,1280,1092,1103,1092,rainbow dash
156249.png,https://derpicdn.net/img/view/2012/11/18/156249.png,0,0.99566716,152,10,486,344,334,334,rainbow dash
1563083.png,https://derpicdn.net/img/view/2017/10/16/1563083.png,0,0.966460764,213,193,2877,2857,2664,2664,rainbow dash
1563616.png,https://derpicdn.net/img/view/2017/10/17/1563616.png,0,0.996094704,820,100,2432,1712,1612,1612,rainbow dash
1563772.png,https://derpicdn.net/img/view/2017/10/17/1563772.png,0,0.999365211,325,0,777,422,452,422,rainbow dash
1564284.png,https://derpicdn.net/img/view/2017/10/18/1564284.png,0,0.999358177,1417,0,2453,1011,1036,1011,rainbow dash
1568375.png,https://derpicdn.net/img/view/2017/10/23/1568375.png,0,0.991245329,111,36,1329,1254,1218,1218,rainbow dash
1568378.png,https://derpicdn.net/img/view/2017/10/23/1568378.png,0,0.92157644,658,178,1454,974,796,796,rainbow dash
1568648.png,https://derpicdn.net/img/view/2017/10/23/1568648.png,0,0.996999383,845,0,1831,965,986,965,rainbow dash
1569947.png,https://derpicdn.net/img/view/2017/10/25/1569947.png,0,0.993734181,108,0,590,439,482,439,rainbow dash
1572627.png,https://derpicdn.net/img/view/2017/10/29/1572627.png,0,0.980118036,142,0,612,450,470,450,rainbow dash
1576101.png,https://derpicdn.net/img/view/2017/11/2/1576101.png,0,0.997163177,196,0,574,344,378,344,rainbow dash
1576392.png,https://derpicdn.net/img/view/2017/11/2/1576392.png,0,0.953929603,221,0,1053,816,832,816,rainbow dash
1578940.png,https://derpicdn.net/img/view/2017/11/5/1578940.png,0,0.940902293,480,0,1320,800,840,800,rainbow dash
1584138.png,https://derpicdn.net/img/view/2017/11/12/1584138.png,0,0.995230258,73,0,901,798,828,798,rainbow dash
1584653.png,https://derpicdn.net/img/view/2017/11/12/1584653.png,0,0.994586051,463,85,737,359,274,274,rainbow dash
1584981.png,https://derpicdn.net/img/view/2017/11/12/1584981.png,0,0.996161461,54,0,534,467,480,467,rainbow dash
1588593.png,https://derpicdn.net/img/view/2017/11/17/1588593.png,0,0.994350672,295,0,1143,755,848,755,rainbow dash
1592136.png,https://derpicdn.net/img/view/2017/11/22/1592136.png,0,0.908723593,147,0,689,529,542,529,rainbow dash
1594144.png,https://derpicdn.net/img/view/2017/11/25/1594144.png,0,0.912236989,78,60,906,888,828,828,rainbow dash
1594282.png,https://derpicdn.net/img/view/2017/11/25/1594282.png,0,0.996967912,152,0,980,801,828,801,rainbow dash
1594320.png,https://derpicdn.net/img/view/2017/11/26/1594320.png,0,0.942484677,57,47,597,587,540,540,rainbow dash
1594538.png,https://derpicdn.net/img/view/2017/11/26/1594538.png,0,0.986857414,12,0,538,482,526,482,rainbow dash
1596526.png,https://derpicdn.net/img/view/2017/11/28/1596526.png,0,0.971664906,291,0,727,435,436,435,rainbow dash
1599172.png,https://derpicdn.net/img/view/2017/12/2/1599172.png,0,0.999341547,114,0,716,592,602,592,rainbow dash
1604127.png,https://derpicdn.net/img/view/2017/12/9/1604127.png,0,0.991066098,409,84,697,372,288,288,rainbow dash
1606025.png,https://derpicdn.net/img/view/2017/12/12/1606025.png,0,0.991325617,1791,18,2803,1030,1012,1012,rainbow dash
1606905.png,https://derpicdn.net/img/view/2017/12/13/1606905.png,0,0.966745555,123,0,735,593,612,593,rainbow dash
1607093.png,https://derpicdn.net/img/view/2017/12/13/1607093.png,0,0.974490821,0,0,1677,1930,1677,1930,rainbow dash
1608302.png,https://derpicdn.net/img/view/2017/12/15/1608302.png,0,0.977325797,981,71,1735,825,754,754,rainbow dash
1608305.png,https://derpicdn.net/img/view/2017/12/15/1608305.png,0,0.963068783,1012,73,1806,867,794,794,rainbow dash
1609629.png,https://derpicdn.net/img/view/2017/12/17/1609629.png,0,0.997343302,298,14,940,656,642,642,rainbow dash
1610258.png,https://derpicdn.net/img/view/2017/12/18/1610258.png,0,0.982053995,275,346,819,890,544,544,rainbow dash
1611454.png,https://derpicdn.net/img/view/2017/12/19/1611454.png,0,0.994007111,129,5,371,247,242,242,rainbow dash
1613719.png,https://derpicdn.net/img/view/2017/12/22/1613719.png,0,0.973751128,0,0,431,430,431,430,rainbow dash
1614075.png,https://derpicdn.net/img/view/2017/12/23/1614075.png,0,0.993158996,81,0,761,670,680,670,rainbow dash
1616848.png,https://derpicdn.net/img/view/2017/12/26/1616848.png,0,0.998463631,359,0,976,539,617,539,rainbow dash
1619737.png,https://derpicdn.net/img/view/2017/12/30/1619737.png,0,0.999452293,365,0,961,571,596,571,rainbow dash
1620216.png,https://derpicdn.net/img/view/2017/12/31/1620216.png,0,0.997963488,512,133,1190,811,678,678,rainbow dash
1620843.png,https://derpicdn.net/img/view/2017/12/31/1620843.png,0,0.932761371,369,130,661,422,292,292,rainbow dash
1623564.png,https://derpicdn.net/img/view/2018/1/4/1623564.png,0,0.999132931,1032,40,2014,1022,982,982,rainbow dash
1624970.png,https://derpicdn.net/img/view/2018/1/5/1624970.png,0,0.999011636,307,26,949,668,642,642,rainbow dash
1625198.png,https://derpicdn.net/img/view/2018/1/6/1625198.png,0,0.997583687,601,0,1281,631,680,631,rainbow dash
1626877.png,https://derpicdn.net/img/view/2018/1/8/1626877.png,0,0.997947216,909,59,2799,1949,1890,1890,rainbow dash
1626879.png,https://derpicdn.net/img/view/2018/1/8/1626879.png,0,0.987691462,1647,17,3081,1451,1434,1434,rainbow dash
1627196.png,https://derpicdn.net/img/view/2018/1/8/1627196.png,0,0.995625615,160,0,384,211,224,211,rainbow dash
1628789.png,https://derpicdn.net/img/view/2018/1/10/1628789.png,0,0.989841223,169,0,1321,1125,1152,1125,rainbow dash
1629379.png,https://derpicdn.net/img/view/2018/1/11/1629379.png,0,0.991024852,130,0,2024,1728,1894,1728,rainbow dash
1629380.png,https://derpicdn.net/img/view/2018/1/11/1629380.png,0,0.998188019,905,62,2815,1972,1910,1910,rainbow dash
1629795.png,https://derpicdn.net/img/view/2018/1/11/1629795.png,0,0.994874179,0,58,829,912,829,854,rainbow dash
1634476.png,https://derpicdn.net/img/view/2018/1/17/1634476.png,0,0.991245031,332,149,912,729,580,580,rainbow dash
1634866.png,https://derpicdn.net/img/view/2018/1/18/1634866.png,0,0.995974958,283,0,549,245,266,245,rainbow dash
1634886.png,https://derpicdn.net/img/view/2018/1/18/1634886.png,0,0.973018527,0,27,450,581,450,554,rainbow dash
1637806.png,https://derpicdn.net/img/view/2018/1/21/1637806.png,0,0.992153823,203,37,747,581,544,544,rainbow dash
1637980.png,https://derpicdn.net/img/view/2018/1/22/1637980.png,0,0.998622298,535,0,2057,1476,1522,1476,rainbow dash
1639107.png,https://derpicdn.net/img/view/2018/1/23/1639107.png,0,0.996112287,398,0,1106,708,708,708,rainbow dash
1639109.png,https://derpicdn.net/img/view/2018/1/23/1639109.png,0,0.997166038,394,0,1106,711,712,711,rainbow dash
1640117.png,https://derpicdn.net/img/view/2018/1/24/1640117.png,0,0.988322318,489,0,939,438,450,438,rainbow dash
1640332.png,https://derpicdn.net/img/view/2018/1/25/1640332.png,0,0.982467651,414,18,924,528,510,510,rainbow dash
1643147.png,https://derpicdn.net/img/view/2018/1/28/1643147.png,0,0.977425873,10,5,694,689,684,684,rainbow dash
1645686.png,https://derpicdn.net/img/view/2018/2/1/1645686.png,0,0.993197799,233,18,893,678,660,660,rainbow dash
1646290.png,https://derpicdn.net/img/view/2018/2/1/1646290.png,0,0.999037504,348,0,784,406,436,406,rainbow dash
1646291.png,https://derpicdn.net/img/view/2018/2/1/1646291.png,0,0.993883908,65,0,721,644,656,644,rainbow dash
1646306.png,https://derpicdn.net/img/view/2018/2/1/1646306.png,0,0.99429214,583,0,1055,461,472,461,rainbow dash
1646432.png,https://derpicdn.net/img/view/2018/2/2/1646432.png,0,0.991695881,79,0,2293,1883,2214,1883,rainbow dash
1646753.png,https://derpicdn.net/img/view/2018/2/2/1646753.png,0,0.996084452,71,0,723,636,652,636,rainbow dash
1647670.png,https://derpicdn.net/img/view/2018/2/3/1647670.png,0,0.992967188,58,0,1008,939,950,939,rainbow dash
1648884.png,https://derpicdn.net/img/view/2018/2/5/1648884.png,0,0.953733265,17,0,828,812,811,812,rainbow dash
1652068.png,https://derpicdn.net/img/view/2018/2/9/1652068.png,0,0.9961164,383,0,853,439,470,439,rainbow dash
1652069.png,https://derpicdn.net/img/view/2018/2/9/1652069.png,0,0.99683392,412,0,904,440,492,440,rainbow dash
1652070.png,https://derpicdn.net/img/view/2018/2/9/1652070.png,0,0.993752122,14,0,468,414,454,414,rainbow dash
1654845.png,https://derpicdn.net/img/view/2018/2/13/1654845.png,0,0.996274054,180,0,1164,975,984,975,rainbow dash
1656045.png,https://derpicdn.net/img/view/2018/2/14/1656045.png,0,0.964727521,430,71,1336,977,906,906,rainbow dash
1657391.png,https://derpicdn.net/img/view/2018/2/16/1657391.png,0,0.979538143,238,0,3346,3068,3108,3068,rainbow dash
1657850.png,https://derpicdn.net/img/view/2018/2/17/1657850.png,0,0.963044524,470,119,2806,2455,2336,2336,rainbow dash
1658766.png,https://derpicdn.net/img/view/2018/2/18/1658766.png,0,0.983486116,175,0,1411,1111,1236,1111,rainbow dash
1660036.png,https://derpicdn.net/img/view/2018/2/19/1660036.png,0,0.998980641,666,0,2476,1795,1810,1795,rainbow dash
1664633.png,https://derpicdn.net/img/view/2018/2/24/1664633.png,0,0.987169266,0,377,1009,1397,1009,1020,rainbow dash
1666048.png,https://derpicdn.net/img/view/2018/2/26/1666048.png,0,0.999830842,2303,76,4089,1862,1786,1786,rainbow dash
1671822.png,https://derpicdn.net/img/view/2018/3/4/1671822.png,0,0.995911181,210,90,1152,1032,942,942,rainbow dash
1673237.png,https://derpicdn.net/img/view/2018/3/6/1673237.png,0,0.999297142,167,0,707,540,540,540,rainbow dash
1674310.png,https://derpicdn.net/img/view/2018/3/8/1674310.png,1,0.991466284,1,256,269,524,268,268,rainbow dash
1674310.png,https://derpicdn.net/img/view/2018/3/8/1674310.png,2,0.989589751,1206,0,1476,264,270,264,rainbow dash
1674310.png,https://derpicdn.net/img/view/2018/3/8/1674310.png,3,0.988237441,909,495,1195,768,286,273,rainbow dash
1674310.png,https://derpicdn.net/img/view/2018/3/8/1674310.png,4,0.988088846,300,240,580,520,280,280,rainbow dash
1674310.png,https://derpicdn.net/img/view/2018/3/8/1674310.png,5,0.976917028,286,500,566,768,280,268,rainbow dash
1674310.png,https://derpicdn.net/img/view/2018/3/8/1674310.png,6,0.974263728,0,498,275,768,275,270,rainbow dash
1674310.png,https://derpicdn.net/img/view/2018/3/8/1674310.png,7,0.95069927,609,9,857,257,248,248,rainbow dash
1674310.png,https://derpicdn.net/img/view/2018/3/8/1674310.png,8,0.906909466,909,0,1187,266,278,266,rainbow dash
1675970.png,https://derpicdn.net/img/view/2018/3/10/1675970.png,0,0.984147966,40,0,728,671,688,671,rainbow dash
1677557.png,https://derpicdn.net/img/view/2018/3/11/1677557.png,0,0.993106782,1430,689,2172,1431,742,742,rainbow dash
1677631.png,https://derpicdn.net/img/view/2018/3/11/1677631.png,0,0.997332036,557,27,1650,1147,1093,1120,rainbow dash
1679041.png,https://derpicdn.net/img/view/2018/3/13/1679041.png,0,0.983730853,0,0,1988,1986,1988,1986,rainbow dash
1679205.png,https://derpicdn.net/img/view/2018/3/13/1679205.png,0,0.999609411,631,0,1309,643,678,643,rainbow dash
1680400.png,https://derpicdn.net/img/view/2018/3/14/1680400.png,0,0.987560749,159,0,1043,844,884,844,rainbow dash
1681821.png,https://derpicdn.net/img/view/2018/3/16/1681821.png,0,0.998804092,272,21,926,675,654,654,rainbow dash
1683677.png,https://derpicdn.net/img/view/2018/3/18/1683677.png,0,0.999612689,344,32,878,566,534,534,rainbow dash
1684552.png,https://derpicdn.net/img/view/2018/3/19/1684552.png,0,0.999351323,707,74,2241,1608,1534,1534,rainbow dash
1684557.png,https://derpicdn.net/img/view/2018/3/19/1684557.png,0,0.996399224,887,0,2587,1611,1700,1611,rainbow dash
1685931.png,https://derpicdn.net/img/view/2018/3/20/1685931.png,0,0.99438554,343,5,751,413,408,408,rainbow dash
1686979.png,https://derpicdn.net/img/view/2018/3/21/1686979.png,0,0.966256857,324,0,754,398,430,398,rainbow dash
1688298.png,https://derpicdn.net/img/view/2018/3/23/1688298.png,0,0.997978806,0,19,1065,1177,1065,1158,rainbow dash
1689638.png,https://derpicdn.net/img/view/2018/3/24/1689638.png,0,0.98471415,44,76,840,872,796,796,rainbow dash
1691309.png,https://derpicdn.net/img/view/2018/3/26/1691309.png,0,0.914172232,97,0,421,313,324,313,rainbow dash
1692548.png,https://derpicdn.net/img/view/2018/3/27/1692548.png,0,0.996982694,459,1,1461,1003,1002,1002,rainbow dash
1692579.png,https://derpicdn.net/img/view/2018/3/28/1692579.png,0,0.979359329,147,0,1280,1107,1133,1107,rainbow dash
1693393.png,https://derpicdn.net/img/view/2018/3/29/1693393.png,0,0.991519272,184,93,1738,1647,1554,1554,rainbow dash
1694469.png,https://derpicdn.net/img/view/2018/3/30/1694469.png,0,0.997764945,429,0,1061,621,632,621,rainbow dash
1694662.png,https://derpicdn.net/img/view/2018/3/30/1694662.png,0,0.991344512,924,0,1524,474,600,474,rainbow dash
1695196.png,https://derpicdn.net/img/view/2018/3/31/1695196.png,0,0.998972595,142,0,994,777,852,777,rainbow dash
1696227.png,https://derpicdn.net/img/view/2018/4/1/1696227.png,0,0.999017239,78,0,728,648,650,648,rainbow dash
1696765.png,https://derpicdn.net/img/view/2018/4/1/1696765.png,0,0.965106606,634,0,2020,1304,1386,1304,rainbow dash
1698810.png,https://derpicdn.net/img/view/2018/4/4/1698810.png,0,0.997941673,610,0,1414,699,804,699,rainbow dash
1701002.png,https://derpicdn.net/img/view/2018/4/6/1701002.png,0,0.965072155,0,0,793,825,793,825,rainbow dash
1701600.png,https://derpicdn.net/img/view/2018/4/7/1701600.png,0,0.999357283,75,55,1001,981,926,926,rainbow dash
1702362.png,https://derpicdn.net/img/view/2018/4/8/1702362.png,0,0.986950815,63,0,563,484,500,484,rainbow dash
1703936.png,https://derpicdn.net/img/view/2018/4/10/1703936.png,0,0.937470496,794,0,2244,1373,1450,1373,rainbow dash
1709864.png,https://derpicdn.net/img/view/2018/4/17/1709864.png,0,0.953719795,1351,0,5446,4491,4095,4491,rainbow dash
1711332.png,https://derpicdn.net/img/view/2018/4/19/1711332.png,0,0.999020994,1648,21,2970,1343,1322,1322,rainbow dash
1711841.png,https://derpicdn.net/img/view/2018/4/19/1711841.png,0,0.993563831,107,2,611,506,504,504,rainbow dash
1715689.png,https://derpicdn.net/img/view/2018/4/24/1715689.png,0,0.989282727,34,160,588,714,554,554,rainbow dash
1717429.png,https://derpicdn.net/img/view/2018/4/26/1717429.png,0,0.999441445,433,0,1951,1483,1518,1483,rainbow dash
1718933.png,https://derpicdn.net/img/view/2018/4/28/1718933.png,0,0.991509676,453,4,1991,1542,1538,1538,rainbow dash
1723054.png,https://derpicdn.net/img/view/2018/5/3/1723054.png,0,0.998934448,36,0,784,708,748,708,rainbow dash
1723477.png,https://derpicdn.net/img/view/2018/5/3/1723477.png,0,0.996696532,532,0,1740,1007,1208,1007,rainbow dash
1725084.png,https://derpicdn.net/img/view/2018/5/5/1725084.png,0,0.999238014,907,118,2129,1340,1222,1222,rainbow dash
1725958.png,https://derpicdn.net/img/view/2018/5/6/1725958.png,0,0.996713519,781,121,1327,667,546,546,rainbow dash
1726317.png,https://derpicdn.net/img/view/2018/5/6/1726317.png,0,0.973905385,377,0,2681,2436,2304,2436,rainbow dash
1727234.png,https://derpicdn.net/img/view/2018/5/8/1727234.png,0,0.992270708,218,76,1952,1810,1734,1734,rainbow dash
1727514.png,https://derpicdn.net/img/view/2018/5/8/1727514.png,0,0.997592151,177,0,551,371,374,371,rainbow dash
1729552.png,https://derpicdn.net/img/view/2018/5/10/1729552.png,0,0.984146297,2868,902,3855,1926,987,1024,rainbow dash
1731891.png,https://derpicdn.net/img/view/2018/5/13/1731891.png,0,0.953667939,554,114,1196,756,642,642,rainbow dash
1733054.png,https://derpicdn.net/img/view/2018/5/15/1733054.png,0,0.999159396,34,0,782,709,748,709,rainbow dash
1738527.png,https://derpicdn.net/img/view/2018/5/21/1738527.png,0,0.952289939,524,0,2314,1444,1790,1444,rainbow dash
1743418.png,https://derpicdn.net/img/view/2018/5/28/1743418.png,0,0.962716162,512,483,984,955,472,472,rainbow dash
1744168.png,https://derpicdn.net/img/view/2018/5/29/1744168.png,0,0.994448185,255,0,2475,2087,2220,2087,rainbow dash
1744227.png,https://derpicdn.net/img/view/2018/5/29/1744227.png,0,0.909281373,530,269,2466,2205,1936,1936,rainbow dash
1745716.png,https://derpicdn.net/img/view/2018/5/31/1745716.png,0,0.999031186,313,139,683,509,370,370,rainbow dash
1746895.png,https://derpicdn.net/img/view/2018/6/1/1746895.png,0,0.998371005,274,46,990,762,716,716,rainbow dash
1746897.png,https://derpicdn.net/img/view/2018/6/1/1746897.png,0,0.930268228,3292,1925,4662,3295,1370,1370,rainbow dash
1747008.png,https://derpicdn.net/img/view/2018/6/1/1747008.png,0,0.995523453,1488,565,2140,1217,652,652,rainbow dash
1747440.png,https://derpicdn.net/img/view/2018/6/2/1747440.png,0,0.988955796,1389,17,2001,629,612,612,rainbow dash
1747440.png,https://derpicdn.net/img/view/2018/6/2/1747440.png,1,0.963178098,0,765,759,1527,759,762,rainbow dash
1750075.png,https://derpicdn.net/img/view/2018/6/4/1750075.png,0,0.999360561,95,0,761,662,666,662,rainbow dash
1755380.png,https://derpicdn.net/img/view/2018/6/11/1755380.png,0,0.988550663,169,0,433,242,264,242,rainbow dash
1759249.png,https://derpicdn.net/img/view/2018/6/16/1759249.png,0,0.998635292,446,0,1358,871,912,871,rainbow dash
1760204.png,https://derpicdn.net/img/view/2018/6/18/1760204.png,0,0.929837167,112,12,480,380,368,368,rainbow dash
1760226.png,https://derpicdn.net/img/view/2018/6/18/1760226.png,0,0.958850384,391,56,977,642,586,586,rainbow dash
1760249.png,https://derpicdn.net/img/view/2018/6/18/1760249.png,0,0.9896276,2,0,702,664,700,664,rainbow dash
1760973.png,https://derpicdn.net/img/view/2018/6/19/1760973.png,0,0.993114412,82,0,1242,1154,1160,1154,rainbow dash
1761475.png,https://derpicdn.net/img/view/2018/6/19/1761475.png,0,0.997634649,81,65,831,815,750,750,rainbow dash
1761752.png,https://derpicdn.net/img/view/2018/6/20/1761752.png,0,0.998746991,485,0,1889,1366,1404,1366,rainbow dash
1762808.png,https://derpicdn.net/img/view/2018/6/21/1762808.png,0,0.999844909,0,0,1285,1248,1285,1248,rainbow dash
1762808.png,https://derpicdn.net/img/view/2018/6/21/1762808.png,1,0.997585595,0,1086,1250,2342,1250,1256,rainbow dash
1764185.png,https://derpicdn.net/img/view/2018/6/23/1764185.png,0,0.986438453,434,0,1348,793,914,793,rainbow dash
1765376.png,https://derpicdn.net/img/view/2018/6/25/1765376.png,0,0.999202847,438,35,2052,1649,1614,1614,rainbow dash
1765377.png,https://derpicdn.net/img/view/2018/6/25/1765377.png,0,0.973778844,209,37,1143,971,934,934,rainbow dash
1766587.png,https://derpicdn.net/img/view/2018/6/26/1766587.png,0,0.984827459,19,117,859,957,840,840,rainbow dash
1769520.png,https://derpicdn.net/img/view/2018/6/30/1769520.png,0,0.999221861,1105,0,2000,883,895,883,rainbow dash
1771893.png,https://derpicdn.net/img/view/2018/7/3/1771893.png,0,0.967874467,214,0,740,498,526,498,rainbow dash
1776643.png,https://derpicdn.net/img/view/2018/7/9/1776643.png,0,0.986756802,477,202,1929,1654,1452,1452,rainbow dash
1777883.png,https://derpicdn.net/img/view/2018/7/10/1777883.png,0,0.980302095,0,140,749,900,749,760,rainbow dash
1777883.png,https://derpicdn.net/img/view/2018/7/10/1777883.png,1,0.960985124,158,20,900,770,742,750,rainbow dash
1779964.png,https://derpicdn.net/img/view/2018/7/13/1779964.png,0,0.9903391,1172,3383,2536,4747,1364,1364,rainbow dash
1782714.png,https://derpicdn.net/img/view/2018/7/17/1782714.png,0,0.999286413,557,0,1043,465,486,465,rainbow dash
1788231.png,https://derpicdn.net/img/view/2018/7/24/1788231.png,0,0.988086998,733,59,2009,1335,1276,1276,rainbow dash
1791722.png,https://derpicdn.net/img/view/2018/7/28/1791722.png,0,0.987046003,0,0,806,840,806,840,rainbow dash
1792379.png,https://derpicdn.net/img/view/2018/7/29/1792379.png,0,0.990053117,32,0,356,297,324,297,rainbow dash
1792379.png,https://derpicdn.net/img/view/2018/7/29/1792379.png,1,0.928348541,0,51,319,391,319,340,rainbow dash
1793909.png,https://derpicdn.net/img/view/2018/7/31/1793909.png,0,0.94087863,831,210,2405,1784,1574,1574,rainbow dash
1794141.png,https://derpicdn.net/img/view/2018/7/31/1794141.png,0,0.992784142,0,0,1697,1721,1697,1721,rainbow dash
1794405.png,https://derpicdn.net/img/view/2018/7/31/1794405.png,0,0.984577477,0,0,215,224,215,224,rainbow dash
1795865.png,https://derpicdn.net/img/view/2018/8/2/1795865.png,0,0.982500732,941,0,2235,1046,1294,1046,rainbow dash
1796283.png,https://derpicdn.net/img/view/2018/8/2/1796283.png,0,0.998891711,245,10,603,368,358,358,rainbow dash
1796978.png,https://derpicdn.net/img/view/2018/8/3/1796978.png,0,0.999161482,687,204,2529,2046,1842,1842,rainbow dash
1798606.png,https://derpicdn.net/img/view/2018/8/5/1798606.png,0,0.997825027,1005,0,2019,969,1014,969,rainbow dash
1798606.png,https://derpicdn.net/img/view/2018/8/5/1798606.png,1,0.995196104,290,669,1134,1513,844,844,rainbow dash
1798997.png,https://derpicdn.net/img/view/2018/8/5/1798997.png,0,0.998205185,1857,7,3213,1363,1356,1356,rainbow dash
1801407.png,https://derpicdn.net/img/view/2018/8/8/1801407.png,0,0.982141614,647,171,1117,641,470,470,rainbow dash
1801538.png,https://derpicdn.net/img/view/2018/8/8/1801538.png,0,0.992989182,855,32,1501,678,646,646,rainbow dash
1805251.png,https://derpicdn.net/img/view/2018/8/12/1805251.png,0,0.979165554,72,0,1024,1008,952,1008,rainbow dash
180880.png,https://derpicdn.net/img/view/2012/12/12/180880.png,0,0.996967018,234,0,682,426,448,426,rainbow dash
1811887.png,https://derpicdn.net/img/view/2018/8/20/1811887.png,0,0.970954001,381,44,1863,1526,1482,1482,rainbow dash
1813308.png,https://derpicdn.net/img/view/2018/8/22/1813308.png,0,0.998750985,222,47,1082,907,860,860,rainbow dash
1818821.png,https://derpicdn.net/img/view/2018/8/28/1818821.png,0,0.985992372,377,45,635,303,258,258,rainbow dash
1824536.png,https://derpicdn.net/img/view/2018/9/4/1824536.png,0,0.993043542,59,4,573,518,514,514,rainbow dash
1824936.png,https://derpicdn.net/img/view/2018/9/4/1824936.png,0,0.981791615,456,0,1938,1314,1482,1314,rainbow dash
1827011.png,https://derpicdn.net/img/view/2018/9/7/1827011.png,0,0.994113445,477,0,1135,639,658,639,rainbow dash
1827500.png,https://derpicdn.net/img/view/2018/9/8/1827500.png,0,0.999675632,245,16,733,504,488,488,rainbow dash
1827585.png,https://derpicdn.net/img/view/2018/9/8/1827585.png,0,0.998860836,1242,13,2576,1347,1334,1334,rainbow dash
1833986.png,https://derpicdn.net/img/view/2018/9/16/1833986.png,0,0.998912215,702,8,1164,510,462,502,rainbow dash
1837448.png,https://derpicdn.net/img/view/2018/9/21/1837448.png,0,0.908512592,112,18,1008,914,896,896,rainbow dash
1841374.png,https://derpicdn.net/img/view/2018/9/25/1841374.png,0,0.975192189,25,28,635,638,610,610,rainbow dash
1841458.png,https://derpicdn.net/img/view/2018/9/26/1841458.png,0,0.997127414,14,3,328,317,314,314,rainbow dash
1841723.png,https://derpicdn.net/img/view/2018/9/26/1841723.png,0,0.998369575,0,56,658,718,658,662,rainbow dash
1842807.png,https://derpicdn.net/img/view/2018/9/27/1842807.png,0,0.998317182,460,5,1194,739,734,734,rainbow dash
1846340.png,https://derpicdn.net/img/view/2018/10/2/1846340.png,0,0.992350757,421,77,2319,1975,1898,1898,rainbow dash
1846580.png,https://derpicdn.net/img/view/2018/10/2/1846580.png,0,0.998678863,495,0,2127,1403,1632,1403,rainbow dash
1847180.png,https://derpicdn.net/img/view/2018/10/3/1847180.png,0,0.971359432,162,53,552,443,390,390,rainbow dash
1851697.png,https://derpicdn.net/img/view/2018/10/8/1851697.png,0,0.993638575,941,0,2915,1812,1974,1812,rainbow dash
1854451.png,https://derpicdn.net/img/view/2018/10/12/1854451.png,0,0.988878429,1301,2609,3099,4407,1798,1798,rainbow dash
1855639.png,https://derpicdn.net/img/view/2018/10/13/1855639.png,0,0.961399257,502,70,1320,888,818,818,rainbow dash
1858323.png,https://derpicdn.net/img/view/2018/10/16/1858323.png,0,0.963877738,526,0,2118,1251,1592,1251,rainbow dash
1861041.png,https://derpicdn.net/img/view/2018/10/20/1861041.png,0,0.977214575,50,0,762,666,712,666,rainbow dash
1861276.png,https://derpicdn.net/img/view/2018/10/20/1861276.png,0,0.978445709,106,151,1882,1927,1776,1776,rainbow dash
1864298.png,https://derpicdn.net/img/view/2018/10/23/1864298.png,0,0.995106399,0,0,2630,2712,2630,2712,rainbow dash
1871434.png,https://derpicdn.net/img/view/2018/10/31/1871434.png,0,0.996634364,539,186,761,408,222,222,rainbow dash
1871434.png,https://derpicdn.net/img/view/2018/10/31/1871434.png,1,0.983842194,81,406,301,626,220,220,rainbow dash
1872050.png,https://derpicdn.net/img/view/2018/11/1/1872050.png,0,0.998947799,822,29,1510,717,688,688,rainbow dash
1876262.png,https://derpicdn.net/img/view/2018/11/6/1876262.png,0,0.995190203,101,0,493,385,392,385,rainbow dash
1877386.png,https://derpicdn.net/img/view/2018/11/7/1877386.png,0,0.992898881,610,62,1952,1404,1342,1342,rainbow dash
1882514.png,https://derpicdn.net/img/view/2018/11/15/1882514.png,0,0.997838497,753,2,1609,858,856,856,rainbow dash
1882531.png,https://derpicdn.net/img/view/2018/11/15/1882531.png,0,0.93653512,55,0,405,341,350,341,rainbow dash
188436.png,https://derpicdn.net/img/view/2012/12/20/188436.png,0,0.963014901,221,0,731,503,510,503,rainbow dash
1884837.png,https://derpicdn.net/img/view/2018/11/18/1884837.png,0,0.999481916,896,0,1800,820,904,820,rainbow dash
1890077.png,https://derpicdn.net/img/view/2018/11/24/1890077.png,0,0.997889102,0,0,2625,2603,2625,2603,rainbow dash
1892479.png,https://derpicdn.net/img/view/2018/11/27/1892479.png,0,0.995304108,1100,0,2878,1714,1778,1714,rainbow dash
1892880.png,https://derpicdn.net/img/view/2018/11/28/1892880.png,0,0.998018563,183,0,545,342,362,342,rainbow dash
1893560.png,https://derpicdn.net/img/view/2018/11/29/1893560.png,0,0.93637991,215,364,1721,1870,1506,1506,rainbow dash
1895886.png,https://derpicdn.net/img/view/2018/12/2/1895886.png,0,0.942926645,270,157,954,841,684,684,rainbow dash
1895909.png,https://derpicdn.net/img/view/2018/12/2/1895909.png,0,0.993688405,574,0,2016,1415,1442,1415,rainbow dash
1896516.png,https://derpicdn.net/img/view/2018/12/2/1896516.png,0,0.992696822,90,0,626,508,536,508,rainbow dash
1896542.png,https://derpicdn.net/img/view/2018/12/2/1896542.png,0,0.99466759,435,0,1519,956,1084,956,rainbow dash
1904778.png,https://derpicdn.net/img/view/2018/12/10/1904778.png,0,0.99923563,2885,843,3417,1375,532,532,rainbow dash
1904778.png,https://derpicdn.net/img/view/2018/12/10/1904778.png,1,0.994257331,594,797,1310,1513,716,716,rainbow dash
1904778.png,https://derpicdn.net/img/view/2018/12/10/1904778.png,2,0.982029378,0,783,734,1525,734,742,rainbow dash
1904778.png,https://derpicdn.net/img/view/2018/12/10/1904778.png,3,0.980475605,2195,812,2729,1346,534,534,rainbow dash
1904921.png,https://derpicdn.net/img/view/2018/12/10/1904921.png,0,0.958346665,446,0,862,372,416,372,rainbow dash
1904950.png,https://derpicdn.net/img/view/2018/12/11/1904950.png,0,0.986339509,638,281,2082,1725,1444,1444,rainbow dash
1906495.png,https://derpicdn.net/img/view/2018/12/12/1906495.png,0,0.993239164,144,77,1414,1347,1270,1270,rainbow dash
1906589.png,https://derpicdn.net/img/view/2018/12/12/1906589.png,0,0.999357224,128,0,724,508,596,508,rainbow dash
1906590.png,https://derpicdn.net/img/view/2018/12/12/1906590.png,0,0.999273658,126,0,728,509,602,509,rainbow dash
1906935.png,https://derpicdn.net/img/view/2018/12/13/1906935.png,0,0.999135971,677,0,1537,832,860,832,rainbow dash
1907260.png,https://derpicdn.net/img/view/2018/12/13/1907260.png,0,0.994572997,106,0,914,725,808,725,rainbow dash
1911353.png,https://derpicdn.net/img/view/2018/12/17/1911353.png,0,0.982280076,797,122,2023,1348,1226,1226,rainbow dash
1913109.png,https://derpicdn.net/img/view/2018/12/19/1913109.png,0,0.999429524,7,22,859,874,852,852,rainbow dash
1913912.png,https://derpicdn.net/img/view/2018/12/20/1913912.png,0,0.983161449,0,142,1359,1554,1359,1412,rainbow dash
1917668.png,https://derpicdn.net/img/view/2018/12/24/1917668.png,0,0.955476344,52,0,344,268,292,268,rainbow dash
1917717.png,https://derpicdn.net/img/view/2018/12/24/1917717.png,0,0.986438215,493,0,2831,2178,2338,2178,rainbow dash
1919717.png,https://derpicdn.net/img/view/2018/12/27/1919717.png,0,0.96368897,76,3,956,883,880,880,rainbow dash
1920068.png,https://derpicdn.net/img/view/2018/12/27/1920068.png,0,0.99657923,126,50,1776,1700,1650,1650,rainbow dash
1922647.png,https://derpicdn.net/img/view/2018/12/31/1922647.png,0,0.979510188,337,20,881,564,544,544,rainbow dash
1924059.png,https://derpicdn.net/img/view/2019/1/1/1924059.png,0,0.996577621,569,0,1117,521,548,521,rainbow dash
1924130.png,https://derpicdn.net/img/view/2019/1/1/1924130.png,0,0.991623104,381,40,959,618,578,578,rainbow dash
1924350.png,https://derpicdn.net/img/view/2019/1/1/1924350.png,0,0.980944455,81,0,1263,1141,1182,1141,rainbow dash
192897.png,https://derpicdn.net/img/view/2012/12/25/192897.png,0,0.997282147,287,0,783,470,496,470,rainbow dash
1929440.png,https://derpicdn.net/img/view/2019/1/8/1929440.png,0,0.995422959,134,36,582,484,448,448,rainbow dash
1929510.png,https://derpicdn.net/img/view/2019/1/8/1929510.png,0,0.967801511,1965,0,5987,3769,4022,3769,rainbow dash
1932698.png,https://derpicdn.net/img/view/2019/1/12/1932698.png,0,0.998747945,2914,0,6120,3026,3206,3026,rainbow dash
1932845.png,https://derpicdn.net/img/view/2019/1/12/1932845.png,0,0.995572925,799,0,2500,1573,1701,1573,rainbow dash
1941097.png,https://derpicdn.net/img/view/2019/1/21/1941097.png,0,0.982511938,698,0,1384,536,686,536,rainbow dash
1941098.png,https://derpicdn.net/img/view/2019/1/21/1941098.png,0,0.972890258,34,0,514,451,480,451,rainbow dash
1941099.png,https://derpicdn.net/img/view/2019/1/21/1941099.png,0,0.969484031,95,0,649,479,554,479,rainbow dash
1941755.png,https://derpicdn.net/img/view/2019/1/22/1941755.png,0,0.97160393,99,101,1459,1461,1360,1360,rainbow dash
1944303.png,https://derpicdn.net/img/view/2019/1/25/1944303.png,0,0.998709023,560,0,1716,1113,1156,1113,rainbow dash
1948761.png,https://derpicdn.net/img/view/2019/1/30/1948761.png,0,0.99161768,264,0,514,248,250,248,rainbow dash
1949219.png,https://derpicdn.net/img/view/2019/1/31/1949219.png,0,0.962696731,191,110,1000,1000,809,890,rainbow dash
1949222.png,https://derpicdn.net/img/view/2019/1/31/1949222.png,0,0.981858611,203,67,1409,1273,1206,1206,rainbow dash
1949800.png,https://derpicdn.net/img/view/2019/1/31/1949800.png,0,0.999118865,1432,13,2624,1205,1192,1192,rainbow dash
1950747.png,https://derpicdn.net/img/view/2019/2/2/1950747.png,0,0.995069087,240,0,656,387,416,387,rainbow dash
1952825.png,https://derpicdn.net/img/view/2019/2/4/1952825.png,0,0.970227242,0,141,581,755,581,614,rainbow dash
1952979.png,https://derpicdn.net/img/view/2019/2/4/1952979.png,0,0.985242248,36,0,1722,1734,1686,1734,rainbow dash
1953138.png,https://derpicdn.net/img/view/2019/2/4/1953138.png,0,0.996088803,1165,0,2421,1184,1256,1184,rainbow dash
1955807.png,https://derpicdn.net/img/view/2019/2/7/1955807.png,0,0.999782503,998,0,1852,772,854,772,rainbow dash
1955807.png,https://derpicdn.net/img/view/2019/2/7/1955807.png,1,0.996159077,82,145,844,907,762,762,rainbow dash
1959248.png,https://derpicdn.net/img/view/2019/2/11/1959248.png,0,0.999163985,657,0,2249,1556,1592,1556,rainbow dash
1959636.png,https://derpicdn.net/img/view/2019/2/11/1959636.png,0,0.999804258,2982,0,5364,2315,2382,2315,rainbow dash
1960529.png,https://derpicdn.net/img/view/2019/2/13/1960529.png,0,0.999445617,955,110,2359,1514,1404,1404,rainbow dash
1960856.png,https://derpicdn.net/img/view/2019/2/13/1960856.png,0,0.980824113,132,0,838,706,706,706,rainbow dash
1965375.png,https://derpicdn.net/img/view/2019/2/18/1965375.png,0,0.984320819,0,26,693,748,693,722,rainbow dash
1969543.png,https://derpicdn.net/img/view/2019/2/23/1969543.png,0,0.989571691,39,20,591,572,552,552,rainbow dash
1969593.png,https://derpicdn.net/img/view/2019/2/23/1969593.png,0,0.957867324,427,191,1045,809,618,618,rainbow dash
1974546.png,https://derpicdn.net/img/view/2019/3/1/1974546.png,0,0.985078275,490,0,4518,3716,4028,3716,rainbow dash
1978855.png,https://derpicdn.net/img/view/2019/3/6/1978855.png,0,0.99785316,1216,0,2836,1584,1620,1584,rainbow dash
1979857.png,https://derpicdn.net/img/view/2019/3/7/1979857.png,0,0.992794991,786,8,1424,646,638,638,rainbow dash
1980394.png,https://derpicdn.net/img/view/2019/3/8/1980394.png,0,0.99664104,615,0,1363,732,748,732,rainbow dash
1984464.png,https://derpicdn.net/img/view/2019/3/13/1984464.png,0,0.983673155,416,94,1344,1022,928,928,rainbow dash
1985618.png,https://derpicdn.net/img/view/2019/3/14/1985618.png,0,0.997418642,256,0,720,419,464,419,rainbow dash
1989393.png,https://derpicdn.net/img/view/2019/3/18/1989393.png,0,0.951794505,430,114,1324,1008,894,894,rainbow dash
1990895.png,https://derpicdn.net/img/view/2019/3/20/1990895.png,0,0.994418681,452,221,1260,1029,808,808,rainbow dash
1990904.png,https://derpicdn.net/img/view/2019/3/20/1990904.png,0,0.90943253,364,180,586,402,222,222,rainbow dash
1990908.png,https://derpicdn.net/img/view/2019/3/20/1990908.png,0,0.985493362,831,61,2273,1503,1442,1442,rainbow dash
1992962.png,https://derpicdn.net/img/view/2019/3/23/1992962.png,0,0.931753397,494,116,740,362,246,246,rainbow dash
1994348.png,https://derpicdn.net/img/view/2019/3/25/1994348.png,0,0.999219656,329,43,883,597,554,554,rainbow dash
1995117.png,https://derpicdn.net/img/view/2019/3/26/1995117.png,0,0.999062419,306,216,1452,1362,1146,1146,rainbow dash
1995519.png,https://derpicdn.net/img/view/2019/3/26/1995519.png,0,0.998266757,1904,4,2526,626,622,622,rainbow dash
1995519.png,https://derpicdn.net/img/view/2019/3/26/1995519.png,1,0.997432649,496,64,1078,646,582,582,rainbow dash
1996328.png,https://derpicdn.net/img/view/2019/3/27/1996328.png,0,0.990623474,92,0,4418,3816,4326,3816,rainbow dash
1997558.png,https://derpicdn.net/img/view/2019/3/29/1997558.png,0,0.965062261,20,0,1080,1115,1060,1115,rainbow dash
1997799.png,https://derpicdn.net/img/view/2019/3/29/1997799.png,0,0.957700908,0,0,1744,1640,1744,1640,rainbow dash
1997819.png,https://derpicdn.net/img/view/2019/3/29/1997819.png,0,0.999052942,306,216,1452,1362,1146,1146,rainbow dash
1998622.png,https://derpicdn.net/img/view/2019/3/30/1998622.png,0,0.954587519,294,205,600,519,306,314,rainbow dash
2000000.png,https://derpicdn.net/img/view/2019/4/1/2000000.png,0,0.991761208,255,23,639,407,384,384,rainbow dash
2000330.png,https://derpicdn.net/img/view/2019/4/1/2000330.png,0,0.900183022,204,226,3500,4032,3296,3806,rainbow dash
2001354.png,https://derpicdn.net/img/view/2019/4/2/2001354.png,0,0.99721998,768,0,1774,957,1006,957,rainbow dash
2008742.png,https://derpicdn.net/img/view/2019/4/11/2008742.png,0,0.995337367,447,1140,1281,1974,834,834,rainbow dash
2015500.png,https://derpicdn.net/img/view/2019/4/18/2015500.png,0,0.99885577,0,0,547,536,547,536,rainbow dash
2017245.png,https://derpicdn.net/img/view/2019/4/20/2017245.png,0,0.998207271,1103,0,2351,1218,1248,1218,rainbow dash
2018081.png,https://derpicdn.net/img/view/2019/4/20/2018081.png,0,0.985215902,66,0,696,555,630,555,rainbow dash
2020177.png,https://derpicdn.net/img/view/2019/4/22/2020177.png,0,0.969400704,372,235,846,709,474,474,rainbow dash
2021439.png,https://derpicdn.net/img/view/2019/4/24/2021439.png,0,0.9840343,391,0,1191,765,800,765,rainbow dash
2021758.png,https://derpicdn.net/img/view/2019/4/24/2021758.png,0,0.983662188,61,536,1321,1796,1260,1260,rainbow dash
2022210.png,https://derpicdn.net/img/view/2019/4/24/2022210.png,0,0.997718453,99,23,847,771,748,748,rainbow dash
2028446.png,https://derpicdn.net/img/view/2019/5/1/2028446.png,0,0.927335382,126,0,2744,2300,2618,2300,rainbow dash
2033508.png,https://derpicdn.net/img/view/2019/5/7/2033508.png,0,0.996610045,837,116,1673,952,836,836,rainbow dash
2035029.png,https://derpicdn.net/img/view/2019/5/9/2035029.png,0,0.991485059,481,0,2550,2060,2069,2060,rainbow dash
2035688.png,https://derpicdn.net/img/view/2019/5/10/2035688.png,0,0.993253589,310,0,966,593,656,593,rainbow dash
2035690.png,https://derpicdn.net/img/view/2019/5/10/2035690.png,0,0.980212033,316,67,796,547,480,480,rainbow dash
2038099.png,https://derpicdn.net/img/view/2019/5/13/2038099.png,0,0.983596802,518,704,826,1012,308,308,rainbow dash
2039339.png,https://derpicdn.net/img/view/2019/5/15/2039339.png,0,0.995085895,1312,0,2126,798,814,798,rainbow dash
2045266.png,https://derpicdn.net/img/view/2019/5/21/2045266.png,0,0.998440623,403,145,2145,1887,1742,1742,rainbow dash
2046715.png,https://derpicdn.net/img/view/2019/5/23/2046715.png,0,0.999479413,1044,64,2266,1286,1222,1222,rainbow dash
2047957.png,https://derpicdn.net/img/view/2019/5/24/2047957.png,0,0.999336898,1169,22,2153,1006,984,984,rainbow dash
2049623.png,https://derpicdn.net/img/view/2019/5/26/2049623.png,0,0.959995329,225,0,937,709,712,709,rainbow dash
2050713.png,https://derpicdn.net/img/view/2019/5/27/2050713.png,0,0.948313534,816,109,1524,817,708,708,rainbow dash
2051761.png,https://derpicdn.net/img/view/2019/5/28/2051761.png,0,0.978581846,5,0,880,852,875,852,rainbow dash
2052131.png,https://derpicdn.net/img/view/2019/5/29/2052131.png,0,0.99955529,2671,0,6237,2946,3566,2946,rainbow dash
2056079.png,https://derpicdn.net/img/view/2019/6/2/2056079.png,0,0.971691728,0,0,821,811,821,811,rainbow dash
2057945.png,https://derpicdn.net/img/view/2019/6/4/2057945.png,0,0.956422925,891,247,1941,1297,1050,1050,rainbow dash
2060159.png,https://derpicdn.net/img/view/2019/6/7/2060159.png,0,0.99620682,555,0,1407,766,852,766,rainbow dash
2061978.png,https://derpicdn.net/img/view/2019/6/10/2061978.png,0,0.985140562,436,205,976,745,540,540,rainbow dash
2063000.png,https://derpicdn.net/img/view/2019/6/11/2063000.png,0,0.992022336,269,0,545,263,276,263,rainbow dash
2063096.png,https://derpicdn.net/img/view/2019/6/11/2063096.png,0,0.973321676,541,0,871,304,330,304,rainbow dash
2063587.png,https://derpicdn.net/img/view/2019/6/12/2063587.png,0,0.976814628,573,451,895,773,322,322,rainbow dash
2063696.png,https://derpicdn.net/img/view/2019/6/12/2063696.png,0,0.999357939,454,40,1258,844,804,804,rainbow dash
2063715.png,https://derpicdn.net/img/view/2019/6/12/2063715.png,0,0.944846034,1095,910,2297,2112,1202,1202,rainbow dash
2064206.png,https://derpicdn.net/img/view/2019/6/13/2064206.png,0,0.988553584,732,0,1208,448,476,448,rainbow dash
2065443.png,https://derpicdn.net/img/view/2019/6/14/2065443.png,0,0.98559773,34,0,1252,1097,1218,1097,rainbow dash
2065569.png,https://derpicdn.net/img/view/2019/6/15/2065569.png,0,0.984342337,166,0,882,671,716,671,rainbow dash
2066054.png,https://derpicdn.net/img/view/2019/6/15/2066054.png,0,0.998778224,270,0,688,403,418,403,rainbow dash
2067987.png,https://derpicdn.net/img/view/2019/6/17/2067987.png,1,0.925435185,911,549,1275,913,364,364,rainbow dash
2070231.png,https://derpicdn.net/img/view/2019/6/20/2070231.png,0,0.995442927,689,26,2241,1578,1552,1552,rainbow dash
2070264.png,https://derpicdn.net/img/view/2019/6/20/2070264.png,0,0.997022867,677,17,2255,1595,1578,1578,rainbow dash
2074059.png,https://derpicdn.net/img/view/2019/6/24/2074059.png,0,0.992607713,70,115,1056,1101,986,986,rainbow dash
2074059.png,https://derpicdn.net/img/view/2019/6/24/2074059.png,1,0.955177546,2080,98,2982,1000,902,902,rainbow dash
2074680.png,https://derpicdn.net/img/view/2019/6/25/2074680.png,1,0.996250629,701,1958,1487,2744,786,786,rainbow dash
2074680.png,https://derpicdn.net/img/view/2019/6/25/2074680.png,2,0.987125576,563,196,1263,896,700,700,rainbow dash
2075294.png,https://derpicdn.net/img/view/2019/6/25/2075294.png,0,0.994484603,1688,635,2776,1723,1088,1088,rainbow dash
2079172.png,https://derpicdn.net/img/view/2019/6/30/2079172.png,0,0.999283493,339,0,1323,947,984,947,rainbow dash
2081381.png,https://derpicdn.net/img/view/2019/7/2/2081381.png,0,0.999042332,125,48,547,470,422,422,rainbow dash
2082220.png,https://derpicdn.net/img/view/2019/7/3/2082220.png,0,0.998499036,490,17,1010,537,520,520,rainbow dash
2082421.png,https://derpicdn.net/img/view/2019/7/4/2082421.png,0,0.995331228,2612,824,4068,2280,1456,1456,rainbow dash
2090203.png,https://derpicdn.net/img/view/2019/7/13/2090203.png,0,0.990477622,9,115,701,807,692,692,rainbow dash
2096698.png,https://derpicdn.net/img/view/2019/7/20/2096698.png,0,0.938791931,59,126,1011,1078,952,952,rainbow dash
2096970.png,https://derpicdn.net/img/view/2019/7/20/2096970.png,0,0.999465585,300,12,784,496,484,484,rainbow dash
2100226.png,https://derpicdn.net/img/view/2019/7/24/2100226.png,0,0.987559497,24,0,178,133,154,133,rainbow dash
2101085.png,https://derpicdn.net/img/view/2019/7/25/2101085.png,0,0.957338929,576,0,2964,2384,2388,2384,rainbow dash
2101684.png,https://derpicdn.net/img/view/2019/7/26/2101684.png,0,0.977810264,150,0,632,444,482,444,rainbow dash
2104315.png,https://derpicdn.net/img/view/2019/7/29/2104315.png,0,0.983497083,91,83,1931,1923,1840,1840,rainbow dash
2104950.png,https://derpicdn.net/img/view/2019/7/30/2104950.png,0,0.995526433,138,0,388,248,250,248,rainbow dash
2105588.png,https://derpicdn.net/img/view/2019/7/31/2105588.png,0,0.982204556,677,43,1571,937,894,894,rainbow dash
2105594.png,https://derpicdn.net/img/view/2019/7/31/2105594.png,0,0.983824909,1377,42,2241,906,864,864,rainbow dash
2107851.png,https://derpicdn.net/img/view/2019/8/3/2107851.png,0,0.983442962,25,0,401,309,376,309,rainbow dash
2108368.png,https://derpicdn.net/img/view/2019/8/3/2108368.png,0,0.979378581,436,59,1934,1557,1498,1498,rainbow dash
2110943.png,https://derpicdn.net/img/view/2019/8/7/2110943.png,0,0.997458756,792,0,1350,501,558,501,rainbow dash
2111612.png,https://derpicdn.net/img/view/2019/8/7/2111612.png,0,0.996005118,435,157,2087,1809,1652,1652,rainbow dash
2112691.png,https://derpicdn.net/img/view/2019/8/9/2112691.png,0,0.974454939,120,0,1668,1493,1548,1493,rainbow dash
2116578.png,https://derpicdn.net/img/view/2019/8/12/2116578.png,0,0.990749657,776,342,1672,1238,896,896,rainbow dash
2116833.png,https://derpicdn.net/img/view/2019/8/13/2116833.png,0,0.940493464,388,0,1852,1307,1464,1307,rainbow dash
2118512.png,https://derpicdn.net/img/view/2019/8/15/2118512.png,0,0.99881202,264,0,802,527,538,527,rainbow dash
2120231.png,https://derpicdn.net/img/view/2019/8/17/2120231.png,0,0.997761786,324,0,4124,3497,3800,3497,rainbow dash
2120528.png,https://derpicdn.net/img/view/2019/8/17/2120528.png,0,0.918173909,0,0,956,857,956,857,rainbow dash
2128256.png,https://derpicdn.net/img/view/2019/8/26/2128256.png,0,0.983850121,141,87,1003,949,862,862,rainbow dash
2129106.png,https://derpicdn.net/img/view/2019/8/27/2129106.png,0,0.972144306,0,325,1629,1800,1629,1475,rainbow dash
2134158.png,https://derpicdn.net/img/view/2019/9/2/2134158.png,0,0.988032341,758,0,4020,2943,3262,2943,rainbow dash
2136421.png,https://derpicdn.net/img/view/2019/9/4/2136421.png,1,0.908118129,1161,18,1989,846,828,828,rainbow dash
2145815.png,https://derpicdn.net/img/view/2019/9/16/2145815.png,0,0.995074093,580,0,1644,972,1064,972,rainbow dash
2147105.png,https://derpicdn.net/img/view/2019/9/18/2147105.png,0,0.99391222,739,0,1385,564,646,564,rainbow dash
2148278.png,https://derpicdn.net/img/view/2019/9/20/2148278.png,0,0.99523896,1831,0,4627,2635,2796,2635,rainbow dash
2152663.png,https://derpicdn.net/img/view/2019/9/25/2152663.png,0,0.985605657,28,0,610,559,582,559,rainbow dash
2152664.png,https://derpicdn.net/img/view/2019/9/25/2152664.png,0,0.985550225,28,0,610,559,582,559,rainbow dash
2155773.png,https://derpicdn.net/img/view/2019/9/29/2155773.png,0,0.96997267,106,0,890,783,784,783,rainbow dash
2162811.png,https://derpicdn.net/img/view/2019/10/7/2162811.png,0,0.919190645,0,24,1754,2134,1754,2110,rainbow dash
2163364.png,https://derpicdn.net/img/view/2019/10/8/2163364.png,0,0.997856796,1207,0,3635,2277,2428,2277,rainbow dash
2164992.png,https://derpicdn.net/img/view/2019/10/10/2164992.png,0,0.997550368,0,110,790,914,790,804,rainbow dash
2166319.png,https://derpicdn.net/img/view/2019/10/12/2166319.png,0,0.9992522,88,0,1248,1113,1160,1113,rainbow dash
2166514.png,https://derpicdn.net/img/view/2019/10/12/2166514.png,0,0.995871782,1185,651,2085,1551,900,900,rainbow dash
2168440.png,https://derpicdn.net/img/view/2019/10/14/2168440.png,0,0.912970841,0,0,1484,1583,1484,1583,rainbow dash
2177317.png,https://derpicdn.net/img/view/2019/10/24/2177317.png,0,0.992773712,0,0,2323,2160,2323,2160,rainbow dash
2177317.png,https://derpicdn.net/img/view/2019/10/24/2177317.png,1,0.955889702,2403,0,3559,1122,1156,1122,rainbow dash
2180248.png,https://derpicdn.net/img/view/2019/10/27/2180248.png,0,0.997196138,268,871,702,1305,434,434,rainbow dash
2180248.png,https://derpicdn.net/img/view/2019/10/27/2180248.png,1,0.987800241,1314,0,1776,414,462,414,rainbow dash
2183147.png,https://derpicdn.net/img/view/2019/10/30/2183147.png,0,0.945017099,604,267,1478,1141,874,874,rainbow dash
2183767.png,https://derpicdn.net/img/view/2019/10/31/2183767.png,0,0.974662066,241,178,693,630,452,452,rainbow dash
2183793.png,https://derpicdn.net/img/view/2019/10/31/2183793.png,0,0.994027615,2325,1770,4717,4162,2392,2392,rainbow dash
2185880.png,https://derpicdn.net/img/view/2019/11/2/2185880.png,0,0.998902857,202,0,664,460,462,460,rainbow dash
2186447.png,https://derpicdn.net/img/view/2019/11/3/2186447.png,0,0.966908813,653,0,1354,697,701,697,rainbow dash
2190100.png,https://derpicdn.net/img/view/2019/11/8/2190100.png,0,0.993675709,127,52,709,634,582,582,rainbow dash
2191399.png,https://derpicdn.net/img/view/2019/11/9/2191399.png,0,0.999206424,541,0,1029,439,488,439,rainbow dash
2195037.png,https://derpicdn.net/img/view/2019/11/13/2195037.png,0,0.998541355,685,0,1875,1087,1190,1087,rainbow dash
2195053.png,https://derpicdn.net/img/view/2019/11/13/2195053.png,0,0.976251245,415,16,2715,2316,2300,2300,rainbow dash
2196394.png,https://derpicdn.net/img/view/2019/11/15/2196394.png,0,0.979291797,239,0,777,538,538,538,rainbow dash
2197547.png,https://derpicdn.net/img/view/2019/11/16/2197547.png,0,0.944332182,87,0,550,471,463,471,rainbow dash
2204932.png,https://derpicdn.net/img/view/2019/11/25/2204932.png,0,0.998365402,107,0,2055,1865,1948,1865,rainbow dash
2205776.png,https://derpicdn.net/img/view/2019/11/26/2205776.png,0,0.98601985,191,8,575,392,384,384,rainbow dash
2214325.png,https://derpicdn.net/img/view/2019/12/6/2214325.png,0,0.952056766,615,14,1169,568,554,554,rainbow dash
2215731.png,https://derpicdn.net/img/view/2019/12/8/2215731.png,0,0.991809785,938,0,2106,1115,1168,1115,rainbow dash
2216053.png,https://derpicdn.net/img/view/2019/12/8/2216053.png,0,0.993309021,245,5,763,523,518,518,rainbow dash
2218508.png,https://derpicdn.net/img/view/2019/12/12/2218508.png,0,0.999851942,491,88,1705,1302,1214,1214,rainbow dash
2221237.png,https://derpicdn.net/img/view/2019/12/15/2221237.png,0,0.95477283,1270,430,1996,1156,726,726,rainbow dash
2222793.png,https://derpicdn.net/img/view/2019/12/17/2222793.png,0,0.99683696,423,0,1941,1480,1518,1480,rainbow dash
2227460.png,https://derpicdn.net/img/view/2019/12/23/2227460.png,0,0.997503579,988,0,2810,1808,1822,1808,rainbow dash
2229144.png,https://derpicdn.net/img/view/2019/12/24/2229144.png,0,0.967491686,34,0,2346,2242,2312,2242,rainbow dash
2229408.png,https://derpicdn.net/img/view/2019/12/25/2229408.png,0,0.93135041,440,83,1446,1089,1006,1006,rainbow dash
2230137.png,https://derpicdn.net/img/view/2019/12/26/2230137.png,0,0.997737169,915,0,1809,873,894,873,rainbow dash
2233710.png,https://derpicdn.net/img/view/2019/12/30/2233710.png,0,0.983433604,658,0,1522,732,864,732,rainbow dash
2234654.png,https://derpicdn.net/img/view/2019/12/31/2234654.png,0,0.993318617,297,35,797,535,500,500,rainbow dash
2234725.jpg,https://derpicdn.net/img/view/2019/12/31/2234725.jpg,0,0.997263491,265,160,885,780,620,620,rainbow dash
2234753.png,https://derpicdn.net/img/view/2019/12/31/2234753.png,0,0.975369692,16,0,318,301,302,301,rainbow dash
2235521.png,https://derpicdn.net/img/view/2020/1/1/2235521.png,0,0.985038936,103,16,1883,1796,1780,1780,rainbow dash
2236793.jpg,https://derpicdn.net/img/view/2020/1/2/2236793.jpg,0,0.964294553,249,832,1849,2432,1600,1600,rainbow dash
2237666.png,https://derpicdn.net/img/view/2020/1/3/2237666.png,0,0.973082721,278,93,798,613,520,520,rainbow dash
223961.png,https://derpicdn.net/img/view/2013/1/26/223961.png,0,0.994261563,172,4,478,310,306,306,rainbow dash
2243331.jpg,https://derpicdn.net/img/view/2020/1/10/2243331.jpg,0,0.98070389,523,0,1273,711,750,711,rainbow dash
2245733.jpg,https://derpicdn.net/img/view/2020/1/12/2245733.jpg,0,0.999016166,11,17,861,867,850,850,rainbow dash
2251410.jpg,https://derpicdn.net/img/view/2020/1/19/2251410.jpg,0,0.991758525,184,0,1522,1296,1338,1296,rainbow dash
2252009.png,https://derpicdn.net/img/view/2020/1/20/2252009.png,0,0.925002933,256,218,616,578,360,360,rainbow dash
2254403.png,https://derpicdn.net/img/view/2020/1/23/2254403.png,0,0.992025971,681,70,2647,2036,1966,1966,rainbow dash
2254787.jpg,https://derpicdn.net/img/view/2020/1/23/2254787.jpg,0,0.995208263,305,0,931,603,626,603,rainbow dash
2256381.png,https://derpicdn.net/img/view/2020/1/25/2256381.png,0,0.980742753,135,24,555,444,420,420,rainbow dash
2256772.png,https://derpicdn.net/img/view/2020/1/25/2256772.png,0,0.99484086,73,0,1201,1020,1128,1020,rainbow dash
2260455.jpg,https://derpicdn.net/img/view/2020/1/29/2260455.jpg,0,0.988736629,253,0,1067,754,814,754,rainbow dash
2262911.jpg,https://derpicdn.net/img/view/2020/2/1/2262911.jpg,0,0.9871369,953,276,1841,1164,888,888,rainbow dash
2264793.jpg,https://derpicdn.net/img/view/2020/2/3/2264793.jpg,0,0.997931659,180,0,1464,1193,1284,1193,rainbow dash
2265383.jpg,https://derpicdn.net/img/view/2020/2/4/2265383.jpg,0,0.939594686,84,494,274,684,190,190,rainbow dash
2265576.jpg,https://derpicdn.net/img/view/2020/2/4/2265576.jpg,0,0.991591632,611,79,1757,1225,1146,1146,rainbow dash
2265621.png,https://derpicdn.net/img/view/2020/2/4/2265621.png,0,0.997302294,132,0,2492,2282,2360,2282,rainbow dash
2265978.jpg,https://derpicdn.net/img/view/2020/2/5/2265978.jpg,0,0.986189961,0,0,1181,1286,1181,1286,rainbow dash
2266477.png,https://derpicdn.net/img/view/2020/2/5/2266477.png,0,0.932906985,0,0,669,570,669,570,rainbow dash
2266837.png,https://derpicdn.net/img/view/2020/2/6/2266837.png,0,0.946083844,527,6,2283,1762,1756,1756,rainbow dash
2267846.jpg,https://derpicdn.net/img/view/2020/2/7/2267846.jpg,0,0.995107591,573,1119,1251,1797,678,678,rainbow dash
2267846.jpg,https://derpicdn.net/img/view/2020/2/7/2267846.jpg,1,0.98804003,82,702,602,1222,520,520,rainbow dash
2267846.jpg,https://derpicdn.net/img/view/2020/2/7/2267846.jpg,2,0.931792021,1085,279,1683,877,598,598,rainbow dash
2267979.png,https://derpicdn.net/img/view/2020/2/7/2267979.png,0,0.966162026,986,0,1650,533,664,533,rainbow dash
2268979.png,https://derpicdn.net/img/view/2020/2/8/2268979.png,0,0.98442322,0,228,1838,2158,1838,1930,rainbow dash
2278971.jpg,https://derpicdn.net/img/view/2020/2/20/2278971.jpg,0,0.952037394,151,0,1685,1417,1534,1417,rainbow dash
2289077.png,https://derpicdn.net/img/view/2020/3/3/2289077.png,0,0.906745791,0,240,2130,2500,2130,2260,rainbow dash
2290454.png,https://derpicdn.net/img/view/2020/3/5/2290454.png,0,0.983039141,939,9,2221,1291,1282,1282,rainbow dash
2291419.png,https://derpicdn.net/img/view/2020/3/6/2291419.png,0,0.981211066,0,13,821,885,821,872,rainbow dash
2292275.png,https://derpicdn.net/img/view/2020/3/7/2292275.png,0,0.994559765,1759,210,2953,1404,1194,1194,rainbow dash
2292275.png,https://derpicdn.net/img/view/2020/3/7/2292275.png,1,0.977911592,1821,1279,2899,2357,1078,1078,rainbow dash
2292685.jpg,https://derpicdn.net/img/view/2020/3/8/2292685.jpg,0,0.98349458,67,0,1037,820,970,820,rainbow dash
2293711.png,https://derpicdn.net/img/view/2020/3/9/2293711.png,0,0.941487372,315,264,557,506,242,242,rainbow dash
2294955.jpg,https://derpicdn.net/img/view/2020/3/11/2294955.jpg,0,0.923623383,0,1649,657,2479,657,830,rainbow dash
2295872.png,https://derpicdn.net/img/view/2020/3/12/2295872.png,0,0.932799518,547,97,1215,765,668,668,rainbow dash
2296896.jpg,https://derpicdn.net/img/view/2020/3/14/2296896.jpg,0,0.974418402,502,251,1088,837,586,586,rainbow dash
2297271.png,https://derpicdn.net/img/view/2020/3/14/2297271.png,0,0.980692625,165,0,487,299,322,299,rainbow dash
2298676.png,https://derpicdn.net/img/view/2020/3/16/2298676.png,1,0.995267034,84,0,488,394,404,394,rainbow dash
2299450.png,https://derpicdn.net/img/view/2020/3/17/2299450.png,0,0.999075413,209,189,1517,1497,1308,1308,rainbow dash
2299959.png,https://derpicdn.net/img/view/2020/3/17/2299959.png,0,0.988358557,646,0,1614,879,968,879,rainbow dash
2300592.png,https://derpicdn.net/img/view/2020/3/18/2300592.png,0,0.997677207,447,0,1097,629,650,629,rainbow dash
2301496.png,https://derpicdn.net/img/view/2020/3/20/2301496.png,0,0.997043669,29,0,1173,986,1144,986,rainbow dash
2302582.jpg,https://derpicdn.net/img/view/2020/3/21/2302582.jpg,0,0.988579512,1213,14,1957,758,744,744,rainbow dash
2304959.png,https://derpicdn.net/img/view/2020/3/24/2304959.png,0,0.979311585,252,0,1901,1614,1649,1614,rainbow dash
230509.jpg,https://derpicdn.net/img/view/2013/2/1/230509.jpg,0,0.964397252,932,0,1638,577,706,577,rainbow dash
2305190.jpg,https://derpicdn.net/img/view/2020/3/24/2305190.jpg,0,0.930384934,0,0,889,1071,889,1071,rainbow dash
2308609.jpg,https://derpicdn.net/img/view/2020/3/29/2308609.jpg,0,0.995233178,77,114,1449,1486,1372,1372,rainbow dash
2310058.png,https://derpicdn.net/img/view/2020/3/30/2310058.png,0,0.945760846,660,0,1478,703,818,703,rainbow dash
2310926.jpg,https://derpicdn.net/img/view/2020/3/31/2310926.jpg,0,0.948051214,966,374,1584,992,618,618,rainbow dash
2313808.png,https://derpicdn.net/img/view/2020/4/4/2313808.png,0,0.95096916,65,42,321,298,256,256,rainbow dash
2315327.png,https://derpicdn.net/img/view/2020/4/6/2315327.png,0,0.978246629,332,87,2794,2549,2462,2462,rainbow dash
2316886.jpg,https://derpicdn.net/img/view/2020/4/8/2316886.jpg,0,0.981546044,24,8,586,570,562,562,rainbow dash
2317342.png,https://derpicdn.net/img/view/2020/4/8/2317342.png,0,0.952937007,5,0,387,308,382,308,rainbow dash
2318266.jpg,https://derpicdn.net/img/view/2020/4/9/2318266.jpg,0,0.988722086,1971,78,3769,1876,1798,1798,rainbow dash
2320195.jpg,https://derpicdn.net/img/view/2020/4/12/2320195.jpg,0,0.991305947,199,0,601,365,402,365,rainbow dash
2322789.png,https://derpicdn.net/img/view/2020/4/15/2322789.png,0,0.961505711,86,0,2504,2300,2418,2300,rainbow dash
2325815.jpg,https://derpicdn.net/img/view/2020/4/18/2325815.jpg,0,0.998389244,1956,340,3028,1412,1072,1072,rainbow dash
2326282.jpg,https://derpicdn.net/img/view/2020/4/19/2326282.jpg,0,0.980217993,19,147,789,917,770,770,rainbow dash
2326951.jpg,https://derpicdn.net/img/view/2020/4/20/2326951.jpg,0,0.958799779,404,41,800,437,396,396,rainbow dash
2328934.jpg,https://derpicdn.net/img/view/2020/4/22/2328934.jpg,0,0.954682469,157,281,497,621,340,340,rainbow dash
2330409.png,https://derpicdn.net/img/view/2020/4/24/2330409.png,0,0.977871418,67,37,2159,2129,2092,2092,rainbow dash
2333329.png,https://derpicdn.net/img/view/2020/4/27/2333329.png,0,0.996623039,109,19,551,461,442,442,rainbow dash
2337222.png,https://derpicdn.net/img/view/2020/5/2/2337222.png,0,0.912064135,0,80,2313,2474,2313,2394,rainbow dash
2340201.jpg,https://derpicdn.net/img/view/2020/5/5/2340201.jpg,0,0.971323371,414,0,1334,887,920,887,rainbow dash
2341639.png,https://derpicdn.net/img/view/2020/5/7/2341639.png,0,0.999034941,810,0,2308,1498,1498,1498,rainbow dash
2346303.png,https://derpicdn.net/img/view/2020/5/12/2346303.png,0,0.969917119,0,0,2263,2000,2263,2000,rainbow dash
2347337.png,https://derpicdn.net/img/view/2020/5/13/2347337.png,0,0.993522704,878,0,1564,682,686,682,rainbow dash
2348413.png,https://derpicdn.net/img/view/2020/5/14/2348413.png,0,0.999232471,258,55,1228,1025,970,970,rainbow dash
2351523.png,https://derpicdn.net/img/view/2020/5/18/2351523.png,0,0.995661557,0,69,1459,1587,1459,1518,rainbow dash
2355355.png,https://derpicdn.net/img/view/2020/5/22/2355355.png,1,0.991868496,328,144,1142,958,814,814,rainbow dash
238198.png,https://derpicdn.net/img/view/2013/2/9/238198.png,0,0.962587893,274,0,634,350,360,350,rainbow dash
23886.png,https://derpicdn.net/img/view/2012/6/28/23886.png,0,0.996036947,1,6,515,520,514,514,rainbow dash
2529.png,https://derpicdn.net/img/view/2012/1/28/2529.png,0,0.997056007,244,0,740,462,496,462,rainbow dash
276520.png,https://derpicdn.net/img/view/2013/3/22/276520.png,0,0.998640299,186,0,1262,930,1076,930,rainbow dash
277843.png,https://derpicdn.net/img/view/2013/3/23/277843.png,0,0.991280258,46,12,788,754,742,742,rainbow dash
280608.png,https://derpicdn.net/img/view/2013/3/27/280608.png,0,0.998596013,223,0,603,364,380,364,rainbow dash
290852.png,https://derpicdn.net/img/view/2013/4/7/290852.png,0,0.998558879,270,110,1634,1474,1364,1364,rainbow dash
303553.png,https://derpicdn.net/img/view/2013/4/20/303553.png,0,0.98629123,200,57,538,395,338,338,rainbow dash
311301.png,https://derpicdn.net/img/view/2013/4/29/311301.png,0,0.9960711,452,39,900,495,448,456,rainbow dash
31948.png,https://derpicdn.net/img/view/2012/7/4/31948.png,0,0.996831059,343,3,989,649,646,646,rainbow dash
31988.png,https://derpicdn.net/img/view/2012/7/5/31988.png,0,0.970220745,670,7,1250,587,580,580,rainbow dash
329.jpg,https://derpicdn.net/img/view/2012/1/15/329.jpg,0,0.95040524,108,60,644,596,536,536,rainbow dash
339225.png,https://derpicdn.net/img/view/2013/6/2/339225.png,0,0.950371206,260,176,570,486,310,310,rainbow dash
339225.png,https://derpicdn.net/img/view/2013/6/2/339225.png,1,0.904062152,99,11,331,243,232,232,rainbow dash
339332.png,https://derpicdn.net/img/view/2013/6/2/339332.png,0,0.935938597,242,0,882,575,640,575,rainbow dash
349654.png,https://derpicdn.net/img/view/2013/6/16/349654.png,0,0.983736098,232,283,632,683,400,400,rainbow dash
354480.png,https://derpicdn.net/img/view/2013/6/22/354480.png,0,0.910117745,656,70,832,246,176,176,rainbow dash
354480.png,https://derpicdn.net/img/view/2013/6/22/354480.png,1,0.9030689,157,58,351,252,194,194,rainbow dash
355.jpg,https://derpicdn.net/img/view/2012/1/15/355.jpg,0,0.983206511,43,0,491,424,448,424,rainbow dash
359057.png,https://derpicdn.net/img/view/2013/6/28/359057.png,0,0.997097611,366,0,8544,7347,8178,7347,rainbow dash
359210.png,https://derpicdn.net/img/view/2013/6/28/359210.png,0,0.993133485,0,0,7476,7423,7476,7423,rainbow dash
369450.png,https://derpicdn.net/img/view/2013/7/10/369450.png,0,0.985572875,79,0,635,530,556,530,rainbow dash
38.png,https://derpicdn.net/img/view/2012/1/6/38.png,0,0.984863102,0,22,234,255,234,233,rainbow dash
3816.png,https://derpicdn.net/img/view/2012/3/21/3816.png,0,0.937861502,141,483,655,997,514,514,rainbow dash
390066.png,https://derpicdn.net/img/view/2013/8/3/390066.png,0,0.996921957,313,0,1009,671,696,671,rainbow dash
391865.png,https://derpicdn.net/img/view/2013/8/5/391865.png,0,0.98704648,158,0,1082,905,924,905,rainbow dash
394440.png,https://derpicdn.net/img/view/2013/8/8/394440.png,1,0.964635968,3,11,455,463,452,452,rainbow dash
400078.png,https://derpicdn.net/img/view/2013/8/14/400078.png,0,0.998394966,2051,0,4475,2315,2424,2315,rainbow dash
401207.png,https://derpicdn.net/img/view/2013/8/15/401207.png,0,0.996913016,261,0,575,281,314,281,rainbow dash
417112.png,https://derpicdn.net/img/view/2013/9/2/417112.png,0,0.98250252,0,0,1581,2129,1581,2129,rainbow dash
417118.png,https://derpicdn.net/img/view/2013/9/2/417118.png,0,0.992236793,0,0,2568,2662,2568,2662,rainbow dash
435422.png,https://derpicdn.net/img/view/2013/9/26/435422.png,0,0.951723695,571,0,4401,2867,3830,2867,rainbow dash
437069.png,https://derpicdn.net/img/view/2013/9/28/437069.png,0,0.992791355,264,0,728,429,464,429,rainbow dash
437485.png,https://derpicdn.net/img/view/2013/9/29/437485.png,0,0.998637974,4,0,726,704,722,704,rainbow dash
437800.png,https://derpicdn.net/img/view/2013/9/29/437800.png,0,0.982961595,44,90,1188,1234,1144,1144,rainbow dash
442025.png,https://derpicdn.net/img/view/2013/10/5/442025.png,0,0.994994402,859,70,1713,924,854,854,rainbow dash
445029.png,https://derpicdn.net/img/view/2013/10/9/445029.png,0,0.989981472,870,0,1380,496,510,496,rainbow dash
445029.png,https://derpicdn.net/img/view/2013/10/9/445029.png,1,0.954911709,107,100,795,788,688,688,rainbow dash
455439.jpg,https://derpicdn.net/img/view/2013/10/24/455439.jpg,0,0.942737937,651,3,983,335,332,332,rainbow dash
478136.png,https://derpicdn.net/img/view/2013/11/22/478136.png,0,0.998400807,457,0,943,471,486,471,rainbow dash
480216.png,https://derpicdn.net/img/view/2013/11/24/480216.png,0,0.998703659,573,0,1215,616,642,616,rainbow dash
480708.png,https://derpicdn.net/img/view/2013/11/24/480708.png,0,0.997772992,149,0,905,673,756,673,rainbow dash
492036.png,https://derpicdn.net/img/view/2013/12/7/492036.png,0,0.993177235,0,0,673,635,673,635,rainbow dash
492898.png,https://derpicdn.net/img/view/2013/12/8/492898.png,0,0.996927321,914,392,1894,1372,980,980,rainbow dash
493530.png,https://derpicdn.net/img/view/2013/12/9/493530.png,0,0.990910232,79,0,967,940,888,940,rainbow dash
494039.png,https://derpicdn.net/img/view/2013/12/10/494039.png,0,0.979693711,73,0,967,894,894,894,rainbow dash
497775.png,https://derpicdn.net/img/view/2013/12/15/497775.png,0,0.929751694,1066,90,2132,1156,1066,1066,rainbow dash
4999.png,https://derpicdn.net/img/view/2012/6/17/4999.png,0,0.996829987,342,3,988,649,646,646,rainbow dash
504907.png,https://derpicdn.net/img/view/2013/12/23/504907.png,0,0.950654149,0,0,589,605,589,605,rainbow dash
505939.png,https://derpicdn.net/img/view/2013/12/25/505939.png,0,0.997678399,134,63,464,393,330,330,rainbow dash
505939.png,https://derpicdn.net/img/view/2013/12/25/505939.png,1,0.980170608,465,0,843,368,378,368,rainbow dash
510682.png,https://derpicdn.net/img/view/2013/12/31/510682.png,0,0.998425126,598,0,1040,411,442,411,rainbow dash
510682.png,https://derpicdn.net/img/view/2013/12/31/510682.png,1,0.996146381,623,445,847,669,224,224,rainbow dash
510682.png,https://derpicdn.net/img/view/2013/12/31/510682.png,2,0.963600457,209,510,543,844,334,334,rainbow dash
51100.png,https://derpicdn.net/img/view/2012/7/21/51100.png,0,0.99771148,381,0,627,244,246,244,rainbow dash
520270.jpg,https://derpicdn.net/img/view/2014/1/10/520270.jpg,0,0.97917217,670,0,1202,491,532,491,rainbow dash
531375.png,https://derpicdn.net/img/view/2014/1/22/531375.png,0,0.943684459,316,4,984,672,668,668,rainbow dash
536419.png,https://derpicdn.net/img/view/2014/1/28/536419.png,0,0.963734388,80,345,768,1033,688,688,rainbow dash
541011.png,https://derpicdn.net/img/view/2014/2/2/541011.png,0,0.999617755,448,0,912,390,464,390,rainbow dash
542485.jpg,https://derpicdn.net/img/view/2014/2/3/542485.jpg,0,0.98178333,40,0,284,242,244,242,rainbow dash
545718.png,https://derpicdn.net/img/view/2014/2/7/545718.png,0,0.995516062,3165,0,7055,3723,3890,3723,rainbow dash
547215.jpg,https://derpicdn.net/img/view/2014/2/9/547215.jpg,0,0.915154994,0,0,1240,1414,1240,1414,rainbow dash
550061.png,https://derpicdn.net/img/view/2014/2/12/550061.png,0,0.953690708,36,33,614,611,578,578,rainbow dash
553146.png,https://derpicdn.net/img/view/2014/2/15/553146.png,0,0.98432219,157,0,491,328,334,328,rainbow dash
555573.png,https://derpicdn.net/img/view/2014/2/18/555573.png,0,0.996380627,219,0,635,399,416,399,rainbow dash
555764.png,https://derpicdn.net/img/view/2014/2/18/555764.png,0,0.994563341,222,10,684,472,462,462,rainbow dash
561246.png,https://derpicdn.net/img/view/2014/2/25/561246.png,0,0.987735212,137,0,933,754,796,754,rainbow dash
562414.png,https://derpicdn.net/img/view/2014/2/27/562414.png,0,0.988996387,248,5,806,563,558,558,rainbow dash
566146.png,https://derpicdn.net/img/view/2014/3/3/566146.png,0,0.998354375,2192,0,5658,3396,3466,3396,rainbow dash
569052.png,https://derpicdn.net/img/view/2014/3/8/569052.png,0,0.990250051,22,0,424,378,402,378,rainbow dash
593986.png,https://derpicdn.net/img/view/2014/4/6/593986.png,0,0.995571017,2674,1545,3566,2429,892,884,rainbow dash
594347.png,https://derpicdn.net/img/view/2014/4/6/594347.png,0,0.911178768,73,0,585,489,512,489,rainbow dash
595875.png,https://derpicdn.net/img/view/2014/4/8/595875.png,0,0.991119146,393,0,851,449,458,449,rainbow dash
597196.png,https://derpicdn.net/img/view/2014/4/10/597196.png,0,0.939055026,818,443,2094,1719,1276,1276,rainbow dash
597740.png,https://derpicdn.net/img/view/2014/4/11/597740.png,0,0.999539912,735,18,2343,1626,1608,1608,rainbow dash
598745.jpg,https://derpicdn.net/img/view/2014/4/12/598745.jpg,0,0.998379827,231,10,759,538,528,528,rainbow dash
600290.png,https://derpicdn.net/img/view/2014/4/14/600290.png,0,0.998350024,232,10,760,538,528,528,rainbow dash
607980.png,https://derpicdn.net/img/view/2014/4/23/607980.png,0,0.98703444,2167,693,4900,3691,2733,2998,rainbow dash
612298.png,https://derpicdn.net/img/view/2014/4/28/612298.png,0,0.978275716,150,0,830,593,680,593,rainbow dash
619598.png,https://derpicdn.net/img/view/2014/5/6/619598.png,0,0.994970322,876,89,1698,911,822,822,rainbow dash
636288.png,https://derpicdn.net/img/view/2014/5/25/636288.png,0,0.927993059,251,53,500,305,249,252,rainbow dash
637804.png,https://derpicdn.net/img/view/2014/5/27/637804.png,0,0.925354958,322,43,1086,807,764,764,rainbow dash
641134.png,https://derpicdn.net/img/view/2014/5/31/641134.png,0,0.999636352,334,0,722,366,388,366,rainbow dash
652944.png,https://derpicdn.net/img/view/2014/6/14/652944.png,0,0.993758082,916,0,2610,1568,1694,1568,rainbow dash
654701.png,https://derpicdn.net/img/view/2014/6/16/654701.png,0,0.997486949,0,0,647,635,647,635,rainbow dash
655248.png,https://derpicdn.net/img/view/2014/6/17/655248.png,0,0.913508713,87,0,437,319,350,319,rainbow dash
657313.png,https://derpicdn.net/img/view/2014/6/20/657313.png,0,0.993826389,1637,0,3597,1726,1960,1726,rainbow dash
65870.jpg,https://derpicdn.net/img/view/2012/8/3/65870.jpg,0,0.90781939,1392,47,1876,531,484,484,rainbow dash
660005.png,https://derpicdn.net/img/view/2014/6/23/660005.png,0,0.96982789,0,63,919,1017,919,954,rainbow dash
661759.png,https://derpicdn.net/img/view/2014/6/26/661759.png,0,0.950079918,1559,946,2953,2340,1394,1394,rainbow dash
665812.png,https://derpicdn.net/img/view/2014/7/2/665812.png,0,0.98417449,127,0,1031,891,904,891,rainbow dash
665894.png,https://derpicdn.net/img/view/2014/7/2/665894.png,0,0.993067205,0,0,1561,1500,1561,1500,rainbow dash
665932.jpg,https://derpicdn.net/img/view/2014/7/2/665932.jpg,0,0.994730473,735,0,1303,524,568,524,rainbow dash
670207.jpg,https://derpicdn.net/img/view/2014/7/8/670207.jpg,0,0.991823852,188,0,676,460,488,460,rainbow dash
670209.jpg,https://derpicdn.net/img/view/2014/7/8/670209.jpg,0,0.991823435,188,0,676,460,488,460,rainbow dash
670540.jpg,https://derpicdn.net/img/view/2014/7/8/670540.jpg,0,0.900863647,43,0,600,554,557,554,rainbow dash
670707.jpg,https://derpicdn.net/img/view/2014/7/9/670707.jpg,0,0.976488292,15,0,587,469,572,469,rainbow dash
673632.png,https://derpicdn.net/img/view/2014/7/12/673632.png,0,0.999070585,150,0,678,480,528,480,rainbow dash
675863.png,https://derpicdn.net/img/view/2014/7/16/675863.png,0,0.98311013,630,0,1698,989,1068,989,rainbow dash
677238.png,https://derpicdn.net/img/view/2014/7/17/677238.png,0,0.994145274,0,0,690,670,690,670,rainbow dash
685111.png,https://derpicdn.net/img/view/2014/7/28/685111.png,0,0.986178756,0,0,451,498,451,498,rainbow dash
692575.png,https://derpicdn.net/img/view/2014/8/6/692575.png,0,0.996460319,447,0,1317,796,870,796,rainbow dash
695758.png,https://derpicdn.net/img/view/2014/8/9/695758.png,0,0.992064834,269,0,1023,724,754,724,rainbow dash
697432.png,https://derpicdn.net/img/view/2014/8/11/697432.png,0,0.998936713,1658,0,4184,2340,2526,2340,rainbow dash
697799.png,https://derpicdn.net/img/view/2014/8/12/697799.png,0,0.986483932,123,0,394,236,271,236,rainbow dash
697799.png,https://derpicdn.net/img/view/2014/8/12/697799.png,1,0.933327258,97,4,394,252,297,248,rainbow dash
699425.png,https://derpicdn.net/img/view/2014/8/14/699425.png,0,0.997809649,1015,38,1821,844,806,806,rainbow dash
701383.png,https://derpicdn.net/img/view/2014/8/16/701383.png,0,0.983192086,106,0,620,417,514,417,rainbow dash
704627.png,https://derpicdn.net/img/view/2014/8/21/704627.png,0,0.998952508,528,14,1618,1104,1090,1090,rainbow dash
707814.png,https://derpicdn.net/img/view/2014/8/25/707814.png,0,0.992977858,182,0,548,346,366,346,rainbow dash
708925.png,https://derpicdn.net/img/view/2014/8/27/708925.png,0,0.995720148,337,93,741,497,404,404,rainbow dash
720755.png,https://derpicdn.net/img/view/2014/9/12/720755.png,0,0.983762801,157,0,713,491,556,491,rainbow dash
725336.jpg,https://derpicdn.net/img/view/2014/9/19/725336.jpg,0,0.994053125,113,0,1449,1284,1336,1284,rainbow dash
729479.png,https://derpicdn.net/img/view/2014/9/25/729479.png,0,0.998269856,223,183,1059,1019,836,836,rainbow dash
730861.png,https://derpicdn.net/img/view/2014/9/28/730861.png,0,0.999180019,561,171,1335,945,774,774,rainbow dash
739357.jpg,https://derpicdn.net/img/view/2014/10/9/739357.jpg,0,0.912442684,709,0,2069,1185,1360,1185,rainbow dash
739393.png,https://derpicdn.net/img/view/2014/10/9/739393.png,0,0.99955231,169,24,349,204,180,180,rainbow dash
742121.jpg,https://derpicdn.net/img/view/2014/10/13/742121.jpg,0,0.994629502,252,0,652,360,400,360,rainbow dash
747334.png,https://derpicdn.net/img/view/2014/10/21/747334.png,0,0.981017828,0,0,612,599,612,599,rainbow dash
749483.png,https://derpicdn.net/img/view/2014/10/24/749483.png,0,0.996953964,196,34,462,300,266,266,rainbow dash
756605.png,https://derpicdn.net/img/view/2014/11/3/756605.png,0,0.977832973,90,135,540,585,450,450,rainbow dash
758400.png,https://derpicdn.net/img/view/2014/11/5/758400.png,0,0.977740109,132,218,602,688,470,470,rainbow dash
758506.png,https://derpicdn.net/img/view/2014/11/5/758506.png,0,0.991795957,284,16,644,376,360,360,rainbow dash
761352.png,https://derpicdn.net/img/view/2014/11/9/761352.png,0,0.99160254,935,0,1889,874,954,874,rainbow dash
765663.png,https://derpicdn.net/img/view/2014/11/16/765663.png,0,0.995313883,279,0,631,336,352,336,rainbow dash
765663.png,https://derpicdn.net/img/view/2014/11/16/765663.png,1,0.993013084,0,13,330,353,330,340,rainbow dash
77.png,https://derpicdn.net/img/view/2012/1/6/77.png,0,0.982129812,596,147,978,529,382,382,rainbow dash
770621.png,https://derpicdn.net/img/view/2014/11/23/770621.png,0,0.96660018,190,32,460,302,270,270,rainbow dash
777506.png,https://derpicdn.net/img/view/2014/12/4/777506.png,0,0.998084188,1348,0,2704,1252,1356,1252,rainbow dash
78252.jpg,https://derpicdn.net/img/view/2012/8/20/78252.jpg,0,0.997826219,0,0,328,303,328,303,rainbow dash
78252.jpg,https://derpicdn.net/img/view/2012/8/20/78252.jpg,1,0.966405213,316,48,638,370,322,322,rainbow dash
783202.png,https://derpicdn.net/img/view/2014/12/12/783202.png,0,0.980359912,31,126,1905,2000,1874,1874,rainbow dash
784060.jpg,https://derpicdn.net/img/view/2014/12/13/784060.jpg,0,0.963364542,81,0,471,385,390,385,rainbow dash
784077.jpg,https://derpicdn.net/img/view/2014/12/13/784077.jpg,0,0.932326078,75,0,451,360,376,360,rainbow dash
786076.png,https://derpicdn.net/img/view/2014/12/16/786076.png,0,0.97308588,55,0,431,321,376,321,rainbow dash
787310.png,https://derpicdn.net/img/view/2014/12/18/787310.png,0,0.998250186,185,0,1089,864,904,864,rainbow dash
787311.png,https://derpicdn.net/img/view/2014/12/18/787311.png,0,0.980751336,8,0,1019,1001,1011,1001,rainbow dash
789042.png,https://derpicdn.net/img/view/2014/12/20/789042.png,0,0.999904394,691,0,1203,495,512,495,rainbow dash
789764.png,https://derpicdn.net/img/view/2014/12/21/789764.png,0,0.999208093,514,0,1258,707,744,707,rainbow dash
789791.png,https://derpicdn.net/img/view/2014/12/21/789791.png,1,0.984292865,961,0,1379,364,418,364,rainbow dash
790132.jpg,https://derpicdn.net/img/view/2014/12/22/790132.jpg,0,0.945546508,1165,897,1693,1425,528,528,rainbow dash
790197.png,https://derpicdn.net/img/view/2014/12/22/790197.png,0,0.998055756,1226,100,1912,786,686,686,rainbow dash
791731.jpg,https://derpicdn.net/img/view/2014/12/24/791731.jpg,0,0.987452924,0,0,850,765,850,765,rainbow dash
792242.png,https://derpicdn.net/img/view/2014/12/25/792242.png,0,0.909234643,953,26,3083,2156,2130,2130,rainbow dash
792567.png,https://derpicdn.net/img/view/2014/12/25/792567.png,0,0.963843644,0,85,1210,1395,1210,1310,rainbow dash
79541.png,https://derpicdn.net/img/view/2012/8/21/79541.png,0,0.983401597,0,59,801,935,801,876,rainbow dash
79996.jpg,https://derpicdn.net/img/view/2012/8/22/79996.jpg,0,0.984653652,307,82,615,390,308,308,rainbow dash
805270.png,https://derpicdn.net/img/view/2015/1/13/805270.png,0,0.986647606,0,0,1138,1228,1138,1228,rainbow dash
806611.png,https://derpicdn.net/img/view/2015/1/14/806611.png,0,0.983803511,249,0,675,386,426,386,rainbow dash
806750.png,https://derpicdn.net/img/view/2015/1/14/806750.png,1,0.987868607,263,31,447,215,184,184,rainbow dash
807545.png,https://derpicdn.net/img/view/2015/1/16/807545.png,0,0.920663595,548,326,940,718,392,392,rainbow dash
809706.png,https://derpicdn.net/img/view/2015/1/19/809706.png,0,0.995943487,151,30,435,314,284,284,rainbow dash
809706.png,https://derpicdn.net/img/view/2015/1/19/809706.png,1,0.995582759,434,35,724,325,290,290,rainbow dash
815259.png,https://derpicdn.net/img/view/2015/1/26/815259.png,0,0.98261869,928,11,2704,1787,1776,1776,rainbow dash
817754.jpg,https://derpicdn.net/img/view/2015/1/30/817754.jpg,0,0.998138547,299,5,1163,869,864,864,rainbow dash
8184.jpg,https://derpicdn.net/img/view/2012/6/18/8184.jpg,0,0.942874134,658,109,1072,523,414,414,rainbow dash
824108.jpg,https://derpicdn.net/img/view/2015/2/8/824108.jpg,0,0.989780545,144,0,632,486,488,486,rainbow dash
827976.png,https://derpicdn.net/img/view/2015/2/14/827976.png,0,0.998056471,1005,20,2415,1430,1410,1410,rainbow dash
829342.png,https://derpicdn.net/img/view/2015/2/15/829342.png,0,0.99928689,580,0,1222,628,642,628,rainbow dash
832624.png,https://derpicdn.net/img/view/2015/2/19/832624.png,0,0.972422123,821,0,2573,1736,1752,1736,rainbow dash
832809.png,https://derpicdn.net/img/view/2015/2/20/832809.png,0,0.993584931,623,7,1027,411,404,404,rainbow dash
834056.jpg,https://derpicdn.net/img/view/2015/2/21/834056.jpg,0,0.958173573,42,5,500,557,458,552,rainbow dash
835605.png,https://derpicdn.net/img/view/2015/2/23/835605.png,0,0.987361491,262,247,1326,1311,1064,1064,rainbow dash
835928.png,https://derpicdn.net/img/view/2015/2/23/835928.png,0,0.98986423,0,0,1368,1354,1368,1354,rainbow dash
836483.png,https://derpicdn.net/img/view/2015/2/24/836483.png,0,0.987517178,718,77,2064,1423,1346,1346,rainbow dash
836537.png,https://derpicdn.net/img/view/2015/2/24/836537.png,0,0.99684155,121,31,603,513,482,482,rainbow dash
840311.png,https://derpicdn.net/img/view/2015/3/2/840311.png,0,0.994750559,397,61,1043,707,646,646,rainbow dash
840354.png,https://derpicdn.net/img/view/2015/3/2/840354.png,0,0.947558165,0,857,7192,7875,7192,7018,rainbow dash
840878.png,https://derpicdn.net/img/view/2015/3/2/840878.png,0,0.996635139,77,0,817,699,740,699,rainbow dash
845930.png,https://derpicdn.net/img/view/2015/3/9/845930.png,0,0.99983418,452,0,1226,712,774,712,rainbow dash
849701.jpg,https://derpicdn.net/img/view/2015/3/15/849701.jpg,0,0.950350344,478,115,1776,1413,1298,1298,rainbow dash
849949.png,https://derpicdn.net/img/view/2015/3/15/849949.png,0,0.97995013,477,60,1251,834,774,774,rainbow dash
854277.jpg,https://derpicdn.net/img/view/2015/3/21/854277.jpg,0,0.999169767,0,25,439,483,439,458,rainbow dash
854277.jpg,https://derpicdn.net/img/view/2015/3/21/854277.jpg,1,0.998809636,5,653,419,1067,414,414,rainbow dash
854277.jpg,https://derpicdn.net/img/view/2015/3/21/854277.jpg,2,0.997784257,500,0,1130,617,630,617,rainbow dash
856449.png,https://derpicdn.net/img/view/2015/3/24/856449.png,0,0.972803652,396,0,1102,636,706,636,rainbow dash
859519.png,https://derpicdn.net/img/view/2015/3/29/859519.png,0,0.99450475,126,0,728,546,602,546,rainbow dash
8607.jpg,https://derpicdn.net/img/view/2012/6/18/8607.jpg,0,0.996022582,9,65,355,411,346,346,rainbow dash
8719.png,https://derpicdn.net/img/view/2012/6/18/8719.png,0,0.999877572,363,7,1221,865,858,858,rainbow dash
87263.png,https://derpicdn.net/img/view/2012/8/31/87263.png,0,0.973953664,205,0,1109,876,904,876,rainbow dash
878506.png,https://derpicdn.net/img/view/2015/4/20/878506.png,0,0.994169593,0,6,825,834,825,828,rainbow dash
882589.png,https://derpicdn.net/img/view/2015/4/25/882589.png,0,0.992189288,420,186,788,554,368,368,rainbow dash
882738.png,https://derpicdn.net/img/view/2015/4/25/882738.png,0,0.994681239,0,22,993,1074,993,1052,rainbow dash
882738.png,https://derpicdn.net/img/view/2015/4/25/882738.png,1,0.907113314,295,0,1280,966,985,966,rainbow dash
888011.png,https://derpicdn.net/img/view/2015/5/3/888011.png,0,0.994360864,0,0,1595,1637,1595,1637,rainbow dash
889328.png,https://derpicdn.net/img/view/2015/5/4/889328.png,0,0.967833757,260,8,664,412,404,404,rainbow dash
889598.png,https://derpicdn.net/img/view/2015/5/5/889598.png,0,0.958772242,493,0,2331,1822,1838,1822,rainbow dash
890668.png,https://derpicdn.net/img/view/2015/5/6/890668.png,0,0.974306166,118,33,558,473,440,440,rainbow dash
892919.png,https://derpicdn.net/img/view/2015/5/10/892919.png,0,0.969062865,351,0,2067,1589,1716,1589,rainbow dash
894158.png,https://derpicdn.net/img/view/2015/5/11/894158.png,0,0.967853129,33,44,479,490,446,446,rainbow dash
895606.png,https://derpicdn.net/img/view/2015/5/14/895606.png,0,0.946161211,153,0,433,271,280,271,rainbow dash
895704.png,https://derpicdn.net/img/view/2015/5/14/895704.png,0,0.927325726,305,0,1863,1488,1558,1488,rainbow dash
895770.png,https://derpicdn.net/img/view/2015/5/14/895770.png,0,0.990239978,108,0,382,270,274,270,rainbow dash
896874.png,https://derpicdn.net/img/view/2015/5/16/896874.png,0,0.925395787,786,287,1624,1125,838,838,rainbow dash
897715.png,https://derpicdn.net/img/view/2015/5/17/897715.png,0,0.985168338,0,0,1332,1352,1332,1352,rainbow dash
900994.png,https://derpicdn.net/img/view/2015/5/21/900994.png,0,0.94740057,76,0,672,575,596,575,rainbow dash
901545.png,https://derpicdn.net/img/view/2015/5/22/901545.png,0,0.970822632,0,0,2014,2147,2014,2147,rainbow dash
902463.png,https://derpicdn.net/img/view/2015/5/23/902463.png,0,0.937477648,1306,68,5532,4294,4226,4226,rainbow dash
902488.png,https://derpicdn.net/img/view/2015/5/23/902488.png,0,0.940513134,254,0,854,604,600,604,rainbow dash
902651.png,https://derpicdn.net/img/view/2015/5/23/902651.png,0,0.99640274,215,0,917,649,702,649,rainbow dash
902651.png,https://derpicdn.net/img/view/2015/5/23/902651.png,1,0.951216102,1004,56,1528,580,524,524,rainbow dash
903128.png,https://derpicdn.net/img/view/2015/5/24/903128.png,0,0.9971928,605,167,1083,645,478,478,rainbow dash
90884.png,https://derpicdn.net/img/view/2012/9/5/90884.png,0,0.999497175,376,264,794,682,418,418,rainbow dash
909189.png,https://derpicdn.net/img/view/2015/6/3/909189.png,0,0.991042376,362,0,1714,1280,1352,1280,rainbow dash
909421.png,https://derpicdn.net/img/view/2015/6/3/909421.png,0,0.986600935,639,0,2205,1536,1566,1536,rainbow dash
909983.png,https://derpicdn.net/img/view/2015/6/4/909983.png,0,0.995846391,877,34,1471,628,594,594,rainbow dash
911706.png,https://derpicdn.net/img/view/2015/6/6/911706.png,0,0.973926902,659,71,1377,789,718,718,rainbow dash
912764.png,https://derpicdn.net/img/view/2015/6/8/912764.png,0,0.933101892,602,0,1652,965,1050,965,rainbow dash
913572.jpg,https://derpicdn.net/img/view/2015/6/9/913572.jpg,0,0.995403409,70,3,754,687,684,684,rainbow dash
914261.png,https://derpicdn.net/img/view/2015/6/10/914261.png,0,0.996437728,760,0,1946,1164,1186,1164,rainbow dash
915512.png,https://derpicdn.net/img/view/2015/6/12/915512.png,0,0.999439776,665,0,2065,1377,1400,1377,rainbow dash
91708.png,https://derpicdn.net/img/view/2012/9/7/91708.png,0,0.978941679,772,864,1510,1602,738,738,rainbow dash
91708.png,https://derpicdn.net/img/view/2012/9/7/91708.png,1,0.964989364,3830,1488,4500,2172,670,684,rainbow dash
91708.png,https://derpicdn.net/img/view/2012/9/7/91708.png,3,0.951736391,1717,769,2507,1559,790,790,rainbow dash
91708.png,https://derpicdn.net/img/view/2012/9/7/91708.png,4,0.92146033,131,709,933,1511,802,802,rainbow dash
91708.png,https://derpicdn.net/img/view/2012/9/7/91708.png,6,0.908188999,3273,1511,3963,2201,690,690,rainbow dash
917854.png,https://derpicdn.net/img/view/2015/6/15/917854.png,0,0.988085389,427,0,2453,2004,2026,2004,rainbow dash
919581.png,https://derpicdn.net/img/view/2015/6/19/919581.png,0,0.954228282,107,0,1081,953,974,953,rainbow dash
923821.png,https://derpicdn.net/img/view/2015/6/26/923821.png,0,0.990857601,178,0,1888,1636,1710,1636,rainbow dash
925122.png,https://derpicdn.net/img/view/2015/6/27/925122.png,0,0.999795973,335,4,789,458,454,454,rainbow dash
926116.png,https://derpicdn.net/img/view/2015/6/29/926116.png,0,0.992076337,510,117,1804,1411,1294,1294,rainbow dash
928213.png,https://derpicdn.net/img/view/2015/7/2/928213.png,0,0.985106647,131,0,2951,2600,2820,2600,rainbow dash
928725.png,https://derpicdn.net/img/view/2015/7/3/928725.png,0,0.998396814,374,0,686,304,312,304,rainbow dash
929319.png,https://derpicdn.net/img/view/2015/7/4/929319.png,0,0.924823344,328,40,1910,1622,1582,1582,rainbow dash
933233.png,https://derpicdn.net/img/view/2015/7/9/933233.png,0,0.919351876,169,0,2421,2154,2252,2154,rainbow dash
941704.png,https://derpicdn.net/img/view/2015/7/22/941704.png,0,0.917711198,44,0,1216,1100,1172,1100,rainbow dash
943293.png,https://derpicdn.net/img/view/2015/7/25/943293.png,0,0.998647392,153,0,653,470,500,470,rainbow dash
944800.png,https://derpicdn.net/img/view/2015/7/27/944800.png,0,0.964363217,353,0,833,429,480,429,rainbow dash
947712.png,https://derpicdn.net/img/view/2015/7/31/947712.png,0,0.982346237,409,6,797,394,388,388,rainbow dash
952717.png,https://derpicdn.net/img/view/2015/8/7/952717.png,0,0.993389189,605,26,1249,670,644,644,rainbow dash
953761.png,https://derpicdn.net/img/view/2015/8/8/953761.png,0,0.989721298,562,0,936,351,374,351,rainbow dash
957904.png,https://derpicdn.net/img/view/2015/8/14/957904.png,0,0.928030372,95,0,2001,1906,1906,1906,rainbow dash
960291.png,https://derpicdn.net/img/view/2015/8/18/960291.png,0,0.959704697,112,0,1060,818,948,818,rainbow dash
960893.jpg,https://derpicdn.net/img/view/2015/8/19/960893.jpg,0,0.999104798,466,115,1270,919,804,804,rainbow dash
962692.png,https://derpicdn.net/img/view/2015/8/21/962692.png,0,0.988464773,68,5,228,165,160,160,rainbow dash
963482.png,https://derpicdn.net/img/view/2015/8/22/963482.png,0,0.996541083,39,35,573,569,534,534,rainbow dash
964182.png,https://derpicdn.net/img/view/2015/8/23/964182.png,0,0.998859048,340,53,1008,721,668,668,rainbow dash
965272.png,https://derpicdn.net/img/view/2015/8/25/965272.png,0,0.967701018,34,0,892,819,858,819,rainbow dash
965906.png,https://derpicdn.net/img/view/2015/8/26/965906.png,0,0.991096616,141,0,527,364,386,364,rainbow dash
967500.png,https://derpicdn.net/img/view/2015/8/28/967500.png,0,0.997865856,75,0,467,375,392,375,rainbow dash
969327.png,https://derpicdn.net/img/view/2015/8/30/969327.png,0,0.993693769,275,31,1655,1411,1380,1380,rainbow dash
971841.jpg,https://derpicdn.net/img/view/2015/9/3/971841.jpg,0,0.99418205,134,46,344,256,210,210,rainbow dash
978494.png,https://derpicdn.net/img/view/2015/9/13/978494.png,0,0.99980545,210,13,1490,1293,1280,1280,rainbow dash
979043.jpg,https://derpicdn.net/img/view/2015/9/13/979043.jpg,0,0.981250525,231,352,671,792,440,440,rainbow dash
980693.png,https://derpicdn.net/img/view/2015/9/15/980693.png,0,0.986643791,118,15,1720,1617,1602,1602,rainbow dash
983301.png,https://derpicdn.net/img/view/2015/9/19/983301.png,0,0.997928441,317,0,1309,926,992,926,rainbow dash
983986.png,https://derpicdn.net/img/view/2015/9/20/983986.png,0,0.985917509,852,67,1722,937,870,870,rainbow dash
984442.png,https://derpicdn.net/img/view/2015/9/21/984442.png,0,0.998069465,69,0,877,724,808,724,rainbow dash
988962.png,https://derpicdn.net/img/view/2015/9/27/988962.png,0,0.921930015,87,28,795,736,708,708,rainbow dash
991741.png,https://derpicdn.net/img/view/2015/10/1/991741.png,0,0.97098875,452,86,922,556,470,470,rainbow dash
994948.png,https://derpicdn.net/img/view/2015/10/5/994948.png,0,0.994081855,154,16,402,264,248,248,rainbow dash
995031.png,https://derpicdn.net/img/view/2015/10/5/995031.png,0,0.964221656,582,446,890,754,308,308,rainbow dash
996307.png,https://derpicdn.net/img/view/2015/10/7/996307.png,0,0.994261265,0,0,840,823,840,823,rainbow dash
1003182.png,https://derpicdn.net/img/view/2015/10/16/1003182.png,0,0.981893599,128,0,1110,951,982,951,rainbow dash
1005355.png,https://derpicdn.net/img/view/2015/10/18/1005355.png,0,0.914471686,879,287,1535,943,656,656,rainbow dash
1005355.png,https://derpicdn.net/img/view/2015/10/18/1005355.png,1,0.905433834,52,354,584,886,532,532,rainbow dash
1014378.png,https://derpicdn.net/img/view/2015/11/1/1014378.png,0,0.92973268,0,109,1303,1601,1303,1492,rainbow dash
1014378.png,https://derpicdn.net/img/view/2015/11/1/1014378.png,0,0.92973268,0,109,1303,1601,1303,1492,rainbow dash
1014989.png,https://derpicdn.net/img/view/2015/11/2/1014989.png,0,0.914375603,170,54,688,572,518,518,rainbow dash
1016998.png,https://derpicdn.net/img/view/2015/11/6/1016998.png,0,0.9453457,195,0,325,125,130,125,rainbow dash
1020839.png,https://derpicdn.net/img/view/2015/11/11/1020839.png,0,0.998726606,669,0,1841,1140,1172,1140,rainbow dash
1023638.png,https://derpicdn.net/img/view/2015/11/15/1023638.png,0,0.999012053,757,0,3265,2452,2508,2452,rainbow dash
1029605.png,https://derpicdn.net/img/view/2015/11/24/1029605.png,0,0.999776781,289,73,753,537,464,464,rainbow dash
1033530.png,https://derpicdn.net/img/view/2015/11/30/1033530.png,0,0.990633667,32,0,534,484,502,484,rainbow dash
1034115.png,https://derpicdn.net/img/view/2015/11/30/1034115.png,0,0.996863425,91,102,3431,3442,3340,3340,rainbow dash
1034620.jpg,https://derpicdn.net/img/view/2015/12/1/1034620.jpg,0,0.983547509,36,0,444,362,408,362,rainbow dash
1035053.png,https://derpicdn.net/img/view/2015/12/2/1035053.png,0,0.999197245,82,0,586,496,504,496,rainbow dash
1035842.png,https://derpicdn.net/img/view/2015/12/3/1035842.png,0,0.977510214,0,0,367,380,367,380,rainbow dash
1039456.png,https://derpicdn.net/img/view/2015/12/8/1039456.png,0,0.978913188,184,108,808,732,624,624,rainbow dash
1039756.png,https://derpicdn.net/img/view/2015/12/8/1039756.png,0,0.986076295,104,0,600,478,496,478,rainbow dash
10450.jpg,https://derpicdn.net/img/view/2012/6/19/10450.jpg,0,0.970929623,3,0,679,540,676,540,rainbow dash
1045503.png,https://derpicdn.net/img/view/2015/12/16/1045503.png,0,0.949846983,67,9,317,259,250,250,rainbow dash
1045750.png,https://derpicdn.net/img/view/2015/12/16/1045750.png,0,0.996027827,1452,0,3587,2062,2135,2062,rainbow dash
1045750.png,https://derpicdn.net/img/view/2015/12/16/1045750.png,0,0.996027827,1452,0,3587,2062,2135,2062,rainbow dash
1050765.png,https://derpicdn.net/img/view/2015/12/23/1050765.png,0,0.96904248,0,0,574,670,574,670,rainbow dash
1053711.png,https://derpicdn.net/img/view/2015/12/27/1053711.png,1,0.96524626,0,178,229,434,229,256,rainbow dash
1053711.png,https://derpicdn.net/img/view/2015/12/27/1053711.png,1,0.96524626,0,178,229,434,229,256,rainbow dash
1054621.png,https://derpicdn.net/img/view/2015/12/28/1054621.png,0,0.997768641,514,0,1682,1116,1168,1116,rainbow dash
10566.jpg,https://derpicdn.net/img/view/2012/6/19/10566.jpg,0,0.998329997,1108,0,2750,1600,1642,1600,rainbow dash
1056998.png,https://derpicdn.net/img/view/2016/1/1/1056998.png,0,0.921329856,100,26,710,636,610,610,rainbow dash
1058395.png,https://derpicdn.net/img/view/2016/1/3/1058395.png,0,0.962962866,83,50,669,636,586,586,rainbow dash
1068108.png,https://derpicdn.net/img/view/2016/1/17/1068108.png,0,0.912148893,3442,0,6744,3179,3302,3179,rainbow dash
1071458.png,https://derpicdn.net/img/view/2016/1/22/1071458.png,0,0.999462605,221,30,1693,1502,1472,1472,rainbow dash
1075852.png,https://derpicdn.net/img/view/2016/1/29/1075852.png,0,0.919555426,0,109,1885,2775,1885,2666,rainbow dash
1076716.png,https://derpicdn.net/img/view/2016/1/30/1076716.png,0,0.971264243,1780,0,5340,4126,3560,4126,rainbow dash
1076840.png,https://derpicdn.net/img/view/2016/1/30/1076840.png,0,0.956883013,192,0,872,675,680,675,rainbow dash
1078119.png,https://derpicdn.net/img/view/2016/2/1/1078119.png,0,0.99861002,303,28,651,376,348,348,rainbow dash
1083867.png,https://derpicdn.net/img/view/2016/2/9/1083867.png,0,0.995202422,672,37,2090,1455,1418,1418,rainbow dash
1088058.png,https://derpicdn.net/img/view/2016/2/14/1088058.png,0,0.979730427,176,1672,1614,3110,1438,1438,rainbow dash
1088924.png,https://derpicdn.net/img/view/2016/2/15/1088924.png,0,0.951607943,70,32,340,302,270,270,rainbow dash
1088924.png,https://derpicdn.net/img/view/2016/2/15/1088924.png,0,0.951607943,70,32,340,302,270,270,rainbow dash
11000.png,https://derpicdn.net/img/view/2012/6/20/11000.png,0,0.973806381,193,0,553,341,360,341,rainbow dash
1101888.png,https://derpicdn.net/img/view/2016/3/4/1101888.png,0,0.972072542,2222,0,4182,1887,1960,1887,rainbow dash
1103144.png,https://derpicdn.net/img/view/2016/3/6/1103144.png,0,0.995460987,1290,91,3043,1885,1753,1794,rainbow dash
1103676.png,https://derpicdn.net/img/view/2016/3/7/1103676.png,0,0.946521938,369,0,1157,753,788,753,rainbow dash
1111567.png,https://derpicdn.net/img/view/2016/3/18/1111567.png,0,0.999150991,125,4,2713,2592,2588,2588,rainbow dash
1115309.png,https://derpicdn.net/img/view/2016/3/23/1115309.png,0,0.991712332,149,0,1217,1049,1068,1049,rainbow dash
1119707.png,https://derpicdn.net/img/view/2016/3/29/1119707.png,0,0.986659765,223,0,1043,756,820,756,rainbow dash
1121083.png,https://derpicdn.net/img/view/2016/3/31/1121083.png,0,0.993340254,80,0,1270,1155,1190,1155,rainbow dash
1121717.png,https://derpicdn.net/img/view/2016/4/1/1121717.png,0,0.983030319,1425,254,2257,1086,832,832,rainbow dash
1127744.png,https://derpicdn.net/img/view/2016/4/8/1127744.png,0,0.978962898,124,270,490,636,366,366,rainbow dash
1128992.png,https://derpicdn.net/img/view/2016/4/10/1128992.png,0,0.997026682,389,15,869,495,480,480,rainbow dash
1139959.png,https://derpicdn.net/img/view/2016/4/25/1139959.png,0,0.975936234,257,32,539,314,282,282,rainbow dash
1149241.png,https://derpicdn.net/img/view/2016/5/8/1149241.png,0,0.99779731,338,0,789,441,451,441,rainbow dash
1149241.png,https://derpicdn.net/img/view/2016/5/8/1149241.png,0,0.99779731,338,0,789,441,451,441,rainbow dash
1149243.png,https://derpicdn.net/img/view/2016/5/8/1149243.png,0,0.906414151,38,26,714,702,676,676,rainbow dash
1152814.png,https://derpicdn.net/img/view/2016/5/13/1152814.png,0,0.993980229,1462,0,3438,1898,1976,1898,rainbow dash
1159206.png,https://derpicdn.net/img/view/2016/5/21/1159206.png,0,0.991604686,1344,0,2248,895,904,895,rainbow dash
1165392.png,https://derpicdn.net/img/view/2016/5/29/1165392.png,0,0.923263133,581,151,995,565,414,414,rainbow dash
1171765.png,https://derpicdn.net/img/view/2016/6/6/1171765.png,0,0.947778046,930,0,3670,2359,2740,2359,rainbow dash
1174251.png,https://derpicdn.net/img/view/2016/6/9/1174251.png,0,0.982659578,54,0,678,567,624,567,rainbow dash
1185824.jpg,https://derpicdn.net/img/view/2016/6/24/1185824.jpg,0,0.996472478,166,0,592,422,426,422,rainbow dash
1189919.png,https://derpicdn.net/img/view/2016/6/30/1189919.png,0,0.999337971,551,14,971,434,420,420,rainbow dash
1190454.png,https://derpicdn.net/img/view/2016/6/30/1190454.png,0,0.999438763,336,0,1076,707,740,707,rainbow dash
1191690.png,https://derpicdn.net/img/view/2016/7/2/1191690.png,0,0.975919962,370,0,782,411,412,411,rainbow dash
1191804.png,https://derpicdn.net/img/view/2016/7/2/1191804.png,0,0.994104564,211,0,745,520,534,520,rainbow dash
1191926.png,https://derpicdn.net/img/view/2016/7/2/1191926.png,0,0.92032218,4,121,462,579,458,458,rainbow dash
1196291.png,https://derpicdn.net/img/view/2016/7/8/1196291.png,0,0.998124123,130,0,2452,2286,2322,2286,rainbow dash
1196709.png,https://derpicdn.net/img/view/2016/7/9/1196709.png,0,0.994468927,0,0,465,460,465,460,rainbow dash
12002.png,https://derpicdn.net/img/view/2012/6/20/12002.png,0,0.996051013,91,0,635,536,544,536,rainbow dash
1200268.png,https://derpicdn.net/img/view/2016/7/14/1200268.png,0,0.996639669,305,56,1197,948,892,892,rainbow dash
120060.jpg,https://derpicdn.net/img/view/2012/10/11/120060.jpg,0,0.924818277,1421,566,1697,842,276,276,rainbow dash
1203203.png,https://derpicdn.net/img/view/2016/7/17/1203203.png,0,0.998464167,1807,205,2805,1203,998,998,rainbow dash
1207296.png,https://derpicdn.net/img/view/2016/7/23/1207296.png,0,0.998204529,358,76,1004,722,646,646,rainbow dash
12085.jpg,https://derpicdn.net/img/view/2012/6/20/12085.jpg,0,0.993101716,46,79,466,499,420,420,rainbow dash
1212538.png,https://derpicdn.net/img/view/2016/7/30/1212538.png,0,0.966400623,0,0,341,340,341,340,rainbow dash
1212577.png,https://derpicdn.net/img/view/2016/7/30/1212577.png,0,0.917319,377,0,1341,720,964,720,rainbow dash
1212577.png,https://derpicdn.net/img/view/2016/7/30/1212577.png,0,0.917319,377,0,1341,720,964,720,rainbow dash
1212709.png,https://derpicdn.net/img/view/2016/7/30/1212709.png,0,0.995978713,0,176,676,920,676,744,rainbow dash
1212925.png,https://derpicdn.net/img/view/2016/7/30/1212925.png,0,0.911067724,0,4,254,270,254,266,rainbow dash
1213624.png,https://derpicdn.net/img/view/2016/7/31/1213624.png,0,0.993993819,211,0,581,334,370,334,rainbow dash
1214037.png,https://derpicdn.net/img/view/2016/8/1/1214037.png,0,0.999312758,716,7,944,235,228,228,rainbow dash
1214037.png,https://derpicdn.net/img/view/2016/8/1/1214037.png,1,0.999275744,668,549,916,797,248,248,rainbow dash
1214037.png,https://derpicdn.net/img/view/2016/8/1/1214037.png,2,0.987454772,166,693,326,853,160,160,rainbow dash
1214058.png,https://derpicdn.net/img/view/2016/8/1/1214058.png,0,0.990626156,58,0,460,365,402,365,rainbow dash
1214495.png,https://derpicdn.net/img/view/2016/8/1/1214495.png,0,0.99437052,185,1,463,279,278,278,rainbow dash
1216787.png,https://derpicdn.net/img/view/2016/8/4/1216787.png,0,0.994430244,636,92,1066,522,430,430,rainbow dash
1216787.png,https://derpicdn.net/img/view/2016/8/4/1216787.png,1,0.946216285,117,0,581,441,464,441,rainbow dash
1217274.png,https://derpicdn.net/img/view/2016/8/5/1217274.png,0,0.990867019,24,0,510,471,486,471,rainbow dash
1218717.png,https://derpicdn.net/img/view/2016/8/6/1218717.png,0,0.976892829,505,0,1631,870,1126,870,rainbow dash
1218806.png,https://derpicdn.net/img/view/2016/8/6/1218806.png,0,0.999736369,361,6,859,504,498,498,rainbow dash
1221824.png,https://derpicdn.net/img/view/2016/8/10/1221824.png,0,0.914920568,131,0,859,724,728,724,rainbow dash
1224254.png,https://derpicdn.net/img/view/2016/8/13/1224254.png,0,0.996178865,594,104,958,468,364,364,rainbow dash
1229912.png,https://derpicdn.net/img/view/2016/8/20/1229912.png,0,0.989861965,447,0,793,327,346,327,rainbow dash
1232096.png,https://derpicdn.net/img/view/2016/8/23/1232096.png,0,0.989418149,878,0,2050,1144,1172,1144,rainbow dash
124267.png,https://derpicdn.net/img/view/2012/10/16/124267.png,0,0.978828251,176,0,406,220,230,220,rainbow dash
1247407.png,https://derpicdn.net/img/view/2016/9/12/1247407.png,0,0.991744637,666,534,1146,1014,480,480,rainbow dash
1261241.png,https://derpicdn.net/img/view/2016/9/29/1261241.png,0,0.984552562,57,0,1477,1526,1420,1526,rainbow dash
1262.png,https://derpicdn.net/img/view/2012/1/22/1262.png,0,0.987902343,34,144,388,498,354,354,rainbow dash
1269008.png,https://derpicdn.net/img/view/2016/10/9/1269008.png,0,0.998026013,404,0,1308,833,904,833,rainbow dash
1273835.png,https://derpicdn.net/img/view/2016/10/15/1273835.png,0,0.921507716,0,0,243,260,243,260,rainbow dash
1275153.png,https://derpicdn.net/img/view/2016/10/17/1275153.png,0,0.93566978,0,0,1814,1986,1814,1986,rainbow dash
1299620.png,https://derpicdn.net/img/view/2016/11/20/1299620.png,0,0.999511778,113,0,737,603,624,603,rainbow dash
13106.png,https://derpicdn.net/img/view/2012/6/21/13106.png,0,0.990611672,176,45,620,489,444,444,rainbow dash
131682.jpg,https://derpicdn.net/img/view/2012/10/25/131682.jpg,0,0.998936474,1453,347,3727,2621,2274,2274,rainbow dash
1329071.png,https://derpicdn.net/img/view/2016/12/31/1329071.png,0,0.998482823,3580,0,7300,3427,3720,3427,rainbow dash
1330916.png,https://derpicdn.net/img/view/2017/1/3/1330916.png,0,0.993054509,97,0,685,566,588,566,rainbow dash
1334170.png,https://derpicdn.net/img/view/2017/1/7/1334170.png,0,0.941933155,386,50,1350,900,964,850,rainbow dash
1334170.png,https://derpicdn.net/img/view/2017/1/7/1334170.png,1,0.93698734,28,38,1048,900,1020,862,rainbow dash
1340482.png,https://derpicdn.net/img/view/2017/1/16/1340482.png,0,0.903784573,295,0,891,587,596,587,rainbow dash
1340899.png,https://derpicdn.net/img/view/2017/1/16/1340899.png,0,0.990799606,492,27,730,265,238,238,rainbow dash
1340899.png,https://derpicdn.net/img/view/2017/1/16/1340899.png,1,0.989407361,490,726,706,942,216,216,rainbow dash
13421.jpg,https://derpicdn.net/img/view/2012/6/21/13421.jpg,0,0.973946095,297,375,1029,1107,732,732,rainbow dash
1342747.png,https://derpicdn.net/img/view/2017/1/19/1342747.png,0,0.993756235,947,119,1971,1143,1024,1024,rainbow dash
1343836.png,https://derpicdn.net/img/view/2017/1/20/1343836.png,0,0.987722576,135,0,1000,855,865,855,rainbow dash
1347.jpg,https://derpicdn.net/img/view/2012/1/22/1347.jpg,0,0.905298471,366,2,728,364,362,362,rainbow dash
1359323.png,https://derpicdn.net/img/view/2017/2/10/1359323.png,0,0.999164045,2414,195,3076,857,662,662,rainbow dash
135941.png,https://derpicdn.net/img/view/2012/10/29/135941.png,0,0.998595834,128,0,472,318,344,318,rainbow dash
1361079.png,https://derpicdn.net/img/view/2017/2/12/1361079.png,0,0.999650836,227,0,633,387,406,387,rainbow dash
1362265.png,https://derpicdn.net/img/view/2017/2/14/1362265.png,0,0.902007699,85,69,779,763,694,694,rainbow dash
1362637.png,https://derpicdn.net/img/view/2017/2/14/1362637.png,0,0.933123171,100,270,728,898,628,628,rainbow dash
1365023.png,https://derpicdn.net/img/view/2017/2/17/1365023.png,0,0.999545276,66,0,1530,1293,1464,1293,rainbow dash
1380351.png,https://derpicdn.net/img/view/2017/3/5/1380351.png,0,0.991650939,577,234,781,438,204,204,rainbow dash
1383399.png,https://derpicdn.net/img/view/2017/3/10/1383399.png,0,0.990553677,193,123,427,357,234,234,rainbow dash
1389286.png,https://derpicdn.net/img/view/2017/3/17/1389286.png,0,0.952700019,39,0,727,671,688,671,rainbow dash
1389456.png,https://derpicdn.net/img/view/2017/3/17/1389456.png,0,0.903623283,139,37,443,341,304,304,rainbow dash
1391570.png,https://derpicdn.net/img/view/2017/3/19/1391570.png,0,0.995421886,616,146,896,426,280,280,rainbow dash
1396489.png,https://derpicdn.net/img/view/2017/3/25/1396489.png,0,0.994372129,1086,67,1992,973,906,906,rainbow dash
1397401.png,https://derpicdn.net/img/view/2017/3/27/1397401.png,0,0.969704747,58,0,726,647,668,647,rainbow dash
1400361.png,https://derpicdn.net/img/view/2017/3/31/1400361.png,0,0.993942201,424,0,1312,1010,888,1010,rainbow dash
1400373.png,https://derpicdn.net/img/view/2017/3/31/1400373.png,0,0.989845634,1666,0,4267,2685,2601,2685,rainbow dash
1401748.png,https://derpicdn.net/img/view/2017/4/1/1401748.png,0,0.974164248,605,0,1207,601,602,601,rainbow dash
1403452.png,https://derpicdn.net/img/view/2017/4/3/1403452.png,0,0.999106288,93,0,1419,1269,1326,1269,rainbow dash
1408070.png,https://derpicdn.net/img/view/2017/4/10/1408070.png,0,0.996561825,284,0,966,650,682,650,rainbow dash
1408070.png,https://derpicdn.net/img/view/2017/4/10/1408070.png,0,0.996561825,284,0,966,650,682,650,rainbow dash
1408364.png,https://derpicdn.net/img/view/2017/4/10/1408364.png,0,0.943162739,0,231,900,1260,900,1029,rainbow dash
1414556.png,https://derpicdn.net/img/view/2017/4/17/1414556.png,0,0.93862915,1361,358,1869,866,508,508,rainbow dash
1417925.png,https://derpicdn.net/img/view/2017/4/21/1417925.png,0,0.999692559,280,157,524,401,244,244,rainbow dash
1419374.png,https://derpicdn.net/img/view/2017/4/23/1419374.png,0,0.970389009,197,13,833,649,636,636,rainbow dash
1421084.png,https://derpicdn.net/img/view/2017/4/25/1421084.png,0,0.996824801,329,148,1271,1090,942,942,rainbow dash
1423396.png,https://derpicdn.net/img/view/2017/4/28/1423396.png,0,0.965178251,359,0,1533,1146,1174,1146,rainbow dash
1425164.png,https://derpicdn.net/img/view/2017/4/30/1425164.png,0,0.994048774,219,6,579,366,360,360,rainbow dash
1425968.png,https://derpicdn.net/img/view/2017/5/1/1425968.png,0,0.981416643,584,70,1168,654,584,584,rainbow dash
1427898.png,https://derpicdn.net/img/view/2017/5/3/1427898.png,0,0.900669694,213,48,559,394,346,346,rainbow dash
1432570.png,https://derpicdn.net/img/view/2017/5/9/1432570.png,0,0.998535454,257,262,725,730,468,468,rainbow dash
1432614.png,https://derpicdn.net/img/view/2017/5/9/1432614.png,0,0.999114215,37,0,639,498,602,498,rainbow dash
1433175.png,https://derpicdn.net/img/view/2017/5/10/1433175.png,0,0.987852931,56,0,346,258,290,258,rainbow dash
1433175.png,https://derpicdn.net/img/view/2017/5/10/1433175.png,1,0.911266029,316,0,700,338,384,338,rainbow dash
1433511.png,https://derpicdn.net/img/view/2017/5/10/1433511.png,0,0.99527806,222,60,1674,1512,1452,1452,rainbow dash
1434270.png,https://derpicdn.net/img/view/2017/5/11/1434270.png,0,0.994055331,837,832,1347,1342,510,510,rainbow dash
1434759.png,https://derpicdn.net/img/view/2017/5/12/1434759.png,0,0.969165742,487,340,1095,948,608,608,rainbow dash
1437824.png,https://derpicdn.net/img/view/2017/5/16/1437824.png,0,0.919015467,84,0,714,621,630,621,rainbow dash
1446910.png,https://derpicdn.net/img/view/2017/5/27/1446910.png,0,0.995757878,500,0,3778,3249,3278,3249,rainbow dash
1447355.png,https://derpicdn.net/img/view/2017/5/27/1447355.png,0,0.995166957,755,24,1115,384,360,360,rainbow dash
1450241.png,https://derpicdn.net/img/view/2017/5/30/1450241.png,0,0.996827006,434,0,1228,718,794,718,rainbow dash
1450304.png,https://derpicdn.net/img/view/2017/5/31/1450304.png,0,0.979057014,0,47,505,599,505,552,rainbow dash
1452914.png,https://derpicdn.net/img/view/2017/6/3/1452914.png,0,0.972244799,16,0,512,480,496,480,rainbow dash
1454391.png,https://derpicdn.net/img/view/2017/6/5/1454391.png,0,0.999140739,291,425,1175,1309,884,884,rainbow dash
1455201.png,https://derpicdn.net/img/view/2017/6/6/1455201.png,0,0.99943608,179,107,557,485,378,378,rainbow dash
1455389.png,https://derpicdn.net/img/view/2017/6/6/1455389.png,1,0.98091954,151,178,757,784,606,606,rainbow dash
1458596.png,https://derpicdn.net/img/view/2017/6/10/1458596.png,0,0.997764051,536,0,1356,800,820,800,rainbow dash
1459712.png,https://derpicdn.net/img/view/2017/6/12/1459712.png,0,0.993957281,132,0,606,422,474,422,rainbow dash
1460063.png,https://derpicdn.net/img/view/2017/6/12/1460063.png,0,0.983449519,768,0,1594,702,826,702,rainbow dash
1468674.png,https://derpicdn.net/img/view/2017/6/22/1468674.png,0,0.983218193,5,35,673,703,668,668,rainbow dash
1469744.png,https://derpicdn.net/img/view/2017/6/23/1469744.png,0,0.996318817,572,351,1922,1701,1350,1350,rainbow dash
1470951.png,https://derpicdn.net/img/view/2017/6/25/1470951.png,0,0.995527983,203,63,465,325,262,262,rainbow dash
1471264.png,https://derpicdn.net/img/view/2017/6/25/1471264.png,0,0.951814353,727,91,1193,557,466,466,rainbow dash
1471564.png,https://derpicdn.net/img/view/2017/6/25/1471564.png,0,0.996692061,293,4,553,264,260,260,rainbow dash
1471564.png,https://derpicdn.net/img/view/2017/6/25/1471564.png,0,0.996692061,293,4,553,264,260,260,rainbow dash
1474288.png,https://derpicdn.net/img/view/2017/6/29/1474288.png,0,0.985512793,0,0,621,642,621,642,rainbow dash
1474536.png,https://derpicdn.net/img/view/2017/6/29/1474536.png,0,0.991956651,102,0,1000,957,898,957,rainbow dash
1474536.png,https://derpicdn.net/img/view/2017/6/29/1474536.png,0,0.991956651,102,0,1000,957,898,957,rainbow dash
1475542.png,https://derpicdn.net/img/view/2017/6/30/1475542.png,0,0.982761204,0,0,630,623,630,623,rainbow dash
1475821.png,https://derpicdn.net/img/view/2017/7/1/1475821.png,0,0.953308702,189,16,415,242,226,226,rainbow dash
1482570.png,https://derpicdn.net/img/view/2017/7/9/1482570.png,0,0.998811722,516,17,1148,649,632,632,rainbow dash
1484137.png,https://derpicdn.net/img/view/2017/7/11/1484137.png,0,0.999759376,533,233,1067,767,534,534,rainbow dash
1485474.png,https://derpicdn.net/img/view/2017/7/13/1485474.png,0,0.986654222,0,0,810,793,810,793,rainbow dash
1485753.png,https://derpicdn.net/img/view/2017/7/14/1485753.png,0,0.976198196,1040,83,1398,441,358,358,rainbow dash
1489005.png,https://derpicdn.net/img/view/2017/7/18/1489005.png,0,0.936735034,159,110,507,458,348,348,rainbow dash
1490622.png,https://derpicdn.net/img/view/2017/7/20/1490622.png,0,0.965652049,0,0,2705,2998,2705,2998,rainbow dash
1492851.png,https://derpicdn.net/img/view/2017/7/23/1492851.png,0,0.966468751,254,87,618,451,364,364,rainbow dash
1493758.png,https://derpicdn.net/img/view/2017/7/24/1493758.png,0,0.995974064,0,0,1213,1251,1213,1251,rainbow dash
1495634.png,https://derpicdn.net/img/view/2017/7/26/1495634.png,0,0.996003985,126,0,824,670,698,670,rainbow dash
1498092.png,https://derpicdn.net/img/view/2017/7/30/1498092.png,0,0.981542349,1189,492,1939,1242,750,750,rainbow dash
1498431.png,https://derpicdn.net/img/view/2017/7/30/1498431.png,0,0.910294116,263,20,695,452,432,432,rainbow dash
1500077.png,https://derpicdn.net/img/view/2017/8/1/1500077.png,0,0.992153764,107,0,1200,1096,1093,1096,rainbow dash
150015.png,https://derpicdn.net/img/view/2012/11/12/150015.png,0,0.91848886,141,1050,3921,4638,3780,3588,rainbow dash
1501912.png,https://derpicdn.net/img/view/2017/8/3/1501912.png,0,0.986611068,1278,0,2804,1478,1526,1478,rainbow dash
1508192.png,https://derpicdn.net/img/view/2017/8/11/1508192.png,0,0.99974817,230,7,1464,1241,1234,1234,rainbow dash
1508192.png,https://derpicdn.net/img/view/2017/8/11/1508192.png,0,0.99974817,230,7,1464,1241,1234,1234,rainbow dash
1514421.png,https://derpicdn.net/img/view/2017/8/19/1514421.png,0,0.995097458,14,0,500,425,486,425,rainbow dash
15154.png,https://derpicdn.net/img/view/2012/6/22/15154.png,0,0.99366343,710,380,2698,2368,1988,1988,rainbow dash
1518349.png,https://derpicdn.net/img/view/2017/8/23/1518349.png,0,0.994461954,179,0,945,704,766,704,rainbow dash
1518942.png,https://derpicdn.net/img/view/2017/8/24/1518942.png,0,0.926240265,208,63,476,331,268,268,rainbow dash
1518943.png,https://derpicdn.net/img/view/2017/8/24/1518943.png,0,0.931389332,505,69,837,401,332,332,rainbow dash
1521778.png,https://derpicdn.net/img/view/2017/8/28/1521778.png,0,0.986952782,45,0,539,469,494,469,rainbow dash
1521843.png,https://derpicdn.net/img/view/2017/8/28/1521843.png,0,0.995489478,206,0,787,529,581,529,rainbow dash
1521860.png,https://derpicdn.net/img/view/2017/8/28/1521860.png,0,0.996796131,126,0,1158,983,1032,983,rainbow dash
1523614.png,https://derpicdn.net/img/view/2017/8/30/1523614.png,0,0.951981485,944,139,1478,673,534,534,rainbow dash
1524887.png,https://derpicdn.net/img/view/2017/9/1/1524887.png,0,0.992573977,146,0,774,601,628,601,rainbow dash
1525652.png,https://derpicdn.net/img/view/2017/9/2/1525652.png,0,0.991493762,274,0,820,483,546,483,rainbow dash
1527838.png,https://derpicdn.net/img/view/2017/9/4/1527838.png,0,0.969431758,408,374,952,918,544,544,rainbow dash
1531885.png,https://derpicdn.net/img/view/2017/9/10/1531885.png,0,0.995756388,60,199,570,709,510,510,rainbow dash
1532010.png,https://derpicdn.net/img/view/2017/9/10/1532010.png,0,0.990358472,396,20,1200,906,804,886,rainbow dash
1533300.png,https://derpicdn.net/img/view/2017/9/11/1533300.png,0,0.974286139,30,0,490,440,460,440,rainbow dash
1536336.png,https://derpicdn.net/img/view/2017/9/16/1536336.png,0,0.991623759,917,0,2071,1102,1154,1102,rainbow dash
1538981.png,https://derpicdn.net/img/view/2017/9/18/1538981.png,0,0.99594903,205,0,551,345,346,345,rainbow dash
1539494.png,https://derpicdn.net/img/view/2017/9/19/1539494.png,0,0.976724327,0,108,1920,2094,1920,1986,rainbow dash
1540225.png,https://derpicdn.net/img/view/2017/9/20/1540225.png,0,0.99673152,804,342,1642,1180,838,838,rainbow dash
1540853.png,https://derpicdn.net/img/view/2017/9/21/1540853.png,0,0.994199395,19,0,784,735,765,735,rainbow dash
1542050.png,https://derpicdn.net/img/view/2017/9/22/1542050.png,0,0.968330324,0,0,1234,1150,1234,1150,rainbow dash
1542050.png,https://derpicdn.net/img/view/2017/9/22/1542050.png,0,0.968330324,0,0,1234,1150,1234,1150,rainbow dash
1545835.png,https://derpicdn.net/img/view/2017/9/27/1545835.png,0,0.992911816,249,68,669,488,420,420,rainbow dash
1545962.png,https://derpicdn.net/img/view/2017/9/27/1545962.png,0,0.991050065,247,0,947,613,700,613,rainbow dash
1550128.png,https://derpicdn.net/img/view/2017/10/2/1550128.png,0,0.996917367,614,63,1260,709,646,646,rainbow dash
1550258.png,https://derpicdn.net/img/view/2017/10/2/1550258.png,0,0.957826138,0,0,972,925,972,925,rainbow dash
1557272.png,https://derpicdn.net/img/view/2017/10/10/1557272.png,0,0.992075503,93,1,401,309,308,308,rainbow dash
1557272.png,https://derpicdn.net/img/view/2017/10/10/1557272.png,1,0.968973577,213,273,537,597,324,324,rainbow dash
156177.png,https://derpicdn.net/img/view/2012/11/18/156177.png,0,0.990263999,279,0,541,253,262,253,rainbow dash
1564892.png,https://derpicdn.net/img/view/2017/10/19/1564892.png,0,0.996048093,250,0,1234,944,984,944,rainbow dash
1566446.png,https://derpicdn.net/img/view/2017/10/21/1566446.png,0,0.972194731,143,89,557,503,414,414,rainbow dash
1569473.png,https://derpicdn.net/img/view/2017/10/24/1569473.png,0,0.987046242,40,0,476,436,436,436,rainbow dash
1569473.png,https://derpicdn.net/img/view/2017/10/24/1569473.png,0,0.987046242,40,0,476,436,436,436,rainbow dash
1569504.png,https://derpicdn.net/img/view/2017/10/24/1569504.png,0,0.98887229,335,69,1425,1159,1090,1090,rainbow dash
1572777.png,https://derpicdn.net/img/view/2017/10/29/1572777.png,0,0.995762706,270,0,646,359,376,359,rainbow dash
1573989.png,https://derpicdn.net/img/view/2017/10/30/1573989.png,0,0.956884861,2321,519,5029,3227,2708,2708,rainbow dash
1574907.png,https://derpicdn.net/img/view/2017/10/31/1574907.png,0,0.973828495,41,0,1021,912,980,912,rainbow dash
1575548.png,https://derpicdn.net/img/view/2017/11/1/1575548.png,0,0.998311937,37,0,509,451,472,451,rainbow dash
1576443.png,https://derpicdn.net/img/view/2017/11/2/1576443.png,0,0.95814985,0,292,4768,6020,4768,5728,rainbow dash
15766.jpg,https://derpicdn.net/img/view/2012/6/22/15766.jpg,0,0.995277703,282,69,646,433,364,364,rainbow dash
15766.jpg,https://derpicdn.net/img/view/2012/6/22/15766.jpg,0,0.995277703,282,69,646,433,364,364,rainbow dash
1579610.png,https://derpicdn.net/img/view/2017/11/6/1579610.png,0,0.987968981,965,23,2987,2045,2022,2022,rainbow dash
1580154.png,https://derpicdn.net/img/view/2017/11/7/1580154.png,0,0.951531768,144,168,1894,1900,1750,1732,rainbow dash
1584654.png,https://derpicdn.net/img/view/2017/11/12/1584654.png,0,0.928498805,0,0,2339,2771,2339,2771,rainbow dash
1584808.png,https://derpicdn.net/img/view/2017/11/12/1584808.png,0,0.997249484,195,0,855,628,660,628,rainbow dash
1584808.png,https://derpicdn.net/img/view/2017/11/12/1584808.png,0,0.997249484,195,0,855,628,660,628,rainbow dash
1589112.png,https://derpicdn.net/img/view/2017/11/18/1589112.png,0,0.981704533,161,0,927,664,766,664,rainbow dash
15909.png,https://derpicdn.net/img/view/2012/6/22/15909.png,0,0.993029773,358,2,598,242,240,240,rainbow dash
159107.jpg,https://derpicdn.net/img/view/2012/11/21/159107.jpg,0,0.998214662,130,0,360,216,230,216,rainbow dash
159107.jpg,https://derpicdn.net/img/view/2012/11/21/159107.jpg,0,0.998214662,130,0,360,216,230,216,rainbow dash
1593011.png,https://derpicdn.net/img/view/2017/11/24/1593011.png,0,0.965832829,0,0,3000,4414,3000,4414,rainbow dash
1593537.png,https://derpicdn.net/img/view/2017/11/25/1593537.png,0,0.995048344,5,0,467,432,462,432,rainbow dash
1594365.png,https://derpicdn.net/img/view/2017/11/26/1594365.png,0,0.999087453,831,111,2083,1363,1252,1252,rainbow dash
1595216.png,https://derpicdn.net/img/view/2017/11/27/1595216.png,0,0.999387622,992,109,2564,1681,1572,1572,rainbow dash
1595254.png,https://derpicdn.net/img/view/2017/11/27/1595254.png,0,0.940643251,69,0,549,475,480,475,rainbow dash
1596908.png,https://derpicdn.net/img/view/2017/11/29/1596908.png,0,0.936926842,378,0,2182,1797,1804,1797,rainbow dash
1600896.png,https://derpicdn.net/img/view/2017/12/5/1600896.png,0,0.996351779,249,57,895,703,646,646,rainbow dash
1601600.png,https://derpicdn.net/img/view/2017/12/6/1601600.png,0,0.99683404,2217,0,3511,1123,1294,1123,rainbow dash
1605814.png,https://derpicdn.net/img/view/2017/12/12/1605814.png,0,0.98931241,621,267,2307,1953,1686,1686,rainbow dash
1608266.png,https://derpicdn.net/img/view/2017/12/15/1608266.png,0,0.989546537,31,0,531,498,500,498,rainbow dash
1608303.png,https://derpicdn.net/img/view/2017/12/15/1608303.png,0,0.95821929,1012,74,1806,868,794,794,rainbow dash
1608304.png,https://derpicdn.net/img/view/2017/12/15/1608304.png,0,0.966983318,1015,77,1803,865,788,788,rainbow dash
1612315.png,https://derpicdn.net/img/view/2017/12/20/1612315.png,0,0.989674687,139,225,521,607,382,382,rainbow dash
1612419.png,https://derpicdn.net/img/view/2017/12/21/1612419.png,0,0.984280527,192,47,734,589,542,542,rainbow dash
1612820.png,https://derpicdn.net/img/view/2017/12/21/1612820.png,0,0.98543489,0,0,1461,1311,1461,1311,rainbow dash
1614200.png,https://derpicdn.net/img/view/2017/12/23/1614200.png,0,0.998806298,573,0,1287,683,714,683,rainbow dash
1614200.png,https://derpicdn.net/img/view/2017/12/23/1614200.png,0,0.998806298,573,0,1287,683,714,683,rainbow dash
1615560.png,https://derpicdn.net/img/view/2017/12/25/1615560.png,0,0.999553978,263,51,629,417,366,366,rainbow dash
1615963.png,https://derpicdn.net/img/view/2017/12/25/1615963.png,0,0.961055815,0,0,596,563,596,563,rainbow dash
1619970.png,https://derpicdn.net/img/view/2017/12/30/1619970.png,0,0.995930076,62,0,1254,1147,1192,1147,rainbow dash
1620394.png,https://derpicdn.net/img/view/2017/12/31/1620394.png,0,0.989007831,86,143,390,447,304,304,rainbow dash
1621003.png,https://derpicdn.net/img/view/2017/12/31/1621003.png,0,0.967498302,0,167,1173,1280,1173,1113,rainbow dash
1621253.png,https://derpicdn.net/img/view/2018/1/1/1621253.png,0,0.927863777,2069,282,3063,1276,994,994,rainbow dash
1623141.png,https://derpicdn.net/img/view/2018/1/3/1623141.png,0,0.990692258,35,0,569,503,534,503,rainbow dash
1623591.png,https://derpicdn.net/img/view/2018/1/4/1623591.png,0,0.970846891,627,17,1587,977,960,960,rainbow dash
1623682.png,https://derpicdn.net/img/view/2018/1/4/1623682.png,0,0.996258974,936,46,1920,1030,984,984,rainbow dash
1623794.png,https://derpicdn.net/img/view/2018/1/4/1623794.png,0,0.996894896,28,54,492,518,464,464,rainbow dash
16261.jpg,https://derpicdn.net/img/view/2012/6/23/16261.jpg,0,0.987773538,813,105,2027,1343,1214,1238,rainbow dash
1626151.png,https://derpicdn.net/img/view/2018/1/7/1626151.png,0,0.985706925,465,13,929,477,464,464,rainbow dash
1629809.png,https://derpicdn.net/img/view/2018/1/11/1629809.png,0,0.979220569,32,0,1678,1080,1646,1080,rainbow dash
1634750.png,https://derpicdn.net/img/view/2018/1/18/1634750.png,0,0.997256696,1237,35,3181,1979,1944,1944,rainbow dash
1635026.png,https://derpicdn.net/img/view/2018/1/18/1635026.png,0,0.998280048,493,0,1069,531,576,531,rainbow dash
1638321.png,https://derpicdn.net/img/view/2018/1/22/1638321.png,0,0.958296955,362,0,968,580,606,580,rainbow dash
1640923.png,https://derpicdn.net/img/view/2018/1/25/1640923.png,0,0.947776377,6,35,552,581,546,546,rainbow dash
1641631.png,https://derpicdn.net/img/view/2018/1/26/1641631.png,0,0.927455366,1075,43,1401,369,326,326,rainbow dash
1642736.png,https://derpicdn.net/img/view/2018/1/28/1642736.png,0,0.99220407,170,61,986,877,816,816,rainbow dash
1642970.png,https://derpicdn.net/img/view/2018/1/28/1642970.png,0,0.919594526,109,0,711,602,602,602,rainbow dash
1645292.png,https://derpicdn.net/img/view/2018/1/31/1645292.png,0,0.999478817,0,0,1150,976,1150,976,rainbow dash
1645604.png,https://derpicdn.net/img/view/2018/1/31/1645604.png,0,0.99190259,348,0,1694,1309,1346,1309,rainbow dash
1646466.png,https://derpicdn.net/img/view/2018/2/2/1646466.png,0,0.928866088,0,598,632,1272,632,674,rainbow dash
1649638.png,https://derpicdn.net/img/view/2018/2/6/1649638.png,0,0.983005226,0,39,532,633,532,594,rainbow dash
1650309.png,https://derpicdn.net/img/view/2018/2/7/1650309.png,0,0.926374853,420,65,800,445,380,380,rainbow dash
1653002.png,https://derpicdn.net/img/view/2018/2/11/1653002.png,0,0.99546814,534,46,972,484,438,438,rainbow dash
1653351.png,https://derpicdn.net/img/view/2018/2/11/1653351.png,0,0.999538243,1112,0,2468,1356,1356,1356,rainbow dash
1656159.png,https://derpicdn.net/img/view/2018/2/14/1656159.png,0,0.997865498,300,14,814,528,514,514,rainbow dash
1657218.png,https://derpicdn.net/img/view/2018/2/16/1657218.png,0,0.945151865,261,0,2677,2191,2416,2191,rainbow dash
1661785.png,https://derpicdn.net/img/view/2018/2/21/1661785.png,0,0.972151697,799,0,2735,1689,1936,1689,rainbow dash
1662010.png,https://derpicdn.net/img/view/2018/2/21/1662010.png,0,0.971363902,217,14,1829,1626,1612,1612,rainbow dash
1662601.png,https://derpicdn.net/img/view/2018/2/22/1662601.png,0,0.995763183,672,496,1228,1052,556,556,rainbow dash
1665891.png,https://derpicdn.net/img/view/2018/2/25/1665891.png,0,0.994546771,1162,0,3948,2578,2786,2578,rainbow dash
1667412.png,https://derpicdn.net/img/view/2018/2/27/1667412.png,0,0.998442829,812,449,1632,1269,820,820,rainbow dash
1671265.png,https://derpicdn.net/img/view/2018/3/4/1671265.png,0,0.9845559,260,0,672,381,412,381,rainbow dash
1672445.png,https://derpicdn.net/img/view/2018/3/5/1672445.png,0,0.983697951,4,47,674,698,670,651,rainbow dash
16727.png,https://derpicdn.net/img/view/2012/6/23/16727.png,0,0.939495325,410,61,712,363,302,302,rainbow dash
1683181.png,https://derpicdn.net/img/view/2018/3/17/1683181.png,0,0.997501194,1255,298,2529,1572,1274,1274,rainbow dash
1684856.png,https://derpicdn.net/img/view/2018/3/19/1684856.png,0,0.990841269,0,0,1712,1740,1712,1740,rainbow dash
1685224.png,https://derpicdn.net/img/view/2018/3/19/1685224.png,0,0.999007344,601,172,1559,1130,958,958,rainbow dash
1685324.png,https://derpicdn.net/img/view/2018/3/20/1685324.png,0,0.965144277,173,0,2711,2459,2538,2459,rainbow dash
1686103.png,https://derpicdn.net/img/view/2018/3/20/1686103.png,0,0.99625504,237,0,899,519,662,519,rainbow dash
1691764.png,https://derpicdn.net/img/view/2018/3/27/1691764.png,0,0.999330699,422,0,624,199,202,199,rainbow dash
1691837.png,https://derpicdn.net/img/view/2018/3/27/1691837.png,0,0.971442699,0,63,529,631,529,568,rainbow dash
1691837.png,https://derpicdn.net/img/view/2018/3/27/1691837.png,0,0.971442699,0,63,529,631,529,568,rainbow dash
1708696.png,https://derpicdn.net/img/view/2018/4/15/1708696.png,0,0.905369401,318,70,882,634,564,564,rainbow dash
1712895.png,https://derpicdn.net/img/view/2018/4/20/1712895.png,0,0.97809726,0,0,544,577,544,577,rainbow dash
1713531.png,https://derpicdn.net/img/view/2018/4/21/1713531.png,0,0.953358829,128,128,550,550,422,422,rainbow dash
1713531.png,https://derpicdn.net/img/view/2018/4/21/1713531.png,0,0.953358829,128,128,550,550,422,422,rainbow dash
1720011.png,https://derpicdn.net/img/view/2018/4/29/1720011.png,0,0.993102312,42,319,1246,1523,1204,1204,rainbow dash
1720142.png,https://derpicdn.net/img/view/2018/4/29/1720142.png,0,0.984065354,0,29,604,773,604,744,rainbow dash
1720532.png,https://derpicdn.net/img/view/2018/4/30/1720532.png,0,0.996408224,243,0,653,400,410,400,rainbow dash
1722171.png,https://derpicdn.net/img/view/2018/5/2/1722171.png,0,0.989201248,541,126,1057,642,516,516,rainbow dash
1722200.png,https://derpicdn.net/img/view/2018/5/2/1722200.png,0,0.912553966,174,0,2422,2215,2248,2215,rainbow dash
1726815.png,https://derpicdn.net/img/view/2018/5/7/1726815.png,0,0.979688227,50,0,3494,3321,3444,3321,rainbow dash
1731810.png,https://derpicdn.net/img/view/2018/5/13/1731810.png,0,0.951948881,645,0,2203,1525,1558,1525,rainbow dash
1733879.png,https://derpicdn.net/img/view/2018/5/16/1733879.png,0,0.923483193,74,0,416,350,342,350,rainbow dash
1739134.png,https://derpicdn.net/img/view/2018/5/22/1739134.png,0,0.999070048,53,0,471,407,418,407,rainbow dash
1739207.png,https://derpicdn.net/img/view/2018/5/22/1739207.png,0,0.998765886,38,0,446,394,408,394,rainbow dash
1739682.png,https://derpicdn.net/img/view/2018/5/23/1739682.png,0,0.993379653,1940,2,3684,1746,1744,1744,rainbow dash
1741078.png,https://derpicdn.net/img/view/2018/5/25/1741078.png,0,0.999249637,639,0,2341,1639,1702,1639,rainbow dash
1742708.png,https://derpicdn.net/img/view/2018/5/27/1742708.png,0,0.997081459,583,0,1649,1029,1066,1029,rainbow dash
174447.jpg,https://derpicdn.net/img/view/2012/12/6/174447.jpg,0,0.998395383,151,43,1101,993,950,950,rainbow dash
174447.jpg,https://derpicdn.net/img/view/2012/12/6/174447.jpg,0,0.998395383,151,43,1101,993,950,950,rainbow dash
1748855.png,https://derpicdn.net/img/view/2018/6/3/1748855.png,0,0.983820021,28,0,564,508,536,508,rainbow dash
1749087.png,https://derpicdn.net/img/view/2018/6/3/1749087.png,0,0.99610287,621,398,1329,1162,708,764,rainbow dash
1750689.png,https://derpicdn.net/img/view/2018/6/5/1750689.png,0,0.996117473,1178,0,2044,837,866,837,rainbow dash
1750689.png,https://derpicdn.net/img/view/2018/6/5/1750689.png,1,0.991829336,156,317,1028,1189,872,872,rainbow dash
1751039.png,https://derpicdn.net/img/view/2018/6/6/1751039.png,0,0.996649325,57,0,523,413,466,413,rainbow dash
1751942.png,https://derpicdn.net/img/view/2018/6/7/1751942.png,0,0.988413095,273,28,559,314,286,286,rainbow dash
1752942.png,https://derpicdn.net/img/view/2018/6/8/1752942.png,0,0.993249834,345,315,1437,1407,1092,1092,rainbow dash
1753264.png,https://derpicdn.net/img/view/2018/6/9/1753264.png,0,0.999036372,53,0,411,349,358,349,rainbow dash
1753477.png,https://derpicdn.net/img/view/2018/6/9/1753477.png,0,0.999534249,1251,185,1935,869,684,684,rainbow dash
1755488.png,https://derpicdn.net/img/view/2018/6/11/1755488.png,0,0.997522354,226,0,704,432,478,432,rainbow dash
1755599.png,https://derpicdn.net/img/view/2018/6/11/1755599.png,0,0.984000027,260,102,936,778,676,676,rainbow dash
1756238.png,https://derpicdn.net/img/view/2018/6/12/1756238.png,0,0.998879313,236,21,2528,2313,2292,2292,rainbow dash
1757858.png,https://derpicdn.net/img/view/2018/6/15/1757858.png,0,0.999021828,682,127,1442,887,760,760,rainbow dash
1758358.png,https://derpicdn.net/img/view/2018/6/15/1758358.png,0,0.955574989,399,321,899,821,500,500,rainbow dash
1758358.png,https://derpicdn.net/img/view/2018/6/15/1758358.png,0,0.955574989,399,321,899,821,500,500,rainbow dash
1761839.png,https://derpicdn.net/img/view/2018/6/20/1761839.png,0,0.919602275,275,168,781,674,506,506,rainbow dash
1762225.png,https://derpicdn.net/img/view/2018/6/20/1762225.png,0,0.990831912,31,0,400,334,369,334,rainbow dash
1767585.png,https://derpicdn.net/img/view/2018/6/27/1767585.png,0,0.997440517,293,0,739,428,446,428,rainbow dash
1767711.png,https://derpicdn.net/img/view/2018/6/28/1767711.png,0,0.99987638,500,0,1948,1394,1448,1394,rainbow dash
1768063.png,https://derpicdn.net/img/view/2018/6/28/1768063.png,0,0.94971633,1045,0,4039,2959,2994,2959,rainbow dash
1768176.png,https://derpicdn.net/img/view/2018/6/28/1768176.png,0,0.940782249,0,0,675,583,675,583,rainbow dash
1772783.png,https://derpicdn.net/img/view/2018/7/4/1772783.png,0,0.998597145,46,79,970,1003,924,924,rainbow dash
1777170.png,https://derpicdn.net/img/view/2018/7/9/1777170.png,0,0.996217251,376,17,892,533,516,516,rainbow dash
1777552.png,https://derpicdn.net/img/view/2018/7/10/1777552.png,0,0.981523752,328,0,2050,1784,1722,1784,rainbow dash
1779304.png,https://derpicdn.net/img/view/2018/7/12/1779304.png,0,0.930436075,0,103,339,469,339,366,rainbow dash
1779304.png,https://derpicdn.net/img/view/2018/7/12/1779304.png,0,0.930436075,0,103,339,469,339,366,rainbow dash
1780504.png,https://derpicdn.net/img/view/2018/7/14/1780504.png,0,0.983261108,29,0,715,672,686,672,rainbow dash
1783694.png,https://derpicdn.net/img/view/2018/7/18/1783694.png,0,0.990660965,0,29,916,985,916,956,rainbow dash
1784376.png,https://derpicdn.net/img/view/2018/7/19/1784376.png,0,0.98745048,245,3,767,525,522,522,rainbow dash
1788481.png,https://derpicdn.net/img/view/2018/7/24/1788481.png,0,0.999173939,230,0,590,352,360,352,rainbow dash
1790498.png,https://derpicdn.net/img/view/2018/7/26/1790498.png,0,0.979345441,218,0,1042,737,824,737,rainbow dash
1790498.png,https://derpicdn.net/img/view/2018/7/26/1790498.png,0,0.979345441,218,0,1042,737,824,737,rainbow dash
1791596.png,https://derpicdn.net/img/view/2018/7/28/1791596.png,0,0.998814046,1866,605,2880,1619,1014,1014,rainbow dash
1796701.png,https://derpicdn.net/img/view/2018/8/3/1796701.png,0,0.997878432,280,0,764,460,484,460,rainbow dash
1796920.png,https://derpicdn.net/img/view/2018/8/3/1796920.png,0,0.991063833,50,0,1024,959,974,959,rainbow dash
1797595.png,https://derpicdn.net/img/view/2018/8/4/1797595.png,0,0.999677539,291,161,1399,1269,1108,1108,rainbow dash
1804821.png,https://derpicdn.net/img/view/2018/8/12/1804821.png,0,0.918887794,10628,0,12418,1774,1790,1774,rainbow dash
1808287.png,https://derpicdn.net/img/view/2018/8/16/1808287.png,0,0.932089865,68,215,960,1107,892,892,rainbow dash
1809224.png,https://derpicdn.net/img/view/2018/8/17/1809224.png,0,0.968084395,1191,0,2591,1296,1400,1296,rainbow dash
1812190.png,https://derpicdn.net/img/view/2018/8/21/1812190.png,0,0.998826921,994,37,1846,889,852,852,rainbow dash
1812190.png,https://derpicdn.net/img/view/2018/8/21/1812190.png,0,0.998826921,994,37,1846,889,852,852,rainbow dash
1813337.png,https://derpicdn.net/img/view/2018/8/22/1813337.png,0,0.992152512,235,0,500,260,265,260,rainbow dash
1813527.png,https://derpicdn.net/img/view/2018/8/22/1813527.png,0,0.982050776,250,244,2449,2449,2199,2205,rainbow dash
1814202.png,https://derpicdn.net/img/view/2018/8/23/1814202.png,0,0.995705783,372,116,1164,908,792,792,rainbow dash
1818154.png,https://derpicdn.net/img/view/2018/8/27/1818154.png,0,0.999787509,138,19,622,503,484,484,rainbow dash
1819846.png,https://derpicdn.net/img/view/2018/8/29/1819846.png,0,0.923604131,66,0,476,378,410,378,rainbow dash
1828.png,https://derpicdn.net/img/view/2012/1/23/1828.png,0,0.996510446,0,0,485,462,485,462,rainbow dash
1829883.png,https://derpicdn.net/img/view/2018/9/11/1829883.png,0,0.99729389,592,0,1032,395,440,395,rainbow dash
1831338.png,https://derpicdn.net/img/view/2018/9/12/1831338.png,0,0.996578336,1363,451,2069,1157,706,706,rainbow dash
1832856.png,https://derpicdn.net/img/view/2018/9/15/1832856.png,0,0.976123869,271,121,1345,1195,1074,1074,rainbow dash
1832856.png,https://derpicdn.net/img/view/2018/9/15/1832856.png,0,0.976123869,271,121,1345,1195,1074,1074,rainbow dash
1833381.png,https://derpicdn.net/img/view/2018/9/15/1833381.png,0,0.951995611,342,150,1280,1176,938,1026,rainbow dash
1833382.png,https://derpicdn.net/img/view/2018/9/15/1833382.png,0,0.988762975,97,0,871,715,774,715,rainbow dash
1833382.png,https://derpicdn.net/img/view/2018/9/15/1833382.png,0,0.988762975,97,0,871,715,774,715,rainbow dash
18346.jpg,https://derpicdn.net/img/view/2012/6/24/18346.jpg,0,0.967104316,23,0,939,863,916,863,rainbow dash
1836359.png,https://derpicdn.net/img/view/2018/9/19/1836359.png,0,0.999584854,0,23,256,289,256,266,rainbow dash
1837213.png,https://derpicdn.net/img/view/2018/9/20/1837213.png,0,0.9687379,0,0,255,247,255,247,rainbow dash
1839570.png,https://derpicdn.net/img/view/2018/9/23/1839570.png,0,0.998312354,224,0,646,413,422,413,rainbow dash
1840491.png,https://derpicdn.net/img/view/2018/9/24/1840491.png,0,0.983661652,0,0,388,353,388,353,rainbow dash
1844102.png,https://derpicdn.net/img/view/2018/9/29/1844102.png,0,0.994989216,232,0,1004,712,772,712,rainbow dash
1845829.png,https://derpicdn.net/img/view/2018/10/2/1845829.png,0,0.922890186,0,0,700,698,700,698,rainbow dash
1846830.png,https://derpicdn.net/img/view/2018/10/3/1846830.png,0,0.982559383,0,432,2480,3724,2480,3292,rainbow dash
1848331.png,https://derpicdn.net/img/view/2018/10/5/1848331.png,0,0.964419961,195,0,2281,1997,2086,1997,rainbow dash
1848931.png,https://derpicdn.net/img/view/2018/10/5/1848931.png,0,0.943848193,400,0,1236,791,836,791,rainbow dash
1851683.png,https://derpicdn.net/img/view/2018/10/8/1851683.png,0,0.974996388,872,173,1918,1219,1046,1046,rainbow dash
1855792.png,https://derpicdn.net/img/view/2018/10/13/1855792.png,0,0.99936235,1006,0,2106,1023,1100,1023,rainbow dash
1858291.png,https://derpicdn.net/img/view/2018/10/16/1858291.png,0,0.979786336,0,12,741,782,741,770,rainbow dash
1860660.png,https://derpicdn.net/img/view/2018/10/19/1860660.png,0,0.993277133,282,0,1270,970,988,970,rainbow dash
1862182.png,https://derpicdn.net/img/view/2018/10/21/1862182.png,0,0.999218404,238,0,834,543,596,543,rainbow dash
1862458.png,https://derpicdn.net/img/view/2018/10/21/1862458.png,0,0.994838357,127,0,1585,1443,1458,1443,rainbow dash
1862458.png,https://derpicdn.net/img/view/2018/10/21/1862458.png,0,0.994838357,127,0,1585,1443,1458,1443,rainbow dash
1864151.png,https://derpicdn.net/img/view/2018/10/23/1864151.png,0,0.9991045,202,0,470,256,268,256,rainbow dash
1867514.png,https://derpicdn.net/img/view/2018/10/27/1867514.png,0,0.99006933,228,0,835,606,607,606,rainbow dash
18712.jpg,https://derpicdn.net/img/view/2012/6/24/18712.jpg,0,0.98571068,1020,199,1712,891,692,692,rainbow dash
1877055.png,https://derpicdn.net/img/view/2018/11/7/1877055.png,0,0.993441224,643,0,2600,1915,1957,1915,rainbow dash
1877055.png,https://derpicdn.net/img/view/2018/11/7/1877055.png,0,0.993441224,643,0,2600,1915,1957,1915,rainbow dash
1885262.png,https://derpicdn.net/img/view/2018/11/18/1885262.png,0,0.988567233,18,0,2152,2038,2134,2038,rainbow dash
1889934.png,https://derpicdn.net/img/view/2018/11/24/1889934.png,0,0.939637661,362,243,1072,953,710,710,rainbow dash
1892493.png,https://derpicdn.net/img/view/2018/11/27/1892493.png,0,0.991138339,1108,0,2874,1724,1766,1724,rainbow dash
1893182.png,https://derpicdn.net/img/view/2018/11/28/1893182.png,0,0.998179734,742,152,1100,510,358,358,rainbow dash
1893182.png,https://derpicdn.net/img/view/2018/11/28/1893182.png,0,0.998179734,742,152,1100,510,358,358,rainbow dash
1893603.png,https://derpicdn.net/img/view/2018/11/29/1893603.png,0,0.985472143,0,0,806,919,806,919,rainbow dash
1893800.png,https://derpicdn.net/img/view/2018/11/29/1893800.png,0,0.997731626,192,54,722,584,530,530,rainbow dash
1893800.png,https://derpicdn.net/img/view/2018/11/29/1893800.png,1,0.992466867,640,108,1110,578,470,470,rainbow dash
1900987.png,https://derpicdn.net/img/view/2018/12/7/1900987.png,0,0.997164905,1918,386,2562,1030,644,644,rainbow dash
1902982.png,https://derpicdn.net/img/view/2018/12/8/1902982.png,0,0.99513495,572,0,1042,390,470,390,rainbow dash
1902982.png,https://derpicdn.net/img/view/2018/12/8/1902982.png,1,0.975715458,394,0,674,277,280,277,rainbow dash
1902983.png,https://derpicdn.net/img/view/2018/12/8/1902983.png,0,0.995091856,575,0,1037,384,462,384,rainbow dash
1902983.png,https://derpicdn.net/img/view/2018/12/8/1902983.png,1,0.968715191,397,0,671,273,274,273,rainbow dash
1904561.png,https://derpicdn.net/img/view/2018/12/10/1904561.png,0,0.941543877,75,78,911,914,836,836,rainbow dash
1905254.png,https://derpicdn.net/img/view/2018/12/11/1905254.png,0,0.99110043,62,0,1488,1342,1426,1342,rainbow dash
1908688.png,https://derpicdn.net/img/view/2018/12/15/1908688.png,0,0.997822106,56,83,262,289,206,206,rainbow dash
1908688.png,https://derpicdn.net/img/view/2018/12/15/1908688.png,0,0.997822106,56,83,262,289,206,206,rainbow dash
19094.jpg,https://derpicdn.net/img/view/2012/6/24/19094.jpg,0,0.992123127,0,0,706,674,706,674,rainbow dash
1910155.png,https://derpicdn.net/img/view/2018/12/16/1910155.png,0,0.988569617,981,0,2717,1708,1736,1708,rainbow dash
1911062.png,https://derpicdn.net/img/view/2018/12/17/1911062.png,0,0.987873852,90,173,412,495,322,322,rainbow dash
1911744.png,https://derpicdn.net/img/view/2018/12/18/1911744.png,0,0.993870139,54,0,2224,2080,2170,2080,rainbow dash
1913193.png,https://derpicdn.net/img/view/2018/12/19/1913193.png,0,0.937704206,262,0,792,458,530,458,rainbow dash
1916663.png,https://derpicdn.net/img/view/2018/12/23/1916663.png,0,0.998308718,141,0,537,394,396,394,rainbow dash
1917663.png,https://derpicdn.net/img/view/2018/12/24/1917663.png,0,0.967732787,21,0,335,294,314,294,rainbow dash
1918482.png,https://derpicdn.net/img/view/2018/12/25/1918482.png,0,0.981174409,0,0,2893,3055,2893,3055,rainbow dash
1921340.png,https://derpicdn.net/img/view/2018/12/29/1921340.png,0,0.919314086,437,0,900,445,463,445,rainbow dash
1923581.png,https://derpicdn.net/img/view/2019/1/1/1923581.png,0,0.989653349,0,16,207,238,207,222,rainbow dash
1923581.png,https://derpicdn.net/img/view/2019/1/1/1923581.png,1,0.944140077,34,0,250,212,216,212,rainbow dash
1924060.png,https://derpicdn.net/img/view/2019/1/1/1924060.png,0,0.952729642,0,0,1869,1929,1869,1929,rainbow dash
1924159.png,https://derpicdn.net/img/view/2019/1/1/1924159.png,0,0.998873591,0,0,920,898,920,898,rainbow dash
1925648.png,https://derpicdn.net/img/view/2019/1/3/1925648.png,0,0.998872638,13,197,433,617,420,420,rainbow dash
1926776.png,https://derpicdn.net/img/view/2019/1/5/1926776.png,0,0.981231868,0,107,1113,1445,1113,1338,rainbow dash
1928680.png,https://derpicdn.net/img/view/2019/1/7/1928680.png,0,0.996689916,1279,0,4791,3353,3512,3353,rainbow dash
1930072.png,https://derpicdn.net/img/view/2019/1/8/1930072.png,0,0.928946018,450,167,722,439,272,272,rainbow dash
1930680.png,https://derpicdn.net/img/view/2019/1/9/1930680.png,0,0.941919804,556,485,954,883,398,398,rainbow dash
1932553.png,https://derpicdn.net/img/view/2019/1/11/1932553.png,0,0.998495877,673,775,2607,2709,1934,1934,rainbow dash
1934357.png,https://derpicdn.net/img/view/2019/1/13/1934357.png,0,0.988275528,195,3,1165,973,970,970,rainbow dash
1935906.png,https://derpicdn.net/img/view/2019/1/15/1935906.png,0,0.989160657,1894,26,3802,1934,1908,1908,rainbow dash
1940084.png,https://derpicdn.net/img/view/2019/1/20/1940084.png,0,0.991336465,771,0,1163,390,392,390,rainbow dash
1940250.png,https://derpicdn.net/img/view/2019/1/20/1940250.png,0,0.969531953,29,10,639,499,610,489,rainbow dash
1940599.png,https://derpicdn.net/img/view/2019/1/21/1940599.png,0,0.956162691,714,0,2314,1555,1600,1555,rainbow dash
1941155.png,https://derpicdn.net/img/view/2019/1/21/1941155.png,0,0.957530379,165,150,601,586,436,436,rainbow dash
1941848.png,https://derpicdn.net/img/view/2019/1/22/1941848.png,0,0.999253333,440,0,1288,847,848,847,rainbow dash
1942521.png,https://derpicdn.net/img/view/2019/1/23/1942521.png,0,0.98071903,1195,42,1983,830,788,788,rainbow dash
1944535.png,https://derpicdn.net/img/view/2019/1/25/1944535.png,0,0.998305857,689,57,1829,1197,1140,1140,rainbow dash
1947639.png,https://derpicdn.net/img/view/2019/1/29/1947639.png,0,0.976610839,0,0,606,528,606,528,rainbow dash
1950978.png,https://derpicdn.net/img/view/2019/2/2/1950978.png,0,0.963848472,7,0,1251,1192,1244,1192,rainbow dash
1953110.png,https://derpicdn.net/img/view/2019/2/4/1953110.png,0,0.984373271,419,22,833,436,414,414,rainbow dash
1957465.png,https://derpicdn.net/img/view/2019/2/9/1957465.png,0,0.998794377,214,0,984,750,770,750,rainbow dash
1957976.png,https://derpicdn.net/img/view/2019/2/10/1957976.png,0,0.972099423,812,96,1556,840,744,744,rainbow dash
1958665.png,https://derpicdn.net/img/view/2019/2/10/1958665.png,0,0.997997284,658,23,1824,1189,1166,1166,rainbow dash
1958873.png,https://derpicdn.net/img/view/2019/2/11/1958873.png,0,0.978515506,541,0,2560,2046,2019,2046,rainbow dash
1960781.png,https://derpicdn.net/img/view/2019/2/13/1960781.png,0,0.962616503,116,0,1110,991,994,991,rainbow dash
1961573.png,https://derpicdn.net/img/view/2019/2/14/1961573.png,0,0.957622409,521,622,3607,3708,3086,3086,rainbow dash
1961795.png,https://derpicdn.net/img/view/2019/2/14/1961795.png,0,0.986842692,45,0,1391,1271,1346,1271,rainbow dash
1962267.png,https://derpicdn.net/img/view/2019/2/14/1962267.png,0,0.979962707,335,0,2123,1670,1788,1670,rainbow dash
1962267.png,https://derpicdn.net/img/view/2019/2/14/1962267.png,0,0.979962707,335,0,2123,1670,1788,1670,rainbow dash
1965055.png,https://derpicdn.net/img/view/2019/2/18/1965055.png,0,0.992876112,228,0,602,387,374,387,rainbow dash
1967670.png,https://derpicdn.net/img/view/2019/2/21/1967670.png,0,0.999413788,680,0,1508,805,828,805,rainbow dash
1968138.png,https://derpicdn.net/img/view/2019/2/21/1968138.png,0,0.983536124,771,0,3199,2282,2428,2282,rainbow dash
1968465.png,https://derpicdn.net/img/view/2019/2/22/1968465.png,0,0.961008251,701,37,1971,1307,1270,1270,rainbow dash
1968963.png,https://derpicdn.net/img/view/2019/2/22/1968963.png,0,0.994786859,130,0,1884,1999,1754,1999,rainbow dash
1971300.png,https://derpicdn.net/img/view/2019/2/25/1971300.png,0,0.941728055,561,237,2880,2711,2319,2474,rainbow dash
1973623.png,https://derpicdn.net/img/view/2019/2/28/1973623.png,0,0.999303102,160,13,746,599,586,586,rainbow dash
1974148.png,https://derpicdn.net/img/view/2019/3/1/1974148.png,0,0.958918333,346,56,888,598,542,542,rainbow dash
1975355.png,https://derpicdn.net/img/view/2019/3/2/1975355.png,0,0.913792133,281,7,877,603,596,596,rainbow dash
1976146.png,https://derpicdn.net/img/view/2019/3/3/1976146.png,0,0.963557899,23,0,511,472,488,472,rainbow dash
1976671.png,https://derpicdn.net/img/view/2019/3/3/1976671.png,0,0.978403032,330,0,844,513,514,513,rainbow dash
1980.jpg,https://derpicdn.net/img/view/2012/1/24/1980.jpg,0,0.998582363,510,5,822,317,312,312,rainbow dash
1983510.png,https://derpicdn.net/img/view/2019/3/12/1983510.png,0,0.972188115,745,1214,3161,3630,2416,2416,rainbow dash
1986891.png,https://derpicdn.net/img/view/2019/3/16/1986891.png,0,0.996627748,33,0,1321,1241,1288,1241,rainbow dash
1989597.png,https://derpicdn.net/img/view/2019/3/18/1989597.png,0,0.985932589,32,0,458,401,426,401,rainbow dash
1990038.png,https://derpicdn.net/img/view/2019/3/19/1990038.png,0,0.969953001,217,30,643,456,426,426,rainbow dash
1993167.png,https://derpicdn.net/img/view/2019/3/23/1993167.png,0,0.997965991,76,0,354,260,278,260,rainbow dash
1994134.png,https://derpicdn.net/img/view/2019/3/24/1994134.png,0,0.995663583,872,0,1832,948,960,948,rainbow dash
1997633.png,https://derpicdn.net/img/view/2019/3/29/1997633.png,0,0.986822248,244,0,1600,1358,1356,1358,rainbow dash
1999962.png,https://derpicdn.net/img/view/2019/4/1/1999962.png,0,0.955546618,16,0,782,736,766,736,rainbow dash
2007594.png,https://derpicdn.net/img/view/2019/4/9/2007594.png,0,0.997982442,30,0,620,564,590,564,rainbow dash
2017934.png,https://derpicdn.net/img/view/2019/4/20/2017934.png,0,0.983556211,375,0,1190,717,815,717,rainbow dash
2018163.png,https://derpicdn.net/img/view/2019/4/20/2018163.png,0,0.988214016,81,0,1193,1016,1112,1016,rainbow dash
2018352.png,https://derpicdn.net/img/view/2019/4/21/2018352.png,0,0.936019838,0,9,290,313,290,304,rainbow dash
2018795.png,https://derpicdn.net/img/view/2019/4/21/2018795.png,0,0.997729301,502,0,2394,1836,1892,1836,rainbow dash
2020140.png,https://derpicdn.net/img/view/2019/4/22/2020140.png,0,0.985033274,0,10,318,340,318,330,rainbow dash
2020140.png,https://derpicdn.net/img/view/2019/4/22/2020140.png,0,0.985033274,0,10,318,340,318,330,rainbow dash
2020526.png,https://derpicdn.net/img/view/2019/4/23/2020526.png,0,0.968969047,0,506,2282,3076,2282,2570,rainbow dash
2023448.png,https://derpicdn.net/img/view/2019/4/26/2023448.png,0,0.962931216,508,66,1160,718,652,652,rainbow dash
2024668.png,https://derpicdn.net/img/view/2019/4/27/2024668.png,0,0.999207854,580,0,1242,630,662,630,rainbow dash
2024668.png,https://derpicdn.net/img/view/2019/4/27/2024668.png,0,0.999207854,580,0,1242,630,662,630,rainbow dash
2025649.png,https://derpicdn.net/img/view/2019/4/28/2025649.png,0,0.912835777,409,367,989,947,580,580,rainbow dash
202596.png,https://derpicdn.net/img/view/2013/1/4/202596.png,0,0.991976321,57,98,497,538,440,440,rainbow dash
2028643.png,https://derpicdn.net/img/view/2019/5/1/2028643.png,0,0.9769122,166,18,2232,2084,2066,2066,rainbow dash
2032018.png,https://derpicdn.net/img/view/2019/5/6/2032018.png,0,0.99867177,1019,480,3561,3022,2542,2542,rainbow dash
2032918.png,https://derpicdn.net/img/view/2019/5/7/2032918.png,0,0.992027521,54,0,588,511,534,511,rainbow dash
2034934.png,https://derpicdn.net/img/view/2019/5/9/2034934.png,0,0.997507274,246,0,872,598,626,598,rainbow dash
2036795.png,https://derpicdn.net/img/view/2019/5/12/2036795.png,0,0.983987689,65,0,2051,1940,1986,1940,rainbow dash
2038098.png,https://derpicdn.net/img/view/2019/5/13/2038098.png,0,0.982708931,523,710,819,1006,296,296,rainbow dash
2040708.png,https://derpicdn.net/img/view/2019/5/16/2040708.png,0,0.994690478,847,0,2675,1668,1828,1668,rainbow dash
2042681.png,https://derpicdn.net/img/view/2019/5/18/2042681.png,0,0.916407883,0,0,2412,2275,2412,2275,rainbow dash
2045737.png,https://derpicdn.net/img/view/2019/5/22/2045737.png,0,0.995292485,14,0,1130,1083,1116,1083,rainbow dash
204676.jpg,https://derpicdn.net/img/view/2013/1/6/204676.jpg,0,0.993056476,299,1,581,283,282,282,rainbow dash
2048726.png,https://derpicdn.net/img/view/2019/5/25/2048726.png,0,0.9854846,229,0,549,315,320,315,rainbow dash
2050542.png,https://derpicdn.net/img/view/2019/5/27/2050542.png,0,0.971111894,505,38,3581,3114,3076,3076,rainbow dash
2051393.png,https://derpicdn.net/img/view/2019/5/28/2051393.png,0,0.999713361,1549,18,3287,1756,1738,1738,rainbow dash
2051977.png,https://derpicdn.net/img/view/2019/5/28/2051977.png,0,0.996420145,485,0,1843,1233,1358,1233,rainbow dash
2053555.png,https://derpicdn.net/img/view/2019/5/30/2053555.png,0,0.963260651,58,0,600,469,542,469,rainbow dash
2058798.png,https://derpicdn.net/img/view/2019/6/5/2058798.png,0,0.989384413,222,43,1396,1217,1174,1174,rainbow dash
2059643.png,https://derpicdn.net/img/view/2019/6/7/2059643.png,0,0.938461065,369,386,1515,1532,1146,1146,rainbow dash
2060494.png,https://derpicdn.net/img/view/2019/6/8/2060494.png,0,0.994884729,0,0,1050,938,1050,938,rainbow dash
2061139.png,https://derpicdn.net/img/view/2019/6/9/2061139.png,0,0.998681009,1586,0,3192,1482,1606,1482,rainbow dash
2061345.png,https://derpicdn.net/img/view/2019/6/9/2061345.png,0,0.980010688,285,157,717,589,432,432,rainbow dash
2061530.png,https://derpicdn.net/img/view/2019/6/9/2061530.png,0,0.998861611,37,0,593,520,556,520,rainbow dash
2061636.png,https://derpicdn.net/img/view/2019/6/9/2061636.png,0,0.998140275,177,0,895,700,718,700,rainbow dash
2062397.png,https://derpicdn.net/img/view/2019/6/10/2062397.png,0,0.992198706,443,439,1735,1731,1292,1292,rainbow dash
2063452.png,https://derpicdn.net/img/view/2019/6/12/2063452.png,0,0.954498291,27,0,863,685,836,685,rainbow dash
206571.png,https://derpicdn.net/img/view/2013/1/8/206571.png,0,0.971131146,48,0,484,391,436,391,rainbow dash
2067537.png,https://derpicdn.net/img/view/2019/6/17/2067537.png,0,0.973004818,145,27,535,417,390,390,rainbow dash
2068103.png,https://derpicdn.net/img/view/2019/6/17/2068103.png,0,0.982753515,256,943,934,1621,678,678,rainbow dash
2068103.png,https://derpicdn.net/img/view/2019/6/17/2068103.png,1,0.950949669,2036,854,2776,1594,740,740,rainbow dash
2069483.png,https://derpicdn.net/img/view/2019/6/19/2069483.png,0,0.994230628,381,18,913,550,532,532,rainbow dash
2071883.png,https://derpicdn.net/img/view/2019/6/22/2071883.png,0,0.993617713,622,0,1304,674,682,674,rainbow dash
2074871.png,https://derpicdn.net/img/view/2019/6/25/2074871.png,0,0.978661239,162,26,888,752,726,726,rainbow dash
2075563.png,https://derpicdn.net/img/view/2019/6/26/2075563.png,0,0.933683217,247,0,1151,858,904,858,rainbow dash
2082029.png,https://derpicdn.net/img/view/2019/7/3/2082029.png,0,0.996033847,547,0,3385,2691,2838,2691,rainbow dash
2092017.png,https://derpicdn.net/img/view/2019/7/15/2092017.png,0,0.989818275,554,0,2880,1620,2326,1620,rainbow dash
2092407.png,https://derpicdn.net/img/view/2019/7/15/2092407.png,0,0.993511498,924,0,2460,1494,1536,1494,rainbow dash
2092874.png,https://derpicdn.net/img/view/2019/7/16/2092874.png,0,0.967035234,15,2,557,544,542,542,rainbow dash
2096507.png,https://derpicdn.net/img/view/2019/7/20/2096507.png,0,0.92356354,824,154,2130,1460,1306,1306,rainbow dash
2096507.png,https://derpicdn.net/img/view/2019/7/20/2096507.png,0,0.92356354,824,154,2130,1460,1306,1306,rainbow dash
2098488.png,https://derpicdn.net/img/view/2019/7/22/2098488.png,0,0.998978138,463,257,1349,1143,886,886,rainbow dash
2098488.png,https://derpicdn.net/img/view/2019/7/22/2098488.png,0,0.998978138,463,257,1349,1143,886,886,rainbow dash
2098779.png,https://derpicdn.net/img/view/2019/7/22/2098779.png,0,0.998230457,0,11,755,777,755,766,rainbow dash
2099425.png,https://derpicdn.net/img/view/2019/7/23/2099425.png,0,0.976558089,116,40,530,454,414,414,rainbow dash
2101182.png,https://derpicdn.net/img/view/2019/7/25/2101182.png,0,0.98180747,88,109,1798,1819,1710,1710,rainbow dash
2104848.png,https://derpicdn.net/img/view/2019/7/30/2104848.png,0,0.972859025,0,0,1186,1143,1186,1143,rainbow dash
2105431.png,https://derpicdn.net/img/view/2019/7/31/2105431.png,0,0.989050269,1386,809,2114,1537,728,728,rainbow dash
2107293.png,https://derpicdn.net/img/view/2019/8/2/2107293.png,0,0.976881921,373,116,833,576,460,460,rainbow dash
2107680.png,https://derpicdn.net/img/view/2019/8/3/2107680.png,0,0.983851731,557,0,2500,1913,1943,1913,rainbow dash
210885.jpg,https://derpicdn.net/img/view/2013/1/13/210885.jpg,0,0.995197058,583,62,1253,732,670,670,rainbow dash
210885.jpg,https://derpicdn.net/img/view/2013/1/13/210885.jpg,1,0.956180215,2181,60,2845,724,664,664,rainbow dash
2109725.png,https://derpicdn.net/img/view/2019/8/5/2109725.png,0,0.991729975,444,150,1132,838,688,688,rainbow dash
2117993.png,https://derpicdn.net/img/view/2019/8/14/2117993.png,0,0.998690844,337,0,843,493,506,493,rainbow dash
2118302.png,https://derpicdn.net/img/view/2019/8/15/2118302.png,0,0.953512907,459,0,2935,2476,2476,2476,rainbow dash
2120597.png,https://derpicdn.net/img/view/2019/8/17/2120597.png,0,0.96374619,172,25,579,451,407,426,rainbow dash
2125821.png,https://derpicdn.net/img/view/2019/8/24/2125821.png,0,0.98094064,1445,178,2981,1714,1536,1536,rainbow dash
2130805.png,https://derpicdn.net/img/view/2019/8/29/2130805.png,0,0.981226742,0,137,1117,1285,1117,1148,rainbow dash
2132807.png,https://derpicdn.net/img/view/2019/8/31/2132807.png,0,0.99757874,905,1603,2051,2749,1146,1146,rainbow dash
2136599.png,https://derpicdn.net/img/view/2019/9/4/2136599.png,0,0.998466134,320,44,1172,896,852,852,rainbow dash
2139210.png,https://derpicdn.net/img/view/2019/9/8/2139210.png,0,0.981380939,77,203,927,1053,850,850,rainbow dash
2139210.png,https://derpicdn.net/img/view/2019/9/8/2139210.png,0,0.981380939,77,203,927,1053,850,850,rainbow dash
2143277.png,https://derpicdn.net/img/view/2019/9/13/2143277.png,0,0.991862893,1508,0,3392,1871,1884,1871,rainbow dash
2146624.png,https://derpicdn.net/img/view/2019/9/17/2146624.png,0,0.992562056,1392,0,3098,1422,1706,1422,rainbow dash
2146624.png,https://derpicdn.net/img/view/2019/9/17/2146624.png,0,0.992562056,1392,0,3098,1422,1706,1422,rainbow dash
2147691.png,https://derpicdn.net/img/view/2019/9/19/2147691.png,0,0.978503168,2155,0,6782,4570,4627,4570,rainbow dash
2150037.png,https://derpicdn.net/img/view/2019/9/22/2150037.png,0,0.9868536,244,220,684,660,440,440,rainbow dash
2153741.png,https://derpicdn.net/img/view/2019/9/26/2153741.png,0,0.998037398,171,0,955,739,784,739,rainbow dash
2159610.png,https://derpicdn.net/img/view/2019/10/4/2159610.png,0,0.991543233,106,0,464,343,358,343,rainbow dash
21626.png,https://derpicdn.net/img/view/2012/6/26/21626.png,0,0.991923928,186,0,918,669,732,669,rainbow dash
2165270.png,https://derpicdn.net/img/view/2019/10/11/2165270.png,0,0.994695902,353,39,795,481,442,442,rainbow dash
2174070.png,https://derpicdn.net/img/view/2019/10/20/2174070.png,0,0.990674675,290,0,1440,1099,1150,1099,rainbow dash
2177306.png,https://derpicdn.net/img/view/2019/10/24/2177306.png,0,0.996650338,1613,870,2465,1722,852,852,rainbow dash
2177306.png,https://derpicdn.net/img/view/2019/10/24/2177306.png,1,0.935595155,391,1415,1057,2081,666,666,rainbow dash
2179103.png,https://derpicdn.net/img/view/2019/10/25/2179103.png,0,0.995821536,412,0,1086,581,674,581,rainbow dash
2183703.png,https://derpicdn.net/img/view/2019/10/31/2183703.png,0,0.999480963,279,22,1371,1114,1092,1092,rainbow dash
2183703.png,https://derpicdn.net/img/view/2019/10/31/2183703.png,1,0.990386844,1657,260,2927,1530,1270,1270,rainbow dash
2184820.png,https://derpicdn.net/img/view/2019/11/1/2184820.png,0,0.995354176,0,349,2661,3069,2661,2720,rainbow dash
2187806.png,https://derpicdn.net/img/view/2019/11/4/2187806.png,0,0.998116553,333,1,1811,1479,1478,1478,rainbow dash
2187806.png,https://derpicdn.net/img/view/2019/11/4/2187806.png,0,0.998116553,333,1,1811,1479,1478,1478,rainbow dash
2187892.png,https://derpicdn.net/img/view/2019/11/5/2187892.png,0,0.968253195,62,17,262,186,200,169,rainbow dash
2191352.png,https://derpicdn.net/img/view/2019/11/9/2191352.png,0,0.991596401,131,140,1198,1386,1067,1246,rainbow dash
2191532.png,https://derpicdn.net/img/view/2019/11/9/2191532.png,0,0.959292531,0,0,733,770,733,770,rainbow dash
2198497.png,https://derpicdn.net/img/view/2019/11/17/2198497.png,0,0.941451788,0,0,837,696,837,696,rainbow dash
2198497.png,https://derpicdn.net/img/view/2019/11/17/2198497.png,0,0.941451788,0,0,837,696,837,696,rainbow dash
2199365.png,https://derpicdn.net/img/view/2019/11/18/2199365.png,0,0.946474433,712,234,1466,988,754,754,rainbow dash
2199365.png,https://derpicdn.net/img/view/2019/11/18/2199365.png,0,0.946474433,712,234,1466,988,754,754,rainbow dash
2199425.png,https://derpicdn.net/img/view/2019/11/18/2199425.png,0,0.999741137,507,69,1023,585,516,516,rainbow dash
2202256.png,https://derpicdn.net/img/view/2019/11/21/2202256.png,0,0.922487736,91,27,431,367,340,340,rainbow dash
2205145.png,https://derpicdn.net/img/view/2019/11/25/2205145.png,0,0.911937654,459,208,1747,1496,1288,1288,rainbow dash
2207073.png,https://derpicdn.net/img/view/2019/11/27/2207073.png,0,0.982070684,55,0,836,776,781,776,rainbow dash
2208041.png,https://derpicdn.net/img/view/2019/11/28/2208041.png,0,0.999808073,15,0,485,454,470,454,rainbow dash
2211635.png,https://derpicdn.net/img/view/2019/12/3/2211635.png,0,0.99576062,130,11,704,585,574,574,rainbow dash
2214013.png,https://derpicdn.net/img/view/2019/12/6/2214013.png,0,0.945938945,1083,0,2539,1194,1456,1194,rainbow dash
2214015.png,https://derpicdn.net/img/view/2019/12/6/2214015.png,0,0.99827832,684,0,1652,950,968,950,rainbow dash
2215781.png,https://derpicdn.net/img/view/2019/12/8/2215781.png,0,0.990594149,574,46,1250,788,676,742,rainbow dash
2216159.png,https://derpicdn.net/img/view/2019/12/8/2216159.png,0,0.999404788,447,0,1571,1112,1124,1112,rainbow dash
2216547.png,https://derpicdn.net/img/view/2019/12/9/2216547.png,0,0.989726484,0,0,892,938,892,938,rainbow dash
2218439.png,https://derpicdn.net/img/view/2019/12/11/2218439.png,0,0.971319497,349,18,1637,1306,1288,1288,rainbow dash
2228083.jpg,https://derpicdn.net/img/view/2019/12/23/2228083.jpg,0,0.992021739,831,0,2051,1060,1220,1060,rainbow dash
2229910.jpg,https://derpicdn.net/img/view/2019/12/25/2229910.jpg,0,0.999406636,556,0,1140,569,584,569,rainbow dash
2230973.png,https://derpicdn.net/img/view/2019/12/27/2230973.png,0,0.975061476,1247,1198,2155,2106,908,908,rainbow dash
2234770.png,https://derpicdn.net/img/view/2019/12/31/2234770.png,0,0.999611139,203,124,1293,1214,1090,1090,rainbow dash
2237556.png,https://derpicdn.net/img/view/2020/1/3/2237556.png,1,0.996210158,2671,319,4109,1757,1438,1438,rainbow dash
2239701.jpg,https://derpicdn.net/img/view/2020/1/5/2239701.jpg,0,0.99203676,30,6,960,936,930,930,rainbow dash
2240625.jpg,https://derpicdn.net/img/view/2020/1/7/2240625.jpg,0,0.98657608,23,0,585,546,562,546,rainbow dash
22420.png,https://derpicdn.net/img/view/2012/6/27/22420.png,0,0.99930203,905,302,1479,876,574,574,rainbow dash
2242466.jpg,https://derpicdn.net/img/view/2020/1/9/2242466.jpg,0,0.980644763,0,0,844,791,844,791,rainbow dash
2242473.jpg,https://derpicdn.net/img/view/2020/1/9/2242473.jpg,0,0.9923383,74,0,672,573,598,573,rainbow dash
2245734.jpg,https://derpicdn.net/img/view/2020/1/12/2245734.jpg,0,0.999060214,11,17,861,867,850,850,rainbow dash
2246502.jpg,https://derpicdn.net/img/view/2020/1/13/2246502.jpg,0,0.970971763,0,0,1240,1419,1240,1419,rainbow dash
2247129.jpg,https://derpicdn.net/img/view/2020/1/14/2247129.jpg,0,0.914016545,245,0,1627,1320,1382,1320,rainbow dash
2248980.png,https://derpicdn.net/img/view/2020/1/16/2248980.png,0,0.977912605,0,0,1300,1493,1300,1493,rainbow dash
2254780.jpg,https://derpicdn.net/img/view/2020/1/23/2254780.jpg,0,0.911454141,374,0,1394,984,1020,984,rainbow dash
2255030.jpg,https://derpicdn.net/img/view/2020/1/23/2255030.jpg,0,0.939546287,31,0,499,456,468,456,rainbow dash
2256060.jpg,https://derpicdn.net/img/view/2020/1/24/2256060.jpg,0,0.998413205,428,1194,1336,2102,908,908,rainbow dash
2256060.jpg,https://derpicdn.net/img/view/2020/1/24/2256060.jpg,1,0.995642185,1733,1186,2477,1930,744,744,rainbow dash
2256327.png,https://derpicdn.net/img/view/2020/1/25/2256327.png,0,0.994856477,48,2,348,302,300,300,rainbow dash
2258273.jpg,https://derpicdn.net/img/view/2020/1/27/2258273.jpg,0,0.94222635,218,38,3410,3230,3192,3192,rainbow dash
2258575.jpg,https://derpicdn.net/img/view/2020/1/27/2258575.jpg,0,0.967914343,0,0,2135,1600,2135,1600,rainbow dash
2259217.png,https://derpicdn.net/img/view/2020/1/28/2259217.png,0,0.990364611,1791,1080,3575,2864,1784,1784,rainbow dash
2259507.png,https://derpicdn.net/img/view/2020/1/28/2259507.png,0,0.998214304,289,0,735,441,446,441,rainbow dash
2261435.png,https://derpicdn.net/img/view/2020/1/30/2261435.png,0,0.965001643,0,48,663,722,663,674,rainbow dash
2261500.jpg,https://derpicdn.net/img/view/2020/1/30/2261500.jpg,0,0.990339279,343,7,1077,741,734,734,rainbow dash
2262570.jpg,https://derpicdn.net/img/view/2020/2/1/2262570.jpg,0,0.99549973,798,669,1066,925,268,256,rainbow dash
2262570.jpg,https://derpicdn.net/img/view/2020/2/1/2262570.jpg,1,0.99319458,927,0,1229,289,302,289,rainbow dash
2262570.jpg,https://derpicdn.net/img/view/2020/2/1/2262570.jpg,2,0.938411415,194,71,512,389,318,318,rainbow dash
2262570.jpg,https://derpicdn.net/img/view/2020/2/1/2262570.jpg,0,0.99549973,798,669,1066,925,268,256,rainbow dash
2262570.jpg,https://derpicdn.net/img/view/2020/2/1/2262570.jpg,1,0.99319458,927,0,1229,289,302,289,rainbow dash
2262570.jpg,https://derpicdn.net/img/view/2020/2/1/2262570.jpg,2,0.938411415,194,71,512,389,318,318,rainbow dash
2262732.png,https://derpicdn.net/img/view/2020/2/1/2262732.png,0,0.99685818,511,0,985,453,474,453,rainbow dash
2263527.png,https://derpicdn.net/img/view/2020/2/2/2263527.png,0,0.998327613,254,35,1030,811,776,776,rainbow dash
2265780.jpg,https://derpicdn.net/img/view/2020/2/4/2265780.jpg,0,0.980139732,208,34,1028,854,820,820,rainbow dash
2265842.png,https://derpicdn.net/img/view/2020/2/4/2265842.png,0,0.907517076,121,0,839,718,718,718,rainbow dash
2266389.jpg,https://derpicdn.net/img/view/2020/2/5/2266389.jpg,0,0.998460233,326,833,552,1059,226,226,rainbow dash
2266389.jpg,https://derpicdn.net/img/view/2020/2/5/2266389.jpg,1,0.947942376,64,295,428,659,364,364,rainbow dash
2266389.jpg,https://derpicdn.net/img/view/2020/2/5/2266389.jpg,2,0.921405077,616,0,1168,635,552,635,rainbow dash
2266389.jpg,https://derpicdn.net/img/view/2020/2/5/2266389.jpg,0,0.998460233,326,833,552,1059,226,226,rainbow dash
2266389.jpg,https://derpicdn.net/img/view/2020/2/5/2266389.jpg,1,0.947942376,64,295,428,659,364,364,rainbow dash
2266389.jpg,https://derpicdn.net/img/view/2020/2/5/2266389.jpg,2,0.921405077,616,0,1168,635,552,635,rainbow dash
2266932.png,https://derpicdn.net/img/view/2020/2/6/2266932.png,0,0.91435039,468,185,1514,1297,1046,1112,rainbow dash
2268487.png,https://derpicdn.net/img/view/2020/2/8/2268487.png,0,0.996098936,0,0,2999,2819,2999,2819,rainbow dash
2269055.png,https://derpicdn.net/img/view/2020/2/8/2269055.png,0,0.960430026,91,0,703,545,612,545,rainbow dash
2269317.png,https://derpicdn.net/img/view/2020/2/9/2269317.png,0,0.984919608,382,66,1686,1370,1304,1304,rainbow dash
2270256.png,https://derpicdn.net/img/view/2020/2/10/2270256.png,0,0.98379612,217,0,1535,1258,1318,1258,rainbow dash
2270606.png,https://derpicdn.net/img/view/2020/2/10/2270606.png,0,0.996148109,872,0,2050,1121,1178,1121,rainbow dash
2272452.jpg,https://derpicdn.net/img/view/2020/2/12/2272452.jpg,0,0.961156666,1,0,1531,1527,1530,1527,rainbow dash
2273028.jpg,https://derpicdn.net/img/view/2020/2/13/2273028.jpg,1,0.999164462,0,0,1141,1132,1141,1132,rainbow dash
2273449.jpg,https://derpicdn.net/img/view/2020/2/13/2273449.jpg,0,0.993723512,204,257,904,957,700,700,rainbow dash
2273764.png,https://derpicdn.net/img/view/2020/2/14/2273764.png,0,0.998625696,1140,0,2922,1749,1782,1749,rainbow dash
2274375.png,https://derpicdn.net/img/view/2020/2/14/2274375.png,0,0.964799762,897,0,1381,459,484,459,rainbow dash
2274439.png,https://derpicdn.net/img/view/2020/2/14/2274439.png,0,0.961403072,169,549,455,835,286,286,rainbow dash
2278312.jpg,https://derpicdn.net/img/view/2020/2/19/2278312.jpg,0,0.993069649,276,22,1000,746,724,724,rainbow dash
2279324.png,https://derpicdn.net/img/view/2020/2/20/2279324.png,0,0.935485423,51,0,847,763,796,763,rainbow dash
2280093.png,https://derpicdn.net/img/view/2020/2/21/2280093.png,0,0.946836948,92,97,2164,2169,2072,2072,rainbow dash
2280643.jpg,https://derpicdn.net/img/view/2020/2/22/2280643.jpg,0,0.937698781,121,30,717,626,596,596,rainbow dash
2280643.jpg,https://derpicdn.net/img/view/2020/2/22/2280643.jpg,0,0.937698781,121,30,717,626,596,596,rainbow dash
2283793.png,https://derpicdn.net/img/view/2020/2/26/2283793.png,0,0.998954654,64,0,1208,1099,1144,1099,rainbow dash
2284973.png,https://derpicdn.net/img/view/2020/2/27/2284973.png,0,0.995489419,253,0,1159,864,906,864,rainbow dash
2284986.png,https://derpicdn.net/img/view/2020/2/27/2284986.png,0,0.97207427,1,0,819,725,818,725,rainbow dash
2289036.jpg,https://derpicdn.net/img/view/2020/3/3/2289036.jpg,0,0.984432101,0,0,939,979,939,979,rainbow dash
2295082.jpg,https://derpicdn.net/img/view/2020/3/11/2295082.jpg,1,0.984850287,1873,767,2695,1550,822,783,rainbow dash
2295766.jpg,https://derpicdn.net/img/view/2020/3/12/2295766.jpg,0,0.998499155,374,63,1172,861,798,798,rainbow dash
2297136.png,https://derpicdn.net/img/view/2020/3/14/2297136.png,0,0.992078781,0,0,2860,2653,2860,2653,rainbow dash
2297337.jpg,https://derpicdn.net/img/view/2020/3/14/2297337.jpg,0,0.995350599,512,269,2096,1853,1584,1584,rainbow dash
2297337.jpg,https://derpicdn.net/img/view/2020/3/14/2297337.jpg,0,0.995350599,512,269,2096,1853,1584,1584,rainbow dash
2297389.jpg,https://derpicdn.net/img/view/2020/3/14/2297389.jpg,0,0.998204112,34,0,1772,1660,1738,1660,rainbow dash
2306554.jpg,https://derpicdn.net/img/view/2020/3/26/2306554.jpg,0,0.999201238,239,7,1289,1057,1050,1050,rainbow dash
23068.png,https://derpicdn.net/img/view/2012/6/27/23068.png,0,0.996092737,70,0,1038,924,968,924,rainbow dash
2308026.jpg,https://derpicdn.net/img/view/2020/3/28/2308026.jpg,0,0.981064856,442,0,984,515,542,515,rainbow dash
2308530.png,https://derpicdn.net/img/view/2020/3/29/2308530.png,0,0.99974674,323,78,1749,1504,1426,1426,rainbow dash
2310945.jpg,https://derpicdn.net/img/view/2020/3/31/2310945.jpg,0,0.977479517,105,0,1024,910,919,910,rainbow dash
231185.png,https://derpicdn.net/img/view/2013/2/2/231185.png,0,0.991450667,72,0,500,386,428,386,rainbow dash
2315084.png,https://derpicdn.net/img/view/2020/4/6/2315084.png,0,0.999042749,2196,0,3578,1347,1382,1347,rainbow dash
2316645.png,https://derpicdn.net/img/view/2020/4/7/2316645.png,0,0.996532738,73,0,560,449,487,449,rainbow dash
2317512.jpg,https://derpicdn.net/img/view/2020/4/8/2317512.jpg,0,0.994438767,15,0,933,866,918,866,rainbow dash
2319043.jpg,https://derpicdn.net/img/view/2020/4/10/2319043.jpg,0,0.998617411,491,104,959,572,468,468,rainbow dash
2320726.png,https://derpicdn.net/img/view/2020/4/12/2320726.png,0,0.939802825,613,1371,3415,4173,2802,2802,rainbow dash
2321974.jpg,https://derpicdn.net/img/view/2020/4/14/2321974.jpg,0,0.993423045,467,0,2077,1461,1610,1461,rainbow dash
2322889.jpg,https://derpicdn.net/img/view/2020/4/15/2322889.jpg,0,0.990059435,288,581,1500,1793,1212,1212,rainbow dash
2327266.jpg,https://derpicdn.net/img/view/2020/4/20/2327266.jpg,0,0.998737395,0,0,1230,1255,1230,1255,rainbow dash
2328209.jpg,https://derpicdn.net/img/view/2020/4/21/2328209.jpg,0,0.938863575,590,187,1098,695,508,508,rainbow dash
2329801.jpg,https://derpicdn.net/img/view/2020/4/23/2329801.jpg,0,0.998704612,393,32,1079,718,686,686,rainbow dash
2330589.png,https://derpicdn.net/img/view/2020/4/24/2330589.png,0,0.983041763,196,64,928,796,732,732,rainbow dash
2331527.png,https://derpicdn.net/img/view/2020/4/25/2331527.png,0,0.968482375,231,0,1493,1115,1262,1115,rainbow dash
233708.png,https://derpicdn.net/img/view/2013/2/4/233708.png,0,0.988057971,0,0,5000,5661,5000,5661,rainbow dash
2339504.png,https://derpicdn.net/img/view/2020/5/4/2339504.png,0,0.986596167,1249,62,2165,978,916,916,rainbow dash
2340929.png,https://derpicdn.net/img/view/2020/5/6/2340929.png,0,0.976876616,1871,586,3179,1894,1308,1308,rainbow dash
2342969.png,https://derpicdn.net/img/view/2020/5/8/2342969.png,0,0.998713255,0,18,693,714,693,696,rainbow dash
2345297.png,https://derpicdn.net/img/view/2020/5/11/2345297.png,1,0.95198226,0,145,433,587,433,442,rainbow dash
2347458.jpg,https://derpicdn.net/img/view/2020/5/13/2347458.jpg,0,0.949139416,0,0,780,770,780,770,rainbow dash
2347458.jpg,https://derpicdn.net/img/view/2020/5/13/2347458.jpg,0,0.949139416,0,0,780,770,780,770,rainbow dash
2347793.png,https://derpicdn.net/img/view/2020/5/13/2347793.png,0,0.999211907,472,43,1284,855,812,812,rainbow dash
2350276.png,https://derpicdn.net/img/view/2020/5/16/2350276.png,0,0.973521054,0,0,1184,1219,1184,1219,rainbow dash
2355655.png,https://derpicdn.net/img/view/2020/5/23/2355655.png,0,0.972664773,65,0,349,276,284,276,rainbow dash
2386.png,https://derpicdn.net/img/view/2012/1/25/2386.png,0,0.926461637,141,0,511,364,370,364,rainbow dash
241848.png,https://derpicdn.net/img/view/2013/2/13/241848.png,0,0.984647095,350,41,840,531,490,490,rainbow dash
251759.png,https://derpicdn.net/img/view/2013/2/22/251759.png,0,0.995139241,15,10,305,300,290,290,rainbow dash
254445.png,https://derpicdn.net/img/view/2013/2/24/254445.png,0,0.993423104,468,193,782,507,314,314,rainbow dash
254445.png,https://derpicdn.net/img/view/2013/2/24/254445.png,1,0.989530146,79,185,411,517,332,332,rainbow dash
26055.png,https://derpicdn.net/img/view/2012/6/30/26055.png,0,0.995562255,127,0,711,554,584,554,rainbow dash
264081.png,https://derpicdn.net/img/view/2013/3/6/264081.png,0,0.946516991,298,42,2612,2356,2314,2314,rainbow dash
273742.png,https://derpicdn.net/img/view/2013/3/18/273742.png,0,0.942186594,85,0,429,305,344,305,rainbow dash
276492.png,https://derpicdn.net/img/view/2013/3/22/276492.png,0,0.998439908,200,112,776,688,576,576,rainbow dash
276578.png,https://derpicdn.net/img/view/2013/3/22/276578.png,0,0.952050328,211,22,527,338,316,316,rainbow dash
281807.png,https://derpicdn.net/img/view/2013/3/28/281807.png,0,0.905058444,0,382,582,1074,582,692,rainbow dash
292101.png,https://derpicdn.net/img/view/2013/4/8/292101.png,0,0.995771766,14,0,382,368,368,368,rainbow dash
292984.jpg,https://derpicdn.net/img/view/2013/4/9/292984.jpg,0,0.979666352,171,0,431,254,260,254,rainbow dash
292984.jpg,https://derpicdn.net/img/view/2013/4/9/292984.jpg,0,0.979666352,171,0,431,254,260,254,rainbow dash
2990.jpg,https://derpicdn.net/img/view/2012/2/12/2990.jpg,0,0.960828722,7,0,585,529,578,529,rainbow dash
300349.png,https://derpicdn.net/img/view/2013/4/16/300349.png,0,0.988314211,0,2,358,378,358,376,rainbow dash
304776.png,https://derpicdn.net/img/view/2013/4/21/304776.png,0,0.950219154,0,90,778,888,778,798,rainbow dash
30571.png,https://derpicdn.net/img/view/2012/7/3/30571.png,0,0.91201663,0,123,303,513,303,390,rainbow dash
310132.png,https://derpicdn.net/img/view/2013/4/28/310132.png,0,0.967901766,86,0,800,647,714,647,rainbow dash
316295.png,https://derpicdn.net/img/view/2013/5/4/316295.png,0,0.994296789,50,38,314,302,264,264,rainbow dash
322236.png,https://derpicdn.net/img/view/2013/5/11/322236.png,0,0.999251544,206,0,590,370,384,370,rainbow dash
323011.png,https://derpicdn.net/img/view/2013/5/12/323011.png,0,0.976584017,95,486,1035,1426,940,940,rainbow dash
324907.png,https://derpicdn.net/img/view/2013/5/14/324907.png,0,0.990845561,23,0,339,300,316,300,rainbow dash
325891.png,https://derpicdn.net/img/view/2013/5/15/325891.png,0,0.998577774,394,18,754,378,360,360,rainbow dash
331818.png,https://derpicdn.net/img/view/2013/5/23/331818.png,0,0.972928584,755,60,1043,348,288,288,rainbow dash
340064.png,https://derpicdn.net/img/view/2013/6/3/340064.png,0,0.904499948,54,0,3029,3271,2975,3271,rainbow dash
345708.png,https://derpicdn.net/img/view/2013/6/11/345708.png,0,0.982722223,145,7,611,473,466,466,rainbow dash
348213.png,https://derpicdn.net/img/view/2013/6/14/348213.png,0,0.999770582,14,0,980,926,966,926,rainbow dash
357151.jpg,https://derpicdn.net/img/view/2013/6/25/357151.jpg,0,0.912557364,393,33,705,345,312,312,rainbow dash
362742.png,https://derpicdn.net/img/view/2013/7/2/362742.png,0,0.991727054,860,78,1308,526,448,448,rainbow dash
376039.png,https://derpicdn.net/img/view/2013/7/16/376039.png,0,0.918103218,2356,964,5000,3714,2644,2750,rainbow dash
378474.jpg,https://derpicdn.net/img/view/2013/7/19/378474.jpg,0,0.947327793,35,0,647,591,612,591,rainbow dash
383748.png,https://derpicdn.net/img/view/2013/7/25/383748.png,0,0.986886322,643,1597,2679,3633,2036,2036,rainbow dash
389419.png,https://derpicdn.net/img/view/2013/8/2/389419.png,0,0.965525389,51,84,553,586,502,502,rainbow dash
391716.png,https://derpicdn.net/img/view/2013/8/5/391716.png,0,0.99804318,50,28,782,760,732,732,rainbow dash
402794.jpg,https://derpicdn.net/img/view/2013/8/17/402794.jpg,0,0.992258608,919,0,1789,864,870,864,rainbow dash
403485.png,https://derpicdn.net/img/view/2013/8/18/403485.png,0,0.994755864,820,0,1274,448,454,448,rainbow dash
407464.jpg,https://derpicdn.net/img/view/2013/8/22/407464.jpg,0,0.988390684,343,55,741,453,398,398,rainbow dash
408446.png,https://derpicdn.net/img/view/2013/8/23/408446.png,0,0.916084647,334,0,748,366,414,366,rainbow dash
414545.png,https://derpicdn.net/img/view/2013/8/30/414545.png,0,0.979407549,0,14,626,710,626,696,rainbow dash
416608.png,https://derpicdn.net/img/view/2013/9/1/416608.png,0,0.957467496,24,61,1280,1439,1256,1378,rainbow dash
419938.jpg,https://derpicdn.net/img/view/2013/9/5/419938.jpg,0,0.939409435,783,421,1743,1381,960,960,rainbow dash
420957.png,https://derpicdn.net/img/view/2013/9/6/420957.png,0,0.997662485,12,0,586,469,574,469,rainbow dash
423862.png,https://derpicdn.net/img/view/2013/9/9/423862.png,0,0.969597876,2494,0,5716,2964,3222,2964,rainbow dash
431451.png,https://derpicdn.net/img/view/2013/9/20/431451.png,0,0.998693705,345,621,1647,1923,1302,1302,rainbow dash
433294.png,https://derpicdn.net/img/view/2013/9/23/433294.png,0,0.998179197,2175,0,4879,2582,2704,2582,rainbow dash
433455.png,https://derpicdn.net/img/view/2013/9/23/433455.png,0,0.999103844,75,146,399,470,324,324,rainbow dash
433904.jpg,https://derpicdn.net/img/view/2013/9/24/433904.jpg,0,0.99820292,0,31,270,303,270,272,rainbow dash
440061.png,https://derpicdn.net/img/view/2013/10/2/440061.png,0,0.998956621,160,0,620,436,460,436,rainbow dash
441502.png,https://derpicdn.net/img/view/2013/10/4/441502.png,0,0.988153756,11,8,321,318,310,310,rainbow dash
441710.png,https://derpicdn.net/img/view/2013/10/4/441710.png,0,0.995880544,55,0,833,685,778,685,rainbow dash
457152.png,https://derpicdn.net/img/view/2013/10/26/457152.png,0,0.990974128,686,98,1278,690,592,592,rainbow dash
472106.jpg,https://derpicdn.net/img/view/2013/11/13/472106.jpg,0,0.997312009,86,0,452,353,366,353,rainbow dash
475417.png,https://derpicdn.net/img/view/2013/11/18/475417.png,0,0.961970747,340,53,668,381,328,328,rainbow dash
477846.png,https://derpicdn.net/img/view/2013/11/21/477846.png,0,0.999025583,564,0,1268,623,704,623,rainbow dash
488315.png,https://derpicdn.net/img/view/2013/12/3/488315.png,0,0.984881699,118,0,3000,3057,2882,3057,rainbow dash
492805.png,https://derpicdn.net/img/view/2013/12/8/492805.png,0,0.950889766,199,103,973,877,774,774,rainbow dash
493701.png,https://derpicdn.net/img/view/2013/12/9/493701.png,0,0.956505418,490,378,1181,1074,691,696,rainbow dash
4972.png,https://derpicdn.net/img/view/2012/6/17/4972.png,0,0.966792405,478,40,1000,570,522,530,rainbow dash
497237.png,https://derpicdn.net/img/view/2013/12/15/497237.png,0,0.999193251,392,0,3338,2543,2946,2543,rainbow dash
506730.png,https://derpicdn.net/img/view/2013/12/26/506730.png,0,0.991426408,877,666,1773,1562,896,896,rainbow dash
506730.png,https://derpicdn.net/img/view/2013/12/26/506730.png,0,0.991426408,877,666,1773,1562,896,896,rainbow dash
509746.png,https://derpicdn.net/img/view/2013/12/30/509746.png,0,0.996043801,526,10,1728,1212,1202,1202,rainbow dash
511761.png,https://derpicdn.net/img/view/2014/1/1/511761.png,0,0.985770941,9,13,1663,1667,1654,1654,rainbow dash
512554.png,https://derpicdn.net/img/view/2014/1/2/512554.png,0,0.992646873,0,5,521,533,521,528,rainbow dash
522306.png,https://derpicdn.net/img/view/2014/1/12/522306.png,0,0.985771418,999,234,1559,794,560,560,rainbow dash
524193.png,https://derpicdn.net/img/view/2014/1/14/524193.png,0,0.994505286,124,25,1514,1415,1390,1390,rainbow dash
530520.jpg,https://derpicdn.net/img/view/2014/1/21/530520.jpg,0,0.943463862,310,0,1000,718,690,718,rainbow dash
532121.png,https://derpicdn.net/img/view/2014/1/23/532121.png,0,0.998004436,626,1,1244,619,618,618,rainbow dash
532121.png,https://derpicdn.net/img/view/2014/1/23/532121.png,1,0.995614529,410,505,996,1091,586,586,rainbow dash
541732.png,https://derpicdn.net/img/view/2014/2/2/541732.png,0,0.996626854,450,0,1002,539,552,539,rainbow dash
543360.png,https://derpicdn.net/img/view/2014/2/4/543360.png,0,0.998088002,1679,104,3279,1704,1600,1600,rainbow dash
545034.png,https://derpicdn.net/img/view/2014/2/6/545034.png,0,0.974121988,0,1110,4739,6000,4739,4890,rainbow dash
545109.png,https://derpicdn.net/img/view/2014/2/6/545109.png,0,0.994520843,314,0,3074,2625,2760,2625,rainbow dash
5477.png,https://derpicdn.net/img/view/2012/6/17/5477.png,0,0.996415615,64,0,530,457,466,457,rainbow dash
549964.png,https://derpicdn.net/img/view/2014/2/12/549964.png,0,0.924915016,397,27,735,365,338,338,rainbow dash
554388.png,https://derpicdn.net/img/view/2014/2/17/554388.png,0,0.981362045,282,249,1044,1011,762,762,rainbow dash
562967.png,https://derpicdn.net/img/view/2014/2/27/562967.png,0,0.934750855,59,0,1089,859,1030,859,rainbow dash
564392.png,https://derpicdn.net/img/view/2014/3/1/564392.png,0,0.996664584,221,0,567,345,346,345,rainbow dash
564557.png,https://derpicdn.net/img/view/2014/3/2/564557.png,0,0.989158154,60,0,430,351,370,351,rainbow dash
566065.jpg,https://derpicdn.net/img/view/2014/3/3/566065.jpg,0,0.990209639,1824,2712,2502,3456,678,744,rainbow dash
566065.jpg,https://derpicdn.net/img/view/2014/3/3/566065.jpg,1,0.968666017,1328,2790,2006,3468,678,678,rainbow dash
571458.png,https://derpicdn.net/img/view/2014/3/10/571458.png,0,0.997028172,25,1,795,771,770,770,rainbow dash
574079.png,https://derpicdn.net/img/view/2014/3/13/574079.png,0,0.998960555,453,0,4355,3642,3902,3642,rainbow dash
577953.png,https://derpicdn.net/img/view/2014/3/17/577953.png,0,0.995067835,398,0,898,486,500,486,rainbow dash
580422.png,https://derpicdn.net/img/view/2014/3/20/580422.png,0,0.998750389,1382,0,3824,2332,2442,2332,rainbow dash
593569.jpg,https://derpicdn.net/img/view/2014/4/5/593569.jpg,0,0.969398558,58,0,418,337,360,337,rainbow dash
594321.jpg,https://derpicdn.net/img/view/2014/4/6/594321.jpg,0,0.998658419,370,0,782,385,412,385,rainbow dash
604617.png,https://derpicdn.net/img/view/2014/4/19/604617.png,0,0.987604201,6,0,570,539,564,539,rainbow dash
608959.png,https://derpicdn.net/img/view/2014/4/24/608959.png,0,0.923362613,88,0,900,817,812,817,rainbow dash
609511.png,https://derpicdn.net/img/view/2014/4/25/609511.png,0,0.964608908,179,0,3413,3087,3234,3087,rainbow dash
619946.png,https://derpicdn.net/img/view/2014/5/7/619946.png,0,0.99513489,1318,162,1942,786,624,624,rainbow dash
621041.png,https://derpicdn.net/img/view/2014/5/8/621041.png,0,0.998248279,590,0,1492,863,902,863,rainbow dash
622134.png,https://derpicdn.net/img/view/2014/5/10/622134.png,0,0.990502536,434,4,934,504,500,500,rainbow dash
624914.jpg,https://derpicdn.net/img/view/2014/5/12/624914.jpg,0,0.999046683,170,33,442,305,272,272,rainbow dash
629600.png,https://derpicdn.net/img/view/2014/5/18/629600.png,0,0.978289068,306,0,738,373,432,373,rainbow dash
630591.png,https://derpicdn.net/img/view/2014/5/18/630591.png,0,0.967975378,0,4,1186,1144,1186,1140,rainbow dash
633480.png,https://derpicdn.net/img/view/2014/5/22/633480.png,0,0.989216447,29,0,355,315,326,315,rainbow dash
636032.png,https://derpicdn.net/img/view/2014/5/25/636032.png,0,0.991870284,445,0,759,265,314,265,rainbow dash
648762.png,https://derpicdn.net/img/view/2014/6/9/648762.png,0,0.999001682,217,16,529,328,312,312,rainbow dash
648979.png,https://derpicdn.net/img/view/2014/6/9/648979.png,0,0.998708785,500,0,834,302,334,302,rainbow dash
648979.png,https://derpicdn.net/img/view/2014/6/9/648979.png,1,0.996261418,262,80,534,352,272,272,rainbow dash
649734.png,https://derpicdn.net/img/view/2014/6/10/649734.png,0,0.997140467,319,22,795,498,476,476,rainbow dash
650504.png,https://derpicdn.net/img/view/2014/6/11/650504.png,0,0.983019471,200,31,680,511,480,480,rainbow dash
657.png,https://derpicdn.net/img/view/2012/1/17/657.png,0,0.960515022,474,27,750,303,276,276,rainbow dash
658150.png,https://derpicdn.net/img/view/2014/6/21/658150.png,0,0.999187529,2435,0,4663,2145,2228,2145,rainbow dash
658307.png,https://derpicdn.net/img/view/2014/6/21/658307.png,0,0.980589926,120,7,400,287,280,280,rainbow dash
660801.png,https://derpicdn.net/img/view/2014/6/24/660801.png,0,0.96260941,0,0,1695,1546,1695,1546,rainbow dash
663589.png,https://derpicdn.net/img/view/2014/6/29/663589.png,0,0.973909914,538,76,1166,704,628,628,rainbow dash
664798.jpg,https://derpicdn.net/img/view/2014/6/30/664798.jpg,0,0.968841195,278,391,1390,1503,1112,1112,rainbow dash
674896.png,https://derpicdn.net/img/view/2014/7/14/674896.png,1,0.986019552,391,7,759,375,368,368,rainbow dash
67853.jpg,https://derpicdn.net/img/view/2012/8/5/67853.jpg,0,0.989912391,185,2,753,570,568,568,rainbow dash
684447.png,https://derpicdn.net/img/view/2014/7/27/684447.png,0,0.993284583,142,38,536,432,394,394,rainbow dash
685082.png,https://derpicdn.net/img/view/2014/7/28/685082.png,0,0.998619378,213,4,697,488,484,484,rainbow dash
685243.png,https://derpicdn.net/img/view/2014/7/28/685243.png,0,0.997956336,384,0,1394,923,1010,923,rainbow dash
688778.png,https://derpicdn.net/img/view/2014/8/1/688778.png,0,0.979594171,1222,0,3000,1732,1778,1732,rainbow dash
689942.png,https://derpicdn.net/img/view/2014/8/3/689942.png,0,0.995132327,749,17,1381,649,632,632,rainbow dash
694042.png,https://derpicdn.net/img/view/2014/8/7/694042.png,0,0.999335647,756,53,1644,941,888,888,rainbow dash
695120.png,https://derpicdn.net/img/view/2014/8/9/695120.png,0,0.996591389,630,0,1006,284,376,284,rainbow dash
695120.png,https://derpicdn.net/img/view/2014/8/9/695120.png,0,0.996591389,630,0,1006,284,376,284,rainbow dash
696824.png,https://derpicdn.net/img/view/2014/8/10/696824.png,0,0.999035299,351,5,991,645,640,640,rainbow dash
699216.png,https://derpicdn.net/img/view/2014/8/14/699216.png,0,0.917342126,22,0,478,454,456,454,rainbow dash
705392.png,https://derpicdn.net/img/view/2014/8/22/705392.png,0,0.999104142,385,98,1853,1566,1468,1468,rainbow dash
707040.jpg,https://derpicdn.net/img/view/2014/8/24/707040.jpg,0,0.995205343,149,0,387,235,238,235,rainbow dash
711065.png,https://derpicdn.net/img/view/2014/8/30/711065.png,0,0.999459326,144,0,778,607,634,607,rainbow dash
711065.png,https://derpicdn.net/img/view/2014/8/30/711065.png,0,0.999459326,144,0,778,607,634,607,rainbow dash
713488.png,https://derpicdn.net/img/view/2014/9/2/713488.png,0,0.991901994,246,82,574,410,328,328,rainbow dash
713488.png,https://derpicdn.net/img/view/2014/9/2/713488.png,0,0.991901994,246,82,574,410,328,328,rainbow dash
724993.png,https://derpicdn.net/img/view/2014/9/19/724993.png,0,0.991670012,76,0,714,603,638,603,rainbow dash
728154.png,https://derpicdn.net/img/view/2014/9/24/728154.png,0,0.997673392,205,0,1287,1068,1082,1068,rainbow dash
728858.png,https://derpicdn.net/img/view/2014/9/25/728858.png,0,0.942278206,0,0,445,451,445,451,rainbow dash
736082.jpg,https://derpicdn.net/img/view/2014/10/5/736082.jpg,0,0.994563401,117,0,497,377,380,377,rainbow dash
73616.png,https://derpicdn.net/img/view/2012/8/13/73616.png,0,0.997390032,108,1,482,375,374,374,rainbow dash
739909.png,https://derpicdn.net/img/view/2014/10/10/739909.png,0,0.945496321,139,0,1071,911,932,911,rainbow dash
744311.png,https://derpicdn.net/img/view/2014/10/16/744311.png,0,0.999506056,359,9,1205,855,846,846,rainbow dash
744311.png,https://derpicdn.net/img/view/2014/10/16/744311.png,0,0.999506056,359,9,1205,855,846,846,rainbow dash
747704.png,https://derpicdn.net/img/view/2014/10/21/747704.png,0,0.982095242,182,72,390,280,208,208,rainbow dash
748253.png,https://derpicdn.net/img/view/2014/10/22/748253.png,0,0.965335727,88,0,1460,1080,1372,1080,rainbow dash
748253.png,https://derpicdn.net/img/view/2014/10/22/748253.png,0,0.965335727,88,0,1460,1080,1372,1080,rainbow dash
756587.png,https://derpicdn.net/img/view/2014/11/2/756587.png,0,0.986329913,100,157,510,567,410,410,rainbow dash
757431.png,https://derpicdn.net/img/view/2014/11/4/757431.png,0,0.991224647,0,0,931,836,931,836,rainbow dash
75985.png,https://derpicdn.net/img/view/2012/8/16/75985.png,0,0.958078504,649,234,2945,2530,2296,2296,rainbow dash
761266.png,https://derpicdn.net/img/view/2014/11/9/761266.png,0,0.998454809,207,0,517,303,310,303,rainbow dash
764041.png,https://derpicdn.net/img/view/2014/11/13/764041.png,0,0.982862949,74,73,400,399,326,326,rainbow dash
764041.png,https://derpicdn.net/img/view/2014/11/13/764041.png,0,0.982862949,74,73,400,399,326,326,rainbow dash
771891.png,https://derpicdn.net/img/view/2014/11/25/771891.png,0,0.993449271,614,639,1122,1147,508,508,rainbow dash
772314.jpg,https://derpicdn.net/img/view/2014/11/26/772314.jpg,0,0.998875916,336,51,770,485,434,434,rainbow dash
774783.png,https://derpicdn.net/img/view/2014/11/30/774783.png,0,0.998288393,327,40,1283,996,956,956,rainbow dash
77542.png,https://derpicdn.net/img/view/2012/8/18/77542.png,0,0.915760338,208,48,510,350,302,302,rainbow dash
775449.png,https://derpicdn.net/img/view/2014/11/30/775449.png,0,0.998833477,210,32,722,544,512,512,rainbow dash
776632.png,https://derpicdn.net/img/view/2014/12/2/776632.png,0,0.991570234,746,0,2014,1268,1268,1268,rainbow dash
780281.png,https://derpicdn.net/img/view/2014/12/7/780281.png,0,0.993369877,217,13,1099,895,882,882,rainbow dash
780338.jpg,https://derpicdn.net/img/view/2014/12/8/780338.jpg,0,0.996800959,287,0,729,423,442,423,rainbow dash
781117.png,https://derpicdn.net/img/view/2014/12/9/781117.png,0,0.984684527,0,62,1227,1396,1227,1334,rainbow dash
78782.png,https://derpicdn.net/img/view/2012/8/20/78782.png,0,0.959041536,105,9,437,341,332,332,rainbow dash
791133.png,https://derpicdn.net/img/view/2014/12/23/791133.png,0,0.995361388,356,71,1242,957,886,886,rainbow dash
792765.png,https://derpicdn.net/img/view/2014/12/26/792765.png,0,0.999008536,313,0,763,404,450,404,rainbow dash
800410.png,https://derpicdn.net/img/view/2015/1/6/800410.png,0,0.996625781,0,0,494,556,494,556,rainbow dash
804086.png,https://derpicdn.net/img/view/2015/1/11/804086.png,0,0.994891286,249,0,591,336,342,336,rainbow dash
806624.png,https://derpicdn.net/img/view/2015/1/14/806624.png,0,0.996739924,1001,0,2003,982,1002,982,rainbow dash
807544.jpg,https://derpicdn.net/img/view/2015/1/16/807544.jpg,0,0.992239833,622,199,1664,1241,1042,1042,rainbow dash
818979.png,https://derpicdn.net/img/view/2015/2/1/818979.png,0,0.9779737,0,0,601,635,601,635,rainbow dash
825024.png,https://derpicdn.net/img/view/2015/2/9/825024.png,0,0.989955962,107,0,643,501,536,501,rainbow dash
828982.png,https://derpicdn.net/img/view/2015/2/15/828982.png,0,0.984177947,597,424,1501,1328,904,904,rainbow dash
832129.png,https://derpicdn.net/img/view/2015/2/19/832129.png,0,0.995984316,659,0,1781,1080,1122,1080,rainbow dash
833052.png,https://derpicdn.net/img/view/2015/2/20/833052.png,0,0.999710858,237,0,679,424,442,424,rainbow dash
833282.jpg,https://derpicdn.net/img/view/2015/2/20/833282.jpg,0,0.968913376,151,12,385,246,234,234,rainbow dash
834303.png,https://derpicdn.net/img/view/2015/2/21/834303.png,0,0.998973191,356,0,1028,661,672,661,rainbow dash
835805.png,https://derpicdn.net/img/view/2015/2/23/835805.png,0,0.973206282,365,70,687,392,322,322,rainbow dash
837394.png,https://derpicdn.net/img/view/2015/2/25/837394.png,0,0.998071253,815,0,1865,1011,1050,1011,rainbow dash
838070.png,https://derpicdn.net/img/view/2015/2/27/838070.png,0,0.995400071,457,69,1517,1129,1060,1060,rainbow dash
840387.png,https://derpicdn.net/img/view/2015/3/2/840387.png,0,0.973998666,886,2090,3924,5128,3038,3038,rainbow dash
843050.png,https://derpicdn.net/img/view/2015/3/5/843050.png,0,0.995284081,287,5,535,253,248,248,rainbow dash
8444.png,https://derpicdn.net/img/view/2012/6/18/8444.png,0,0.966337562,0,0,674,698,674,698,rainbow dash
84483.jpg,https://derpicdn.net/img/view/2012/8/28/84483.jpg,0,0.948018253,1058,7,1406,355,348,348,rainbow dash
845694.png,https://derpicdn.net/img/view/2015/3/9/845694.png,0,0.988902926,282,0,782,564,500,564,rainbow dash
851173.png,https://derpicdn.net/img/view/2015/3/17/851173.png,0,0.912763894,136,562,302,728,166,166,rainbow dash
852194.png,https://derpicdn.net/img/view/2015/3/18/852194.png,0,0.989790082,413,0,3307,2160,2894,2160,rainbow dash
853312.png,https://derpicdn.net/img/view/2015/3/20/853312.png,0,0.997917533,431,123,1157,849,726,726,rainbow dash
854217.png,https://derpicdn.net/img/view/2015/3/21/854217.png,0,0.98137182,519,72,845,398,326,326,rainbow dash
859335.png,https://derpicdn.net/img/view/2015/3/29/859335.png,0,0.987172842,73,33,447,407,374,374,rainbow dash
862163.png,https://derpicdn.net/img/view/2015/4/1/862163.png,0,0.988102138,117,0,565,405,448,405,rainbow dash
862468.png,https://derpicdn.net/img/view/2015/4/1/862468.png,0,0.967812717,33,147,723,837,690,690,rainbow dash
862703.png,https://derpicdn.net/img/view/2015/4/2/862703.png,0,0.996156514,279,0,1041,721,762,721,rainbow dash
86516.png,https://derpicdn.net/img/view/2012/8/30/86516.png,0,0.984736562,80,0,736,643,656,643,rainbow dash
866003.jpg,https://derpicdn.net/img/view/2015/4/5/866003.jpg,0,0.996860921,107,326,317,536,210,210,rainbow dash
870225.png,https://derpicdn.net/img/view/2015/4/10/870225.png,0,0.99501282,253,0,789,536,536,536,rainbow dash
883853.png,https://derpicdn.net/img/view/2015/4/27/883853.png,0,0.993387282,0,11,1008,1087,1008,1076,rainbow dash
883853.png,https://derpicdn.net/img/view/2015/4/27/883853.png,1,0.926624596,268,0,1280,976,1012,976,rainbow dash
896013.png,https://derpicdn.net/img/view/2015/5/14/896013.png,0,0.96548605,674,79,2848,2253,2174,2174,rainbow dash
901634.png,https://derpicdn.net/img/view/2015/5/22/901634.png,0,0.948566377,59,6,790,758,731,752,rainbow dash
902791.png,https://derpicdn.net/img/view/2015/5/23/902791.png,0,0.99564898,32,0,720,658,688,658,rainbow dash
902921.png,https://derpicdn.net/img/view/2015/5/24/902921.png,0,0.990071595,800,234,1170,604,370,370,rainbow dash
902921.png,https://derpicdn.net/img/view/2015/5/24/902921.png,0,0.990071595,800,234,1170,604,370,370,rainbow dash
9066.png,https://derpicdn.net/img/view/2012/6/19/9066.png,0,0.976216018,1261,0,1913,546,652,546,rainbow dash
907240.png,https://derpicdn.net/img/view/2015/5/31/907240.png,0,0.978275716,473,0,1600,1145,1127,1145,rainbow dash
908744.png,https://derpicdn.net/img/view/2015/6/2/908744.png,0,0.989236832,75,33,675,633,600,600,rainbow dash
909994.png,https://derpicdn.net/img/view/2015/6/4/909994.png,0,0.994450688,24,0,1250,1238,1226,1238,rainbow dash
912904.png,https://derpicdn.net/img/view/2015/6/8/912904.png,0,0.939457357,115,0,599,444,484,444,rainbow dash
919542.png,https://derpicdn.net/img/view/2015/6/19/919542.png,0,0.995724261,151,20,419,288,268,268,rainbow dash
924491.png,https://derpicdn.net/img/view/2015/6/27/924491.png,0,0.990397632,444,426,722,704,278,278,rainbow dash
946296.png,https://derpicdn.net/img/view/2015/7/29/946296.png,0,0.990146875,201,277,1203,1279,1002,1002,rainbow dash
946515.jpg,https://derpicdn.net/img/view/2015/7/29/946515.jpg,0,0.995395839,141,0,663,499,522,499,rainbow dash
946515.jpg,https://derpicdn.net/img/view/2015/7/29/946515.jpg,0,0.995395839,141,0,663,499,522,499,rainbow dash
950622.png,https://derpicdn.net/img/view/2015/8/4/950622.png,0,0.99623692,280,0,638,348,358,348,rainbow dash
950648.png,https://derpicdn.net/img/view/2015/8/4/950648.png,0,0.977598011,0,0,877,858,877,858,rainbow dash
953283.png,https://derpicdn.net/img/view/2015/8/8/953283.png,0,0.998663425,138,5,490,357,352,352,rainbow dash
954169.png,https://derpicdn.net/img/view/2015/8/9/954169.png,0,0.998315632,139,0,2021,1812,1882,1812,rainbow dash
958263.png,https://derpicdn.net/img/view/2015/8/15/958263.png,0,0.995932817,181,142,473,434,292,292,rainbow dash
958263.png,https://derpicdn.net/img/view/2015/8/15/958263.png,0,0.995932817,181,142,473,434,292,292,rainbow dash
959075.png,https://derpicdn.net/img/view/2015/8/16/959075.png,0,0.984084964,0,0,201,196,201,196,rainbow dash
964756.jpg,https://derpicdn.net/img/view/2015/8/24/964756.jpg,0,0.99491173,435,0,965,526,530,526,rainbow dash
968713.png,https://derpicdn.net/img/view/2015/8/30/968713.png,0,0.920563698,254,14,470,238,216,224,rainbow dash
969284.png,https://derpicdn.net/img/view/2015/8/30/969284.png,0,0.988973916,284,280,4632,4628,4348,4348,rainbow dash
969284.png,https://derpicdn.net/img/view/2015/8/30/969284.png,0,0.988973916,284,280,4632,4628,4348,4348,rainbow dash
972166.png,https://derpicdn.net/img/view/2015/9/3/972166.png,0,0.9827739,254,0,882,518,628,518,rainbow dash
982410.png,https://derpicdn.net/img/view/2015/9/18/982410.png,0,0.995792866,837,70,1927,1160,1090,1090,rainbow dash
982410.png,https://derpicdn.net/img/view/2015/9/18/982410.png,0,0.995792866,837,70,1927,1160,1090,1090,rainbow dash
983025.png,https://derpicdn.net/img/view/2015/9/19/983025.png,0,0.982449114,210,0,633,411,423,411,rainbow dash
983323.png,https://derpicdn.net/img/view/2015/9/19/983323.png,0,0.996838152,1591,0,3340,1829,1749,1829,rainbow dash
98345.png,https://derpicdn.net/img/view/2012/9/15/98345.png,0,0.999132574,732,87,1280,649,548,562,rainbow dash
986865.png,https://derpicdn.net/img/view/2015/9/24/986865.png,0,0.99210608,770,0,1668,851,898,851,rainbow dash
989958.png,https://derpicdn.net/img/view/2015/9/28/989958.png,0,0.97740525,0,0,932,899,932,899,rainbow dash
992492.png,https://derpicdn.net/img/view/2015/10/2/992492.png,0,0.988565266,201,84,747,630,546,546,rainbow dash
998405.jpg,https://derpicdn.net/img/view/2015/10/10/998405.jpg,0,0.995120287,511,0,955,408,444,408,rainbow dash
100168.png,https://derpicdn.net/img/view/2012/9/17/100168.png,0,0.999105632,99,0,481,342,382,342,rainbow dash
1007962.png,https://derpicdn.net/img/view/2015/10/23/1007962.png,0,0.99982214,60,14,514,468,454,454,rainbow dash
1023330.png,https://derpicdn.net/img/view/2015/11/15/1023330.png,0,0.977593422,0,0,465,482,465,482,rainbow dash
1023752.png,https://derpicdn.net/img/view/2015/11/16/1023752.png,0,0.997256339,318,0,740,394,422,394,rainbow dash
1024687.png,https://derpicdn.net/img/view/2015/11/17/1024687.png,0,0.997432292,0,28,718,784,718,756,rainbow dash
1028907.png,https://derpicdn.net/img/view/2015/11/23/1028907.png,0,0.999360144,630,0,1618,926,988,926,rainbow dash
1030048.png,https://derpicdn.net/img/view/2015/11/25/1030048.png,0,0.994806588,0,0,2784,2832,2784,2832,rainbow dash
1030128.png,https://derpicdn.net/img/view/2015/11/25/1030128.png,0,0.994938195,849,197,1143,491,294,294,rainbow dash
1031294.png,https://derpicdn.net/img/view/2015/11/27/1031294.png,0,0.999763906,408,0,1054,603,646,603,rainbow dash
1032057.png,https://derpicdn.net/img/view/2015/11/28/1032057.png,0,0.965023696,304,0,892,572,588,572,rainbow dash
1032198.png,https://derpicdn.net/img/view/2015/11/28/1032198.png,0,0.922067046,797,0,3103,2226,2306,2226,rainbow dash
1041209.png,https://derpicdn.net/img/view/2015/12/10/1041209.png,0,0.993192971,405,0,1785,1119,1380,1119,rainbow dash
1043440.png,https://derpicdn.net/img/view/2015/12/13/1043440.png,0,0.978313446,1009,1094,1639,1724,630,630,rainbow dash
1044388.jpg,https://derpicdn.net/img/view/2015/12/14/1044388.jpg,0,0.98013258,0,0,813,764,813,764,rainbow dash
1057418.png,https://derpicdn.net/img/view/2016/1/1/1057418.png,0,0.998823285,139,0,697,512,558,512,rainbow dash
1062739.png,https://derpicdn.net/img/view/2016/1/9/1062739.png,0,0.990959227,408,289,938,819,530,530,rainbow dash
1062739.png,https://derpicdn.net/img/view/2016/1/9/1062739.png,1,0.985997796,844,1016,1300,1472,456,456,rainbow dash
1066194.png,https://derpicdn.net/img/view/2016/1/14/1066194.png,0,0.983932853,0,0,4120,4716,4120,4716,rainbow dash
1066194.png,https://derpicdn.net/img/view/2016/1/14/1066194.png,1,0.948836505,0,0,3480,3727,3480,3727,rainbow dash
1066493.png,https://derpicdn.net/img/view/2016/1/14/1066493.png,0,0.996706486,681,54,1057,430,376,376,rainbow dash
1076780.png,https://derpicdn.net/img/view/2016/1/30/1076780.png,0,0.997323096,154,27,764,637,610,610,rainbow dash
1078679.png,https://derpicdn.net/img/view/2016/2/2/1078679.png,0,0.994240642,1173,37,2815,1679,1642,1642,rainbow dash
1083864.png,https://derpicdn.net/img/view/2016/2/9/1083864.png,0,0.995851934,675,37,2093,1455,1418,1418,rainbow dash
1086412.png,https://derpicdn.net/img/view/2016/2/12/1086412.png,0,0.995216131,318,0,892,568,574,568,rainbow dash
1089211.png,https://derpicdn.net/img/view/2016/2/15/1089211.png,0,0.988301039,1844,1015,2408,1579,564,564,rainbow dash
1089211.png,https://derpicdn.net/img/view/2016/2/15/1089211.png,1,0.980909467,366,28,892,554,526,526,rainbow dash
1092494.png,https://derpicdn.net/img/view/2016/2/20/1092494.png,0,0.993824065,191,0,827,615,636,615,rainbow dash
1098699.png,https://derpicdn.net/img/view/2016/2/28/1098699.png,0,0.927408516,398,34,968,604,570,570,rainbow dash
1105870.png,https://derpicdn.net/img/view/2016/3/10/1105870.png,0,0.989564657,149,21,587,459,438,438,rainbow dash
1133025.png,https://derpicdn.net/img/view/2016/4/16/1133025.png,0,0.993118882,0,377,2519,2927,2519,2550,rainbow dash
1133441.png,https://derpicdn.net/img/view/2016/4/16/1133441.png,0,0.99938035,351,0,601,211,250,211,rainbow dash
1134020.png,https://derpicdn.net/img/view/2016/4/17/1134020.png,0,0.987207651,601,0,1011,404,410,404,rainbow dash
1134021.png,https://derpicdn.net/img/view/2016/4/17/1134021.png,0,0.922552943,628,181,996,549,368,368,rainbow dash
1134022.png,https://derpicdn.net/img/view/2016/4/17/1134022.png,0,0.949774742,614,202,1040,628,426,426,rainbow dash
1140300.png,https://derpicdn.net/img/view/2016/4/26/1140300.png,0,0.993934155,148,232,610,694,462,462,rainbow dash
1143983.png,https://derpicdn.net/img/view/2016/5/1/1143983.png,0,0.987383187,129,0,499,366,370,366,rainbow dash
1147338.png,https://derpicdn.net/img/view/2016/5/5/1147338.png,0,0.980054319,650,66,1040,456,390,390,rainbow dash
1149052.png,https://derpicdn.net/img/view/2016/5/8/1149052.png,0,0.974925399,0,150,618,731,618,581,rainbow dash
1149349.png,https://derpicdn.net/img/view/2016/5/8/1149349.png,0,0.99671793,900,101,1856,1057,956,956,rainbow dash
1150193.png,https://derpicdn.net/img/view/2016/5/9/1150193.png,0,0.961126268,211,0,1137,720,926,720,rainbow dash
1152240.png,https://derpicdn.net/img/view/2016/5/12/1152240.png,0,0.997402668,1488,0,2902,1346,1414,1346,rainbow dash
1170264.png,https://derpicdn.net/img/view/2016/6/4/1170264.png,0,0.973652303,0,0,304,331,304,331,rainbow dash
1173613.png,https://derpicdn.net/img/view/2016/6/8/1173613.png,0,0.907225311,583,117,2864,2559,2281,2442,rainbow dash
1175806.png,https://derpicdn.net/img/view/2016/6/11/1175806.png,0,0.987235069,0,0,320,347,320,347,rainbow dash
1181025.png,https://derpicdn.net/img/view/2016/6/18/1181025.png,0,0.999405921,639,195,1241,797,602,602,rainbow dash
1181025.png,https://derpicdn.net/img/view/2016/6/18/1181025.png,1,0.995021582,1172,353,1806,987,634,634,rainbow dash
1184259.png,https://derpicdn.net/img/view/2016/6/22/1184259.png,0,0.95929718,0,0,530,499,530,499,rainbow dash
1185276.png,https://derpicdn.net/img/view/2016/6/23/1185276.png,0,0.99500376,503,0,1629,1072,1126,1072,rainbow dash
1185407.jpg,https://derpicdn.net/img/view/2016/6/23/1185407.jpg,0,0.991296768,149,0,901,711,752,711,rainbow dash
1187096.png,https://derpicdn.net/img/view/2016/6/26/1187096.png,0,0.961957395,465,26,1099,660,634,634,rainbow dash
1206358.png,https://derpicdn.net/img/view/2016/7/22/1206358.png,1,0.993190169,1415,226,2729,1540,1314,1314,rainbow dash
1212522.png,https://derpicdn.net/img/view/2016/7/30/1212522.png,0,0.928076923,0,0,1221,1034,1221,1034,rainbow dash
1219294.png,https://derpicdn.net/img/view/2016/8/7/1219294.png,0,0.968078613,49,4,387,374,338,370,rainbow dash
1222738.png,https://derpicdn.net/img/view/2016/8/11/1222738.png,0,0.984712839,1106,202,1832,928,726,726,rainbow dash
1225290.png,https://derpicdn.net/img/view/2016/8/14/1225290.png,0,0.955089629,140,3,648,511,508,508,rainbow dash
12548.jpg,https://derpicdn.net/img/view/2012/6/20/12548.jpg,0,0.998278975,123,0,405,281,282,281,rainbow dash
1269953.png,https://derpicdn.net/img/view/2016/10/10/1269953.png,0,0.979513466,100,0,360,244,260,244,rainbow dash
1276438.png,https://derpicdn.net/img/view/2016/10/18/1276438.png,0,0.999079466,35,0,483,430,448,430,rainbow dash
1276929.png,https://derpicdn.net/img/view/2016/10/19/1276929.png,0,0.999131918,328,2,1280,954,952,952,rainbow dash
1279568.png,https://derpicdn.net/img/view/2016/10/23/1279568.png,0,0.994032145,451,0,2491,1948,2040,1948,rainbow dash
1283491.png,https://derpicdn.net/img/view/2016/10/28/1283491.png,0,0.91491282,39,0,1187,800,1148,800,rainbow dash
1286922.png,https://derpicdn.net/img/view/2016/11/2/1286922.png,0,0.978290796,0,0,1544,1710,1544,1710,rainbow dash
1287943.png,https://derpicdn.net/img/view/2016/11/3/1287943.png,0,0.993782997,146,0,770,547,624,547,rainbow dash
1298838.png,https://derpicdn.net/img/view/2016/11/19/1298838.png,0,0.912278831,340,0,784,435,444,435,rainbow dash
1302772.png,https://derpicdn.net/img/view/2016/11/24/1302772.png,0,0.997644484,20,0,478,409,458,409,rainbow dash
1304505.png,https://derpicdn.net/img/view/2016/11/27/1304505.png,0,0.961254179,0,72,490,562,490,490,rainbow dash
1304748.png,https://derpicdn.net/img/view/2016/11/27/1304748.png,0,0.975805163,264,141,524,401,260,260,rainbow dash
1323023.png,https://derpicdn.net/img/view/2016/12/22/1323023.png,0,0.962808669,270,221,696,647,426,426,rainbow dash
1326124.png,https://derpicdn.net/img/view/2016/12/27/1326124.png,0,0.994328737,2134,126,4528,2634,2394,2508,rainbow dash
1330072.png,https://derpicdn.net/img/view/2017/1/1/1330072.png,0,0.991078317,127,28,523,424,396,396,rainbow dash
1331837.png,https://derpicdn.net/img/view/2017/1/4/1331837.png,0,0.907456875,26,2,688,664,662,662,rainbow dash
1336067.png,https://derpicdn.net/img/view/2017/1/9/1336067.png,0,0.99731189,259,0,1077,812,818,812,rainbow dash
1340313.png,https://derpicdn.net/img/view/2017/1/15/1340313.png,0,0.957569301,0,0,957,978,957,978,rainbow dash
1340960.png,https://derpicdn.net/img/view/2017/1/16/1340960.png,0,0.91769594,53,30,913,890,860,860,rainbow dash
1357439.png,https://derpicdn.net/img/view/2017/2/7/1357439.png,0,0.925005376,828,59,2000,1239,1172,1180,rainbow dash
1359109.png,https://derpicdn.net/img/view/2017/2/10/1359109.png,0,0.998025537,59,0,1255,1132,1196,1132,rainbow dash
1365599.png,https://derpicdn.net/img/view/2017/2/17/1365599.png,0,0.997380972,646,0,1496,795,850,795,rainbow dash
1368074.png,https://derpicdn.net/img/view/2017/2/20/1368074.png,0,0.900461793,361,0,1183,707,822,707,rainbow dash
1373552.png,https://derpicdn.net/img/view/2017/2/26/1373552.png,0,0.954020023,259,93,743,577,484,484,rainbow dash
1377104.png,https://derpicdn.net/img/view/2017/3/2/1377104.png,0,0.998436213,21,0,479,424,458,424,rainbow dash
1382779.png,https://derpicdn.net/img/view/2017/3/9/1382779.png,0,0.994831204,413,0,1233,818,820,818,rainbow dash
1383259.png,https://derpicdn.net/img/view/2017/3/9/1383259.png,0,0.995994389,1676,0,3244,1491,1568,1491,rainbow dash
1387706.png,https://derpicdn.net/img/view/2017/3/15/1387706.png,0,0.959841192,157,114,371,328,214,214,rainbow dash
1391322.png,https://derpicdn.net/img/view/2017/3/19/1391322.png,0,0.984453082,1045,310,2351,1616,1306,1306,rainbow dash
1395684.png,https://derpicdn.net/img/view/2017/3/25/1395684.png,0,0.963576555,200,30,712,542,512,512,rainbow dash
1397429.png,https://derpicdn.net/img/view/2017/3/27/1397429.png,0,0.998086095,818,0,1800,950,982,950,rainbow dash
1397485.png,https://derpicdn.net/img/view/2017/3/27/1397485.png,0,0.992119849,359,8,708,360,349,352,rainbow dash
1401198.png,https://derpicdn.net/img/view/2017/4/1/1401198.png,0,0.942831337,345,0,655,303,310,303,rainbow dash
1406768.png,https://derpicdn.net/img/view/2017/4/8/1406768.png,0,0.993399799,208,33,1000,825,792,792,rainbow dash
1407772.png,https://derpicdn.net/img/view/2017/4/9/1407772.png,0,0.997448921,926,49,1718,841,792,792,rainbow dash
1407977.png,https://derpicdn.net/img/view/2017/4/10/1407977.png,0,0.999332845,1610,0,3410,1722,1800,1722,rainbow dash
1408572.png,https://derpicdn.net/img/view/2017/4/10/1408572.png,0,0.954014003,0,0,1004,1036,1004,1036,rainbow dash
1413.jpg,https://derpicdn.net/img/view/2012/1/22/1413.jpg,0,0.944941282,41,140,361,460,320,320,rainbow dash
1415179.png,https://derpicdn.net/img/view/2017/4/18/1415179.png,0,0.976572156,0,0,1200,1523,1200,1523,rainbow dash
1418265.png,https://derpicdn.net/img/view/2017/4/22/1418265.png,0,0.98357892,12,0,966,768,954,768,rainbow dash
1427460.png,https://derpicdn.net/img/view/2017/5/3/1427460.png,0,0.973624766,73,62,595,584,522,522,rainbow dash
1429361.png,https://derpicdn.net/img/view/2017/5/5/1429361.png,0,0.977800667,341,148,775,582,434,434,rainbow dash
1440758.png,https://derpicdn.net/img/view/2017/5/20/1440758.png,1,0.97708565,0,149,781,937,781,788,rainbow dash
1443159.png,https://derpicdn.net/img/view/2017/5/22/1443159.png,0,0.990308821,198,12,608,422,410,410,rainbow dash
1445642.png,https://derpicdn.net/img/view/2017/5/25/1445642.png,0,0.941501439,0,40,795,868,795,828,rainbow dash
1447019.png,https://derpicdn.net/img/view/2017/5/27/1447019.png,0,0.999210358,1006,146,3990,3130,2984,2984,rainbow dash
1447194.png,https://derpicdn.net/img/view/2017/5/27/1447194.png,0,0.937100351,996,0,6000,4307,5004,4307,rainbow dash
1447869.png,https://derpicdn.net/img/view/2017/5/28/1447869.png,0,0.953718007,516,8,2300,1884,1784,1876,rainbow dash
1451861.png,https://derpicdn.net/img/view/2017/6/2/1451861.png,0,0.937141418,186,0,978,712,792,712,rainbow dash
1455579.png,https://derpicdn.net/img/view/2017/6/6/1455579.png,0,0.981664121,605,81,1639,1115,1034,1034,rainbow dash
1459704.png,https://derpicdn.net/img/view/2017/6/12/1459704.png,0,0.999727309,230,73,726,569,496,496,rainbow dash
1463437.png,https://derpicdn.net/img/view/2017/6/16/1463437.png,0,0.973449647,0,288,1295,1644,1295,1356,rainbow dash
1475811.png,https://derpicdn.net/img/view/2017/7/1/1475811.png,0,0.991782665,81,98,601,618,520,520,rainbow dash
1480292.png,https://derpicdn.net/img/view/2017/7/6/1480292.png,0,0.994484663,689,0,1157,410,468,410,rainbow dash
1481.jpg,https://derpicdn.net/img/view/2012/1/22/1481.jpg,0,0.999667287,233,106,459,332,226,226,rainbow dash
1481680.png,https://derpicdn.net/img/view/2017/7/8/1481680.png,0,0.969139457,2509,0,4520,2022,2011,2022,rainbow dash
1484865.png,https://derpicdn.net/img/view/2017/7/12/1484865.png,0,0.999546707,1085,17,2511,1443,1426,1426,rainbow dash
1488411.png,https://derpicdn.net/img/view/2017/7/17/1488411.png,0,0.972830176,0,0,444,408,444,408,rainbow dash
1488753.png,https://derpicdn.net/img/view/2017/7/18/1488753.png,0,0.980683208,0,0,1953,1950,1953,1950,rainbow dash
1494570.png,https://derpicdn.net/img/view/2017/7/25/1494570.png,0,0.989648163,721,0,2484,1773,1763,1773,rainbow dash
1498620.png,https://derpicdn.net/img/view/2017/7/30/1498620.png,0,0.942072749,593,394,1653,1454,1060,1060,rainbow dash
1501674.png,https://derpicdn.net/img/view/2017/8/3/1501674.png,0,0.994971216,0,0,185,199,185,199,rainbow dash
1501674.png,https://derpicdn.net/img/view/2017/8/3/1501674.png,1,0.921337008,29,13,218,231,189,218,rainbow dash
1506227.png,https://derpicdn.net/img/view/2017/8/9/1506227.png,0,0.990211546,32,47,788,721,756,674,rainbow dash
1508171.png,https://derpicdn.net/img/view/2017/8/11/1508171.png,0,0.996115565,270,0,634,308,364,308,rainbow dash
1508171.png,https://derpicdn.net/img/view/2017/8/11/1508171.png,1,0.987531245,597,155,877,435,280,280,rainbow dash
1510573.png,https://derpicdn.net/img/view/2017/8/14/1510573.png,0,0.974596679,257,0,1145,770,888,770,rainbow dash
15113.png,https://derpicdn.net/img/view/2012/6/22/15113.png,0,0.998021662,620,19,1000,407,380,388,rainbow dash
1514707.png,https://derpicdn.net/img/view/2017/8/19/1514707.png,0,0.999314427,105,0,1243,1099,1138,1099,rainbow dash
1518879.png,https://derpicdn.net/img/view/2017/8/24/1518879.png,0,0.99973315,37,66,495,524,458,458,rainbow dash
1519.jpg,https://derpicdn.net/img/view/2012/1/23/1519.jpg,0,0.997734129,166,0,502,336,336,336,rainbow dash
1520454.png,https://derpicdn.net/img/view/2017/8/26/1520454.png,0,0.973554254,419,913,6563,7057,6144,6144,rainbow dash
1520959.png,https://derpicdn.net/img/view/2017/8/27/1520959.png,0,0.947852075,469,0,1379,870,910,870,rainbow dash
1524757.png,https://derpicdn.net/img/view/2017/9/1/1524757.png,0,0.979563594,151,195,457,501,306,306,rainbow dash
1531.png,https://derpicdn.net/img/view/2012/1/23/1531.png,0,0.969519556,143,75,473,405,330,330,rainbow dash
1531843.png,https://derpicdn.net/img/view/2017/9/10/1531843.png,0,0.99888432,47,5,601,559,554,554,rainbow dash
1536268.png,https://derpicdn.net/img/view/2017/9/15/1536268.png,0,0.956341743,71,158,3229,3316,3158,3158,rainbow dash
1539638.png,https://derpicdn.net/img/view/2017/9/19/1539638.png,0,0.949901104,39,0,417,335,378,335,rainbow dash
15408.png,https://derpicdn.net/img/view/2012/6/22/15408.png,0,0.988281786,405,462,737,794,332,332,rainbow dash
1540926.png,https://derpicdn.net/img/view/2017/9/21/1540926.png,0,0.967706203,148,0,522,363,374,363,rainbow dash
1542225.png,https://derpicdn.net/img/view/2017/9/23/1542225.png,0,0.969355702,97,0,391,279,294,279,rainbow dash
1544.jpg,https://derpicdn.net/img/view/2012/1/23/1544.jpg,0,0.960638165,160,10,580,430,420,420,rainbow dash
1548342.png,https://derpicdn.net/img/view/2017/9/30/1548342.png,0,0.997735918,49,8,481,440,432,432,rainbow dash
1548620.png,https://derpicdn.net/img/view/2017/9/30/1548620.png,0,0.910789132,317,18,807,508,490,490,rainbow dash
1554389.png,https://derpicdn.net/img/view/2017/10/7/1554389.png,0,0.981193185,414,109,912,607,498,498,rainbow dash
1554422.png,https://derpicdn.net/img/view/2017/10/7/1554422.png,0,0.95285356,0,514,6812,7830,6812,7316,rainbow dash
1555369.png,https://derpicdn.net/img/view/2017/10/8/1555369.png,0,0.986808658,557,0,2404,1656,1847,1656,rainbow dash
1557315.png,https://derpicdn.net/img/view/2017/10/10/1557315.png,0,0.99615401,237,0,736,488,499,488,rainbow dash
1562023.png,https://derpicdn.net/img/view/2017/10/15/1562023.png,0,0.998698652,0,0,2031,1946,2031,1946,rainbow dash
1563425.png,https://derpicdn.net/img/view/2017/10/17/1563425.png,0,0.998997927,1058,0,3750,2453,2692,2453,rainbow dash
1570639.png,https://derpicdn.net/img/view/2017/10/26/1570639.png,0,0.901430249,527,0,2155,1554,1628,1554,rainbow dash
1572327.png,https://derpicdn.net/img/view/2017/10/28/1572327.png,0,0.986756444,323,0,1069,700,746,700,rainbow dash
1580557.png,https://derpicdn.net/img/view/2017/11/7/1580557.png,0,0.99970144,516,243,892,619,376,376,rainbow dash
1581983.png,https://derpicdn.net/img/view/2017/11/9/1581983.png,0,0.991372287,1107,26,1515,434,408,408,rainbow dash
1584172.png,https://derpicdn.net/img/view/2017/11/12/1584172.png,0,0.986184299,22,18,596,624,574,606,rainbow dash
1588055.png,https://derpicdn.net/img/view/2017/11/17/1588055.png,0,0.994486451,629,0,1745,1012,1116,1012,rainbow dash
1592690.png,https://derpicdn.net/img/view/2017/11/23/1592690.png,0,0.938960493,326,4,2250,1928,1924,1924,rainbow dash
1598498.png,https://derpicdn.net/img/view/2017/12/1/1598498.png,0,0.949242294,581,183,1011,613,430,430,rainbow dash
1600119.png,https://derpicdn.net/img/view/2017/12/4/1600119.png,0,0.994164169,21,0,979,768,958,768,rainbow dash
1603162.png,https://derpicdn.net/img/view/2017/12/8/1603162.png,0,0.982868552,157,35,645,523,488,488,rainbow dash
1605432.png,https://derpicdn.net/img/view/2017/12/11/1605432.png,0,0.932951689,38,36,259,280,221,244,rainbow dash
1613865.png,https://derpicdn.net/img/view/2017/12/23/1613865.png,0,0.964128375,571,202,1187,818,616,616,rainbow dash
1620748.png,https://derpicdn.net/img/view/2017/12/31/1620748.png,0,0.966570377,247,0,733,483,486,483,rainbow dash
1629051.png,https://derpicdn.net/img/view/2018/1/10/1629051.png,0,0.939932525,349,47,797,495,448,448,rainbow dash
1632258.png,https://derpicdn.net/img/view/2018/1/14/1632258.png,0,0.924793363,404,1610,2180,3386,1776,1776,rainbow dash
1634265.png,https://derpicdn.net/img/view/2018/1/17/1634265.png,0,0.955821395,182,126,1700,1700,1518,1574,rainbow dash
1636.png,https://derpicdn.net/img/view/2012/1/23/1636.png,0,0.999548852,3,0,377,362,374,362,rainbow dash
1639377.png,https://derpicdn.net/img/view/2018/1/24/1639377.png,0,0.951148868,332,101,556,325,224,224,rainbow dash
1640922.png,https://derpicdn.net/img/view/2018/1/25/1640922.png,0,0.919935942,87,0,487,381,400,381,rainbow dash
1641481.png,https://derpicdn.net/img/view/2018/1/26/1641481.png,0,0.997123897,0,0,228,244,228,244,rainbow dash
1645991.png,https://derpicdn.net/img/view/2018/2/1/1645991.png,0,0.990152836,121,25,719,623,598,598,rainbow dash
1646070.png,https://derpicdn.net/img/view/2018/2/1/1646070.png,0,0.996124268,276,167,1326,1217,1050,1050,rainbow dash
1649639.png,https://derpicdn.net/img/view/2018/2/6/1649639.png,0,0.979411304,231,0,595,319,364,319,rainbow dash
1652066.png,https://derpicdn.net/img/view/2018/2/9/1652066.png,0,0.963003814,0,408,2200,2862,2200,2454,rainbow dash
1652986.png,https://derpicdn.net/img/view/2018/2/11/1652986.png,0,0.965753973,187,0,919,685,732,685,rainbow dash
1654427.png,https://derpicdn.net/img/view/2018/2/12/1654427.png,0,0.996339142,383,21,881,519,498,498,rainbow dash
1654840.png,https://derpicdn.net/img/view/2018/2/13/1654840.png,0,0.909435093,64,0,990,806,926,806,rainbow dash
1661243.png,https://derpicdn.net/img/view/2018/2/20/1661243.png,0,0.998197973,772,0,2732,1512,1960,1512,rainbow dash
1663325.png,https://derpicdn.net/img/view/2018/2/23/1663325.png,0,0.999548852,154,0,976,759,822,759,rainbow dash
1663556.png,https://derpicdn.net/img/view/2018/2/23/1663556.png,0,0.99305892,388,97,820,529,432,432,rainbow dash
1668395.png,https://derpicdn.net/img/view/2018/2/28/1668395.png,0,0.998937964,0,0,2081,2126,2081,2126,rainbow dash
1672419.png,https://derpicdn.net/img/view/2018/3/5/1672419.png,0,0.989419878,127,0,2581,2102,2454,2102,rainbow dash
1674457.png,https://derpicdn.net/img/view/2018/3/8/1674457.png,0,0.987166405,523,3,1055,535,532,532,rainbow dash
1675334.png,https://derpicdn.net/img/view/2018/3/9/1675334.png,0,0.99457705,503,0,989,458,486,458,rainbow dash
1676284.png,https://derpicdn.net/img/view/2018/3/10/1676284.png,0,0.95535171,351,116,1193,958,842,842,rainbow dash
1678549.png,https://derpicdn.net/img/view/2018/3/12/1678549.png,0,0.989504755,616,109,854,347,238,238,rainbow dash
1678968.png,https://derpicdn.net/img/view/2018/3/13/1678968.png,0,0.986195982,0,1093,760,2023,760,930,rainbow dash
1688651.png,https://derpicdn.net/img/view/2018/3/24/1688651.png,0,0.931638956,0,0,229,241,229,241,rainbow dash
1690162.png,https://derpicdn.net/img/view/2018/3/25/1690162.png,0,0.986859381,1283,601,1691,1009,408,408,rainbow dash
1692158.png,https://derpicdn.net/img/view/2018/3/27/1692158.png,0,0.999883294,326,38,2046,1758,1720,1720,rainbow dash
1692413.png,https://derpicdn.net/img/view/2018/3/27/1692413.png,0,0.998097658,132,0,942,755,810,755,rainbow dash
1692447.png,https://derpicdn.net/img/view/2018/3/27/1692447.png,0,0.9089275,416,134,950,668,534,534,rainbow dash
1697812.png,https://derpicdn.net/img/view/2018/4/3/1697812.png,0,0.991750896,692,0,2000,1262,1308,1262,rainbow dash
1700588.png,https://derpicdn.net/img/view/2018/4/6/1700588.png,0,0.981330872,195,0,1705,1417,1510,1417,rainbow dash
1701881.png,https://derpicdn.net/img/view/2018/4/7/1701881.png,0,0.996326506,87,0,539,443,452,443,rainbow dash
1715647.png,https://derpicdn.net/img/view/2018/4/23/1715647.png,0,0.992570937,804,289,1410,895,606,606,rainbow dash
1716638.png,https://derpicdn.net/img/view/2018/4/25/1716638.png,0,0.997356415,40,0,700,645,660,645,rainbow dash
1718807.png,https://derpicdn.net/img/view/2018/4/28/1718807.png,0,0.995714843,411,469,1393,1451,982,982,rainbow dash
1718877.png,https://derpicdn.net/img/view/2018/4/28/1718877.png,0,0.993644536,2169,0,4297,2004,2128,2004,rainbow dash
1721797.png,https://derpicdn.net/img/view/2018/5/1/1721797.png,0,0.982924163,284,10,692,418,408,408,rainbow dash
1721860.png,https://derpicdn.net/img/view/2018/5/1/1721860.png,0,0.993637085,0,337,740,1087,740,750,rainbow dash
17312.png,https://derpicdn.net/img/view/2012/6/23/17312.png,0,0.915081799,367,0,841,428,474,428,rainbow dash
1735882.png,https://derpicdn.net/img/view/2018/5/18/1735882.png,0,0.994884074,899,0,2863,1910,1964,1910,rainbow dash
1738609.png,https://derpicdn.net/img/view/2018/5/22/1738609.png,0,0.993540227,993,107,1631,745,638,638,rainbow dash
1738850.png,https://derpicdn.net/img/view/2018/5/22/1738850.png,0,0.997162819,1271,0,2065,751,794,751,rainbow dash
1739465.png,https://derpicdn.net/img/view/2018/5/23/1739465.png,0,0.999150455,1175,0,2533,1297,1358,1297,rainbow dash
1744219.png,https://derpicdn.net/img/view/2018/5/29/1744219.png,0,0.982894361,0,51,2341,3107,2341,3056,rainbow dash
1746533.png,https://derpicdn.net/img/view/2018/6/1/1746533.png,0,0.998061419,92,7,450,365,358,358,rainbow dash
1752231.png,https://derpicdn.net/img/view/2018/6/7/1752231.png,0,0.990255713,543,286,1229,972,686,686,rainbow dash
1753229.png,https://derpicdn.net/img/view/2018/6/9/1753229.png,0,0.962025046,15,0,261,244,246,244,rainbow dash
1753231.png,https://derpicdn.net/img/view/2018/6/9/1753231.png,0,0.978267848,13,0,261,245,248,245,rainbow dash
1753232.png,https://derpicdn.net/img/view/2018/6/9/1753232.png,0,0.974643171,12,0,262,246,250,246,rainbow dash
1755645.png,https://derpicdn.net/img/view/2018/6/11/1755645.png,0,0.981982708,525,0,1189,661,664,661,rainbow dash
1758394.png,https://derpicdn.net/img/view/2018/6/15/1758394.png,0,0.98947686,409,331,1099,1021,690,690,rainbow dash
1758732.png,https://derpicdn.net/img/view/2018/6/16/1758732.png,0,0.989534378,171,0,4545,4085,4374,4085,rainbow dash
1764657.png,https://derpicdn.net/img/view/2018/6/24/1764657.png,0,0.99520129,0,0,391,412,391,412,rainbow dash
1765316.png,https://derpicdn.net/img/view/2018/6/25/1765316.png,0,0.903516173,279,253,1155,1129,876,876,rainbow dash
1765607.png,https://derpicdn.net/img/view/2018/6/25/1765607.png,0,0.966511488,44,0,1552,1481,1508,1481,rainbow dash
1766502.png,https://derpicdn.net/img/view/2018/6/26/1766502.png,0,0.985646069,0,0,906,720,906,720,rainbow dash
1766502.png,https://derpicdn.net/img/view/2018/6/26/1766502.png,1,0.935610592,106,0,1210,720,1104,720,rainbow dash
1767336.png,https://derpicdn.net/img/view/2018/6/27/1767336.png,0,0.9964692,588,0,1344,743,756,743,rainbow dash
1768590.png,https://derpicdn.net/img/view/2018/6/29/1768590.png,0,0.994646251,0,0,952,923,952,923,rainbow dash
1768697.png,https://derpicdn.net/img/view/2018/6/29/1768697.png,0,0.997939289,394,0,1090,663,696,663,rainbow dash
1774769.png,https://derpicdn.net/img/view/2018/7/7/1774769.png,0,0.999154508,470,0,1386,913,916,913,rainbow dash
1778545.png,https://derpicdn.net/img/view/2018/7/11/1778545.png,0,0.913505971,291,145,1629,1483,1338,1338,rainbow dash
1781197.png,https://derpicdn.net/img/view/2018/7/15/1781197.png,0,0.999014854,748,79,2402,1733,1654,1654,rainbow dash
1783625.png,https://derpicdn.net/img/view/2018/7/18/1783625.png,0,0.986175418,0,0,495,541,495,541,rainbow dash
1786825.png,https://derpicdn.net/img/view/2018/7/22/1786825.png,0,0.998120189,705,23,1893,1211,1188,1188,rainbow dash
1786906.png,https://derpicdn.net/img/view/2018/7/22/1786906.png,0,0.961956918,56,0,548,483,492,483,rainbow dash
1792031.png,https://derpicdn.net/img/view/2018/7/28/1792031.png,0,0.982578576,107,101,1271,1265,1164,1164,rainbow dash
1795556.png,https://derpicdn.net/img/view/2018/8/2/1795556.png,0,0.996702194,219,0,679,374,460,374,rainbow dash
1802397.png,https://derpicdn.net/img/view/2018/8/9/1802397.png,0,0.983082354,48,0,910,767,862,767,rainbow dash
1802401.png,https://derpicdn.net/img/view/2018/8/9/1802401.png,0,0.994607925,355,0,1235,871,880,871,rainbow dash
1805377.png,https://derpicdn.net/img/view/2018/8/13/1805377.png,0,0.980107069,165,34,767,636,602,602,rainbow dash
1808053.png,https://derpicdn.net/img/view/2018/8/16/1808053.png,0,0.974847257,142,53,1778,1689,1636,1636,rainbow dash
1817523.png,https://derpicdn.net/img/view/2018/8/27/1817523.png,0,0.977403998,21,0,500,485,479,485,rainbow dash
1818987.png,https://derpicdn.net/img/view/2018/8/29/1818987.png,0,0.991948009,118,10,750,642,632,632,rainbow dash
1824790.png,https://derpicdn.net/img/view/2018/9/4/1824790.png,0,0.990961075,453,0,1407,953,954,953,rainbow dash
1824829.png,https://derpicdn.net/img/view/2018/9/4/1824829.png,0,0.974414647,156,7,1492,1343,1336,1336,rainbow dash
1830946.png,https://derpicdn.net/img/view/2018/9/12/1830946.png,0,0.984386325,0,0,4213,4427,4213,4427,rainbow dash
1832316.png,https://derpicdn.net/img/view/2018/9/14/1832316.png,0,0.988055944,166,39,770,643,604,604,rainbow dash
1837771.png,https://derpicdn.net/img/view/2018/9/21/1837771.png,0,0.983806312,3,0,575,549,572,549,rainbow dash
1844204.png,https://derpicdn.net/img/view/2018/9/29/1844204.png,0,0.997204781,608,0,1528,915,920,915,rainbow dash
1844291.png,https://derpicdn.net/img/view/2018/9/30/1844291.png,0,0.952811658,740,398,1512,1170,772,772,rainbow dash
1848148.png,https://derpicdn.net/img/view/2018/10/4/1848148.png,0,0.995785534,126,0,1170,1001,1044,1001,rainbow dash
1851358.png,https://derpicdn.net/img/view/2018/10/8/1851358.png,0,0.990692317,41,38,1191,1188,1150,1150,rainbow dash
1854397.png,https://derpicdn.net/img/view/2018/10/12/1854397.png,0,0.973141968,152,55,1120,1023,968,968,rainbow dash
1855573.png,https://derpicdn.net/img/view/2018/10/13/1855573.png,1,0.989451587,314,432,542,660,228,228,rainbow dash
186143.png,https://derpicdn.net/img/view/2012/12/18/186143.png,0,0.991694927,469,0,1305,774,836,774,rainbow dash
1862015.png,https://derpicdn.net/img/view/2018/10/21/1862015.png,0,0.958888173,0,85,1672,1811,1672,1726,rainbow dash
1862462.png,https://derpicdn.net/img/view/2018/10/21/1862462.png,0,0.989741981,1240,589,2000,1349,760,760,rainbow dash
1862462.png,https://derpicdn.net/img/view/2018/10/21/1862462.png,1,0.975648463,530,677,1300,1447,770,770,rainbow dash
1865326.png,https://derpicdn.net/img/view/2018/10/25/1865326.png,0,0.979261458,306,0,1572,1230,1266,1230,rainbow dash
1869951.png,https://derpicdn.net/img/view/2018/10/30/1869951.png,0,0.999032199,0,0,799,804,799,804,rainbow dash
1871774.png,https://derpicdn.net/img/view/2018/10/31/1871774.png,0,0.986275256,2,0,641,633,639,633,rainbow dash
1873569.png,https://derpicdn.net/img/view/2018/11/2/1873569.png,0,0.960780203,41,0,679,596,638,596,rainbow dash
1877447.png,https://derpicdn.net/img/view/2018/11/8/1877447.png,0,0.998222709,0,34,614,666,614,632,rainbow dash
1877526.png,https://derpicdn.net/img/view/2018/11/8/1877526.png,0,0.999392509,2872,0,5688,2738,2816,2738,rainbow dash
1879885.png,https://derpicdn.net/img/view/2018/11/11/1879885.png,0,0.978023529,427,52,797,422,370,370,rainbow dash
1884257.png,https://derpicdn.net/img/view/2018/11/17/1884257.png,0,0.985578179,263,0,615,350,352,350,rainbow dash
1890438.png,https://derpicdn.net/img/view/2018/11/25/1890438.png,0,0.999334395,47,0,351,295,304,295,rainbow dash
18935.png,https://derpicdn.net/img/view/2012/6/24/18935.png,0,0.997773886,48,0,404,339,356,339,rainbow dash
1897888.png,https://derpicdn.net/img/view/2018/12/4/1897888.png,0,0.995417416,538,65,924,451,386,386,rainbow dash
1900919.png,https://derpicdn.net/img/view/2018/12/7/1900919.png,0,0.998759925,1732,0,3976,2157,2244,2157,rainbow dash
1904553.png,https://derpicdn.net/img/view/2018/12/10/1904553.png,0,0.908421278,211,0,1145,1093,934,1093,rainbow dash
1905563.png,https://derpicdn.net/img/view/2018/12/11/1905563.png,1,0.927054524,704,219,1474,989,770,770,rainbow dash
1907714.png,https://derpicdn.net/img/view/2018/12/13/1907714.png,0,0.99873507,28,0,368,291,340,291,rainbow dash
1917871.png,https://derpicdn.net/img/view/2018/12/24/1917871.png,0,0.992316246,294,801,1522,2029,1228,1228,rainbow dash
1917986.png,https://derpicdn.net/img/view/2018/12/25/1917986.png,0,0.99957031,0,0,472,484,472,484,rainbow dash
1921200.png,https://derpicdn.net/img/view/2018/12/29/1921200.png,0,0.988625705,258,0,2858,2483,2600,2483,rainbow dash
1921470.png,https://derpicdn.net/img/view/2018/12/29/1921470.png,0,0.998849034,185,12,453,280,268,268,rainbow dash
1924114.png,https://derpicdn.net/img/view/2019/1/1/1924114.png,0,0.979939342,478,102,852,476,374,374,rainbow dash
1925490.png,https://derpicdn.net/img/view/2019/1/3/1925490.png,0,0.983846307,184,0,1280,1163,1096,1163,rainbow dash
192713.png,https://derpicdn.net/img/view/2012/12/24/192713.png,0,0.922914088,1,0,1315,1256,1314,1256,rainbow dash
1933218.png,https://derpicdn.net/img/view/2019/1/12/1933218.png,0,0.996703029,698,108,1862,1272,1164,1164,rainbow dash
1936078.png,https://derpicdn.net/img/view/2019/1/15/1936078.png,0,0.985753655,444,1,902,459,458,458,rainbow dash
19361.png,https://derpicdn.net/img/view/2012/6/24/19361.png,0,0.989273012,0,63,480,543,480,480,rainbow dash
1937983.png,https://derpicdn.net/img/view/2019/1/18/1937983.png,0,0.96484381,46,0,286,234,240,234,rainbow dash
1937983.png,https://derpicdn.net/img/view/2019/1/18/1937983.png,1,0.918794274,0,91,269,400,269,309,rainbow dash
1938479.png,https://derpicdn.net/img/view/2019/1/18/1938479.png,0,0.987338483,1975,0,4845,2776,2870,2776,rainbow dash
1940215.png,https://derpicdn.net/img/view/2019/1/20/1940215.png,0,0.990189672,0,0,1245,1295,1245,1295,rainbow dash
1940870.png,https://derpicdn.net/img/view/2019/1/21/1940870.png,0,0.997275889,342,191,634,483,292,292,rainbow dash
1941084.png,https://derpicdn.net/img/view/2019/1/21/1941084.png,0,0.997091889,160,73,472,385,312,312,rainbow dash
1946262.png,https://derpicdn.net/img/view/2019/1/27/1946262.png,0,0.994531572,40,0,532,480,492,480,rainbow dash
1946562.png,https://derpicdn.net/img/view/2019/1/28/1946562.png,0,0.998177409,0,0,476,460,476,460,rainbow dash
1948128.png,https://derpicdn.net/img/view/2019/1/29/1948128.png,0,0.984557986,200,23,618,441,418,418,rainbow dash
1948934.png,https://derpicdn.net/img/view/2019/1/30/1948934.png,0,0.999234915,1670,1040,2696,2066,1026,1026,rainbow dash
1958048.png,https://derpicdn.net/img/view/2019/2/10/1958048.png,0,0.992266357,90,36,4730,4676,4640,4640,rainbow dash
1961136.png,https://derpicdn.net/img/view/2019/2/13/1961136.png,0,0.985110402,30,117,846,933,816,816,rainbow dash
1964734.png,https://derpicdn.net/img/view/2019/2/17/1964734.png,0,0.99440676,67,0,597,509,530,509,rainbow dash
1977363.png,https://derpicdn.net/img/view/2019/3/4/1977363.png,0,0.989980221,449,9,971,531,522,522,rainbow dash
1982223.png,https://derpicdn.net/img/view/2019/3/10/1982223.png,0,0.999851823,388,0,1196,802,808,802,rainbow dash
1984470.png,https://derpicdn.net/img/view/2019/3/13/1984470.png,0,0.99661845,1017,0,2015,945,998,945,rainbow dash
1988621.png,https://derpicdn.net/img/view/2019/3/17/1988621.png,1,0.962744594,1535,0,4203,2642,2668,2642,rainbow dash
1998900.png,https://derpicdn.net/img/view/2019/3/31/1998900.png,0,0.987685382,289,0,987,673,698,673,rainbow dash
2002265.png,https://derpicdn.net/img/view/2019/4/3/2002265.png,0,0.983935416,77,0,533,427,456,427,rainbow dash
2008335.png,https://derpicdn.net/img/view/2019/4/10/2008335.png,0,0.994265079,21,12,529,520,508,508,rainbow dash
2008420.png,https://derpicdn.net/img/view/2019/4/10/2008420.png,0,0.946718454,38,4,274,240,236,236,rainbow dash
2008736.png,https://derpicdn.net/img/view/2019/4/11/2008736.png,0,0.984759927,825,0,1859,1008,1034,1008,rainbow dash
2010275.png,https://derpicdn.net/img/view/2019/4/13/2010275.png,0,0.959206879,282,49,606,373,324,324,rainbow dash
2011377.png,https://derpicdn.net/img/view/2019/4/14/2011377.png,0,0.991873264,21,0,665,578,644,578,rainbow dash
2015319.png,https://derpicdn.net/img/view/2019/4/17/2015319.png,0,0.983697891,102,86,1528,1512,1426,1426,rainbow dash
2016481.png,https://derpicdn.net/img/view/2019/4/19/2016481.png,0,0.997859716,733,0,1517,761,784,761,rainbow dash
2018522.png,https://derpicdn.net/img/view/2019/4/21/2018522.png,0,0.97761637,934,1494,1344,1904,410,410,rainbow dash
2018522.png,https://derpicdn.net/img/view/2019/4/21/2018522.png,1,0.976650238,0,326,262,600,262,274,rainbow dash
2018522.png,https://derpicdn.net/img/view/2019/4/21/2018522.png,2,0.967357576,1448,1230,1900,1682,452,452,rainbow dash
2018522.png,https://derpicdn.net/img/view/2019/4/21/2018522.png,3,0.954565823,2348,255,2766,673,418,418,rainbow dash
2018522.png,https://derpicdn.net/img/view/2019/4/21/2018522.png,4,0.939291954,2034,936,2458,1360,424,424,rainbow dash
2020187.png,https://derpicdn.net/img/view/2019/4/22/2020187.png,0,0.992001295,165,46,623,504,458,458,rainbow dash
2020344.png,https://derpicdn.net/img/view/2019/4/22/2020344.png,0,0.998366654,494,0,1396,896,902,896,rainbow dash
2020736.png,https://derpicdn.net/img/view/2019/4/23/2020736.png,0,0.913300931,110,0,1740,1078,1630,1078,rainbow dash
2021121.png,https://derpicdn.net/img/view/2019/4/23/2021121.png,0,0.996075392,126,0,758,627,632,627,rainbow dash
2024521.png,https://derpicdn.net/img/view/2019/4/27/2024521.png,0,0.996561825,1227,198,1933,904,706,706,rainbow dash
2026950.png,https://derpicdn.net/img/view/2019/4/30/2026950.png,0,0.994400799,702,131,1642,1071,940,940,rainbow dash
2029108.png,https://derpicdn.net/img/view/2019/5/2/2029108.png,0,0.997042656,717,133,1637,1053,920,920,rainbow dash
2037017.png,https://derpicdn.net/img/view/2019/5/12/2037017.png,0,0.997118711,994,13,2060,1079,1066,1066,rainbow dash
2037301.png,https://derpicdn.net/img/view/2019/5/12/2037301.png,0,0.997744024,1039,204,2069,1234,1030,1030,rainbow dash
2037649.png,https://derpicdn.net/img/view/2019/5/13/2037649.png,0,0.999358177,2433,0,4803,2364,2370,2364,rainbow dash
204407.png,https://derpicdn.net/img/view/2013/1/6/204407.png,0,0.991167665,390,192,616,418,226,226,rainbow dash
2046449.png,https://derpicdn.net/img/view/2019/5/22/2046449.png,0,0.962192595,928,59,2024,1155,1096,1096,rainbow dash
2048405.png,https://derpicdn.net/img/view/2019/5/25/2048405.png,0,0.997439206,295,8,1125,838,830,830,rainbow dash
2054811.png,https://derpicdn.net/img/view/2019/6/1/2054811.png,0,0.99884814,297,0,708,403,411,403,rainbow dash
2057011.png,https://derpicdn.net/img/view/2019/6/3/2057011.png,0,0.997865915,195,64,509,378,314,314,rainbow dash
2058269.png,https://derpicdn.net/img/view/2019/6/5/2058269.png,0,0.968525589,1311,201,1997,887,686,686,rainbow dash
2058948.png,https://derpicdn.net/img/view/2019/6/6/2058948.png,0,0.966489077,122,0,1804,1459,1682,1459,rainbow dash
2061029.png,https://derpicdn.net/img/view/2019/6/8/2061029.png,0,0.97318238,133,70,1085,1022,952,952,rainbow dash
2063396.png,https://derpicdn.net/img/view/2019/6/12/2063396.png,0,0.99838084,0,0,214,186,214,186,rainbow dash
2066702.png,https://derpicdn.net/img/view/2019/6/16/2066702.png,0,0.97968173,0,0,2114,2229,2114,2229,rainbow dash
2067177.png,https://derpicdn.net/img/view/2019/6/16/2067177.png,0,0.96751982,0,0,907,1021,907,1021,rainbow dash
2067943.png,https://derpicdn.net/img/view/2019/6/17/2067943.png,0,0.921978295,0,45,1690,1879,1690,1834,rainbow dash
2075371.png,https://derpicdn.net/img/view/2019/6/26/2075371.png,0,0.971259534,250,0,1270,977,1020,977,rainbow dash
2075720.png,https://derpicdn.net/img/view/2019/6/26/2075720.png,0,0.998551428,264,0,2544,2207,2280,2207,rainbow dash
2075722.png,https://derpicdn.net/img/view/2019/6/26/2075722.png,0,0.998996437,291,0,2511,2156,2220,2156,rainbow dash
2079352.png,https://derpicdn.net/img/view/2019/6/30/2079352.png,0,0.978097737,14,37,380,403,366,366,rainbow dash
2079530.png,https://derpicdn.net/img/view/2019/6/30/2079530.png,0,0.999510825,8,0,1092,1061,1084,1061,rainbow dash
2079530.png,https://derpicdn.net/img/view/2019/6/30/2079530.png,1,0.945471585,714,1097,1366,1749,652,652,rainbow dash
2082792.png,https://derpicdn.net/img/view/2019/7/4/2082792.png,0,0.999071598,491,71,851,431,360,360,rainbow dash
2083625.png,https://derpicdn.net/img/view/2019/7/5/2083625.png,0,0.935183227,2444,1197,3812,2565,1368,1368,rainbow dash
2093374.png,https://derpicdn.net/img/view/2019/7/16/2093374.png,0,0.991348982,3384,1542,4112,2270,728,728,rainbow dash
2093374.png,https://derpicdn.net/img/view/2019/7/16/2093374.png,1,0.991154909,2484,164,3204,884,720,720,rainbow dash
2094712.png,https://derpicdn.net/img/view/2019/7/18/2094712.png,0,0.995702386,755,405,1071,721,316,316,rainbow dash
2097311.png,https://derpicdn.net/img/view/2019/7/21/2097311.png,0,0.99723053,279,0,869,531,590,531,rainbow dash
2099439.png,https://derpicdn.net/img/view/2019/7/23/2099439.png,0,0.970220149,230,0,1734,1443,1504,1443,rainbow dash
2105480.png,https://derpicdn.net/img/view/2019/7/31/2105480.png,0,0.991678298,116,0,561,457,445,457,rainbow dash
2112852.png,https://derpicdn.net/img/view/2019/8/9/2112852.png,0,0.995729744,41,13,543,515,502,502,rainbow dash
2116615.png,https://derpicdn.net/img/view/2019/8/13/2116615.png,0,0.987606645,438,141,1604,1307,1166,1166,rainbow dash
2128851.png,https://derpicdn.net/img/view/2019/8/27/2128851.png,0,0.986533284,5418,1693,8656,4931,3238,3238,rainbow dash
2138586.png,https://derpicdn.net/img/view/2019/9/7/2138586.png,0,0.998792589,0,0,495,541,495,541,rainbow dash
2139963.png,https://derpicdn.net/img/view/2019/9/9/2139963.png,0,0.973251343,431,386,663,618,232,232,rainbow dash
2143397.png,https://derpicdn.net/img/view/2019/9/13/2143397.png,0,0.994420111,105,0,939,783,834,783,rainbow dash
2145447.png,https://derpicdn.net/img/view/2019/9/16/2145447.png,0,0.987603664,483,0,882,408,399,408,rainbow dash
2146113.png,https://derpicdn.net/img/view/2019/9/17/2146113.png,0,0.99927479,0,103,671,791,671,688,rainbow dash
2158462.png,https://derpicdn.net/img/view/2019/10/2/2158462.png,0,0.994566858,417,8,873,464,456,456,rainbow dash
2163139.png,https://derpicdn.net/img/view/2019/10/8/2163139.png,0,0.996173263,236,0,1754,1140,1518,1140,rainbow dash
2166573.png,https://derpicdn.net/img/view/2019/10/12/2166573.png,0,0.904584706,354,14,648,308,294,294,rainbow dash
2166833.png,https://derpicdn.net/img/view/2019/10/13/2166833.png,0,0.973296821,1547,0,4270,3341,2723,3341,rainbow dash
2168381.png,https://derpicdn.net/img/view/2019/10/14/2168381.png,0,0.949856222,0,0,2556,2618,2556,2618,rainbow dash
2168868.png,https://derpicdn.net/img/view/2019/10/14/2168868.png,0,0.969139755,143,0,1489,1597,1346,1597,rainbow dash
2169481.png,https://derpicdn.net/img/view/2019/10/15/2169481.png,0,0.981807113,150,18,1346,1214,1196,1196,rainbow dash
2170154.png,https://derpicdn.net/img/view/2019/10/16/2170154.png,0,0.991379619,1902,82,3028,1208,1126,1126,rainbow dash
2178445.png,https://derpicdn.net/img/view/2019/10/25/2178445.png,0,0.961782694,317,237,1763,1683,1446,1446,rainbow dash
2181580.png,https://derpicdn.net/img/view/2019/10/28/2181580.png,0,0.996710837,54,0,1296,1167,1242,1167,rainbow dash
2185186.png,https://derpicdn.net/img/view/2019/11/2/2185186.png,0,0.931638837,363,1,957,595,594,594,rainbow dash
2185968.png,https://derpicdn.net/img/view/2019/11/2/2185968.png,0,0.992381215,110,0,228,118,118,118,rainbow dash
2185968.png,https://derpicdn.net/img/view/2019/11/2/2185968.png,1,0.948945284,0,55,200,246,200,191,rainbow dash
2186663.png,https://derpicdn.net/img/view/2019/11/3/2186663.png,1,0.96998775,1314,96,1750,532,436,436,rainbow dash
2187810.png,https://derpicdn.net/img/view/2019/11/4/2187810.png,0,0.998100519,334,5,1808,1479,1474,1474,rainbow dash
2191730.png,https://derpicdn.net/img/view/2019/11/9/2191730.png,0,0.939843178,46,0,712,630,666,630,rainbow dash
21921.png,https://derpicdn.net/img/view/2012/6/26/21921.png,0,0.998576403,749,90,1409,750,660,660,rainbow dash
2197832.png,https://derpicdn.net/img/view/2019/11/16/2197832.png,0,0.996460021,363,157,1545,1339,1182,1182,rainbow dash
2198090.png,https://derpicdn.net/img/view/2019/11/17/2198090.png,0,0.999439061,72,0,1250,1125,1178,1125,rainbow dash
2198090.png,https://derpicdn.net/img/view/2019/11/17/2198090.png,1,0.993766785,2432,2043,3490,3101,1058,1058,rainbow dash
2198090.png,https://derpicdn.net/img/view/2019/11/17/2198090.png,2,0.980296671,1451,852,2683,2084,1232,1232,rainbow dash
2198090.png,https://derpicdn.net/img/view/2019/11/17/2198090.png,3,0.904638052,367,1732,1407,2772,1040,1040,rainbow dash
2198781.png,https://derpicdn.net/img/view/2019/11/17/2198781.png,0,0.963663459,44,23,462,441,418,418,rainbow dash
2200474.png,https://derpicdn.net/img/view/2019/11/19/2200474.png,0,0.982621491,13,0,373,355,360,355,rainbow dash
2203286.png,https://derpicdn.net/img/view/2019/11/23/2203286.png,0,0.982977211,0,0,407,391,407,391,rainbow dash
2203286.png,https://derpicdn.net/img/view/2019/11/23/2203286.png,1,0.920294046,82,15,500,463,418,448,rainbow dash
2203287.png,https://derpicdn.net/img/view/2019/11/23/2203287.png,0,0.971770525,0,17,437,455,437,438,rainbow dash
2204402.png,https://derpicdn.net/img/view/2019/11/24/2204402.png,0,0.994555414,470,0,1240,734,770,734,rainbow dash
2212743.png,https://derpicdn.net/img/view/2019/12/5/2212743.png,0,0.997544348,81,0,747,652,666,652,rainbow dash
2216985.png,https://derpicdn.net/img/view/2019/12/10/2216985.png,0,0.939446151,0,0,840,832,840,832,rainbow dash
2217773.png,https://derpicdn.net/img/view/2019/12/11/2217773.png,0,0.990737081,9,0,169,153,160,153,rainbow dash
221949.jpg,https://derpicdn.net/img/view/2013/1/24/221949.jpg,0,0.948031545,186,0,432,220,246,220,rainbow dash
2220657.png,https://derpicdn.net/img/view/2019/12/14/2220657.png,0,0.999191046,330,0,2006,1541,1676,1541,rainbow dash
2221656.png,https://derpicdn.net/img/view/2019/12/15/2221656.png,0,0.903053522,189,27,1018,863,829,836,rainbow dash
2223047.png,https://derpicdn.net/img/view/2019/12/17/2223047.png,0,0.975144267,0,215,1062,1341,1062,1126,rainbow dash
2228428.png,https://derpicdn.net/img/view/2019/12/24/2228428.png,0,0.921489716,62,23,776,737,714,714,rainbow dash
2230520.png,https://derpicdn.net/img/view/2019/12/26/2230520.png,0,0.993197143,0,119,1023,1199,1023,1080,rainbow dash
2230739.png,https://derpicdn.net/img/view/2019/12/26/2230739.png,0,0.993363857,0,60,358,418,358,358,rainbow dash
2231083.png,https://derpicdn.net/img/view/2019/12/27/2231083.png,0,0.956958115,243,7,971,735,728,728,rainbow dash
2237222.png,https://derpicdn.net/img/view/2020/1/3/2237222.png,0,0.971056044,1,0,1225,1182,1224,1182,rainbow dash
2238889.jpg,https://derpicdn.net/img/view/2020/1/4/2238889.jpg,0,0.997475445,0,0,547,549,547,549,rainbow dash
2239110.png,https://derpicdn.net/img/view/2020/1/5/2239110.png,0,0.997699261,393,152,1135,894,742,742,rainbow dash
2239684.jpg,https://derpicdn.net/img/view/2020/1/5/2239684.jpg,0,0.994424641,182,0,1392,1055,1210,1055,rainbow dash
2241491.jpg,https://derpicdn.net/img/view/2020/1/8/2241491.jpg,0,0.999220431,820,54,1582,816,762,762,rainbow dash
2241892.png,https://derpicdn.net/img/view/2020/1/8/2241892.png,0,0.948330462,242,0,1574,1231,1332,1231,rainbow dash
2244895.jpg,https://derpicdn.net/img/view/2020/1/11/2244895.jpg,0,0.985052943,0,384,807,1336,807,952,rainbow dash
2248244.png,https://derpicdn.net/img/view/2020/1/15/2248244.png,0,0.983812153,54,0,668,552,614,552,rainbow dash
2248475.png,https://derpicdn.net/img/view/2020/1/15/2248475.png,0,0.985168993,49,68,551,570,502,502,rainbow dash
2248483.png,https://derpicdn.net/img/view/2020/1/15/2248483.png,0,0.999200761,101,189,393,481,292,292,rainbow dash
2249364.png,https://derpicdn.net/img/view/2020/1/17/2249364.png,0,0.989228725,725,197,1169,641,444,444,rainbow dash
2250974.png,https://derpicdn.net/img/view/2020/1/18/2250974.png,0,0.975733638,213,112,809,708,596,596,rainbow dash
2252463.png,https://derpicdn.net/img/view/2020/1/20/2252463.png,0,0.970116794,165,63,680,579,515,516,rainbow dash
2256861.jpg,https://derpicdn.net/img/view/2020/1/25/2256861.jpg,0,0.966545522,91,0,791,670,700,670,rainbow dash
2257562.png,https://derpicdn.net/img/view/2020/1/26/2257562.png,0,0.993895948,667,0,1920,1280,1253,1280,rainbow dash
2259427.jpg,https://derpicdn.net/img/view/2020/1/28/2259427.jpg,0,0.995753288,0,0,718,716,718,716,rainbow dash
2259762.png,https://derpicdn.net/img/view/2020/1/28/2259762.png,0,0.989123821,0,0,672,766,672,766,rainbow dash
2259763.png,https://derpicdn.net/img/view/2020/1/28/2259763.png,0,0.985307217,0,40,673,718,673,678,rainbow dash
2259933.png,https://derpicdn.net/img/view/2020/1/29/2259933.png,0,0.995102704,384,0,1174,765,790,765,rainbow dash
2259935.png,https://derpicdn.net/img/view/2020/1/29/2259935.png,0,0.98923713,287,0,1305,883,1018,883,rainbow dash
2261067.jpg,https://derpicdn.net/img/view/2020/1/30/2261067.jpg,0,0.979026258,173,0,1899,1593,1726,1593,rainbow dash
2262420.png,https://derpicdn.net/img/view/2020/2/1/2262420.png,0,0.993994594,722,0,1194,440,472,440,rainbow dash
2263106.jpg,https://derpicdn.net/img/view/2020/2/1/2263106.jpg,0,0.971227705,163,0,1011,830,848,830,rainbow dash
2263912.png,https://derpicdn.net/img/view/2020/2/2/2263912.png,0,0.997337222,416,47,1370,1001,954,954,rainbow dash
2264349.png,https://derpicdn.net/img/view/2020/2/2/2264349.png,0,0.996224701,1599,0,2897,1266,1298,1266,rainbow dash
2264944.jpg,https://derpicdn.net/img/view/2020/2/3/2264944.jpg,0,0.998804033,179,22,477,320,298,298,rainbow dash
2266826.jpg,https://derpicdn.net/img/view/2020/2/6/2266826.jpg,0,0.99727273,167,0,941,712,774,712,rainbow dash
2267313.png,https://derpicdn.net/img/view/2020/2/6/2267313.png,0,0.971700549,253,1144,633,1524,380,380,rainbow dash
2267670.png,https://derpicdn.net/img/view/2020/2/7/2267670.png,0,0.982603192,127,0,1297,1136,1170,1136,rainbow dash
2267751.png,https://derpicdn.net/img/view/2020/2/7/2267751.png,0,0.963025928,674,284,1140,750,466,466,rainbow dash
2268152.png,https://derpicdn.net/img/view/2020/2/7/2268152.png,0,0.998729765,77,0,705,599,628,599,rainbow dash
2268520.png,https://derpicdn.net/img/view/2020/2/8/2268520.png,0,0.99855566,0,69,513,615,513,546,rainbow dash
2268520.png,https://derpicdn.net/img/view/2020/2/8/2268520.png,2,0.952419817,570,50,952,432,382,382,rainbow dash
2268782.png,https://derpicdn.net/img/view/2020/2/8/2268782.png,0,0.973922849,76,9,1052,985,976,976,rainbow dash
2269039.png,https://derpicdn.net/img/view/2020/2/8/2269039.png,0,0.982351363,197,0,2541,2153,2344,2153,rainbow dash
2279982.jpg,https://derpicdn.net/img/view/2020/2/21/2279982.jpg,0,0.99472034,136,10,1030,904,894,894,rainbow dash
2284836.png,https://derpicdn.net/img/view/2020/2/27/2284836.png,0,0.964057148,43,0,725,623,682,623,rainbow dash
2286491.png,https://derpicdn.net/img/view/2020/2/29/2286491.png,0,0.997929692,335,30,925,620,590,590,rainbow dash
2287399.png,https://derpicdn.net/img/view/2020/3/1/2287399.png,0,0.98311311,0,0,1164,1127,1164,1127,rainbow dash
2290242.png,https://derpicdn.net/img/view/2020/3/5/2290242.png,0,0.984536588,627,0,2503,1664,1876,1664,rainbow dash
2292952.png,https://derpicdn.net/img/view/2020/3/8/2292952.png,0,0.961298704,95,512,2375,2792,2280,2280,rainbow dash
2294121.png,https://derpicdn.net/img/view/2020/3/10/2294121.png,0,0.991075099,1926,912,2802,1788,876,876,rainbow dash
2295486.png,https://derpicdn.net/img/view/2020/3/12/2295486.png,0,0.99916923,489,1601,955,2067,466,466,rainbow dash
2295486.png,https://derpicdn.net/img/view/2020/3/12/2295486.png,1,0.997415483,1613,1503,2089,1979,476,476,rainbow dash
2295486.png,https://derpicdn.net/img/view/2020/3/12/2295486.png,2,0.983845711,1308,735,1676,1103,368,368,rainbow dash
2295486.png,https://derpicdn.net/img/view/2020/3/12/2295486.png,3,0.9824512,888,604,1362,1078,474,474,rainbow dash
2295486.png,https://derpicdn.net/img/view/2020/3/12/2295486.png,4,0.967623293,532,21,1264,753,732,732,rainbow dash
2295486.png,https://derpicdn.net/img/view/2020/3/12/2295486.png,5,0.965948164,1262,38,1972,748,710,710,rainbow dash
2297521.png,https://derpicdn.net/img/view/2020/3/14/2297521.png,0,0.997698009,235,75,1503,1343,1268,1268,rainbow dash
2299548.png,https://derpicdn.net/img/view/2020/3/17/2299548.png,0,0.995652318,525,0,2735,2160,2210,2160,rainbow dash
2301805.png,https://derpicdn.net/img/view/2020/3/20/2301805.png,0,0.971922457,146,0,875,755,729,755,rainbow dash
2302811.png,https://derpicdn.net/img/view/2020/3/21/2302811.png,0,0.959311187,0,0,2590,2599,2590,2599,rainbow dash
2303266.png,https://derpicdn.net/img/view/2020/3/22/2303266.png,0,0.998878419,1125,64,2057,1052,932,988,rainbow dash
2304354.jpg,https://derpicdn.net/img/view/2020/3/23/2304354.jpg,0,0.978072882,65,0,1161,1054,1096,1054,rainbow dash
2305299.jpg,https://derpicdn.net/img/view/2020/3/25/2305299.jpg,0,0.999798656,471,0,947,425,476,425,rainbow dash
2307481.png,https://derpicdn.net/img/view/2020/3/27/2307481.png,0,0.996073782,931,214,1457,740,526,526,rainbow dash
2307481.png,https://derpicdn.net/img/view/2020/3/27/2307481.png,1,0.994766951,423,564,929,1070,506,506,rainbow dash
2311355.jpg,https://derpicdn.net/img/view/2020/4/1/2311355.jpg,0,0.979180515,1572,259,2582,1269,1010,1010,rainbow dash
2311380.jpg,https://derpicdn.net/img/view/2020/4/1/2311380.jpg,0,0.937872887,229,227,505,503,276,276,rainbow dash
2314267.jpg,https://derpicdn.net/img/view/2020/4/4/2314267.jpg,0,0.947812617,0,0,1053,1077,1053,1077,rainbow dash
2315126.png,https://derpicdn.net/img/view/2020/4/6/2315126.png,0,0.99147439,2909,0,6275,3136,3366,3136,rainbow dash
2316178.png,https://derpicdn.net/img/view/2020/4/7/2316178.png,0,0.997558534,722,0,1274,536,552,536,rainbow dash
2320266.jpg,https://derpicdn.net/img/view/2020/4/12/2320266.jpg,0,0.998635054,298,0,630,282,332,282,rainbow dash
2322591.png,https://derpicdn.net/img/view/2020/4/14/2322591.png,0,0.992173314,730,266,1392,928,662,662,rainbow dash
2326487.png,https://derpicdn.net/img/view/2020/4/19/2326487.png,0,0.972969532,106,0,728,579,622,579,rainbow dash
2329736.jpg,https://derpicdn.net/img/view/2020/4/23/2329736.jpg,0,0.968515873,123,30,1525,1432,1402,1402,rainbow dash
2334001.png,https://derpicdn.net/img/view/2020/4/28/2334001.png,0,0.981790543,287,254,4893,4860,4606,4606,rainbow dash
2334044.jpg,https://derpicdn.net/img/view/2020/4/28/2334044.jpg,0,0.997348487,0,0,1226,1124,1226,1124,rainbow dash
2334560.png,https://derpicdn.net/img/view/2020/4/29/2334560.png,0,0.992732465,52,0,786,724,734,724,rainbow dash
2335238.jpg,https://derpicdn.net/img/view/2020/4/30/2335238.jpg,0,0.999184787,616,0,1100,478,484,478,rainbow dash
2340686.jpg,https://derpicdn.net/img/view/2020/5/6/2340686.jpg,0,0.98201704,177,11,307,141,130,130,rainbow dash
2340702.png,https://derpicdn.net/img/view/2020/5/6/2340702.png,0,0.920749784,60,126,374,440,314,314,rainbow dash
2341328.png,https://derpicdn.net/img/view/2020/5/6/2341328.png,0,0.999720037,25,0,703,601,678,601,rainbow dash
2342453.jpg,https://derpicdn.net/img/view/2020/5/8/2342453.jpg,0,0.945967793,1936,533,2798,1395,862,862,rainbow dash
2343167.png,https://derpicdn.net/img/view/2020/5/8/2343167.png,0,0.983855367,6,0,448,417,442,417,rainbow dash
2345052.png,https://derpicdn.net/img/view/2020/5/10/2345052.png,0,0.986132443,0,8,316,409,316,401,rainbow dash
2345052.png,https://derpicdn.net/img/view/2020/5/10/2345052.png,1,0.943781495,0,0,297,340,297,340,rainbow dash
2347224.jpg,https://derpicdn.net/img/view/2020/5/13/2347224.jpg,0,0.999073863,618,536,1322,1240,704,704,rainbow dash
2349311.png,https://derpicdn.net/img/view/2020/5/15/2349311.png,0,0.983072221,0,230,1659,1910,1659,1680,rainbow dash
2350270.png,https://derpicdn.net/img/view/2020/5/16/2350270.png,0,0.978157818,350,21,1682,1353,1332,1332,rainbow dash
2352250.jpg,https://derpicdn.net/img/view/2020/5/18/2352250.jpg,0,0.945908964,1516,773,3244,2501,1728,1728,rainbow dash
2353454.png,https://derpicdn.net/img/view/2020/5/20/2353454.png,0,0.98200196,121,0,545,390,424,390,rainbow dash
236187.png,https://derpicdn.net/img/view/2013/2/7/236187.png,0,0.999915361,259,0,623,347,364,347,rainbow dash
250976.png,https://derpicdn.net/img/view/2013/2/21/250976.png,0,0.974197924,153,0,1829,1080,1676,1080,rainbow dash
2513.png,https://derpicdn.net/img/view/2012/1/28/2513.png,0,0.918519497,0,0,634,631,634,631,rainbow dash
2513.png,https://derpicdn.net/img/view/2012/1/28/2513.png,1,0.900601208,0,3,411,433,411,430,rainbow dash
25960.png,https://derpicdn.net/img/view/2012/6/30/25960.png,0,0.994144917,215,122,425,332,210,210,rainbow dash
261077.png,https://derpicdn.net/img/view/2013/3/3/261077.png,0,0.997916996,121,0,633,507,512,507,rainbow dash
267552.png,https://derpicdn.net/img/view/2013/3/10/267552.png,0,0.992936969,546,125,1070,649,524,524,rainbow dash
2695.png,https://derpicdn.net/img/view/2012/1/29/2695.png,0,0.999657512,177,25,431,279,254,254,rainbow dash
273724.png,https://derpicdn.net/img/view/2013/3/18/273724.png,0,0.94538486,384,12,1386,1014,1002,1002,rainbow dash
274399.png,https://derpicdn.net/img/view/2013/3/19/274399.png,0,0.987509847,1189,374,2319,1504,1130,1130,rainbow dash
282312.png,https://derpicdn.net/img/view/2013/3/29/282312.png,0,0.999021471,108,0,466,336,358,336,rainbow dash
28719.png,https://derpicdn.net/img/view/2012/7/2/28719.png,0,0.948238909,196,0,462,250,266,250,rainbow dash
288444.png,https://derpicdn.net/img/view/2013/4/4/288444.png,0,0.979624331,104,0,892,780,788,780,rainbow dash
299348.png,https://derpicdn.net/img/view/2013/4/15/299348.png,0,0.983506739,385,9,671,295,286,286,rainbow dash
311689.png,https://derpicdn.net/img/view/2013/4/29/311689.png,0,0.981907308,336,18,1074,756,738,738,rainbow dash
322382.png,https://derpicdn.net/img/view/2013/5/11/322382.png,0,0.995687306,281,190,921,830,640,640,rainbow dash
324801.png,https://derpicdn.net/img/view/2013/5/14/324801.png,0,0.990364373,159,0,1657,1200,1498,1200,rainbow dash
329755.png,https://derpicdn.net/img/view/2013/5/20/329755.png,0,0.971553922,780,410,1228,858,448,448,rainbow dash
338930.png,https://derpicdn.net/img/view/2013/6/2/338930.png,0,0.937012792,71,0,901,769,830,769,rainbow dash
353421.png,https://derpicdn.net/img/view/2013/6/21/353421.png,0,0.963261187,289,145,485,341,196,196,rainbow dash
358493.png,https://derpicdn.net/img/view/2013/6/27/358493.png,0,0.97967732,86,0,552,441,466,441,rainbow dash
368476.png,https://derpicdn.net/img/view/2013/7/9/368476.png,0,0.995065153,296,0,1398,989,1102,989,rainbow dash
395427.png,https://derpicdn.net/img/view/2013/8/9/395427.png,0,0.995704353,0,48,418,472,418,424,rainbow dash
400049.png,https://derpicdn.net/img/view/2013/8/14/400049.png,0,0.998202443,46,0,612,534,566,534,rainbow dash
401753.png,https://derpicdn.net/img/view/2013/8/16/401753.png,0,0.987005532,483,196,1045,758,562,562,rainbow dash
408760.png,https://derpicdn.net/img/view/2013/8/24/408760.png,0,0.987277687,151,108,593,550,442,442,rainbow dash
410645.png,https://derpicdn.net/img/view/2013/8/26/410645.png,0,0.930013716,401,0,1915,1470,1514,1470,rainbow dash
411233.jpg,https://derpicdn.net/img/view/2013/8/26/411233.jpg,0,0.972631872,186,0,586,382,400,382,rainbow dash
414299.png,https://derpicdn.net/img/view/2013/8/30/414299.png,0,0.997094989,73,7,381,315,308,308,rainbow dash
428969.jpg,https://derpicdn.net/img/view/2013/9/16/428969.jpg,0,0.999295056,219,29,575,385,356,356,rainbow dash
434417.png,https://derpicdn.net/img/view/2013/9/25/434417.png,0,0.994613707,477,2,729,254,252,252,rainbow dash
434519.png,https://derpicdn.net/img/view/2013/9/25/434519.png,0,0.998857081,377,68,777,468,400,400,rainbow dash
440214.png,https://derpicdn.net/img/view/2013/10/2/440214.png,0,0.998416066,883,60,1857,1034,974,974,rainbow dash
451505.png,https://derpicdn.net/img/view/2013/10/18/451505.png,0,0.952546954,131,50,583,502,452,452,rainbow dash
460802.png,https://derpicdn.net/img/view/2013/10/31/460802.png,0,0.979368508,99,0,611,485,512,485,rainbow dash
475255.png,https://derpicdn.net/img/view/2013/11/18/475255.png,0,0.987407923,273,90,801,618,528,528,rainbow dash
477475.png,https://derpicdn.net/img/view/2013/11/21/477475.png,0,0.954010248,316,5,984,673,668,668,rainbow dash
478914.png,https://derpicdn.net/img/view/2013/11/23/478914.png,0,0.994855106,747,380,1837,1470,1090,1090,rainbow dash
496610.png,https://derpicdn.net/img/view/2013/12/14/496610.png,0,0.966549516,258,3,502,247,244,244,rainbow dash
497235.png,https://derpicdn.net/img/view/2013/12/15/497235.png,0,0.925262809,142,0,1464,1302,1322,1302,rainbow dash
497355.png,https://derpicdn.net/img/view/2013/12/15/497355.png,1,0.984725356,102,749,464,1111,362,362,rainbow dash
497355.png,https://derpicdn.net/img/view/2013/12/15/497355.png,2,0.904408932,501,0,1031,527,530,527,rainbow dash
501613.png,https://derpicdn.net/img/view/2013/12/20/501613.png,0,0.97998476,913,0,2051,978,1138,978,rainbow dash
50439.png,https://derpicdn.net/img/view/2012/7/20/50439.png,0,0.999458551,544,0,934,371,390,371,rainbow dash
509594.png,https://derpicdn.net/img/view/2013/12/29/509594.png,0,0.968812168,1337,289,3859,2811,2522,2522,rainbow dash
511770.png,https://derpicdn.net/img/view/2014/1/1/511770.png,0,0.997834742,192,17,506,331,314,314,rainbow dash
513.png,https://derpicdn.net/img/view/2012/1/16/513.png,0,0.998918176,1544,47,2805,1335,1261,1288,rainbow dash
518269.png,https://derpicdn.net/img/view/2014/1/7/518269.png,0,0.930226147,1064,460,1652,1048,588,588,rainbow dash
522712.png,https://derpicdn.net/img/view/2014/1/12/522712.png,0,0.99263984,270,1,706,437,436,436,rainbow dash
525892.jpg,https://derpicdn.net/img/view/2014/1/16/525892.jpg,0,0.917160332,46,0,554,485,508,485,rainbow dash
544747.png,https://derpicdn.net/img/view/2014/2/6/544747.png,0,0.996372163,3465,0,4897,1242,1432,1242,rainbow dash
546079.png,https://derpicdn.net/img/view/2014/2/7/546079.png,0,0.946467698,118,0,2550,2418,2432,2418,rainbow dash
55016.jpg,https://derpicdn.net/img/view/2012/7/24/55016.jpg,0,0.98051852,118,119,1056,1057,938,938,rainbow dash
572382.jpg,https://derpicdn.net/img/view/2014/3/11/572382.jpg,0,0.938198984,0,35,419,503,419,468,rainbow dash
579741.jpg,https://derpicdn.net/img/view/2014/3/19/579741.jpg,0,0.94314009,432,94,754,416,322,322,rainbow dash
585184.png,https://derpicdn.net/img/view/2014/3/25/585184.png,0,0.979623973,0,0,761,821,761,821,rainbow dash
585588.jpg,https://derpicdn.net/img/view/2014/3/26/585588.jpg,1,0.930176079,432,248,794,610,362,362,rainbow dash
585771.jpg,https://derpicdn.net/img/view/2014/3/26/585771.jpg,0,0.996570587,247,19,495,267,248,248,rainbow dash
593131.png,https://derpicdn.net/img/view/2014/4/5/593131.png,0,0.984462559,322,0,688,360,366,360,rainbow dash
600282.png,https://derpicdn.net/img/view/2014/4/14/600282.png,0,0.998768985,152,0,518,364,366,364,rainbow dash
604435.png,https://derpicdn.net/img/view/2014/4/19/604435.png,0,0.927576363,100,0,1608,1446,1508,1446,rainbow dash
606351.png,https://derpicdn.net/img/view/2014/4/21/606351.png,0,0.994318783,205,27,437,259,232,232,rainbow dash
611926.png,https://derpicdn.net/img/view/2014/4/28/611926.png,0,0.953815699,0,5,125,159,125,154,rainbow dash
613611.png,https://derpicdn.net/img/view/2014/4/30/613611.png,0,0.986624539,393,19,806,455,413,436,rainbow dash
617652.png,https://derpicdn.net/img/view/2014/5/4/617652.png,0,0.959434092,1446,1501,3816,3871,2370,2370,rainbow dash
622722.png,https://derpicdn.net/img/view/2014/5/10/622722.png,0,0.946690321,0,3,142,151,142,148,rainbow dash
6250.png,https://derpicdn.net/img/view/2012/6/18/6250.png,0,0.995363235,131,0,677,507,546,507,rainbow dash
628291.png,https://derpicdn.net/img/view/2014/5/16/628291.png,0,0.983308196,174,674,504,1004,330,330,rainbow dash
632117.png,https://derpicdn.net/img/view/2014/5/20/632117.png,0,0.998300731,996,0,2728,1641,1732,1641,rainbow dash
6335.png,https://derpicdn.net/img/view/2012/6/18/6335.png,0,0.997072816,251,327,881,957,630,630,rainbow dash
6335.png,https://derpicdn.net/img/view/2012/6/18/6335.png,1,0.907535732,678,660,1106,1088,428,428,rainbow dash
636611.png,https://derpicdn.net/img/view/2014/5/26/636611.png,0,0.972474873,0,0,460,473,460,473,rainbow dash
640861.png,https://derpicdn.net/img/view/2014/5/30/640861.png,0,0.994974077,456,0,1504,1003,1048,1003,rainbow dash
644979.png,https://derpicdn.net/img/view/2014/6/4/644979.png,0,0.998365939,237,0,797,544,560,544,rainbow dash
646365.png,https://derpicdn.net/img/view/2014/6/6/646365.png,0,0.996805847,45,0,1029,940,984,940,rainbow dash
649290.png,https://derpicdn.net/img/view/2014/6/9/649290.png,0,0.983208418,44,0,488,396,444,396,rainbow dash
651543.png,https://derpicdn.net/img/view/2014/6/12/651543.png,0,0.998586893,0,0,672,686,672,686,rainbow dash
651543.png,https://derpicdn.net/img/view/2014/6/12/651543.png,1,0.994827628,949,164,1455,670,506,506,rainbow dash
658992.png,https://derpicdn.net/img/view/2014/6/22/658992.png,0,0.999735534,404,2,652,250,248,248,rainbow dash
662493.png,https://derpicdn.net/img/view/2014/6/27/662493.png,0,0.998487532,1569,0,3531,1692,1962,1692,rainbow dash
668457.png,https://derpicdn.net/img/view/2014/7/6/668457.png,0,0.964277625,2637,1215,7567,6145,4930,4930,rainbow dash
673643.png,https://derpicdn.net/img/view/2014/7/13/673643.png,0,0.995605826,405,38,841,474,436,436,rainbow dash
673643.png,https://derpicdn.net/img/view/2014/7/13/673643.png,1,0.970139503,92,0,514,412,422,412,rainbow dash
674577.png,https://derpicdn.net/img/view/2014/7/14/674577.png,0,0.993298531,469,66,1215,812,746,746,rainbow dash
676620.jpg,https://derpicdn.net/img/view/2014/7/17/676620.jpg,0,0.999559581,242,26,686,470,444,444,rainbow dash
677606.png,https://derpicdn.net/img/view/2014/7/18/677606.png,0,0.948379934,24,0,4260,4044,4236,4044,rainbow dash
687025.png,https://derpicdn.net/img/view/2014/7/30/687025.png,0,0.997452319,235,0,1365,1045,1130,1045,rainbow dash
688032.png,https://derpicdn.net/img/view/2014/7/31/688032.png,0,0.995328367,0,0,578,473,578,473,rainbow dash
690515.jpg,https://derpicdn.net/img/view/2014/8/3/690515.jpg,0,0.96790123,0,0,313,306,313,306,rainbow dash
692736.png,https://derpicdn.net/img/view/2014/8/6/692736.png,0,0.988806844,605,724,1623,1742,1018,1018,rainbow dash
709798.jpg,https://derpicdn.net/img/view/2014/8/28/709798.jpg,0,0.997279346,10,0,782,748,772,748,rainbow dash
715182.png,https://derpicdn.net/img/view/2014/9/5/715182.png,0,0.957129896,61,131,851,921,790,790,rainbow dash
725273.jpg,https://derpicdn.net/img/view/2014/9/19/725273.jpg,0,0.999370039,826,645,1314,1133,488,488,rainbow dash
725273.jpg,https://derpicdn.net/img/view/2014/9/19/725273.jpg,1,0.995669246,24,518,390,884,366,366,rainbow dash
725273.jpg,https://derpicdn.net/img/view/2014/9/19/725273.jpg,2,0.990044713,262,357,708,803,446,446,rainbow dash
733830.png,https://derpicdn.net/img/view/2014/10/2/733830.png,0,0.999653578,570,22,1622,1074,1052,1052,rainbow dash
735961.png,https://derpicdn.net/img/view/2014/10/5/735961.png,0,0.989479125,641,0,1241,589,600,589,rainbow dash
736305.png,https://derpicdn.net/img/view/2014/10/5/736305.png,0,0.903644681,0,0,2570,2704,2570,2704,rainbow dash
741087.png,https://derpicdn.net/img/view/2014/10/12/741087.png,0,0.93852061,432,0,1270,818,838,818,rainbow dash
749144.png,https://derpicdn.net/img/view/2014/10/23/749144.png,0,0.976097345,261,50,815,604,554,554,rainbow dash
752979.png,https://derpicdn.net/img/view/2014/10/29/752979.png,0,0.997226596,119,0,405,264,286,264,rainbow dash
757110.png,https://derpicdn.net/img/view/2014/11/3/757110.png,0,0.941431403,179,29,509,359,330,330,rainbow dash
758428.jpg,https://derpicdn.net/img/view/2014/11/5/758428.jpg,0,0.995616972,50,0,546,408,496,408,rainbow dash
758437.png,https://derpicdn.net/img/view/2014/11/5/758437.png,0,0.999082744,609,38,1109,538,500,500,rainbow dash
761896.png,https://derpicdn.net/img/view/2014/11/10/761896.png,0,0.968621135,238,72,430,264,192,192,rainbow dash
76397.jpg,https://derpicdn.net/img/view/2012/8/17/76397.jpg,0,0.966159284,309,36,617,344,308,308,rainbow dash
769255.png,https://derpicdn.net/img/view/2014/11/22/769255.png,0,0.990904152,118,0,448,318,330,318,rainbow dash
7805.jpg,https://derpicdn.net/img/view/2012/6/18/7805.jpg,0,0.962649882,164,4,474,314,310,310,rainbow dash
795252.png,https://derpicdn.net/img/view/2014/12/29/795252.png,0,0.969719589,478,140,1630,1292,1152,1152,rainbow dash
801769.png,https://derpicdn.net/img/view/2015/1/8/801769.png,0,0.996118903,248,32,582,366,334,334,rainbow dash
806511.png,https://derpicdn.net/img/view/2015/1/14/806511.png,0,0.977510095,209,0,531,319,322,319,rainbow dash
807814.png,https://derpicdn.net/img/view/2015/1/16/807814.png,0,0.965794086,1236,165,2604,1533,1368,1368,rainbow dash
814643.png,https://derpicdn.net/img/view/2015/1/25/814643.png,0,0.964141548,667,168,1009,510,342,342,rainbow dash
815365.png,https://derpicdn.net/img/view/2015/1/26/815365.png,0,0.996732295,115,0,343,217,228,217,rainbow dash
815784.jpg,https://derpicdn.net/img/view/2015/1/27/815784.jpg,0,0.996203303,191,71,683,563,492,492,rainbow dash
832894.jpg,https://derpicdn.net/img/view/2015/2/20/832894.jpg,0,0.994124591,282,0,712,429,430,429,rainbow dash
850803.png,https://derpicdn.net/img/view/2015/3/16/850803.png,0,0.97239095,450,60,1048,658,598,598,rainbow dash
858952.png,https://derpicdn.net/img/view/2015/3/28/858952.png,0,0.996942759,501,38,1201,738,700,700,rainbow dash
860276.png,https://derpicdn.net/img/view/2015/3/30/860276.png,0,0.999483585,256,20,644,408,388,388,rainbow dash
863019.png,https://derpicdn.net/img/view/2015/4/2/863019.png,0,0.958729029,492,163,684,355,192,192,rainbow dash
867306.png,https://derpicdn.net/img/view/2015/4/6/867306.png,0,0.977996051,0,0,881,883,881,883,rainbow dash
872261.png,https://derpicdn.net/img/view/2015/4/12/872261.png,0,0.989598453,111,9,603,501,492,492,rainbow dash
893562.png,https://derpicdn.net/img/view/2015/5/11/893562.png,0,0.978785694,892,88,1816,1012,924,924,rainbow dash
898339.png,https://derpicdn.net/img/view/2015/5/17/898339.png,0,0.999671638,196,26,1034,864,838,838,rainbow dash
90094.jpg,https://derpicdn.net/img/view/2012/9/4/90094.jpg,0,0.985561073,102,95,500,541,398,446,rainbow dash
900995.png,https://derpicdn.net/img/view/2015/5/21/900995.png,0,0.979000986,0,8,193,210,193,202,rainbow dash
903591.png,https://derpicdn.net/img/view/2015/5/25/903591.png,0,0.993721306,92,240,426,574,334,334,rainbow dash
904975.png,https://derpicdn.net/img/view/2015/5/27/904975.png,0,0.985822678,577,346,843,612,266,266,rainbow dash
905084.png,https://derpicdn.net/img/view/2015/5/27/905084.png,0,0.99979955,500,75,760,337,260,262,rainbow dash
910358.png,https://derpicdn.net/img/view/2015/6/5/910358.png,0,0.965045571,79,0,901,706,822,706,rainbow dash
913473.png,https://derpicdn.net/img/view/2015/6/9/913473.png,0,0.999354959,29,0,379,344,350,344,rainbow dash
913551.png,https://derpicdn.net/img/view/2015/6/9/913551.png,0,0.999131739,202,27,422,247,220,220,rainbow dash
913677.png,https://derpicdn.net/img/view/2015/6/9/913677.png,0,0.995479047,122,0,1204,1016,1082,1016,rainbow dash
91711.jpg,https://derpicdn.net/img/view/2012/9/7/91711.jpg,0,0.9972682,586,6,936,356,350,350,rainbow dash
921478.png,https://derpicdn.net/img/view/2015/6/22/921478.png,0,0.998575032,30,0,512,467,482,467,rainbow dash
924480.jpg,https://derpicdn.net/img/view/2015/6/27/924480.jpg,0,0.987301171,13,0,615,365,602,365,rainbow dash
924480.jpg,https://derpicdn.net/img/view/2015/6/27/924480.jpg,1,0.968893886,0,0,492,365,492,365,rainbow dash
93202.png,https://derpicdn.net/img/view/2012/9/9/93202.png,0,0.984315634,3360,275,5000,1943,1640,1668,rainbow dash
937631.png,https://derpicdn.net/img/view/2015/7/15/937631.png,0,0.99669385,239,0,725,447,486,447,rainbow dash
937631.png,https://derpicdn.net/img/view/2015/7/15/937631.png,1,0.952615321,51,0,641,581,590,581,rainbow dash
940784.jpg,https://derpicdn.net/img/view/2015/7/21/940784.jpg,0,0.993755758,216,60,534,378,318,318,rainbow dash
942649.png,https://derpicdn.net/img/view/2015/7/24/942649.png,0,0.985305011,142,0,640,439,498,439,rainbow dash
954391.png,https://derpicdn.net/img/view/2015/8/9/954391.png,0,0.98161906,112,0,416,257,304,257,rainbow dash
960085.png,https://derpicdn.net/img/view/2015/8/18/960085.png,0,0.996581852,187,0,401,187,214,187,rainbow dash
960733.png,https://derpicdn.net/img/view/2015/8/19/960733.png,0,0.979498386,55,171,999,1024,944,853,rainbow dash
961102.png,https://derpicdn.net/img/view/2015/8/19/961102.png,0,0.995516419,202,37,560,395,358,358,rainbow dash
966222.png,https://derpicdn.net/img/view/2015/8/26/966222.png,0,0.997575521,106,77,986,957,880,880,rainbow dash
968505.png,https://derpicdn.net/img/view/2015/8/29/968505.png,0,0.960600495,1624,741,2496,1613,872,872,rainbow dash
972369.png,https://derpicdn.net/img/view/2015/9/4/972369.png,0,0.998501062,211,0,459,247,248,247,rainbow dash
983164.png,https://derpicdn.net/img/view/2015/9/19/983164.png,0,0.986103177,1293,13,1739,459,446,446,rainbow dash
983164.png,https://derpicdn.net/img/view/2015/9/19/983164.png,1,0.968021035,804,7,1228,431,424,424,rainbow dash
983276.png,https://derpicdn.net/img/view/2015/9/19/983276.png,0,0.99758321,1572,0,3200,1563,1628,1563,rainbow dash
985144.png,https://derpicdn.net/img/view/2015/9/22/985144.png,0,0.998704433,1182,132,1762,712,580,580,rainbow dash
986338.png,https://derpicdn.net/img/view/2015/9/23/986338.png,0,0.997780085,756,0,2434,1639,1678,1639,rainbow dash
986840.png,https://derpicdn.net/img/view/2015/9/24/986840.png,0,0.995985866,237,0,1173,876,936,876,rainbow dash
1008851.png,https://derpicdn.net/img/view/2015/10/24/1008851.png,0,0.998575747,245,39,741,535,496,496,rainbow dash
1011806.png,https://derpicdn.net/img/view/2015/10/29/1011806.png,0,0.997145295,108,0,2522,2305,2414,2305,rainbow dash
1012750.png,https://derpicdn.net/img/view/2015/10/30/1012750.png,0,0.907943726,3016,686,3806,1476,790,790,rainbow dash
1017329.png,https://derpicdn.net/img/view/2015/11/6/1017329.png,0,0.999243796,622,30,2086,1494,1464,1464,rainbow dash
1017412.png,https://derpicdn.net/img/view/2015/11/6/1017412.png,0,0.994921625,164,5,390,231,226,226,rainbow dash
1023352.png,https://derpicdn.net/img/view/2015/11/15/1023352.png,0,0.999729455,818,592,1504,1278,686,686,rainbow dash
1023352.png,https://derpicdn.net/img/view/2015/11/15/1023352.png,1,0.988436937,59,12,613,566,554,554,rainbow dash
1023352.png,https://derpicdn.net/img/view/2015/11/15/1023352.png,3,0.975241303,300,459,874,1033,574,574,rainbow dash
1023352.png,https://derpicdn.net/img/view/2015/11/15/1023352.png,4,0.915058196,1461,590,1905,1034,444,444,rainbow dash
10335.png,https://derpicdn.net/img/view/2012/6/19/10335.png,0,0.998722672,204,14,546,356,342,342,rainbow dash
1042902.png,https://derpicdn.net/img/view/2015/12/12/1042902.png,0,0.974260509,32,0,952,574,920,574,rainbow dash
1052455.png,https://derpicdn.net/img/view/2015/12/25/1052455.png,0,0.992489398,635,394,2533,2292,1898,1898,rainbow dash
1055871.png,https://derpicdn.net/img/view/2015/12/30/1055871.png,0,0.999257147,0,61,461,541,461,480,rainbow dash
1059033.png,https://derpicdn.net/img/view/2016/1/3/1059033.png,0,0.980051696,111,0,560,461,449,461,rainbow dash
1062279.png,https://derpicdn.net/img/view/2016/1/8/1062279.png,0,0.974256158,333,268,816,820,483,552,rainbow dash
1070328.png,https://derpicdn.net/img/view/2016/1/20/1070328.png,0,0.998182535,1385,33,2880,1615,1495,1582,rainbow dash
1073795.jpg,https://derpicdn.net/img/view/2016/1/25/1073795.jpg,0,0.980903447,43,0,607,547,564,547,rainbow dash
1080897.png,https://derpicdn.net/img/view/2016/2/5/1080897.png,0,0.978675306,190,0,750,519,560,519,rainbow dash
1088212.png,https://derpicdn.net/img/view/2016/2/14/1088212.png,0,0.990827382,0,0,841,851,841,851,rainbow dash
1092658.png,https://derpicdn.net/img/view/2016/2/20/1092658.png,0,0.998224378,474,113,928,567,454,454,rainbow dash
1105455.png,https://derpicdn.net/img/view/2016/3/9/1105455.png,0,0.999170184,47,34,1133,1120,1086,1086,rainbow dash
1109007.png,https://derpicdn.net/img/view/2016/3/14/1109007.png,0,0.980394304,52,0,350,294,298,294,rainbow dash
1109007.png,https://derpicdn.net/img/view/2016/3/14/1109007.png,1,0.905541301,0,27,266,303,266,276,rainbow dash
1109346.png,https://derpicdn.net/img/view/2016/3/15/1109346.png,0,0.990232706,682,60,2054,1432,1372,1372,rainbow dash
1109349.png,https://derpicdn.net/img/view/2016/3/15/1109349.png,0,0.991165519,678,51,2068,1441,1390,1390,rainbow dash
1109350.png,https://derpicdn.net/img/view/2016/3/15/1109350.png,0,0.994558692,671,32,2095,1456,1424,1424,rainbow dash
1110264.png,https://derpicdn.net/img/view/2016/3/16/1110264.png,0,0.987304151,144,10,732,598,588,588,rainbow dash
1120206.png,https://derpicdn.net/img/view/2016/3/30/1120206.png,0,0.951036692,299,0,1075,759,776,759,rainbow dash
1128022.png,https://derpicdn.net/img/view/2016/4/9/1128022.png,0,0.947141349,538,63,2864,2557,2326,2494,rainbow dash
1137071.png,https://derpicdn.net/img/view/2016/4/21/1137071.png,0,0.954910755,14,0,2194,2168,2180,2168,rainbow dash
1137072.png,https://derpicdn.net/img/view/2016/4/21/1137072.png,0,0.901173949,1221,465,3048,2379,1827,1914,rainbow dash
1139496.png,https://derpicdn.net/img/view/2016/4/25/1139496.png,0,0.996042013,128,0,972,815,844,815,rainbow dash
1148655.png,https://derpicdn.net/img/view/2016/5/7/1148655.png,0,0.964691937,11,416,1135,1540,1124,1124,rainbow dash
1149177.jpg,https://derpicdn.net/img/view/2016/5/8/1149177.jpg,0,0.999509454,621,80,1183,642,562,562,rainbow dash
1157103.png,https://derpicdn.net/img/view/2016/5/18/1157103.png,0,0.995019972,0,0,2353,2390,2353,2390,rainbow dash
1169064.png,https://derpicdn.net/img/view/2016/6/3/1169064.png,0,0.993582129,1136,0,2384,1205,1248,1205,rainbow dash
1173615.png,https://derpicdn.net/img/view/2016/6/8/1173615.png,0,0.961848438,490,10,2864,2590,2374,2580,rainbow dash
1182211.png,https://derpicdn.net/img/view/2016/6/19/1182211.png,0,0.946253479,173,155,587,569,414,414,rainbow dash
1186750.png,https://derpicdn.net/img/view/2016/6/25/1186750.png,1,0.992495954,452,15,746,309,294,294,rainbow dash
1187097.png,https://derpicdn.net/img/view/2016/6/26/1187097.png,0,0.99744457,523,0,1497,842,974,842,rainbow dash
1195424.png,https://derpicdn.net/img/view/2016/7/7/1195424.png,0,0.970912933,218,553,518,853,300,300,rainbow dash
1199732.png,https://derpicdn.net/img/view/2016/7/13/1199732.png,0,0.998250544,867,0,2693,1780,1826,1780,rainbow dash
1209453.png,https://derpicdn.net/img/view/2016/7/26/1209453.png,0,0.952572882,577,345,729,497,152,152,rainbow dash
1213113.png,https://derpicdn.net/img/view/2016/7/31/1213113.png,0,0.992927074,0,5,291,297,291,292,rainbow dash
1214523.png,https://derpicdn.net/img/view/2016/8/1/1214523.png,0,0.991008639,0,0,1334,908,1334,908,rainbow dash
1214567.png,https://derpicdn.net/img/view/2016/8/1/1214567.png,0,0.913660884,76,0,838,746,762,746,rainbow dash
1214801.png,https://derpicdn.net/img/view/2016/8/1/1214801.png,0,0.92168808,242,8,518,284,276,276,rainbow dash
1215520.png,https://derpicdn.net/img/view/2016/8/2/1215520.png,0,0.976318657,64,0,554,396,490,396,rainbow dash
1218330.png,https://derpicdn.net/img/view/2016/8/6/1218330.png,0,0.918948293,169,414,3900,4398,3731,3984,rainbow dash
1228716.png,https://derpicdn.net/img/view/2016/8/19/1228716.png,0,0.99690038,76,0,2996,2748,2920,2748,rainbow dash
1234176.png,https://derpicdn.net/img/view/2016/8/26/1234176.png,0,0.992051601,0,0,711,677,711,677,rainbow dash
1237042.png,https://derpicdn.net/img/view/2016/8/29/1237042.png,0,0.999278665,144,0,986,798,842,798,rainbow dash
1238872.png,https://derpicdn.net/img/view/2016/9/1/1238872.png,0,0.994916618,46,23,440,417,394,394,rainbow dash
1241559.png,https://derpicdn.net/img/view/2016/9/4/1241559.png,0,0.990214348,0,18,370,390,370,372,rainbow dash
1241947.png,https://derpicdn.net/img/view/2016/9/4/1241947.png,0,0.986395359,0,0,466,503,466,503,rainbow dash
1249772.png,https://derpicdn.net/img/view/2016/9/15/1249772.png,0,0.989592552,0,131,2290,2507,2290,2376,rainbow dash
1250112.png,https://derpicdn.net/img/view/2016/9/15/1250112.png,0,0.922555506,174,104,718,648,544,544,rainbow dash
1253212.png,https://derpicdn.net/img/view/2016/9/19/1253212.png,0,0.990579903,22,0,348,315,326,315,rainbow dash
1255607.png,https://derpicdn.net/img/view/2016/9/22/1255607.png,0,0.9994151,354,0,866,482,512,482,rainbow dash
1266061.png,https://derpicdn.net/img/view/2016/10/6/1266061.png,0,0.997266769,2,0,512,494,510,494,rainbow dash
1268901.png,https://derpicdn.net/img/view/2016/10/9/1268901.png,0,0.999158502,194,580,570,956,376,376,rainbow dash
1273045.png,https://derpicdn.net/img/view/2016/10/15/1273045.png,0,0.962477148,0,0,324,342,324,342,rainbow dash
1282091.png,https://derpicdn.net/img/view/2016/10/26/1282091.png,0,0.923398316,137,69,1327,1259,1190,1190,rainbow dash
1293041.png,https://derpicdn.net/img/view/2016/11/11/1293041.png,0,0.961637974,15,19,313,365,298,346,rainbow dash
1293800.png,https://derpicdn.net/img/view/2016/11/12/1293800.png,0,0.995838225,168,0,512,325,344,325,rainbow dash
1296511.png,https://derpicdn.net/img/view/2016/11/15/1296511.png,0,0.974402726,120,0,632,480,512,480,rainbow dash
1298967.png,https://derpicdn.net/img/view/2016/11/19/1298967.png,0,0.990097463,40,2,502,464,462,462,rainbow dash
1298967.png,https://derpicdn.net/img/view/2016/11/19/1298967.png,1,0.903405905,49,58,561,635,512,577,rainbow dash
1301667.png,https://derpicdn.net/img/view/2016/11/23/1301667.png,0,0.998175263,56,63,418,425,362,362,rainbow dash
130481.png,https://derpicdn.net/img/view/2012/10/24/130481.png,0,0.996523321,95,0,379,283,284,283,rainbow dash
1313924.png,https://derpicdn.net/img/view/2016/12/10/1313924.png,0,0.908865273,254,27,818,591,564,564,rainbow dash
1316913.png,https://derpicdn.net/img/view/2016/12/13/1316913.png,0,0.904617369,0,0,3851,4446,3851,4446,rainbow dash
1324007.png,https://derpicdn.net/img/view/2016/12/24/1324007.png,0,0.999158621,0,0,1081,1077,1081,1077,rainbow dash
1324129.png,https://derpicdn.net/img/view/2016/12/24/1324129.png,0,0.998599887,452,0,1020,517,568,517,rainbow dash
1325358.png,https://derpicdn.net/img/view/2016/12/26/1325358.png,0,0.980798602,231,0,573,313,342,313,rainbow dash
1333310.png,https://derpicdn.net/img/view/2017/1/6/1333310.png,0,0.990170598,328,0,764,428,436,428,rainbow dash
1340726.png,https://derpicdn.net/img/view/2017/1/16/1340726.png,0,0.930720508,206,29,1092,915,886,886,rainbow dash
1354908.png,https://derpicdn.net/img/view/2017/2/4/1354908.png,0,0.989833653,0,0,3272,3395,3272,3395,rainbow dash
1355218.png,https://derpicdn.net/img/view/2017/2/4/1355218.png,0,0.997282565,168,19,456,307,288,288,rainbow dash
1357769.png,https://derpicdn.net/img/view/2017/2/8/1357769.png,0,0.991565287,68,11,312,255,244,244,rainbow dash
1360314.png,https://derpicdn.net/img/view/2017/2/11/1360314.png,0,0.999314249,72,0,392,291,320,291,rainbow dash
1360633.png,https://derpicdn.net/img/view/2017/2/12/1360633.png,0,0.994703591,377,84,949,656,572,572,rainbow dash
1365021.png,https://derpicdn.net/img/view/2017/2/17/1365021.png,0,0.99767971,24,11,580,567,556,556,rainbow dash
1365405.png,https://derpicdn.net/img/view/2017/2/17/1365405.png,0,0.994049072,866,88,1280,502,414,414,rainbow dash
1368538.png,https://derpicdn.net/img/view/2017/2/20/1368538.png,0,0.982949317,582,0,1094,473,512,473,rainbow dash
1377030.png,https://derpicdn.net/img/view/2017/3/2/1377030.png,0,0.97371465,254,185,1070,1001,816,816,rainbow dash
1379425.png,https://derpicdn.net/img/view/2017/3/4/1379425.png,0,0.995595396,0,0,485,469,485,469,rainbow dash
1379531.png,https://derpicdn.net/img/view/2017/3/5/1379531.png,0,0.98313868,2635,317,4735,2417,2100,2100,rainbow dash
1381150.png,https://derpicdn.net/img/view/2017/3/7/1381150.png,0,0.965964794,815,0,1627,676,812,676,rainbow dash
1381372.png,https://derpicdn.net/img/view/2017/3/7/1381372.png,0,0.9945907,492,0,2988,2308,2496,2308,rainbow dash
1385289.png,https://derpicdn.net/img/view/2017/3/12/1385289.png,0,0.95344919,330,0,873,562,543,562,rainbow dash
1387677.png,https://derpicdn.net/img/view/2017/3/15/1387677.png,0,0.990493774,0,7,783,815,783,808,rainbow dash
1391172.png,https://derpicdn.net/img/view/2017/3/19/1391172.png,0,0.966334164,88,0,958,692,870,692,rainbow dash
1397857.png,https://derpicdn.net/img/view/2017/3/27/1397857.png,0,0.995409429,4,0,516,490,512,490,rainbow dash
1401195.png,https://derpicdn.net/img/view/2017/4/1/1401195.png,0,0.945910215,109,840,271,1002,162,162,rainbow dash
1401488.png,https://derpicdn.net/img/view/2017/4/1/1401488.png,0,0.973603129,45,0,3405,2852,3360,2852,rainbow dash
1402498.png,https://derpicdn.net/img/view/2017/4/2/1402498.png,0,0.997888029,514,484,1058,1028,544,544,rainbow dash
1405214.png,https://derpicdn.net/img/view/2017/4/6/1405214.png,0,0.970387518,436,0,3332,2607,2896,2607,rainbow dash
1407046.png,https://derpicdn.net/img/view/2017/4/8/1407046.png,0,0.98087275,693,68,1071,446,378,378,rainbow dash
1408167.png,https://derpicdn.net/img/view/2017/4/10/1408167.png,0,0.9899562,1110,9,4492,3391,3382,3382,rainbow dash
1414481.png,https://derpicdn.net/img/view/2017/4/17/1414481.png,0,0.974452913,437,0,4093,2894,3656,2894,rainbow dash
1414666.png,https://derpicdn.net/img/view/2017/4/18/1414666.png,0,0.958528578,568,221,2946,2599,2378,2378,rainbow dash
1420843.png,https://derpicdn.net/img/view/2017/4/24/1420843.png,0,0.993598938,17,0,868,986,851,986,rainbow dash
1423660.png,https://derpicdn.net/img/view/2017/4/28/1423660.png,0,0.938371658,542,81,1390,929,848,848,rainbow dash
1423693.png,https://derpicdn.net/img/view/2017/4/28/1423693.png,0,0.984123766,667,205,1407,945,740,740,rainbow dash
1430960.png,https://derpicdn.net/img/view/2017/5/7/1430960.png,0,0.931527317,0,0,1025,692,1025,692,rainbow dash
1431132.png,https://derpicdn.net/img/view/2017/5/7/1431132.png,0,0.949605465,39,58,383,402,344,344,rainbow dash
1433427.png,https://derpicdn.net/img/view/2017/5/10/1433427.png,0,0.984323382,409,300,2511,2308,2102,2008,rainbow dash
1435772.png,https://derpicdn.net/img/view/2017/5/13/1435772.png,0,0.997861028,275,268,937,930,662,662,rainbow dash
1440924.png,https://derpicdn.net/img/view/2017/5/20/1440924.png,0,0.989777327,462,0,2934,1988,2472,1988,rainbow dash
1441913.png,https://derpicdn.net/img/view/2017/5/21/1441913.png,0,0.994112015,60,0,760,692,700,692,rainbow dash
1442626.png,https://derpicdn.net/img/view/2017/5/21/1442626.png,0,0.997386932,832,0,1956,1086,1124,1086,rainbow dash
1442837.png,https://derpicdn.net/img/view/2017/5/22/1442837.png,0,0.991360366,0,0,842,830,842,830,rainbow dash
1449083.png,https://derpicdn.net/img/view/2017/5/29/1449083.png,0,0.969667971,2219,0,4043,1643,1824,1643,rainbow dash
1450375.png,https://derpicdn.net/img/view/2017/5/31/1450375.png,0,0.980947196,174,120,922,868,748,748,rainbow dash
1451438.png,https://derpicdn.net/img/view/2017/6/1/1451438.png,0,0.994647145,374,63,894,583,520,520,rainbow dash
1452866.png,https://derpicdn.net/img/view/2017/6/3/1452866.png,0,0.925341308,131,72,353,294,222,222,rainbow dash
1461197.png,https://derpicdn.net/img/view/2017/6/13/1461197.png,0,0.999457598,243,0,635,349,392,349,rainbow dash
1462005.png,https://derpicdn.net/img/view/2017/6/14/1462005.png,0,0.998656571,240,19,614,393,374,374,rainbow dash
1464105.png,https://derpicdn.net/img/view/2017/6/17/1464105.png,0,0.995897472,0,0,3359,3598,3359,3598,rainbow dash
1469903.png,https://derpicdn.net/img/view/2017/6/23/1469903.png,0,0.963255763,10,0,568,538,558,538,rainbow dash
1472824.png,https://derpicdn.net/img/view/2017/6/27/1472824.png,0,0.921283066,484,0,2372,1823,1888,1823,rainbow dash
1474448.png,https://derpicdn.net/img/view/2017/6/29/1474448.png,0,0.920797765,0,0,269,266,269,266,rainbow dash
1475221.png,https://derpicdn.net/img/view/2017/6/30/1475221.png,0,0.97585845,1194,63,2070,939,876,876,rainbow dash
1478253.png,https://derpicdn.net/img/view/2017/7/4/1478253.png,0,0.992835402,689,153,1015,479,326,326,rainbow dash
1478691.png,https://derpicdn.net/img/view/2017/7/4/1478691.png,0,0.995073974,568,0,1024,440,456,440,rainbow dash
1479636.png,https://derpicdn.net/img/view/2017/7/6/1479636.png,0,0.98121655,0,97,708,885,708,788,rainbow dash
1481591.png,https://derpicdn.net/img/view/2017/7/8/1481591.png,0,0.996742547,137,23,1033,919,896,896,rainbow dash
1483573.png,https://derpicdn.net/img/view/2017/7/11/1483573.png,0,0.982114732,81,0,811,751,730,751,rainbow dash
1484536.png,https://derpicdn.net/img/view/2017/7/12/1484536.png,0,0.994225502,1022,0,2563,1547,1541,1547,rainbow dash
1485420.png,https://derpicdn.net/img/view/2017/7/13/1485420.png,0,0.901399672,1362,405,3000,2209,1638,1804,rainbow dash
1488226.png,https://derpicdn.net/img/view/2017/7/17/1488226.png,0,0.942937672,0,26,752,886,752,860,rainbow dash
1489758.png,https://derpicdn.net/img/view/2017/7/19/1489758.png,0,0.996799588,1052,37,2124,1109,1072,1072,rainbow dash
1492266.png,https://derpicdn.net/img/view/2017/7/22/1492266.png,0,0.923042953,1070,0,3530,2420,2460,2420,rainbow dash
1492958.png,https://derpicdn.net/img/view/2017/7/23/1492958.png,0,0.996840417,494,0,1070,538,576,538,rainbow dash
1495486.png,https://derpicdn.net/img/view/2017/7/26/1495486.png,0,0.9904266,501,168,1095,762,594,594,rainbow dash
1495564.png,https://derpicdn.net/img/view/2017/7/26/1495564.png,0,0.991002798,584,155,1384,955,800,800,rainbow dash
1496509.png,https://derpicdn.net/img/view/2017/7/28/1496509.png,0,0.980345905,15,2,559,546,544,544,rainbow dash
1498154.png,https://derpicdn.net/img/view/2017/7/30/1498154.png,0,0.986778259,136,0,854,614,718,614,rainbow dash
1499097.png,https://derpicdn.net/img/view/2017/7/31/1499097.png,0,0.997357428,201,0,613,393,412,393,rainbow dash
1499208.png,https://derpicdn.net/img/view/2017/7/31/1499208.png,0,0.999518096,762,0,1584,793,822,793,rainbow dash
1499270.png,https://derpicdn.net/img/view/2017/7/31/1499270.png,0,0.98161453,399,291,1155,1047,756,756,rainbow dash
1507341.png,https://derpicdn.net/img/view/2017/8/10/1507341.png,0,0.995883524,26,0,682,631,656,631,rainbow dash
1508145.png,https://derpicdn.net/img/view/2017/8/11/1508145.png,0,0.993619919,42,0,646,595,604,595,rainbow dash
1511516.png,https://derpicdn.net/img/view/2017/8/15/1511516.png,0,0.958494246,0,0,461,442,461,442,rainbow dash
151261.jpg,https://derpicdn.net/img/view/2012/11/13/151261.jpg,0,0.983212352,6,8,380,382,374,374,rainbow dash
1513828.png,https://derpicdn.net/img/view/2017/8/18/1513828.png,0,0.98180145,105,0,1305,1073,1200,1073,rainbow dash
1515383.png,https://derpicdn.net/img/view/2017/8/20/1515383.png,0,0.938572824,1350,0,2916,1333,1566,1333,rainbow dash
1523134.png,https://derpicdn.net/img/view/2017/8/30/1523134.png,0,0.995558679,471,0,1366,878,895,878,rainbow dash
1524060.png,https://derpicdn.net/img/view/2017/8/31/1524060.png,0,0.990961313,0,0,1655,1835,1655,1835,rainbow dash
1525655.png,https://derpicdn.net/img/view/2017/9/2/1525655.png,0,0.979868054,1512,126,4646,3260,3134,3134,rainbow dash
1528.jpg,https://derpicdn.net/img/view/2012/1/23/1528.jpg,0,0.998737812,330,16,650,336,320,320,rainbow dash
1528501.png,https://derpicdn.net/img/view/2017/9/5/1528501.png,0,0.996406376,2762,0,6064,3179,3302,3179,rainbow dash
1528807.png,https://derpicdn.net/img/view/2017/9/5/1528807.png,0,0.938211501,69,0,607,518,538,518,rainbow dash
153185.jpg,https://derpicdn.net/img/view/2012/11/15/153185.jpg,0,0.946561456,220,57,646,483,426,426,rainbow dash
1534738.png,https://derpicdn.net/img/view/2017/9/13/1534738.png,0,0.948629975,253,266,833,846,580,580,rainbow dash
1535253.png,https://derpicdn.net/img/view/2017/9/14/1535253.png,0,0.988885999,0,386,1189,1632,1189,1246,rainbow dash
1535488.png,https://derpicdn.net/img/view/2017/9/14/1535488.png,0,0.998511195,61,23,329,291,268,268,rainbow dash
1543936.png,https://derpicdn.net/img/view/2017/9/24/1543936.png,0,0.957672954,0,48,819,886,819,838,rainbow dash
1544591.png,https://derpicdn.net/img/view/2017/9/25/1544591.png,0,0.980104804,49,5,264,233,215,228,rainbow dash
1548093.png,https://derpicdn.net/img/view/2017/9/30/1548093.png,0,0.985286772,16,0,562,515,546,515,rainbow dash
1550.jpg,https://derpicdn.net/img/view/2012/1/23/1550.jpg,0,0.998218954,955,128,1399,572,444,444,rainbow dash
1554808.png,https://derpicdn.net/img/view/2017/10/7/1554808.png,1,0.961382926,831,132,1439,740,608,608,rainbow dash
1557450.png,https://derpicdn.net/img/view/2017/10/10/1557450.png,0,0.969589829,36,0,1404,1347,1368,1347,rainbow dash
1561003.png,https://derpicdn.net/img/view/2017/10/14/1561003.png,0,0.942644179,0,0,1368,1457,1368,1457,rainbow dash
1562407.png,https://derpicdn.net/img/view/2017/10/16/1562407.png,0,0.94577992,289,109,1731,1619,1442,1510,rainbow dash
1563570.png,https://derpicdn.net/img/view/2017/10/17/1563570.png,0,0.990895271,158,0,824,637,666,637,rainbow dash
156447.jpg,https://derpicdn.net/img/view/2012/11/18/156447.jpg,0,0.9821226,0,37,610,576,610,539,rainbow dash
1565566.png,https://derpicdn.net/img/view/2017/10/20/1565566.png,0,0.98937583,795,78,1467,750,672,672,rainbow dash
1567131.png,https://derpicdn.net/img/view/2017/10/21/1567131.png,0,0.980997682,22,10,854,918,832,908,rainbow dash
1570125.png,https://derpicdn.net/img/view/2017/10/25/1570125.png,0,0.974766195,219,85,1249,1115,1030,1030,rainbow dash
1572639.png,https://derpicdn.net/img/view/2017/10/29/1572639.png,0,0.996299446,859,0,2253,1332,1394,1332,rainbow dash
1578145.png,https://derpicdn.net/img/view/2017/11/4/1578145.png,0,0.987816155,106,0,2122,1882,2016,1882,rainbow dash
1581224.png,https://derpicdn.net/img/view/2017/11/8/1581224.png,0,0.983449459,353,0,1449,1027,1096,1027,rainbow dash
1583169.png,https://derpicdn.net/img/view/2017/11/10/1583169.png,0,0.954780221,1088,176,3992,3080,2904,2904,rainbow dash
1585246.png,https://derpicdn.net/img/view/2017/11/13/1585246.png,0,0.953974307,202,3,1282,1080,1080,1077,rainbow dash
1587720.png,https://derpicdn.net/img/view/2017/11/16/1587720.png,0,0.998685598,0,2,2893,3182,2893,3180,rainbow dash
1589914.png,https://derpicdn.net/img/view/2017/11/19/1589914.png,0,0.94124794,31,0,569,469,538,469,rainbow dash
1590032.png,https://derpicdn.net/img/view/2017/11/19/1590032.png,0,0.901453674,990,609,2080,1699,1090,1090,rainbow dash
1590128.png,https://derpicdn.net/img/view/2017/11/19/1590128.png,0,0.989303708,1142,0,2598,1388,1456,1388,rainbow dash
1590771.png,https://derpicdn.net/img/view/2017/11/20/1590771.png,0,0.917211652,10,0,868,719,858,719,rainbow dash
1593234.png,https://derpicdn.net/img/view/2017/11/24/1593234.png,0,0.901745737,265,16,965,716,700,700,rainbow dash
1594729.png,https://derpicdn.net/img/view/2017/11/26/1594729.png,0,0.985275209,147,24,505,382,358,358,rainbow dash
1596388.png,https://derpicdn.net/img/view/2017/11/28/1596388.png,0,0.992847681,178,23,716,561,538,538,rainbow dash
1601063.png,https://derpicdn.net/img/view/2017/12/5/1601063.png,0,0.976181746,228,0,1760,1462,1532,1462,rainbow dash
1604263.png,https://derpicdn.net/img/view/2017/12/10/1604263.png,0,0.962439477,468,119,1440,1103,972,984,rainbow dash
1604551.png,https://derpicdn.net/img/view/2017/12/10/1604551.png,0,0.998600721,3036,0,6560,3486,3524,3486,rainbow dash
1604709.png,https://derpicdn.net/img/view/2017/12/10/1604709.png,0,0.984504223,0,0,501,517,501,517,rainbow dash
1604785.png,https://derpicdn.net/img/view/2017/12/10/1604785.png,0,0.998168468,187,25,761,599,574,574,rainbow dash
1605232.png,https://derpicdn.net/img/view/2017/12/11/1605232.png,0,0.983188152,504,628,1872,1996,1368,1368,rainbow dash
1607188.png,https://derpicdn.net/img/view/2017/12/13/1607188.png,0,0.975309074,0,0,452,421,452,421,rainbow dash
1608002.png,https://derpicdn.net/img/view/2017/12/15/1608002.png,0,0.998998106,956,0,1390,350,434,350,rainbow dash
1608002.png,https://derpicdn.net/img/view/2017/12/15/1608002.png,2,0.98606956,87,0,391,300,304,300,rainbow dash
1612842.png,https://derpicdn.net/img/view/2017/12/21/1612842.png,0,0.959273934,0,0,1674,1690,1674,1690,rainbow dash
1615764.png,https://derpicdn.net/img/view/2017/12/25/1615764.png,0,0.999075592,112,573,360,821,248,248,rainbow dash
1615811.png,https://derpicdn.net/img/view/2017/12/25/1615811.png,0,0.983687639,414,148,3000,2886,2586,2738,rainbow dash
1616673.png,https://derpicdn.net/img/view/2017/12/26/1616673.png,0,0.985927105,339,0,1059,690,720,690,rainbow dash
1617123.png,https://derpicdn.net/img/view/2017/12/27/1617123.png,0,0.999097407,410,49,746,385,336,336,rainbow dash
1621197.png,https://derpicdn.net/img/view/2018/1/1/1621197.png,0,0.996554434,71,13,1435,1377,1364,1364,rainbow dash
1625818.png,https://derpicdn.net/img/view/2018/1/6/1625818.png,0,0.992521346,0,8,541,558,541,550,rainbow dash
1626.png,https://derpicdn.net/img/view/2012/1/23/1626.png,0,0.97465539,0,0,312,300,312,300,rainbow dash
1631379.png,https://derpicdn.net/img/view/2018/1/13/1631379.png,0,0.993618786,34,0,388,332,354,332,rainbow dash
1631718.png,https://derpicdn.net/img/view/2018/1/14/1631718.png,0,0.918768585,0,0,636,674,636,674,rainbow dash
1634039.png,https://derpicdn.net/img/view/2018/1/17/1634039.png,0,0.963278592,0,35,1026,1081,1026,1046,rainbow dash
1634817.png,https://derpicdn.net/img/view/2018/1/18/1634817.png,0,0.977393746,0,30,683,792,683,762,rainbow dash
1634817.png,https://derpicdn.net/img/view/2018/1/18/1634817.png,1,0.924171269,133,0,683,621,550,621,rainbow dash
1643084.png,https://derpicdn.net/img/view/2018/1/28/1643084.png,0,0.99755764,71,0,973,900,902,900,rainbow dash
1646918.png,https://derpicdn.net/img/view/2018/2/2/1646918.png,0,0.985207677,61,63,353,355,292,292,rainbow dash
1648052.png,https://derpicdn.net/img/view/2018/2/4/1648052.png,0,0.987454653,103,0,425,321,322,321,rainbow dash
1649169.png,https://derpicdn.net/img/view/2018/2/5/1649169.png,0,0.983640254,248,0,1960,1555,1712,1555,rainbow dash
1656736.png,https://derpicdn.net/img/view/2018/2/15/1656736.png,0,0.935741425,262,0,888,487,626,487,rainbow dash
1663828.png,https://derpicdn.net/img/view/2018/2/23/1663828.png,0,0.994215071,1248,0,2502,1090,1254,1090,rainbow dash
1666668.png,https://derpicdn.net/img/view/2018/2/26/1666668.png,0,0.996099651,1870,0,5369,3821,3499,3821,rainbow dash
1674083.png,https://derpicdn.net/img/view/2018/3/7/1674083.png,0,0.980095387,159,0,837,661,678,661,rainbow dash
1678845.png,https://derpicdn.net/img/view/2018/3/13/1678845.png,0,0.930147707,0,72,492,590,492,518,rainbow dash
1679517.png,https://derpicdn.net/img/view/2018/3/14/1679517.png,0,0.992654264,41,0,907,831,866,831,rainbow dash
1680348.png,https://derpicdn.net/img/view/2018/3/14/1680348.png,0,0.940546274,238,0,1620,1076,1382,1076,rainbow dash
1682520.png,https://derpicdn.net/img/view/2018/3/17/1682520.png,0,0.997822464,221,0,591,322,370,322,rainbow dash
1683680.png,https://derpicdn.net/img/view/2018/3/18/1683680.png,0,0.973146081,0,0,955,992,955,992,rainbow dash
1701982.png,https://derpicdn.net/img/view/2018/4/7/1701982.png,0,0.989634454,984,0,2660,1438,1676,1438,rainbow dash
1710124.png,https://derpicdn.net/img/view/2018/4/17/1710124.png,0,0.995654285,37,0,995,890,958,890,rainbow dash
1718027.png,https://derpicdn.net/img/view/2018/4/27/1718027.png,0,0.912422001,109,28,459,378,350,350,rainbow dash
1721225.png,https://derpicdn.net/img/view/2018/4/30/1721225.png,0,0.971423268,525,0,863,298,338,298,rainbow dash
1727264.png,https://derpicdn.net/img/view/2018/5/8/1727264.png,0,0.965773404,367,19,835,487,468,468,rainbow dash
1728999.png,https://derpicdn.net/img/view/2018/5/10/1728999.png,0,0.977170289,1207,0,2205,876,998,876,rainbow dash
1729722.png,https://derpicdn.net/img/view/2018/5/11/1729722.png,0,0.996222556,74,51,456,433,382,382,rainbow dash
1732381.png,https://derpicdn.net/img/view/2018/5/14/1732381.png,0,0.974617124,0,0,250,342,250,342,rainbow dash
1733120.png,https://derpicdn.net/img/view/2018/5/15/1733120.png,0,0.928570032,512,402,1062,952,550,550,rainbow dash
1733481.png,https://derpicdn.net/img/view/2018/5/15/1733481.png,0,0.981605709,489,1861,3019,4391,2530,2530,rainbow dash
1740363.png,https://derpicdn.net/img/view/2018/5/24/1740363.png,0,0.9976542,605,0,1805,1116,1200,1116,rainbow dash
1741127.png,https://derpicdn.net/img/view/2018/5/25/1741127.png,0,0.998279214,1549,9,3321,1781,1772,1772,rainbow dash
1741152.png,https://derpicdn.net/img/view/2018/5/25/1741152.png,0,0.989290595,27,0,513,467,486,467,rainbow dash
1741681.png,https://derpicdn.net/img/view/2018/5/26/1741681.png,0,0.967049837,1,136,865,1000,864,864,rainbow dash
1744468.png,https://derpicdn.net/img/view/2018/5/29/1744468.png,0,0.999504209,1308,0,3368,1993,2060,1993,rainbow dash
1744757.png,https://derpicdn.net/img/view/2018/5/29/1744757.png,0,0.967307925,102,619,2362,2879,2260,2260,rainbow dash
1750575.png,https://derpicdn.net/img/view/2018/6/5/1750575.png,0,0.999112666,522,293,1582,1353,1060,1060,rainbow dash
1751495.png,https://derpicdn.net/img/view/2018/6/6/1751495.png,0,0.997748494,530,34,1886,1390,1356,1356,rainbow dash
1751948.png,https://derpicdn.net/img/view/2018/6/7/1751948.png,0,0.988562107,502,71,1560,1129,1058,1058,rainbow dash
1761257.png,https://derpicdn.net/img/view/2018/6/19/1761257.png,0,0.98405844,74,34,756,716,682,682,rainbow dash
1761550.png,https://derpicdn.net/img/view/2018/6/19/1761550.png,0,0.999714434,870,245,1848,1223,978,978,rainbow dash
1762218.png,https://derpicdn.net/img/view/2018/6/20/1762218.png,0,0.996844113,0,0,977,1072,977,1072,rainbow dash
1766316.png,https://derpicdn.net/img/view/2018/6/26/1766316.png,0,0.910906732,80,0,250,164,170,164,rainbow dash
1769509.png,https://derpicdn.net/img/view/2018/6/30/1769509.png,0,0.998871803,35,0,675,612,640,612,rainbow dash
1770729.png,https://derpicdn.net/img/view/2018/7/1/1770729.png,0,0.992506683,575,113,1049,587,474,474,rainbow dash
1770729.png,https://derpicdn.net/img/view/2018/7/1/1770729.png,1,0.984687567,110,125,586,601,476,476,rainbow dash
1771154.png,https://derpicdn.net/img/view/2018/7/2/1771154.png,0,0.976106644,605,0,1851,1197,1246,1197,rainbow dash
1777717.png,https://derpicdn.net/img/view/2018/7/10/1777717.png,0,0.995823205,29,0,817,613,788,613,rainbow dash
1781662.png,https://derpicdn.net/img/view/2018/7/15/1781662.png,0,0.953187168,839,152,1833,1146,994,994,rainbow dash
1783475.png,https://derpicdn.net/img/view/2018/7/17/1783475.png,0,0.997518063,221,0,625,383,404,383,rainbow dash
1787625.png,https://derpicdn.net/img/view/2018/7/23/1787625.png,0,0.994279027,11,0,431,389,420,389,rainbow dash
1800118.png,https://derpicdn.net/img/view/2018/8/6/1800118.png,0,0.967434883,283,64,687,468,404,404,rainbow dash
1800297.png,https://derpicdn.net/img/view/2018/8/7/1800297.png,0,0.995614827,339,0,1049,659,710,659,rainbow dash
1805363.png,https://derpicdn.net/img/view/2018/8/13/1805363.png,0,0.97375983,107,0,569,372,462,372,rainbow dash
1807584.png,https://derpicdn.net/img/view/2018/8/15/1807584.png,0,0.990220249,1114,0,2039,894,925,894,rainbow dash
1808496.png,https://derpicdn.net/img/view/2018/8/16/1808496.png,0,0.998519301,191,0,415,223,224,223,rainbow dash
1811664.png,https://derpicdn.net/img/view/2018/8/20/1811664.png,0,0.997274637,1171,0,2673,1434,1502,1434,rainbow dash
1814886.png,https://derpicdn.net/img/view/2018/8/24/1814886.png,0,0.984734714,130,0,592,438,462,438,rainbow dash
1818217.png,https://derpicdn.net/img/view/2018/8/28/1818217.png,0,0.975355685,1630,2423,3454,4247,1824,1824,rainbow dash
1819290.png,https://derpicdn.net/img/view/2018/8/29/1819290.png,0,0.929115832,51,0,759,651,708,651,rainbow dash
1822801.png,https://derpicdn.net/img/view/2018/9/2/1822801.png,0,0.994700968,128,11,770,653,642,642,rainbow dash
1822986.png,https://derpicdn.net/img/view/2018/9/2/1822986.png,0,0.918601394,313,460,769,916,456,456,rainbow dash
1826975.png,https://derpicdn.net/img/view/2018/9/7/1826975.png,0,0.986740053,179,0,867,677,688,677,rainbow dash
1827668.png,https://derpicdn.net/img/view/2018/9/8/1827668.png,0,0.957046986,392,268,810,686,418,418,rainbow dash
1830528.png,https://derpicdn.net/img/view/2018/9/11/1830528.png,0,0.929831207,66,0,1370,1285,1304,1285,rainbow dash
1835572.png,https://derpicdn.net/img/view/2018/9/18/1835572.png,0,0.998964787,0,11,2015,2111,2015,2100,rainbow dash
1840833.png,https://derpicdn.net/img/view/2018/9/25/1840833.png,0,0.981085241,60,0,722,633,662,633,rainbow dash
1849043.png,https://derpicdn.net/img/view/2018/10/5/1849043.png,0,0.978488803,9,0,443,398,434,398,rainbow dash
1851435.png,https://derpicdn.net/img/view/2018/10/8/1851435.png,0,0.936518312,272,0,2334,1877,2062,1877,rainbow dash
1854502.png,https://derpicdn.net/img/view/2018/10/12/1854502.png,0,0.9986431,252,42,540,330,288,288,rainbow dash
1858218.png,https://derpicdn.net/img/view/2018/10/16/1858218.png,0,0.975515842,375,0,719,343,344,343,rainbow dash
1864192.png,https://derpicdn.net/img/view/2018/10/23/1864192.png,0,0.997562945,96,74,740,718,644,644,rainbow dash
1864192.png,https://derpicdn.net/img/view/2018/10/23/1864192.png,1,0.996833026,566,2,1134,570,568,568,rainbow dash
1864242.png,https://derpicdn.net/img/view/2018/10/23/1864242.png,0,0.997268498,219,147,875,803,656,656,rainbow dash
1866324.png,https://derpicdn.net/img/view/2018/10/26/1866324.png,0,0.994378209,98,376,686,964,588,588,rainbow dash
1866324.png,https://derpicdn.net/img/view/2018/10/26/1866324.png,2,0.973885179,1741,303,2323,885,582,582,rainbow dash
1869158.png,https://derpicdn.net/img/view/2018/10/29/1869158.png,0,0.998572469,216,393,422,599,206,206,rainbow dash
1871427.png,https://derpicdn.net/img/view/2018/10/31/1871427.png,0,0.983631611,139,243,281,385,142,142,rainbow dash
1871427.png,https://derpicdn.net/img/view/2018/10/31/1871427.png,2,0.948458493,206,92,428,314,222,222,rainbow dash
1873385.png,https://derpicdn.net/img/view/2018/11/2/1873385.png,0,0.999450028,455,0,903,430,448,430,rainbow dash
1877427.png,https://derpicdn.net/img/view/2018/11/8/1877427.png,0,0.997714043,151,14,1739,1602,1588,1588,rainbow dash
1877970.png,https://derpicdn.net/img/view/2018/11/8/1877970.png,0,0.996691942,1,0,2987,2851,2986,2851,rainbow dash
1879460.png,https://derpicdn.net/img/view/2018/11/11/1879460.png,0,0.986636639,364,0,818,442,454,442,rainbow dash
1879825.png,https://derpicdn.net/img/view/2018/11/11/1879825.png,0,0.989583433,264,48,686,470,422,422,rainbow dash
18804.png,https://derpicdn.net/img/view/2012/6/24/18804.png,0,0.997735143,822,75,1964,1217,1142,1142,rainbow dash
1882160.png,https://derpicdn.net/img/view/2018/11/14/1882160.png,0,0.993256927,73,0,489,359,416,359,rainbow dash
1887758.png,https://derpicdn.net/img/view/2018/11/21/1887758.png,0,0.986739278,70,21,968,919,898,898,rainbow dash
1895007.png,https://derpicdn.net/img/view/2018/12/1/1895007.png,0,0.988133609,344,0,2894,2145,2550,2145,rainbow dash
1895498.png,https://derpicdn.net/img/view/2018/12/1/1895498.png,0,0.981107235,0,0,634,576,634,576,rainbow dash
1899375.png,https://derpicdn.net/img/view/2018/12/5/1899375.png,0,0.984133005,333,0,2939,2041,2606,2041,rainbow dash
1900049.png,https://derpicdn.net/img/view/2018/12/6/1900049.png,0,0.99858427,92,0,514,409,422,409,rainbow dash
1901211.png,https://derpicdn.net/img/view/2018/12/7/1901211.png,0,0.998620987,251,31,697,477,446,446,rainbow dash
1904588.png,https://derpicdn.net/img/view/2018/12/10/1904588.png,0,0.950298965,1947,72,4120,2288,2173,2216,rainbow dash
1904775.png,https://derpicdn.net/img/view/2018/12/10/1904775.png,0,0.998957157,275,0,1015,616,740,616,rainbow dash
1912151.png,https://derpicdn.net/img/view/2018/12/18/1912151.png,0,0.940651834,0,51,666,739,666,688,rainbow dash
1914464.png,https://derpicdn.net/img/view/2018/12/21/1914464.png,0,0.988032401,615,0,3197,2500,2582,2500,rainbow dash
1916456.png,https://derpicdn.net/img/view/2018/12/23/1916456.png,0,0.996691108,660,0,1882,1170,1222,1170,rainbow dash
1917290.png,https://derpicdn.net/img/view/2018/12/24/1917290.png,0,0.967733622,90,29,1024,981,934,952,rainbow dash
1920565.png,https://derpicdn.net/img/view/2018/12/28/1920565.png,0,0.993204117,0,0,1483,1407,1483,1407,rainbow dash
1924235.png,https://derpicdn.net/img/view/2019/1/1/1924235.png,0,0.996405303,840,628,1372,1160,532,532,rainbow dash
1924235.png,https://derpicdn.net/img/view/2019/1/1/1924235.png,2,0.950757325,1543,0,2325,743,782,743,rainbow dash
1924235.png,https://derpicdn.net/img/view/2019/1/1/1924235.png,3,0.9213081,1229,877,2115,1755,886,878,rainbow dash
1924235.png,https://derpicdn.net/img/view/2019/1/1/1924235.png,4,0.908388436,54,417,516,879,462,462,rainbow dash
1925396.png,https://derpicdn.net/img/view/2019/1/3/1925396.png,0,0.944557846,3342,0,5960,2009,2618,2009,rainbow dash
1925480.png,https://derpicdn.net/img/view/2019/1/3/1925480.png,0,0.973042488,0,0,679,574,679,574,rainbow dash
19281.jpg,https://derpicdn.net/img/view/2012/6/24/19281.jpg,0,0.990085542,1379,40,2287,948,908,908,rainbow dash
1928749.png,https://derpicdn.net/img/view/2019/1/7/1928749.png,0,0.976884842,30,0,1454,1248,1424,1248,rainbow dash
1933808.png,https://derpicdn.net/img/view/2019/1/13/1933808.png,0,0.990681767,78,0,888,811,810,811,rainbow dash
1934621.png,https://derpicdn.net/img/view/2019/1/13/1934621.png,0,0.999838114,746,111,1832,1197,1086,1086,rainbow dash
1937135.png,https://derpicdn.net/img/view/2019/1/16/1937135.png,0,0.972056866,543,0,1257,630,714,630,rainbow dash
1937135.png,https://derpicdn.net/img/view/2019/1/16/1937135.png,1,0.96517247,328,273,764,709,436,436,rainbow dash
1937791.png,https://derpicdn.net/img/view/2019/1/17/1937791.png,0,0.997700214,920,804,1720,1604,800,800,rainbow dash
1941242.png,https://derpicdn.net/img/view/2019/1/21/1941242.png,0,0.977774203,1113,704,2521,2112,1408,1408,rainbow dash
1942650.png,https://derpicdn.net/img/view/2019/1/23/1942650.png,0,0.928425133,0,183,4017,4721,4017,4538,rainbow dash
1942847.png,https://derpicdn.net/img/view/2019/1/23/1942847.png,0,0.970675886,456,0,1478,930,1022,930,rainbow dash
1951993.png,https://derpicdn.net/img/view/2019/2/3/1951993.png,0,0.978761375,99,89,3191,3181,3092,3092,rainbow dash
1957738.png,https://derpicdn.net/img/view/2019/2/9/1957738.png,0,0.970681548,0,20,480,610,480,590,rainbow dash
1958298.png,https://derpicdn.net/img/view/2019/2/10/1958298.png,0,0.973519027,107,0,945,828,838,828,rainbow dash
1959683.png,https://derpicdn.net/img/view/2019/2/12/1959683.png,0,0.994072437,359,18,741,400,382,382,rainbow dash
1960623.png,https://derpicdn.net/img/view/2019/2/13/1960623.png,0,0.994585097,186,0,1022,810,836,810,rainbow dash
1965781.png,https://derpicdn.net/img/view/2019/2/19/1965781.png,0,0.999184072,1382,0,2294,946,912,946,rainbow dash
1965843.png,https://derpicdn.net/img/view/2019/2/19/1965843.png,0,0.984230936,198,0,791,569,593,569,rainbow dash
19678.png,https://derpicdn.net/img/view/2012/6/25/19678.png,0,0.986962497,0,119,2400,2923,2400,2804,rainbow dash
1968400.png,https://derpicdn.net/img/view/2019/2/22/1968400.png,0,0.986770093,340,196,1924,1780,1584,1584,rainbow dash
1969755.png,https://derpicdn.net/img/view/2019/2/23/1969755.png,0,0.929000437,209,0,879,647,670,647,rainbow dash
1970935.png,https://derpicdn.net/img/view/2019/2/24/1970935.png,0,0.998960972,36,8,652,624,616,616,rainbow dash
1973474.png,https://derpicdn.net/img/view/2019/2/28/1973474.png,0,0.912368894,2208,1,3906,1773,1698,1772,rainbow dash
1973833.png,https://derpicdn.net/img/view/2019/2/28/1973833.png,0,0.997670889,247,9,812,617,565,608,rainbow dash
1973842.png,https://derpicdn.net/img/view/2019/2/28/1973842.png,0,0.989584744,0,0,318,309,318,309,rainbow dash
1973882.png,https://derpicdn.net/img/view/2019/2/28/1973882.png,0,0.995776057,900,804,1178,1082,278,278,rainbow dash
1977705.png,https://derpicdn.net/img/view/2019/3/4/1977705.png,0,0.975251675,241,9,895,663,654,654,rainbow dash
1979772.png,https://derpicdn.net/img/view/2019/3/7/1979772.png,0,0.99756062,833,618,1401,1080,568,462,rainbow dash
1979772.png,https://derpicdn.net/img/view/2019/3/7/1979772.png,2,0.982488811,858,0,1412,437,554,437,rainbow dash
1979772.png,https://derpicdn.net/img/view/2019/3/7/1979772.png,3,0.981167376,1300,737,1712,1080,412,343,rainbow dash
1980892.png,https://derpicdn.net/img/view/2019/3/9/1980892.png,0,0.954346955,10,0,915,1012,905,1012,rainbow dash
1981386.png,https://derpicdn.net/img/view/2019/3/9/1981386.png,0,0.97484225,0,0,2622,2835,2622,2835,rainbow dash
1984926.png,https://derpicdn.net/img/view/2019/3/14/1984926.png,0,0.998535514,60,0,544,463,484,463,rainbow dash
1985635.png,https://derpicdn.net/img/view/2019/3/14/1985635.png,0,0.996636987,91,0,669,567,578,567,rainbow dash
1987265.png,https://derpicdn.net/img/view/2019/3/16/1987265.png,0,0.94635886,365,26,835,500,470,474,rainbow dash
1996325.png,https://derpicdn.net/img/view/2019/3/27/1996325.png,0,0.999039829,0,0,893,909,893,909,rainbow dash
1996351.png,https://derpicdn.net/img/view/2019/3/27/1996351.png,0,0.98837918,0,76,2294,2464,2294,2388,rainbow dash
1997206.png,https://derpicdn.net/img/view/2019/3/29/1997206.png,0,0.997375071,921,0,2177,1187,1256,1187,rainbow dash
1998134.png,https://derpicdn.net/img/view/2019/3/30/1998134.png,0,0.910004735,29,0,1293,1194,1264,1194,rainbow dash
1998956.png,https://derpicdn.net/img/view/2019/3/31/1998956.png,0,0.954448581,0,0,624,672,624,672,rainbow dash
1999193.png,https://derpicdn.net/img/view/2019/3/31/1999193.png,0,0.990800619,0,0,358,377,358,377,rainbow dash
1999905.png,https://derpicdn.net/img/view/2019/4/1/1999905.png,0,0.994625866,0,0,579,644,579,644,rainbow dash
2000817.png,https://derpicdn.net/img/view/2019/4/2/2000817.png,0,0.987659633,96,0,386,277,290,277,rainbow dash
2005535.png,https://derpicdn.net/img/view/2019/4/7/2005535.png,0,0.938801169,2157,750,5473,4066,3316,3316,rainbow dash
2006154.png,https://derpicdn.net/img/view/2019/4/8/2006154.png,0,0.996892571,935,0,1499,420,564,420,rainbow dash
2007317.png,https://derpicdn.net/img/view/2019/4/9/2007317.png,0,0.966791928,0,0,342,326,342,326,rainbow dash
2009352.png,https://derpicdn.net/img/view/2019/4/11/2009352.png,0,0.998872221,1612,517,2984,1889,1372,1372,rainbow dash
2010963.png,https://derpicdn.net/img/view/2019/4/13/2010963.png,0,0.994660079,1126,0,2324,901,1198,901,rainbow dash
2015235.png,https://derpicdn.net/img/view/2019/4/17/2015235.png,0,0.95939678,35,1452,7692,9000,7657,7548,rainbow dash
2018034.png,https://derpicdn.net/img/view/2019/4/20/2018034.png,3,0.966701984,305,183,575,453,270,270,rainbow dash
2018034.png,https://derpicdn.net/img/view/2019/4/20/2018034.png,4,0.958548725,221,425,513,717,292,292,rainbow dash
2018034.png,https://derpicdn.net/img/view/2019/4/20/2018034.png,5,0.947963238,1249,67,1487,305,238,238,rainbow dash
2020453.png,https://derpicdn.net/img/view/2019/4/23/2020453.png,0,0.988173842,687,0,1777,1058,1090,1058,rainbow dash
2024151.png,https://derpicdn.net/img/view/2019/4/27/2024151.png,0,0.979606092,0,298,2354,2800,2354,2502,rainbow dash
2027781.png,https://derpicdn.net/img/view/2019/5/1/2027781.png,0,0.997286022,0,0,571,630,571,630,rainbow dash
2029439.png,https://derpicdn.net/img/view/2019/5/3/2029439.png,0,0.996956229,551,177,3605,3231,3054,3054,rainbow dash
2030588.png,https://derpicdn.net/img/view/2019/5/4/2030588.png,0,0.999413908,417,0,2459,1962,2042,1962,rainbow dash
2032585.png,https://derpicdn.net/img/view/2019/5/6/2032585.png,0,0.9756459,231,191,543,503,312,312,rainbow dash
2032678.png,https://derpicdn.net/img/view/2019/5/6/2032678.png,0,0.999337733,89,339,997,1247,908,908,rainbow dash
20337.png,https://derpicdn.net/img/view/2012/6/25/20337.png,0,0.998470604,67,189,403,525,336,336,rainbow dash
20337.png,https://derpicdn.net/img/view/2012/6/25/20337.png,1,0.988361776,467,179,787,499,320,320,rainbow dash
2039978.png,https://derpicdn.net/img/view/2019/5/15/2039978.png,0,0.987666309,2593,0,4803,2110,2210,2110,rainbow dash
2043177.png,https://derpicdn.net/img/view/2019/5/19/2043177.png,0,0.916491449,27,55,653,681,626,626,rainbow dash
2044532.png,https://derpicdn.net/img/view/2019/5/20/2044532.png,0,0.931528449,189,0,547,292,358,292,rainbow dash
2045504.png,https://derpicdn.net/img/view/2019/5/21/2045504.png,0,0.996406794,764,0,2358,1520,1594,1520,rainbow dash
2046661.png,https://derpicdn.net/img/view/2019/5/23/2046661.png,0,0.939976573,66,0,782,785,716,785,rainbow dash
2051165.png,https://derpicdn.net/img/view/2019/5/28/2051165.png,0,0.995340645,2204,293,4484,2573,2280,2280,rainbow dash
2051189.png,https://derpicdn.net/img/view/2019/5/28/2051189.png,0,0.980429888,2049,0,4435,2320,2386,2320,rainbow dash
2053076.png,https://derpicdn.net/img/view/2019/5/30/2053076.png,0,0.998745799,1285,0,2316,1032,1031,1032,rainbow dash
2056420.png,https://derpicdn.net/img/view/2019/6/2/2056420.png,0,0.978347838,176,0,608,405,432,405,rainbow dash
2060443.png,https://derpicdn.net/img/view/2019/6/8/2060443.png,0,0.999541342,99,0,1163,952,1064,952,rainbow dash
2063276.png,https://derpicdn.net/img/view/2019/6/11/2063276.png,0,0.99079144,214,87,670,543,456,456,rainbow dash
2064073.png,https://derpicdn.net/img/view/2019/6/13/2064073.png,0,0.981717527,175,0,1151,720,976,720,rainbow dash
2082713.png,https://derpicdn.net/img/view/2019/7/4/2082713.png,0,0.996643424,456,0,2018,1537,1562,1537,rainbow dash
2085549.png,https://derpicdn.net/img/view/2019/7/7/2085549.png,0,0.985441566,2736,0,7000,4338,4264,4338,rainbow dash
2086891.png,https://derpicdn.net/img/view/2019/7/9/2086891.png,0,0.981228173,159,0,4067,3013,3908,3013,rainbow dash
2087308.png,https://derpicdn.net/img/view/2019/7/9/2087308.png,0,0.992763162,510,0,1024,482,514,482,rainbow dash
2087308.png,https://derpicdn.net/img/view/2019/7/9/2087308.png,1,0.944229484,0,0,549,481,549,481,rainbow dash
2104382.png,https://derpicdn.net/img/view/2019/7/29/2104382.png,0,0.988483191,808,0,3000,2112,2192,2112,rainbow dash
2105185.png,https://derpicdn.net/img/view/2019/7/30/2105185.png,0,0.987419188,735,478,1145,888,410,410,rainbow dash
2106079.png,https://derpicdn.net/img/view/2019/8/1/2106079.png,0,0.979938865,164,292,1800,1800,1636,1508,rainbow dash
2112526.png,https://derpicdn.net/img/view/2019/8/8/2112526.png,0,0.960044086,281,28,629,376,348,348,rainbow dash
2120204.png,https://derpicdn.net/img/view/2019/8/17/2120204.png,0,0.980537832,260,344,1108,1192,848,848,rainbow dash
2125031.png,https://derpicdn.net/img/view/2019/8/23/2125031.png,0,0.990657568,311,3,784,499,473,496,rainbow dash
2126332.png,https://derpicdn.net/img/view/2019/8/24/2126332.png,0,0.934618294,321,0,2015,1453,1694,1453,rainbow dash
2128321.png,https://derpicdn.net/img/view/2019/8/26/2128321.png,0,0.990771592,65,7,737,679,672,672,rainbow dash
2130042.png,https://derpicdn.net/img/view/2019/8/28/2130042.png,0,0.975791454,103,0,659,549,556,549,rainbow dash
2139362.png,https://derpicdn.net/img/view/2019/9/8/2139362.png,0,0.998066902,2604,541,3918,1855,1314,1314,rainbow dash
2140461.png,https://derpicdn.net/img/view/2019/9/10/2140461.png,1,0.990138948,5,849,259,1103,254,254,rainbow dash
2142153.png,https://derpicdn.net/img/view/2019/9/12/2142153.png,0,0.998192966,0,0,953,966,953,966,rainbow dash
2149473.png,https://derpicdn.net/img/view/2019/9/21/2149473.png,0,0.995960176,1625,532,3031,2090,1406,1558,rainbow dash
2153414.png,https://derpicdn.net/img/view/2019/9/26/2153414.png,0,0.998596728,55,0,483,398,428,398,rainbow dash
2154341.png,https://derpicdn.net/img/view/2019/9/27/2154341.png,0,0.937030852,818,1584,8805,9362,7987,7778,rainbow dash
2154566.png,https://derpicdn.net/img/view/2019/9/28/2154566.png,0,0.998818815,153,0,543,390,390,390,rainbow dash
2155212.png,https://derpicdn.net/img/view/2019/9/28/2155212.png,0,0.999798715,1662,184,3036,1558,1374,1374,rainbow dash
2156250.png,https://derpicdn.net/img/view/2019/9/29/2156250.png,0,0.999614954,344,15,644,315,300,300,rainbow dash
2158561.png,https://derpicdn.net/img/view/2019/10/2/2158561.png,0,0.999739826,42,0,478,414,436,414,rainbow dash
2159595.png,https://derpicdn.net/img/view/2019/10/4/2159595.png,0,0.916488886,561,413,1311,1163,750,750,rainbow dash
2163486.png,https://derpicdn.net/img/view/2019/10/8/2163486.png,0,0.964177489,0,0,1754,1571,1754,1571,rainbow dash
2173808.png,https://derpicdn.net/img/view/2019/10/19/2173808.png,0,0.970649958,0,0,700,818,700,818,rainbow dash
2176142.png,https://derpicdn.net/img/view/2019/10/22/2176142.png,0,0.997774959,69,23,467,421,398,398,rainbow dash
2176278.png,https://derpicdn.net/img/view/2019/10/22/2176278.png,0,0.996563375,1084,0,2000,905,916,905,rainbow dash
2179421.png,https://derpicdn.net/img/view/2019/10/26/2179421.png,0,0.988777041,120,0,406,279,286,279,rainbow dash
2180961.png,https://derpicdn.net/img/view/2019/10/28/2180961.png,0,0.948888361,98,87,1028,1017,930,930,rainbow dash
2183483.png,https://derpicdn.net/img/view/2019/10/31/2183483.png,0,0.999008775,1405,309,2161,1065,756,756,rainbow dash
2183483.png,https://derpicdn.net/img/view/2019/10/31/2183483.png,2,0.976123631,1931,416,2553,1038,622,622,rainbow dash
2185779.png,https://derpicdn.net/img/view/2019/11/2/2185779.png,0,0.977617085,1870,0,3382,1196,1512,1196,rainbow dash
2189865.png,https://derpicdn.net/img/view/2019/11/7/2189865.png,0,0.906145096,294,202,874,782,580,580,rainbow dash
2197526.png,https://derpicdn.net/img/view/2019/11/16/2197526.png,0,0.976824343,19,0,811,776,792,776,rainbow dash
2198083.png,https://derpicdn.net/img/view/2019/11/17/2198083.png,0,0.996578217,282,81,1126,925,844,844,rainbow dash
2198099.png,https://derpicdn.net/img/view/2019/11/17/2198099.png,0,0.995854378,575,0,1113,497,538,497,rainbow dash
2208987.png,https://derpicdn.net/img/view/2019/11/30/2208987.png,0,0.999821067,113,0,535,418,422,418,rainbow dash
2211919.png,https://derpicdn.net/img/view/2019/12/4/2211919.png,0,0.999390781,17,0,657,592,640,592,rainbow dash
2215084.png,https://derpicdn.net/img/view/2019/12/7/2215084.png,0,0.988756597,114,0,942,807,828,807,rainbow dash
2221838.png,https://derpicdn.net/img/view/2019/12/16/2221838.png,0,0.953652382,0,6,608,642,608,636,rainbow dash
2222773.png,https://derpicdn.net/img/view/2019/12/17/2222773.png,0,0.993704438,169,502,2281,2614,2112,2112,rainbow dash
2228375.png,https://derpicdn.net/img/view/2019/12/24/2228375.png,0,0.987872422,667,16,1107,456,440,440,rainbow dash
2230814.png,https://derpicdn.net/img/view/2019/12/26/2230814.png,0,0.956495464,0,0,655,641,655,641,rainbow dash
2232554.png,https://derpicdn.net/img/view/2019/12/29/2232554.png,0,0.980343342,0,0,707,830,707,830,rainbow dash
2232731.png,https://derpicdn.net/img/view/2019/12/29/2232731.png,0,0.950012147,248,0,1550,1259,1302,1259,rainbow dash
2233444.jpg,https://derpicdn.net/img/view/2019/12/29/2233444.jpg,0,0.932232559,0,0,885,860,885,860,rainbow dash
2237209.jpg,https://derpicdn.net/img/view/2020/1/3/2237209.jpg,0,0.971294641,435,0,855,346,420,346,rainbow dash
2240659.jpg,https://derpicdn.net/img/view/2020/1/7/2240659.jpg,0,0.998452544,16,0,1034,906,1018,906,rainbow dash
2242659.png,https://derpicdn.net/img/view/2020/1/9/2242659.png,0,0.981733084,207,108,801,702,594,594,rainbow dash
2248477.png,https://derpicdn.net/img/view/2020/1/15/2248477.png,0,0.982932985,0,0,430,413,430,413,rainbow dash
2252424.png,https://derpicdn.net/img/view/2020/1/20/2252424.png,0,0.999231756,710,0,1128,360,418,360,rainbow dash
2252424.png,https://derpicdn.net/img/view/2020/1/20/2252424.png,1,0.998654008,52,1670,596,2214,544,544,rainbow dash
2252424.png,https://derpicdn.net/img/view/2020/1/20/2252424.png,2,0.973728359,787,1811,1217,2241,430,430,rainbow dash
2252424.png,https://derpicdn.net/img/view/2020/1/20/2252424.png,3,0.920632124,353,0,621,246,268,246,rainbow dash
2256807.jpg,https://derpicdn.net/img/view/2020/1/25/2256807.jpg,0,0.995964587,0,0,339,355,339,355,rainbow dash
2257666.jpg,https://derpicdn.net/img/view/2020/1/26/2257666.jpg,0,0.999032557,458,58,964,564,506,506,rainbow dash
2258467.jpg,https://derpicdn.net/img/view/2020/1/27/2258467.jpg,1,0.997572958,888,0,1530,613,642,613,rainbow dash
2258467.jpg,https://derpicdn.net/img/view/2020/1/27/2258467.jpg,2,0.981864572,43,0,753,667,710,667,rainbow dash
2258467.jpg,https://derpicdn.net/img/view/2020/1/27/2258467.jpg,4,0.965242505,163,1545,739,2121,576,576,rainbow dash
2258515.png,https://derpicdn.net/img/view/2020/1/27/2258515.png,0,0.999710262,286,0,1664,1361,1378,1361,rainbow dash
2259940.png,https://derpicdn.net/img/view/2020/1/29/2259940.png,0,0.989899576,179,0,933,745,754,745,rainbow dash
2259942.png,https://derpicdn.net/img/view/2020/1/29/2259942.png,0,0.991897106,184,0,952,755,768,755,rainbow dash
2260643.png,https://derpicdn.net/img/view/2020/1/29/2260643.png,0,0.920553446,0,143,736,899,736,756,rainbow dash
2260644.png,https://derpicdn.net/img/view/2020/1/29/2260644.png,0,0.987356007,0,99,605,723,605,624,rainbow dash
2262673.png,https://derpicdn.net/img/view/2020/2/1/2262673.png,0,0.952702582,1138,0,2144,974,1006,974,rainbow dash
2263053.jpg,https://derpicdn.net/img/view/2020/2/1/2263053.jpg,0,0.981765628,68,0,402,330,334,330,rainbow dash
2263681.png,https://derpicdn.net/img/view/2020/2/2/2263681.png,0,0.998916566,144,28,666,550,522,522,rainbow dash
2264250.png,https://derpicdn.net/img/view/2020/2/2/2264250.png,0,0.986753941,527,514,877,864,350,350,rainbow dash
2264250.png,https://derpicdn.net/img/view/2020/2/2/2264250.png,1,0.982240617,6,140,290,424,284,284,rainbow dash
2265516.png,https://derpicdn.net/img/view/2020/2/4/2265516.png,0,0.925391495,436,1084,1812,2460,1376,1376,rainbow dash
2265955.jpg,https://derpicdn.net/img/view/2020/2/4/2265955.jpg,0,0.967732728,0,0,1172,1284,1172,1284,rainbow dash
2269150.png,https://derpicdn.net/img/view/2020/2/9/2269150.png,0,0.989766538,40,0,1208,720,1168,720,rainbow dash
2272650.jpg,https://derpicdn.net/img/view/2020/2/13/2272650.jpg,0,0.996976674,395,0,901,504,506,504,rainbow dash
2273768.png,https://derpicdn.net/img/view/2020/2/14/2273768.png,0,0.963661849,161,0,1001,854,840,854,rainbow dash
2273768.png,https://derpicdn.net/img/view/2020/2/14/2273768.png,1,0.933272123,0,12,872,1022,872,1010,rainbow dash
2275106.jpg,https://derpicdn.net/img/view/2020/2/15/2275106.jpg,0,0.914556324,0,0,1920,2266,1920,2266,rainbow dash
2277488.png,https://derpicdn.net/img/view/2020/2/18/2277488.png,0,0.995657384,669,444,2175,1950,1506,1506,rainbow dash
2277569.jpg,https://derpicdn.net/img/view/2020/2/18/2277569.jpg,0,0.998485148,126,0,626,486,500,486,rainbow dash
2280844.png,https://derpicdn.net/img/view/2020/2/22/2280844.png,0,0.979992509,0,0,809,801,809,801,rainbow dash
2281128.jpg,https://derpicdn.net/img/view/2020/2/22/2281128.jpg,0,0.995799422,1667,60,3797,2190,2130,2130,rainbow dash
2287365.jpg,https://derpicdn.net/img/view/2020/3/1/2287365.jpg,0,0.996433616,497,848,1325,1676,828,828,rainbow dash
2289441.jpg,https://derpicdn.net/img/view/2020/3/4/2289441.jpg,0,0.993779004,138,11,1080,953,942,942,rainbow dash
2291372.jpg,https://derpicdn.net/img/view/2020/3/6/2291372.jpg,0,0.988136888,104,0,716,555,612,555,rainbow dash
2292110.jpg,https://derpicdn.net/img/view/2020/3/7/2292110.jpg,0,0.998622358,180,7,550,377,370,370,rainbow dash
2295924.jpg,https://derpicdn.net/img/view/2020/3/12/2295924.jpg,0,0.99500674,89,192,433,536,344,344,rainbow dash
2295956.png,https://derpicdn.net/img/view/2020/3/12/2295956.png,0,0.938139856,1306,72,1660,426,354,354,rainbow dash
2296407.png,https://derpicdn.net/img/view/2020/3/13/2296407.png,0,0.907045662,184,150,434,400,250,250,rainbow dash
2297522.png,https://derpicdn.net/img/view/2020/3/14/2297522.png,0,0.997569561,237,75,1503,1341,1266,1266,rainbow dash
2297992.jpg,https://derpicdn.net/img/view/2020/3/15/2297992.jpg,0,0.988941789,45,0,773,719,728,719,rainbow dash
2299666.jpg,https://derpicdn.net/img/view/2020/3/17/2299666.jpg,0,0.996653259,64,0,870,763,806,763,rainbow dash
2301041.png,https://derpicdn.net/img/view/2020/3/19/2301041.png,0,0.998105466,8,43,384,419,376,376,rainbow dash
2307860.jpg,https://derpicdn.net/img/view/2020/3/28/2307860.jpg,0,0.998620152,712,67,2192,1547,1480,1480,rainbow dash
2308089.jpg,https://derpicdn.net/img/view/2020/3/28/2308089.jpg,0,0.974358559,45,0,611,520,566,520,rainbow dash
2316174.png,https://derpicdn.net/img/view/2020/4/7/2316174.png,0,0.940478623,710,15,1414,719,704,704,rainbow dash
2321699.png,https://derpicdn.net/img/view/2020/4/13/2321699.png,0,0.992496729,92,0,1634,1447,1542,1447,rainbow dash
2323621.png,https://derpicdn.net/img/view/2020/4/16/2323621.png,0,0.998146832,0,0,1278,1249,1278,1249,rainbow dash
2323631.png,https://derpicdn.net/img/view/2020/4/16/2323631.png,0,0.922420859,0,0,393,387,393,387,rainbow dash
2324799.png,https://derpicdn.net/img/view/2020/4/17/2324799.png,0,0.998315394,254,0,620,323,366,323,rainbow dash
2327366.png,https://derpicdn.net/img/view/2020/4/20/2327366.png,0,0.986467123,1221,0,2429,1138,1208,1138,rainbow dash
2329307.png,https://derpicdn.net/img/view/2020/4/23/2329307.png,0,0.97928983,0,0,618,713,618,713,rainbow dash
2329836.jpg,https://derpicdn.net/img/view/2020/4/23/2329836.jpg,1,0.982037723,880,506,1118,744,238,238,rainbow dash
2331552.png,https://derpicdn.net/img/view/2020/4/25/2331552.png,0,0.960051656,158,50,2236,2128,2078,2078,rainbow dash
2331824.jpg,https://derpicdn.net/img/view/2020/4/26/2331824.jpg,0,0.994469821,0,0,1285,1388,1285,1388,rainbow dash
2336949.jpg,https://derpicdn.net/img/view/2020/5/2/2336949.jpg,0,0.986178994,7,0,657,582,650,582,rainbow dash
2338492.png,https://derpicdn.net/img/view/2020/5/3/2338492.png,0,0.99209857,754,86,2446,1778,1692,1692,rainbow dash
2339645.png,https://derpicdn.net/img/view/2020/5/5/2339645.png,0,0.988879859,867,466,2061,1660,1194,1194,rainbow dash
2340145.png,https://derpicdn.net/img/view/2020/5/5/2340145.png,0,0.996895134,0,635,392,1093,392,458,rainbow dash
2340193.jpg,https://derpicdn.net/img/view/2020/5/5/2340193.jpg,0,0.99325037,87,17,823,753,736,736,rainbow dash
2340302.png,https://derpicdn.net/img/view/2020/5/5/2340302.png,0,0.996801257,0,0,604,587,604,587,rainbow dash
2340619.jpg,https://derpicdn.net/img/view/2020/5/6/2340619.jpg,0,0.982904732,922,78,1748,904,826,826,rainbow dash
2345042.png,https://derpicdn.net/img/view/2020/5/10/2345042.png,0,0.97932905,213,0,824,593,611,593,rainbow dash
2345055.png,https://derpicdn.net/img/view/2020/5/10/2345055.png,0,0.996866167,0,0,675,657,675,657,rainbow dash
2346016.jpg,https://derpicdn.net/img/view/2020/5/11/2346016.jpg,0,0.993293405,23,0,623,581,600,581,rainbow dash
2347718.png,https://derpicdn.net/img/view/2020/5/13/2347718.png,0,0.96326226,124,0,622,423,498,423,rainbow dash
2350337.png,https://derpicdn.net/img/view/2020/5/16/2350337.png,0,0.972927809,0,0,513,627,513,627,rainbow dash
2350337.png,https://derpicdn.net/img/view/2020/5/16/2350337.png,1,0.945825398,0,93,513,753,513,660,rainbow dash
2351035.jpg,https://derpicdn.net/img/view/2020/5/17/2351035.jpg,0,0.992478848,142,731,442,1031,300,300,rainbow dash
238975.png,https://derpicdn.net/img/view/2013/2/10/238975.png,0,0.994609892,202,0,800,591,598,591,rainbow dash
23978.jpg,https://derpicdn.net/img/view/2012/6/28/23978.jpg,0,0.948067904,53,270,463,680,410,410,rainbow dash
244379.jpg,https://derpicdn.net/img/view/2013/2/15/244379.jpg,0,0.974505007,90,0,448,349,358,349,rainbow dash
253233.png,https://derpicdn.net/img/view/2013/2/23/253233.png,0,0.949493051,0,0,194,173,194,173,rainbow dash
253233.png,https://derpicdn.net/img/view/2013/2/23/253233.png,1,0.921868324,1,0,250,235,249,235,rainbow dash
25404.jpg,https://derpicdn.net/img/view/2012/6/29/25404.jpg,0,0.951305985,236,98,706,568,470,470,rainbow dash
258909.jpg,https://derpicdn.net/img/view/2013/3/1/258909.jpg,0,0.99949348,143,178,637,672,494,494,rainbow dash
265672.png,https://derpicdn.net/img/view/2013/3/8/265672.png,0,0.957527041,403,28,927,552,524,524,rainbow dash
267940.jpg,https://derpicdn.net/img/view/2013/3/11/267940.jpg,0,0.998958409,330,0,694,341,364,341,rainbow dash
268712.jpg,https://derpicdn.net/img/view/2013/3/12/268712.jpg,0,0.996717513,639,0,1116,478,477,478,rainbow dash
281321.png,https://derpicdn.net/img/view/2013/3/28/281321.png,0,0.929877102,157,0,640,360,483,360,rainbow dash
286575.png,https://derpicdn.net/img/view/2013/4/3/286575.png,0,0.991569161,1390,0,3670,1838,2280,1838,rainbow dash
290721.png,https://derpicdn.net/img/view/2013/4/7/290721.png,0,0.907790124,0,47,412,461,412,414,rainbow dash
290805.png,https://derpicdn.net/img/view/2013/4/7/290805.png,0,0.999584496,103,0,341,226,238,226,rainbow dash
292107.png,https://derpicdn.net/img/view/2013/4/8/292107.png,0,0.969899476,1733,1993,3127,3387,1394,1394,rainbow dash
292714.png,https://derpicdn.net/img/view/2013/4/9/292714.png,0,0.969189465,322,431,3616,3725,3294,3294,rainbow dash
295067.png,https://derpicdn.net/img/view/2013/4/11/295067.png,0,0.962207437,709,2285,2695,4271,1986,1986,rainbow dash
299293.png,https://derpicdn.net/img/view/2013/4/15/299293.png,0,0.943853021,153,0,977,755,824,755,rainbow dash
300284.png,https://derpicdn.net/img/view/2013/4/16/300284.png,0,0.944119871,4652,1102,7822,4272,3170,3170,rainbow dash
303433.jpg,https://derpicdn.net/img/view/2013/4/20/303433.jpg,0,0.997463763,0,0,2039,1981,2039,1981,rainbow dash
311150.png,https://derpicdn.net/img/view/2013/4/29/311150.png,0,0.993383706,739,176,1179,616,440,440,rainbow dash
311170.png,https://derpicdn.net/img/view/2013/4/29/311170.png,0,0.943817139,0,0,1343,1238,1343,1238,rainbow dash
314173.png,https://derpicdn.net/img/view/2013/5/2/314173.png,0,0.987659216,239,83,775,619,536,536,rainbow dash
31868.jpg,https://derpicdn.net/img/view/2012/7/4/31868.jpg,0,0.984676242,1206,208,2036,1038,830,830,rainbow dash
333845.jpg,https://derpicdn.net/img/view/2013/5/26/333845.jpg,0,0.987267196,0,85,768,861,768,776,rainbow dash
334799.png,https://derpicdn.net/img/view/2013/5/27/334799.png,0,0.980020523,2315,0,4421,2057,2106,2057,rainbow dash
368221.png,https://derpicdn.net/img/view/2013/7/9/368221.png,0,0.979860306,141,0,1099,683,958,683,rainbow dash
374101.png,https://derpicdn.net/img/view/2013/7/14/374101.png,0,0.933690786,0,0,824,1089,824,1089,rainbow dash
376049.png,https://derpicdn.net/img/view/2013/7/16/376049.png,0,0.991832972,2797,11,5471,2685,2674,2674,rainbow dash
3788.png,https://derpicdn.net/img/view/2012/3/21/3788.png,0,0.981616795,277,26,977,726,700,700,rainbow dash
382118.png,https://derpicdn.net/img/view/2013/7/23/382118.png,1,0.963999093,106,444,674,1012,568,568,rainbow dash
382118.png,https://derpicdn.net/img/view/2013/7/23/382118.png,2,0.912605584,465,0,695,227,230,227,rainbow dash
384075.png,https://derpicdn.net/img/view/2013/7/29/384075.png,0,0.934561253,350,0,2104,1654,1754,1654,rainbow dash
401575.png,https://derpicdn.net/img/view/2013/8/16/401575.png,0,0.968997478,112,0,486,332,374,332,rainbow dash
404768.png,https://derpicdn.net/img/view/2013/8/19/404768.png,0,0.975003183,60,0,292,192,232,192,rainbow dash
412534.png,https://derpicdn.net/img/view/2013/8/27/412534.png,0,0.99396646,4,0,822,734,818,734,rainbow dash
413908.png,https://derpicdn.net/img/view/2013/8/29/413908.png,0,0.952302277,228,0,1278,1028,1050,1028,rainbow dash
414652.png,https://derpicdn.net/img/view/2013/8/30/414652.png,0,0.979087293,185,37,397,249,212,212,rainbow dash
420822.png,https://derpicdn.net/img/view/2013/9/6/420822.png,0,0.999305844,1071,0,1903,641,832,641,rainbow dash
4312.png,https://derpicdn.net/img/view/2012/6/5/4312.png,0,0.950701237,0,0,1021,872,1021,872,rainbow dash
4347.jpg,https://derpicdn.net/img/view/2012/6/6/4347.jpg,0,0.948597193,1296,276,2128,1108,832,832,rainbow dash
435253.png,https://derpicdn.net/img/view/2013/9/26/435253.png,0,0.99651289,432,140,874,582,442,442,rainbow dash
437370.jpg,https://derpicdn.net/img/view/2013/9/29/437370.jpg,0,0.925615788,244,9,534,299,290,290,rainbow dash
445239.jpg,https://derpicdn.net/img/view/2013/10/9/445239.jpg,0,0.996542454,488,0,1062,572,574,572,rainbow dash
450248.jpg,https://derpicdn.net/img/view/2013/10/16/450248.jpg,0,0.986578465,54,0,234,177,180,177,rainbow dash
450248.jpg,https://derpicdn.net/img/view/2013/10/16/450248.jpg,1,0.944190741,290,0,510,196,220,196,rainbow dash
452746.png,https://derpicdn.net/img/view/2013/10/20/452746.png,0,0.99906075,0,0,491,509,491,509,rainbow dash
454165.png,https://derpicdn.net/img/view/2013/10/22/454165.png,0,0.990884006,12,0,328,314,316,314,rainbow dash
461485.png,https://derpicdn.net/img/view/2013/10/31/461485.png,0,0.992523313,215,0,1929,1574,1714,1574,rainbow dash
462085.png,https://derpicdn.net/img/view/2013/11/1/462085.png,0,0.999473453,376,0,2036,1525,1660,1525,rainbow dash
46248.png,https://derpicdn.net/img/view/2012/7/16/46248.png,0,0.939012408,349,0,1017,588,668,588,rainbow dash
463039.png,https://derpicdn.net/img/view/2013/11/2/463039.png,0,0.957084179,765,182,1199,616,434,434,rainbow dash
470744.png,https://derpicdn.net/img/view/2013/11/12/470744.png,0,0.988046527,705,2123,1249,2667,544,544,rainbow dash
480325.png,https://derpicdn.net/img/view/2013/11/24/480325.png,0,0.943398237,75,0,645,545,570,545,rainbow dash
48535.jpg,https://derpicdn.net/img/view/2012/7/19/48535.jpg,0,0.999158978,348,350,726,728,378,378,rainbow dash
491957.png,https://derpicdn.net/img/view/2013/12/7/491957.png,0,0.973578811,10,23,476,489,466,466,rainbow dash
493299.png,https://derpicdn.net/img/view/2013/12/8/493299.png,0,0.993620872,311,0,819,503,508,503,rainbow dash
493360.png,https://derpicdn.net/img/view/2013/12/8/493360.png,0,0.998058558,73,21,375,323,302,302,rainbow dash
496761.png,https://derpicdn.net/img/view/2013/12/14/496761.png,0,0.978419006,659,125,1167,633,508,508,rainbow dash
497476.png,https://derpicdn.net/img/view/2013/12/15/497476.png,0,0.999219179,69,0,2513,2349,2444,2349,rainbow dash
4980.png,https://derpicdn.net/img/view/2012/6/17/4980.png,0,0.983281612,260,11,630,381,370,370,rainbow dash
4980.png,https://derpicdn.net/img/view/2012/6/17/4980.png,1,0.974030256,229,574,717,1062,488,488,rainbow dash
500948.jpg,https://derpicdn.net/img/view/2013/12/19/500948.jpg,1,0.989988923,508,25,856,373,348,348,rainbow dash
501525.png,https://derpicdn.net/img/view/2013/12/20/501525.png,0,0.990419865,281,0,817,533,536,533,rainbow dash
515499.png,https://derpicdn.net/img/view/2014/1/5/515499.png,0,0.94458586,439,1773,5200,6000,4761,4227,rainbow dash
515517.png,https://derpicdn.net/img/view/2014/1/5/515517.png,0,0.994444668,210,33,554,377,344,344,rainbow dash
518185.png,https://derpicdn.net/img/view/2014/1/7/518185.png,0,0.990530312,22,126,338,442,316,316,rainbow dash
524863.png,https://derpicdn.net/img/view/2014/1/15/524863.png,0,0.974221706,435,36,827,428,392,392,rainbow dash
533438.png,https://derpicdn.net/img/view/2014/1/25/533438.png,0,0.95129323,3176,883,5622,3329,2446,2446,rainbow dash
534345.png,https://derpicdn.net/img/view/2014/1/25/534345.png,0,0.999033749,545,44,813,312,268,268,rainbow dash
534648.png,https://derpicdn.net/img/view/2014/1/26/534648.png,0,0.998287797,29,2271,1881,4123,1852,1852,rainbow dash
535633.png,https://derpicdn.net/img/view/2014/1/27/535633.png,0,0.980539382,0,0,342,377,342,377,rainbow dash
552210.png,https://derpicdn.net/img/view/2014/2/15/552210.png,0,0.968804836,0,202,750,1004,750,802,rainbow dash
572317.png,https://derpicdn.net/img/view/2014/3/11/572317.png,0,0.997733593,462,0,1270,790,808,790,rainbow dash
573714.png,https://derpicdn.net/img/view/2014/3/13/573714.png,0,0.998027146,627,162,993,528,366,366,rainbow dash
574093.png,https://derpicdn.net/img/view/2014/3/13/574093.png,0,0.999102652,106,0,3980,3731,3874,3731,rainbow dash
580261.png,https://derpicdn.net/img/view/2014/3/20/580261.png,0,0.986603916,331,0,849,510,518,510,rainbow dash
594425.png,https://derpicdn.net/img/view/2014/4/6/594425.png,0,0.972918749,125,29,1599,1503,1474,1474,rainbow dash
59694.png,https://derpicdn.net/img/view/2012/7/28/59694.png,0,0.999485493,235,10,489,264,254,254,rainbow dash
597993.png,https://derpicdn.net/img/view/2014/4/11/597993.png,0,0.972313046,505,0,833,320,328,320,rainbow dash
605102.png,https://derpicdn.net/img/view/2014/4/19/605102.png,0,0.997296572,204,42,596,434,392,392,rainbow dash
609768.png,https://derpicdn.net/img/view/2014/4/25/609768.png,0,0.996604145,3,0,297,292,294,292,rainbow dash
616782.png,https://derpicdn.net/img/view/2014/5/3/616782.png,0,0.930242181,0,0,480,510,480,510,rainbow dash
618600.png,https://derpicdn.net/img/view/2014/5/5/618600.png,0,0.985266626,316,16,662,362,346,346,rainbow dash
61921.png,https://derpicdn.net/img/view/2012/7/30/61921.png,0,0.995953321,344,0,794,430,450,430,rainbow dash
6267.png,https://derpicdn.net/img/view/2012/6/18/6267.png,0,0.979602695,146,67,1242,1163,1096,1096,rainbow dash
627519.png,https://derpicdn.net/img/view/2014/5/15/627519.png,0,0.984172046,132,34,412,314,280,280,rainbow dash
636827.jpg,https://derpicdn.net/img/view/2014/5/26/636827.jpg,0,0.940362334,24,68,336,380,312,312,rainbow dash
6406.jpg,https://derpicdn.net/img/view/2012/6/18/6406.jpg,0,0.900645316,180,0,526,309,346,309,rainbow dash
641346.jpg,https://derpicdn.net/img/view/2014/5/31/641346.jpg,0,0.997795343,529,270,1417,1158,888,888,rainbow dash
646758.png,https://derpicdn.net/img/view/2014/6/6/646758.png,0,0.92755729,399,0,1187,762,788,762,rainbow dash
660386.png,https://derpicdn.net/img/view/2014/6/24/660386.png,0,0.978345931,409,153,749,493,340,340,rainbow dash
664107.png,https://derpicdn.net/img/view/2014/6/29/664107.png,0,0.99685514,224,9,598,383,374,374,rainbow dash
666590.png,https://derpicdn.net/img/view/2014/7/3/666590.png,0,0.988465428,92,6,396,310,304,304,rainbow dash
66942.png,https://derpicdn.net/img/view/2012/8/4/66942.png,0,0.948362827,94,0,860,764,766,764,rainbow dash
674245.png,https://derpicdn.net/img/view/2014/7/13/674245.png,0,0.995327234,101,107,547,553,446,446,rainbow dash
674693.png,https://derpicdn.net/img/view/2014/7/14/674693.png,0,0.984516323,797,0,2155,1352,1358,1352,rainbow dash
680929.png,https://derpicdn.net/img/view/2014/7/22/680929.png,0,0.994279921,196,31,618,453,422,422,rainbow dash
694882.png,https://derpicdn.net/img/view/2014/8/8/694882.png,0,0.964640617,97,0,483,320,386,320,rainbow dash
705939.png,https://derpicdn.net/img/view/2014/8/23/705939.png,0,0.971329689,0,232,5057,6658,5057,6426,rainbow dash
706326.jpg,https://derpicdn.net/img/view/2014/8/23/706326.jpg,0,0.995011091,152,85,386,319,234,234,rainbow dash
715083.png,https://derpicdn.net/img/view/2014/9/4/715083.png,0,0.997842193,551,51,1081,581,530,530,rainbow dash
719324.jpg,https://derpicdn.net/img/view/2014/9/10/719324.jpg,0,0.993726671,980,751,1450,1221,470,470,rainbow dash
719536.png,https://derpicdn.net/img/view/2014/9/10/719536.png,0,0.994259477,711,0,1229,413,518,413,rainbow dash
730181.png,https://derpicdn.net/img/view/2014/9/27/730181.png,0,0.997107327,42,0,382,340,340,340,rainbow dash
734723.png,https://derpicdn.net/img/view/2014/10/3/734723.png,0,0.998801708,3,0,669,642,666,642,rainbow dash
738541.jpg,https://derpicdn.net/img/view/2014/10/8/738541.jpg,0,0.975686133,0,0,359,308,359,308,rainbow dash
738795.jpg,https://derpicdn.net/img/view/2014/10/8/738795.jpg,0,0.985988319,105,84,325,304,220,220,rainbow dash
749619.png,https://derpicdn.net/img/view/2014/10/24/749619.png,0,0.963127911,0,2,698,744,698,742,rainbow dash
752565.jpg,https://derpicdn.net/img/view/2014/10/28/752565.jpg,0,0.965687275,70,0,348,274,278,274,rainbow dash
757992.jpg,https://derpicdn.net/img/view/2014/11/4/757992.jpg,0,0.900205135,1847,0,4096,2255,2249,2255,rainbow dash
781236.png,https://derpicdn.net/img/view/2014/12/9/781236.png,0,0.99212569,0,0,394,404,394,404,rainbow dash
800134.png,https://derpicdn.net/img/view/2015/1/5/800134.png,0,0.924514353,1673,177,2753,1257,1080,1080,rainbow dash
807033.jpg,https://derpicdn.net/img/view/2015/1/15/807033.jpg,0,0.990297854,273,29,561,317,288,288,rainbow dash
807777.png,https://derpicdn.net/img/view/2015/1/16/807777.png,0,0.997543633,406,0,2716,2295,2310,2295,rainbow dash
810244.png,https://derpicdn.net/img/view/2015/1/19/810244.png,0,0.998308361,286,4,740,458,454,454,rainbow dash
811426.png,https://derpicdn.net/img/view/2015/1/21/811426.png,0,0.994841576,802,4803,3114,7115,2312,2312,rainbow dash
814146.png,https://derpicdn.net/img/view/2015/1/25/814146.png,0,0.994852483,99,0,803,653,704,653,rainbow dash
828476.jpg,https://derpicdn.net/img/view/2015/2/14/828476.jpg,0,0.953771532,29,0,377,285,348,285,rainbow dash
831355.png,https://derpicdn.net/img/view/2015/2/17/831355.png,0,0.99415493,115,0,527,388,412,388,rainbow dash
831688.png,https://derpicdn.net/img/view/2015/2/18/831688.png,0,0.989931405,547,365,1111,929,564,564,rainbow dash
840770.jpg,https://derpicdn.net/img/view/2015/3/2/840770.jpg,0,0.993500173,258,0,688,422,430,422,rainbow dash
851730.png,https://derpicdn.net/img/view/2015/3/17/851730.png,0,0.983041346,173,52,1627,1640,1454,1588,rainbow dash
854087.png,https://derpicdn.net/img/view/2015/3/21/854087.png,0,0.962403059,11,0,227,218,216,218,rainbow dash
857322.png,https://derpicdn.net/img/view/2015/3/26/857322.png,0,0.985276282,682,87,1606,1011,924,924,rainbow dash
85914.jpg,https://derpicdn.net/img/view/2012/8/29/85914.jpg,0,0.98072356,0,10,800,852,800,842,rainbow dash
868537.png,https://derpicdn.net/img/view/2015/4/8/868537.png,0,0.983030438,42,48,328,334,286,286,rainbow dash
873281.png,https://derpicdn.net/img/view/2015/4/13/873281.png,0,0.981879234,315,1345,1209,2239,894,894,rainbow dash
882317.png,https://derpicdn.net/img/view/2015/4/25/882317.png,0,0.941104591,656,32,1200,576,544,544,rainbow dash
885148.png,https://derpicdn.net/img/view/2015/4/29/885148.png,0,0.988743961,316,86,500,270,184,184,rainbow dash
885967.png,https://derpicdn.net/img/view/2015/4/30/885967.png,0,0.997775435,411,0,981,551,570,551,rainbow dash
891819.jpg,https://derpicdn.net/img/view/2015/5/8/891819.jpg,0,0.974496484,264,10,448,194,184,184,rainbow dash
898171.png,https://derpicdn.net/img/view/2015/5/17/898171.png,0,0.99846971,222,53,988,819,766,766,rainbow dash
902545.png,https://derpicdn.net/img/view/2015/5/23/902545.png,0,0.942528546,1092,425,1448,781,356,356,rainbow dash
906666.png,https://derpicdn.net/img/view/2015/5/30/906666.png,0,0.989771843,441,0,1399,828,958,828,rainbow dash
91239.png,https://derpicdn.net/img/view/2012/9/6/91239.png,0,0.999883175,405,64,817,476,412,412,rainbow dash
91261.jpg,https://derpicdn.net/img/view/2012/9/6/91261.jpg,0,0.920166075,119,4,483,368,364,364,rainbow dash
922362.jpg,https://derpicdn.net/img/view/2015/6/23/922362.jpg,0,0.998306274,0,0,905,911,905,911,rainbow dash
932851.png,https://derpicdn.net/img/view/2015/7/8/932851.png,0,0.99108988,220,134,948,862,728,728,rainbow dash
933630.png,https://derpicdn.net/img/view/2015/7/9/933630.png,0,0.998735309,245,137,677,569,432,432,rainbow dash
940891.png,https://derpicdn.net/img/view/2015/7/21/940891.png,0,0.937575459,263,0,2361,2003,2098,2003,rainbow dash
942389.jpg,https://derpicdn.net/img/view/2015/7/23/942389.jpg,0,0.998570085,397,0,1031,623,634,623,rainbow dash
945748.png,https://derpicdn.net/img/view/2015/7/28/945748.png,0,0.994068265,0,163,351,543,351,380,rainbow dash
949042.png,https://derpicdn.net/img/view/2015/8/2/949042.png,0,0.986258149,743,559,1979,1795,1236,1236,rainbow dash
956193.png,https://derpicdn.net/img/view/2015/8/12/956193.png,0,0.997938752,346,0,1216,850,870,850,rainbow dash
963714.png,https://derpicdn.net/img/view/2015/8/23/963714.png,1,0.964478672,0,0,539,478,539,478,rainbow dash
966841.png,https://derpicdn.net/img/view/2015/8/27/966841.png,0,0.989596426,1401,0,4481,3120,3080,3120,rainbow dash
969322.jpg,https://derpicdn.net/img/view/2015/8/30/969322.jpg,0,0.990030766,197,4,813,620,616,616,rainbow dash
971428.png,https://derpicdn.net/img/view/2015/9/2/971428.png,0,0.990007699,114,0,598,454,484,454,rainbow dash
973586.jpg,https://derpicdn.net/img/view/2015/9/6/973586.jpg,0,0.966759861,60,0,1176,759,1116,759,rainbow dash
975700.png,https://derpicdn.net/img/view/2015/9/9/975700.png,0,0.990545392,98,48,568,518,470,470,rainbow dash
979771.jpg,https://derpicdn.net/img/view/2015/9/14/979771.jpg,0,0.982447386,482,0,1292,808,810,808,rainbow dash
992993.png,https://derpicdn.net/img/view/2015/10/2/992993.png,0,0.994571745,296,16,816,536,520,520,rainbow dash
1005.jpg,https://derpicdn.net/img/view/2012/1/20/1005.jpg,0,0.995936513,85,0,373,288,288,288,rainbow dash
1006289.png,https://derpicdn.net/img/view/2015/10/20/1006289.png,0,0.925824106,537,237,1067,767,530,530,rainbow dash
1010347.png,https://derpicdn.net/img/view/2015/10/26/1010347.png,0,0.973120213,29,247,597,815,568,568,rainbow dash
1011775.png,https://derpicdn.net/img/view/2015/10/29/1011775.png,0,0.942831278,420,140,928,648,508,508,rainbow dash
1024070.png,https://derpicdn.net/img/view/2015/11/16/1024070.png,0,0.999124348,106,150,1182,1226,1076,1076,rainbow dash
1031400.jpg,https://derpicdn.net/img/view/2015/11/27/1031400.jpg,0,0.983574688,215,50,853,688,638,638,rainbow dash
1041951.png,https://derpicdn.net/img/view/2015/12/11/1041951.png,0,0.90838629,358,132,2300,2074,1942,1942,rainbow dash
1043521.png,https://derpicdn.net/img/view/2015/12/13/1043521.png,0,0.997098446,209,25,663,479,454,454,rainbow dash
1057791.png,https://derpicdn.net/img/view/2016/1/2/1057791.png,0,0.974630952,390,33,766,409,376,376,rainbow dash
1074224.png,https://derpicdn.net/img/view/2016/1/26/1074224.png,0,0.963685215,227,421,843,1037,616,616,rainbow dash
1079352.png,https://derpicdn.net/img/view/2016/2/3/1079352.png,0,0.998806655,675,82,1729,1136,1054,1054,rainbow dash
1087652.png,https://derpicdn.net/img/view/2016/2/14/1087652.png,0,0.966859162,187,0,685,453,498,453,rainbow dash
1091540.png,https://derpicdn.net/img/view/2016/2/18/1091540.png,0,0.907904327,261,0,867,535,606,535,rainbow dash
1092954.png,https://derpicdn.net/img/view/2016/2/20/1092954.png,0,0.996267736,158,5,624,471,466,466,rainbow dash
1097626.jpg,https://derpicdn.net/img/view/2016/2/27/1097626.jpg,0,0.995568395,25,17,331,323,306,306,rainbow dash
1097626.jpg,https://derpicdn.net/img/view/2016/2/27/1097626.jpg,1,0.969228208,564,32,1024,500,460,468,rainbow dash
1108771.png,https://derpicdn.net/img/view/2016/3/14/1108771.png,0,0.983193755,289,0,885,589,596,589,rainbow dash
1111661.png,https://derpicdn.net/img/view/2016/3/18/1111661.png,0,0.988242447,590,19,1208,637,618,618,rainbow dash
1112799.png,https://derpicdn.net/img/view/2016/3/20/1112799.png,0,0.936011434,1345,3,2303,961,958,958,rainbow dash
1113881.png,https://derpicdn.net/img/view/2016/3/21/1113881.png,0,0.99961102,413,0,847,421,434,421,rainbow dash
112867.png,https://derpicdn.net/img/view/2012/10/3/112867.png,0,0.994771421,143,0,893,740,750,740,rainbow dash
1130028.png,https://derpicdn.net/img/view/2016/4/11/1130028.png,0,0.985701561,1238,938,2830,2530,1592,1592,rainbow dash
1136253.png,https://derpicdn.net/img/view/2016/4/20/1136253.png,0,0.987237275,286,15,650,379,364,364,rainbow dash
1142453.png,https://derpicdn.net/img/view/2016/4/29/1142453.png,0,0.902406275,0,0,1425,1342,1425,1342,rainbow dash
1150737.jpg,https://derpicdn.net/img/view/2016/5/10/1150737.jpg,0,0.993847191,101,0,349,204,248,204,rainbow dash
1150737.jpg,https://derpicdn.net/img/view/2016/5/10/1150737.jpg,1,0.985075414,457,0,703,208,246,208,rainbow dash
1152566.png,https://derpicdn.net/img/view/2016/5/12/1152566.png,0,0.976935446,295,20,597,322,302,302,rainbow dash
1154484.jpg,https://derpicdn.net/img/view/2016/5/15/1154484.jpg,0,0.999937654,782,144,1812,1174,1030,1030,rainbow dash
1160724.png,https://derpicdn.net/img/view/2016/5/22/1160724.png,0,0.998889148,358,137,922,701,564,564,rainbow dash
1164983.png,https://derpicdn.net/img/view/2016/5/28/1164983.png,0,0.907888472,885,226,1307,648,422,422,rainbow dash
1168015.jpg,https://derpicdn.net/img/view/2016/6/1/1168015.jpg,0,0.99062264,709,2,1129,422,420,420,rainbow dash
1169364.jpg,https://derpicdn.net/img/view/2016/6/3/1169364.jpg,0,0.998550296,174,1,394,221,220,220,rainbow dash
1170218.png,https://derpicdn.net/img/view/2016/6/4/1170218.png,0,0.986452758,0,26,337,384,337,358,rainbow dash
1170218.png,https://derpicdn.net/img/view/2016/6/4/1170218.png,1,0.928253949,30,58,424,431,394,373,rainbow dash
1184295.png,https://derpicdn.net/img/view/2016/6/22/1184295.png,0,0.983585,669,3,1205,539,536,536,rainbow dash
119007.jpg,https://derpicdn.net/img/view/2012/10/10/119007.jpg,0,0.987561405,877,0,1669,698,792,698,rainbow dash
1190874.png,https://derpicdn.net/img/view/2016/7/1/1190874.png,0,0.996639431,154,236,790,872,636,636,rainbow dash
1199923.png,https://derpicdn.net/img/view/2016/7/13/1199923.png,0,0.949344337,49,49,1005,1005,956,956,rainbow dash
1203238.png,https://derpicdn.net/img/view/2016/7/17/1203238.png,0,0.928875327,78,0,413,346,335,346,rainbow dash
1206821.png,https://derpicdn.net/img/view/2016/7/22/1206821.png,0,0.979176104,619,0,1920,1080,1301,1080,rainbow dash
1210731.png,https://derpicdn.net/img/view/2016/7/28/1210731.png,0,0.914716899,3260,3200,5262,5202,2002,2002,rainbow dash
1213148.png,https://derpicdn.net/img/view/2016/7/31/1213148.png,0,0.955310524,0,0,355,352,355,352,rainbow dash
1213163.png,https://derpicdn.net/img/view/2016/7/31/1213163.png,0,0.976787865,201,0,675,356,474,356,rainbow dash
12134.jpg,https://derpicdn.net/img/view/2012/6/20/12134.jpg,0,0.998011172,14,0,616,587,602,587,rainbow dash
1214901.png,https://derpicdn.net/img/view/2016/8/1/1214901.png,0,0.94375807,320,0,1394,891,1074,891,rainbow dash
1218370.png,https://derpicdn.net/img/view/2016/8/6/1218370.png,0,0.98864007,1789,0,8175,5400,6386,5400,rainbow dash
1218537.png,https://derpicdn.net/img/view/2016/8/6/1218537.png,0,0.983875751,0,0,392,334,392,334,rainbow dash
1224432.png,https://derpicdn.net/img/view/2016/8/13/1224432.png,0,0.997925162,0,0,454,384,454,384,rainbow dash
122492.png,https://derpicdn.net/img/view/2012/10/14/122492.png,0,0.974523008,382,157,708,483,326,326,rainbow dash
1225.png,https://derpicdn.net/img/view/2012/1/22/1225.png,0,0.995709121,57,0,687,569,630,569,rainbow dash
1229649.png,https://derpicdn.net/img/view/2016/8/20/1229649.png,0,0.996685088,16,535,394,913,378,378,rainbow dash
1229649.png,https://derpicdn.net/img/view/2016/8/20/1229649.png,1,0.975954652,567,500,859,792,292,292,rainbow dash
1232016.png,https://derpicdn.net/img/view/2016/8/23/1232016.png,0,0.998538256,193,0,473,250,280,250,rainbow dash
1237097.png,https://derpicdn.net/img/view/2016/8/29/1237097.png,0,0.91106534,231,170,499,438,268,268,rainbow dash
1241033.png,https://derpicdn.net/img/view/2016/9/3/1241033.png,0,0.981357336,569,0,1278,532,709,532,rainbow dash
1241185.png,https://derpicdn.net/img/view/2016/9/3/1241185.png,0,0.975762784,44,0,470,399,426,399,rainbow dash
1241185.png,https://derpicdn.net/img/view/2016/9/3/1241185.png,1,0.961848021,0,91,363,463,363,372,rainbow dash
1253293.png,https://derpicdn.net/img/view/2016/9/19/1253293.png,0,0.964752913,830,0,3329,2344,2499,2344,rainbow dash
1256028.png,https://derpicdn.net/img/view/2016/9/23/1256028.png,0,0.989244521,131,66,771,706,640,640,rainbow dash
1267275.png,https://derpicdn.net/img/view/2016/10/7/1267275.png,0,0.982552409,0,0,1550,1631,1550,1631,rainbow dash
1268347.png,https://derpicdn.net/img/view/2016/10/8/1268347.png,0,0.997910321,377,0,1375,837,998,837,rainbow dash
1278068.png,https://derpicdn.net/img/view/2016/10/21/1278068.png,0,0.996341944,659,349,1187,877,528,528,rainbow dash
1283482.png,https://derpicdn.net/img/view/2016/10/28/1283482.png,0,0.987758398,569,0,1061,415,492,415,rainbow dash
1298006.png,https://derpicdn.net/img/view/2016/11/18/1298006.png,0,0.979803085,0,183,1485,1679,1485,1496,rainbow dash
1310140.png,https://derpicdn.net/img/view/2016/12/5/1310140.png,0,0.998475969,542,0,1168,555,626,555,rainbow dash
1323426.png,https://derpicdn.net/img/view/2016/12/23/1323426.png,0,0.97360462,179,43,1447,1311,1268,1268,rainbow dash
1323800.png,https://derpicdn.net/img/view/2016/12/24/1323800.png,0,0.996088624,194,0,1154,830,960,830,rainbow dash
1324990.png,https://derpicdn.net/img/view/2016/12/25/1324990.png,0,0.968231499,25,0,1477,1080,1452,1080,rainbow dash
1333759.png,https://derpicdn.net/img/view/2017/1/7/1333759.png,0,0.995414555,94,20,1000,926,906,906,rainbow dash
1335932.png,https://derpicdn.net/img/view/2017/1/9/1335932.png,0,0.994134307,445,33,879,467,434,434,rainbow dash
1348935.png,https://derpicdn.net/img/view/2017/1/27/1348935.png,0,0.999105275,389,0,4815,4325,4426,4325,rainbow dash
1354067.png,https://derpicdn.net/img/view/2017/2/3/1354067.png,0,0.997009218,584,20,1442,878,858,858,rainbow dash
1354636.png,https://derpicdn.net/img/view/2017/2/4/1354636.png,0,0.93925035,717,0,1280,544,563,544,rainbow dash
1363990.png,https://derpicdn.net/img/view/2017/2/15/1363990.png,0,0.991162539,0,0,3000,3492,3000,3492,rainbow dash
1365640.png,https://derpicdn.net/img/view/2017/2/17/1365640.png,0,0.999610066,185,19,571,405,386,386,rainbow dash
1365953.png,https://derpicdn.net/img/view/2017/2/18/1365953.png,0,0.999108613,978,2283,2654,3959,1676,1676,rainbow dash
1366660.png,https://derpicdn.net/img/view/2017/2/18/1366660.png,0,0.966314018,530,0,966,381,436,381,rainbow dash
1368346.png,https://derpicdn.net/img/view/2017/2/20/1368346.png,0,0.990213871,167,0,659,455,492,455,rainbow dash
136872.jpg,https://derpicdn.net/img/view/2012/10/30/136872.jpg,0,0.99883604,313,190,485,362,172,172,rainbow dash
136872.jpg,https://derpicdn.net/img/view/2012/10/30/136872.jpg,1,0.989250839,54,1,346,293,292,292,rainbow dash
1373055.png,https://derpicdn.net/img/view/2017/2/25/1373055.png,0,0.985729158,515,0,1167,607,652,607,rainbow dash
1374867.png,https://derpicdn.net/img/view/2017/2/27/1374867.png,0,0.974055588,781,0,4459,3627,3678,3627,rainbow dash
1378587.png,https://derpicdn.net/img/view/2017/3/4/1378587.png,0,0.999071181,404,0,860,426,456,426,rainbow dash
1378790.png,https://derpicdn.net/img/view/2017/3/4/1378790.png,0,0.994235158,4656,0,8247,3569,3591,3569,rainbow dash
1381454.png,https://derpicdn.net/img/view/2017/3/7/1381454.png,0,0.976667464,115,0,1133,720,1018,720,rainbow dash
1385436.png,https://derpicdn.net/img/view/2017/3/12/1385436.png,0,0.99559921,557,0,1377,769,820,769,rainbow dash
13910.png,https://derpicdn.net/img/view/2012/6/21/13910.png,0,0.987470925,172,0,640,401,468,401,rainbow dash
1391511.png,https://derpicdn.net/img/view/2017/3/19/1391511.png,0,0.996529102,404,0,1560,1098,1156,1098,rainbow dash
1394608.png,https://derpicdn.net/img/view/2017/3/23/1394608.png,0,0.994023263,845,3,2284,1529,1439,1526,rainbow dash
1397862.png,https://derpicdn.net/img/view/2017/3/27/1397862.png,0,0.992606819,553,0,1567,946,1014,946,rainbow dash
1399159.png,https://derpicdn.net/img/view/2017/3/29/1399159.png,0,0.922638953,204,0,596,373,392,373,rainbow dash
1400784.png,https://derpicdn.net/img/view/2017/3/31/1400784.png,0,0.961178243,0,0,3230,3446,3230,3446,rainbow dash
1402621.png,https://derpicdn.net/img/view/2017/4/2/1402621.png,0,0.997332752,244,6,802,564,558,558,rainbow dash
1406960.png,https://derpicdn.net/img/view/2017/4/8/1406960.png,0,0.983964503,0,0,358,380,358,380,rainbow dash
1411692.png,https://derpicdn.net/img/view/2017/4/15/1411692.png,0,0.91549474,310,179,864,733,554,554,rainbow dash
1416793.png,https://derpicdn.net/img/view/2017/4/20/1416793.png,0,0.972774923,518,0,9156,6345,8638,6345,rainbow dash
1417026.png,https://derpicdn.net/img/view/2017/4/20/1417026.png,0,0.996017277,130,280,462,612,332,332,rainbow dash
1417026.png,https://derpicdn.net/img/view/2017/4/20/1417026.png,1,0.978978097,342,71,746,475,404,404,rainbow dash
1419944.png,https://derpicdn.net/img/view/2017/4/23/1419944.png,0,0.973271132,30,0,998,956,968,956,rainbow dash
1424881.png,https://derpicdn.net/img/view/2017/4/29/1424881.png,0,0.998432875,565,28,1067,530,502,502,rainbow dash
1427833.png,https://derpicdn.net/img/view/2017/5/3/1427833.png,0,0.970214069,93,0,383,285,290,285,rainbow dash
1428943.png,https://derpicdn.net/img/view/2017/5/5/1428943.png,0,0.959877014,200,0,730,469,530,469,rainbow dash
1429622.png,https://derpicdn.net/img/view/2017/5/6/1429622.png,0,0.988765538,617,55,1207,645,590,590,rainbow dash
1430064.png,https://derpicdn.net/img/view/2017/5/6/1430064.png,0,0.997128427,63,254,347,538,284,284,rainbow dash
1432674.png,https://derpicdn.net/img/view/2017/5/9/1432674.png,0,0.995701849,814,479,3986,3651,3172,3172,rainbow dash
1433171.png,https://derpicdn.net/img/view/2017/5/10/1433171.png,0,0.986405373,1901,0,5897,3859,3996,3859,rainbow dash
1433450.png,https://derpicdn.net/img/view/2017/5/10/1433450.png,0,0.920525253,175,475,3300,4305,3125,3830,rainbow dash
14357.png,https://derpicdn.net/img/view/2012/6/21/14357.png,0,0.986965895,608,471,1816,1679,1208,1208,rainbow dash
1440341.png,https://derpicdn.net/img/view/2017/5/19/1440341.png,0,0.977007449,1611,0,8429,6594,6818,6594,rainbow dash
1446091.png,https://derpicdn.net/img/view/2017/5/26/1446091.png,0,0.999585986,66,0,478,390,412,390,rainbow dash
1446421.png,https://derpicdn.net/img/view/2017/5/26/1446421.png,2,0.98826468,401,368,633,600,232,232,rainbow dash
1447780.png,https://derpicdn.net/img/view/2017/5/28/1447780.png,0,0.95746392,1145,352,1845,1052,700,700,rainbow dash
1449068.png,https://derpicdn.net/img/view/2017/5/29/1449068.png,0,0.996213794,66,18,408,360,342,342,rainbow dash
1449173.png,https://derpicdn.net/img/view/2017/5/29/1449173.png,0,0.950205266,0,0,2480,2884,2480,2884,rainbow dash
1453251.png,https://derpicdn.net/img/view/2017/6/3/1453251.png,0,0.984259844,0,0,1020,1013,1020,1013,rainbow dash
1457766.png,https://derpicdn.net/img/view/2017/6/9/1457766.png,0,0.996500194,712,113,1296,697,584,584,rainbow dash
1463585.png,https://derpicdn.net/img/view/2017/6/17/1463585.png,0,0.999360025,75,0,1025,926,950,926,rainbow dash
1464357.png,https://derpicdn.net/img/view/2017/6/18/1464357.png,0,0.998655021,2450,0,5214,2639,2764,2639,rainbow dash
1464670.png,https://derpicdn.net/img/view/2017/6/18/1464670.png,0,0.965416491,0,0,3236,3102,3236,3102,rainbow dash
1465117.png,https://derpicdn.net/img/view/2017/6/18/1465117.png,0,0.997755885,2436,0,4936,2454,2500,2454,rainbow dash
1466084.png,https://derpicdn.net/img/view/2017/6/19/1466084.png,0,0.996379077,0,0,2694,2980,2694,2980,rainbow dash
1466905.png,https://derpicdn.net/img/view/2017/6/20/1466905.png,0,0.971184134,737,92,3989,3344,3252,3252,rainbow dash
1471270.png,https://derpicdn.net/img/view/2017/6/25/1471270.png,0,0.982345998,11,0,2379,2290,2368,2290,rainbow dash
1472780.png,https://derpicdn.net/img/view/2017/6/27/1472780.png,0,0.999233902,0,29,964,1017,964,988,rainbow dash
1472787.png,https://derpicdn.net/img/view/2017/6/27/1472787.png,0,0.996637523,138,62,644,568,506,506,rainbow dash
1472798.png,https://derpicdn.net/img/view/2017/6/27/1472798.png,0,0.99750036,198,0,4362,4011,4164,4011,rainbow dash
1473489.png,https://derpicdn.net/img/view/2017/6/28/1473489.png,0,0.946476281,60,0,750,692,690,692,rainbow dash
1475180.png,https://derpicdn.net/img/view/2017/6/30/1475180.png,0,0.984745979,836,310,1142,616,306,306,rainbow dash
1475180.png,https://derpicdn.net/img/view/2017/6/30/1475180.png,1,0.979900241,367,243,763,639,396,396,rainbow dash
1481615.png,https://derpicdn.net/img/view/2017/7/8/1481615.png,0,0.981586277,74,8,476,442,402,434,rainbow dash
1482851.png,https://derpicdn.net/img/view/2017/7/10/1482851.png,0,0.97984165,30,0,726,607,696,607,rainbow dash
1486965.png,https://derpicdn.net/img/view/2017/7/15/1486965.png,0,0.999025166,526,0,1258,706,732,706,rainbow dash
1492529.png,https://derpicdn.net/img/view/2017/7/22/1492529.png,0,0.998292387,1499,0,3249,1671,1750,1671,rainbow dash
1492807.png,https://derpicdn.net/img/view/2017/7/23/1492807.png,0,0.971769452,0,2101,4200,6383,4200,4282,rainbow dash
1495410.png,https://derpicdn.net/img/view/2017/7/26/1495410.png,0,0.976772368,778,37,1484,743,706,706,rainbow dash
1498153.png,https://derpicdn.net/img/view/2017/7/30/1498153.png,0,0.991975427,820,242,1814,1236,994,994,rainbow dash
1499261.png,https://derpicdn.net/img/view/2017/7/31/1499261.png,0,0.999665916,232,87,640,495,408,408,rainbow dash
1499309.png,https://derpicdn.net/img/view/2017/7/31/1499309.png,0,0.907559514,99,30,939,870,840,840,rainbow dash
1499969.png,https://derpicdn.net/img/view/2017/8/1/1499969.png,0,0.984699607,226,404,616,794,390,390,rainbow dash
1502165.png,https://derpicdn.net/img/view/2017/8/3/1502165.png,0,0.9747805,1571,0,2433,851,862,851,rainbow dash
1502309.png,https://derpicdn.net/img/view/2017/8/4/1502309.png,0,0.996597707,38,0,600,462,562,462,rainbow dash
1502580.png,https://derpicdn.net/img/view/2017/8/4/1502580.png,0,0.990154088,2670,51,9560,7269,6890,7218,rainbow dash
1503293.png,https://derpicdn.net/img/view/2017/8/5/1503293.png,0,0.990001857,337,0,1159,686,822,686,rainbow dash
1503625.png,https://derpicdn.net/img/view/2017/8/5/1503625.png,0,0.995780706,19,0,197,176,178,176,rainbow dash
1508195.png,https://derpicdn.net/img/view/2017/8/11/1508195.png,0,0.998369992,528,111,1826,1409,1298,1298,rainbow dash
1509207.png,https://derpicdn.net/img/view/2017/8/12/1509207.png,0,0.993459642,817,286,1213,682,396,396,rainbow dash
1519411.png,https://derpicdn.net/img/view/2017/8/25/1519411.png,1,0.99786675,460,27,752,319,292,292,rainbow dash
1525310.png,https://derpicdn.net/img/view/2017/9/1/1525310.png,0,0.997628808,0,0,509,460,509,460,rainbow dash
1526936.png,https://derpicdn.net/img/view/2017/9/3/1526936.png,0,0.992069304,16,0,370,350,354,350,rainbow dash
1527141.png,https://derpicdn.net/img/view/2017/9/3/1527141.png,0,0.994828463,119,0,1295,768,1176,768,rainbow dash
1528925.png,https://derpicdn.net/img/view/2017/9/5/1528925.png,0,0.998643756,503,0,1439,842,936,842,rainbow dash
1529537.png,https://derpicdn.net/img/view/2017/9/6/1529537.png,0,0.936688066,85,0,999,734,914,734,rainbow dash
1534188.png,https://derpicdn.net/img/view/2017/9/13/1534188.png,0,0.912714839,18,0,652,529,634,529,rainbow dash
1538934.png,https://derpicdn.net/img/view/2017/9/18/1538934.png,0,0.992120087,494,19,910,435,416,416,rainbow dash
1544884.png,https://derpicdn.net/img/view/2017/9/25/1544884.png,0,0.985291421,225,0,1247,995,1022,995,rainbow dash
1550135.png,https://derpicdn.net/img/view/2017/10/2/1550135.png,0,0.98191452,136,108,460,432,324,324,rainbow dash
1550800.png,https://derpicdn.net/img/view/2017/10/3/1550800.png,0,0.997582316,2204,0,3960,1703,1756,1703,rainbow dash
1555909.png,https://derpicdn.net/img/view/2017/10/9/1555909.png,0,0.978823245,330,45,1016,731,686,686,rainbow dash
155596.png,https://derpicdn.net/img/view/2012/11/18/155596.png,0,0.994583726,201,1,537,337,336,336,rainbow dash
1556226.png,https://derpicdn.net/img/view/2017/10/9/1556226.png,0,0.991746366,0,0,420,384,420,384,rainbow dash
1560797.png,https://derpicdn.net/img/view/2017/10/14/1560797.png,0,0.9446733,188,96,792,700,604,604,rainbow dash
1561162.png,https://derpicdn.net/img/view/2017/10/14/1561162.png,0,0.985291421,0,0,796,843,796,843,rainbow dash
1564414.png,https://derpicdn.net/img/view/2017/10/18/1564414.png,0,0.997675598,413,7,1069,663,656,656,rainbow dash
1569497.png,https://derpicdn.net/img/view/2017/10/24/1569497.png,0,0.998934746,785,0,1589,757,804,757,rainbow dash
1575545.png,https://derpicdn.net/img/view/2017/11/1/1575545.png,0,0.999472141,824,0,1730,790,906,790,rainbow dash
1576937.png,https://derpicdn.net/img/view/2017/11/3/1576937.png,0,0.988090456,0,37,497,557,497,520,rainbow dash
1582965.png,https://derpicdn.net/img/view/2017/11/10/1582965.png,0,0.993455291,252,703,3500,4135,3248,3432,rainbow dash
1588264.png,https://derpicdn.net/img/view/2017/11/17/1588264.png,0,0.972686708,24,0,702,645,678,645,rainbow dash
1591099.png,https://derpicdn.net/img/view/2017/11/21/1591099.png,0,0.949382007,0,57,591,677,591,620,rainbow dash
1591581.png,https://derpicdn.net/img/view/2017/11/21/1591581.png,0,0.997512043,184,0,576,363,392,363,rainbow dash
1593684.png,https://derpicdn.net/img/view/2017/11/25/1593684.png,0,0.988492191,0,0,3651,3486,3651,3486,rainbow dash
1594840.png,https://derpicdn.net/img/view/2017/11/26/1594840.png,0,0.998591483,0,0,2608,2604,2608,2604,rainbow dash
1597722.png,https://derpicdn.net/img/view/2017/11/30/1597722.png,0,0.995985329,255,0,2583,2240,2328,2240,rainbow dash
1600036.png,https://derpicdn.net/img/view/2017/12/4/1600036.png,0,0.903698444,778,0,1920,1080,1142,1080,rainbow dash
1604520.png,https://derpicdn.net/img/view/2017/12/10/1604520.png,0,0.992045701,3136,211,6690,3765,3554,3554,rainbow dash
1604979.png,https://derpicdn.net/img/view/2017/12/11/1604979.png,0,0.979981542,0,45,913,1002,913,957,rainbow dash
1606489.png,https://derpicdn.net/img/view/2017/12/13/1606489.png,0,0.959277153,0,54,382,436,382,382,rainbow dash
1612314.png,https://derpicdn.net/img/view/2017/12/20/1612314.png,0,0.998543859,78,0,778,616,700,616,rainbow dash
1616349.png,https://derpicdn.net/img/view/2017/12/26/1616349.png,0,0.976769865,68,789,460,1181,392,392,rainbow dash
1618613.png,https://derpicdn.net/img/view/2017/12/29/1618613.png,0,0.996497095,213,0,869,594,656,594,rainbow dash
1622666.png,https://derpicdn.net/img/view/2018/1/2/1622666.png,0,0.972641051,1213,233,2671,1691,1458,1458,rainbow dash
1628444.png,https://derpicdn.net/img/view/2018/1/9/1628444.png,0,0.998747587,201,16,835,650,634,634,rainbow dash
1629705.png,https://derpicdn.net/img/view/2018/1/11/1629705.png,0,0.969237506,0,0,433,400,433,400,rainbow dash
1631343.png,https://derpicdn.net/img/view/2018/1/13/1631343.png,0,0.996691823,349,0,1351,824,1002,824,rainbow dash
1639130.png,https://derpicdn.net/img/view/2018/1/23/1639130.png,0,0.98831439,614,11,1866,1263,1252,1252,rainbow dash
1644956.png,https://derpicdn.net/img/view/2018/1/31/1644956.png,0,0.928956509,44,18,462,436,418,418,rainbow dash
1649346.png,https://derpicdn.net/img/view/2018/2/5/1649346.png,0,0.901790917,356,0,2148,1557,1792,1557,rainbow dash
1651921.png,https://derpicdn.net/img/view/2018/2/9/1651921.png,0,0.966999412,404,0,2722,1977,2318,1977,rainbow dash
1653.png,https://derpicdn.net/img/view/2012/1/23/1653.png,0,0.998338401,16,73,388,445,372,372,rainbow dash
1660568.png,https://derpicdn.net/img/view/2018/2/19/1660568.png,0,0.929010868,646,64,994,412,348,348,rainbow dash
1685273.png,https://derpicdn.net/img/view/2018/3/19/1685273.png,0,0.958622634,21,387,255,621,234,234,rainbow dash
1685759.png,https://derpicdn.net/img/view/2018/3/20/1685759.png,0,0.967533469,0,0,3402,3175,3402,3175,rainbow dash
1689310.png,https://derpicdn.net/img/view/2018/3/24/1689310.png,0,0.950400591,137,0,1145,804,1008,804,rainbow dash
1690273.png,https://derpicdn.net/img/view/2018/3/25/1690273.png,0,0.906014442,466,0,1280,720,814,720,rainbow dash
1692444.png,https://derpicdn.net/img/view/2018/3/27/1692444.png,0,0.999527633,107,382,499,774,392,392,rainbow dash
1701518.png,https://derpicdn.net/img/view/2018/4/7/1701518.png,0,0.994322479,1348,336,3806,2794,2458,2458,rainbow dash
1703577.png,https://derpicdn.net/img/view/2018/4/9/1703577.png,0,0.956692636,303,0,1563,1010,1260,1010,rainbow dash
1705978.png,https://derpicdn.net/img/view/2018/4/12/1705978.png,0,0.98868072,39,0,689,606,650,606,rainbow dash
1708262.png,https://derpicdn.net/img/view/2018/4/15/1708262.png,0,0.979608476,0,58,608,690,608,632,rainbow dash
1719447.png,https://derpicdn.net/img/view/2018/4/28/1719447.png,0,0.974659443,41,17,277,253,236,236,rainbow dash
1722963.png,https://derpicdn.net/img/view/2018/5/3/1722963.png,0,0.965209186,84,0,470,386,386,386,rainbow dash
1724772.png,https://derpicdn.net/img/view/2018/5/5/1724772.png,0,0.934457064,0,0,342,369,342,369,rainbow dash
1729697.png,https://derpicdn.net/img/view/2018/5/11/1729697.png,0,0.912929177,468,0,4020,3337,3552,3337,rainbow dash
1729810.png,https://derpicdn.net/img/view/2018/5/11/1729810.png,0,0.997687161,501,0,1023,492,522,492,rainbow dash
1731283.png,https://derpicdn.net/img/view/2018/5/12/1731283.png,0,0.999540389,506,0,1496,950,990,950,rainbow dash
173203.png,https://derpicdn.net/img/view/2012/12/5/173203.png,0,0.921809971,93,90,669,666,576,576,rainbow dash
1734165.png,https://derpicdn.net/img/view/2018/5/16/1734165.png,0,0.976531386,0,0,572,522,572,522,rainbow dash
1737251.png,https://derpicdn.net/img/view/2018/5/20/1737251.png,0,0.98614049,74,0,1132,1030,1058,1030,rainbow dash
1739851.png,https://derpicdn.net/img/view/2018/5/23/1739851.png,0,0.997364163,15,0,489,433,474,433,rainbow dash
1740420.png,https://derpicdn.net/img/view/2018/5/24/1740420.png,0,0.938295066,231,0,1751,1080,1520,1080,rainbow dash
1740783.png,https://derpicdn.net/img/view/2018/5/25/1740783.png,0,0.997620463,1071,0,1885,800,814,800,rainbow dash
1741691.png,https://derpicdn.net/img/view/2018/5/26/1741691.png,0,0.991141915,25,0,297,262,272,262,rainbow dash
1741691.png,https://derpicdn.net/img/view/2018/5/26/1741691.png,1,0.931425869,0,69,275,350,275,281,rainbow dash
1745669.png,https://derpicdn.net/img/view/2018/5/30/1745669.png,1,0.974728584,217,1675,635,2093,418,418,rainbow dash
1749381.png,https://derpicdn.net/img/view/2018/6/4/1749381.png,0,0.996037662,762,250,1554,1042,792,792,rainbow dash
1753322.png,https://derpicdn.net/img/view/2018/6/9/1753322.png,0,0.969304919,84,17,652,625,568,608,rainbow dash
1753945.png,https://derpicdn.net/img/view/2018/6/9/1753945.png,0,0.999836683,301,0,2547,2142,2246,2142,rainbow dash
1762178.png,https://derpicdn.net/img/view/2018/6/20/1762178.png,0,0.997788846,189,1,641,453,452,452,rainbow dash
1763012.png,https://derpicdn.net/img/view/2018/6/21/1763012.png,0,0.985094547,414,0,736,308,322,308,rainbow dash
1765511.png,https://derpicdn.net/img/view/2018/6/25/1765511.png,0,0.997919083,245,9,733,497,488,488,rainbow dash
1767302.png,https://derpicdn.net/img/view/2018/6/27/1767302.png,0,0.986094177,39,0,401,357,362,357,rainbow dash
1767594.png,https://derpicdn.net/img/view/2018/6/27/1767594.png,0,0.998262465,465,85,1137,757,672,672,rainbow dash
1769217.png,https://derpicdn.net/img/view/2018/6/30/1769217.png,0,0.999217272,182,148,1326,1292,1144,1144,rainbow dash
1772635.png,https://derpicdn.net/img/view/2018/7/4/1772635.png,0,0.999769151,1073,132,1855,914,782,782,rainbow dash
1772709.png,https://derpicdn.net/img/view/2018/7/4/1772709.png,0,0.97772336,594,128,874,408,280,280,rainbow dash
1772709.png,https://derpicdn.net/img/view/2018/7/4/1772709.png,1,0.903183401,0,0,737,641,737,641,rainbow dash
1774907.png,https://derpicdn.net/img/view/2018/7/7/1774907.png,0,0.997255445,460,278,1538,1356,1078,1078,rainbow dash
1777917.png,https://derpicdn.net/img/view/2018/7/10/1777917.png,0,0.977505267,0,0,3845,4131,3845,4131,rainbow dash
1778174.png,https://derpicdn.net/img/view/2018/7/11/1778174.png,0,0.992744684,0,136,398,548,398,412,rainbow dash
1780349.png,https://derpicdn.net/img/view/2018/7/13/1780349.png,0,0.979870915,80,0,820,706,740,706,rainbow dash
1780492.png,https://derpicdn.net/img/view/2018/7/14/1780492.png,0,0.999779284,148,88,610,550,462,462,rainbow dash
1782059.png,https://derpicdn.net/img/view/2018/7/16/1782059.png,0,0.920795143,357,0,1695,1187,1338,1187,rainbow dash
1784474.png,https://derpicdn.net/img/view/2018/7/19/1784474.png,0,0.986525476,231,0,1681,1480,1450,1480,rainbow dash
1787251.png,https://derpicdn.net/img/view/2018/7/22/1787251.png,0,0.953929543,1241,616,2281,1656,1040,1040,rainbow dash
1791930.png,https://derpicdn.net/img/view/2018/7/28/1791930.png,0,0.997479141,401,0,1339,741,938,741,rainbow dash
1798309.png,https://derpicdn.net/img/view/2018/8/5/1798309.png,0,0.925942361,112,0,792,577,680,577,rainbow dash
1799032.png,https://derpicdn.net/img/view/2018/8/5/1799032.png,0,0.936135888,29,0,513,462,484,462,rainbow dash
1800841.png,https://derpicdn.net/img/view/2018/8/7/1800841.png,0,0.929637134,0,0,1349,1352,1349,1352,rainbow dash
1808266.png,https://derpicdn.net/img/view/2018/8/16/1808266.png,0,0.972181439,806,203,2038,1435,1232,1232,rainbow dash
1809804.png,https://derpicdn.net/img/view/2018/8/18/1809804.png,0,0.976426065,5,3,605,603,600,600,rainbow dash
1810332.png,https://derpicdn.net/img/view/2018/8/18/1810332.png,0,0.947853029,67,0,623,556,556,556,rainbow dash
1811969.png,https://derpicdn.net/img/view/2018/8/20/1811969.png,0,0.999618769,1047,0,2013,930,966,930,rainbow dash
1812065.png,https://derpicdn.net/img/view/2018/8/21/1812065.png,0,0.995348215,373,0,1249,668,876,668,rainbow dash
1813087.png,https://derpicdn.net/img/view/2018/8/22/1813087.png,0,0.989838481,6,0,222,201,216,201,rainbow dash
1815948.png,https://derpicdn.net/img/view/2018/8/25/1815948.png,0,0.992497444,113,47,647,581,534,534,rainbow dash
1818617.png,https://derpicdn.net/img/view/2018/8/28/1818617.png,0,0.950281739,7,78,782,861,775,783,rainbow dash
1823928.png,https://derpicdn.net/img/view/2018/9/3/1823928.png,0,0.963273406,0,57,3157,3299,3157,3242,rainbow dash
1826591.png,https://derpicdn.net/img/view/2018/9/7/1826591.png,0,0.977127731,0,0,353,349,353,349,rainbow dash
1830795.png,https://derpicdn.net/img/view/2018/9/12/1830795.png,0,0.981838346,90,6,280,196,190,190,rainbow dash
1841758.png,https://derpicdn.net/img/view/2018/9/26/1841758.png,0,0.902041376,86,0,960,558,874,558,rainbow dash
1841984.png,https://derpicdn.net/img/view/2018/9/26/1841984.png,0,0.991029799,0,0,674,645,674,645,rainbow dash
1845142.png,https://derpicdn.net/img/view/2018/10/1/1845142.png,0,0.96890825,0,0,338,348,338,348,rainbow dash
1847394.png,https://derpicdn.net/img/view/2018/10/3/1847394.png,0,0.990959585,0,0,1127,941,1127,941,rainbow dash
1853315.png,https://derpicdn.net/img/view/2018/10/10/1853315.png,1,0.976674497,0,109,303,417,303,308,rainbow dash
1853912.png,https://derpicdn.net/img/view/2018/10/11/1853912.png,0,0.995016694,0,0,383,398,383,398,rainbow dash
1857631.png,https://derpicdn.net/img/view/2018/10/15/1857631.png,0,0.981966376,458,188,2456,2186,1998,1998,rainbow dash
1859449.png,https://derpicdn.net/img/view/2018/10/18/1859449.png,0,0.987026811,239,95,1393,1249,1154,1154,rainbow dash
1865953.png,https://derpicdn.net/img/view/2018/10/25/1865953.png,0,0.999104559,243,0,1045,766,802,766,rainbow dash
187173.png,https://derpicdn.net/img/view/2012/12/19/187173.png,0,0.992646575,261,131,653,523,392,392,rainbow dash
1871749.png,https://derpicdn.net/img/view/2018/10/31/1871749.png,0,0.992744744,121,0,1225,1069,1104,1069,rainbow dash
1871768.png,https://derpicdn.net/img/view/2018/10/31/1871768.png,0,0.992208421,407,56,1141,790,734,734,rainbow dash
1871782.png,https://derpicdn.net/img/view/2018/10/31/1871782.png,0,0.976453185,71,0,415,329,344,329,rainbow dash
1873964.png,https://derpicdn.net/img/view/2018/11/3/1873964.png,0,0.996423066,838,0,4256,3379,3418,3379,rainbow dash
1875866.png,https://derpicdn.net/img/view/2018/11/5/1875866.png,0,0.976122022,0,0,509,522,509,522,rainbow dash
1879427.png,https://derpicdn.net/img/view/2018/11/10/1879427.png,0,0.978049099,0,23,603,681,603,658,rainbow dash
18813.jpg,https://derpicdn.net/img/view/2012/6/24/18813.jpg,0,0.994278669,479,343,1123,987,644,644,rainbow dash
1881459.png,https://derpicdn.net/img/view/2018/11/13/1881459.png,0,0.998605371,2089,878,3085,1874,996,996,rainbow dash
1885383.png,https://derpicdn.net/img/view/2018/11/18/1885383.png,0,0.989850104,0,0,495,506,495,506,rainbow dash
1890917.png,https://derpicdn.net/img/view/2018/11/25/1890917.png,0,0.987705708,122,0,2890,2720,2768,2720,rainbow dash
1892020.png,https://derpicdn.net/img/view/2018/11/27/1892020.png,0,0.972488046,26,0,366,376,340,376,rainbow dash
1893366.png,https://derpicdn.net/img/view/2018/11/29/1893366.png,0,0.995168567,638,89,1282,733,644,644,rainbow dash
1893507.png,https://derpicdn.net/img/view/2018/11/29/1893507.png,0,0.981455266,615,42,1267,694,652,652,rainbow dash
1900363.png,https://derpicdn.net/img/view/2018/12/6/1900363.png,0,0.997438073,533,177,1341,985,808,808,rainbow dash
1907942.png,https://derpicdn.net/img/view/2018/12/14/1907942.png,0,0.997766137,498,39,840,381,342,342,rainbow dash
1911567.png,https://derpicdn.net/img/view/2018/12/17/1911567.png,0,0.984119177,278,268,1084,1074,806,806,rainbow dash
1912066.png,https://derpicdn.net/img/view/2018/12/18/1912066.png,0,0.998819113,390,8,854,472,464,464,rainbow dash
1913606.png,https://derpicdn.net/img/view/2018/12/20/1913606.png,0,0.991209149,0,0,194,212,194,212,rainbow dash
1914294.png,https://derpicdn.net/img/view/2018/12/21/1914294.png,0,0.997697234,9,0,635,582,626,582,rainbow dash
1918378.png,https://derpicdn.net/img/view/2018/12/25/1918378.png,0,0.984276831,1125,172,1400,468,275,296,rainbow dash
1918378.png,https://derpicdn.net/img/view/2018/12/25/1918378.png,1,0.972563922,680,209,948,477,268,268,rainbow dash
1918378.png,https://derpicdn.net/img/view/2018/12/25/1918378.png,2,0.970728338,830,0,1264,373,434,373,rainbow dash
1921462.png,https://derpicdn.net/img/view/2018/12/29/1921462.png,0,0.988776982,0,38,1967,2330,1967,2292,rainbow dash
1922250.png,https://derpicdn.net/img/view/2018/12/30/1922250.png,0,0.988540947,510,0,1000,465,490,465,rainbow dash
1923640.png,https://derpicdn.net/img/view/2019/1/1/1923640.png,0,0.991685927,1409,0,3122,1807,1713,1807,rainbow dash
1925536.png,https://derpicdn.net/img/view/2019/1/3/1925536.png,0,0.999049306,66,54,1438,1426,1372,1372,rainbow dash
1929206.png,https://derpicdn.net/img/view/2019/1/7/1929206.png,0,0.995267332,401,96,1781,1476,1380,1380,rainbow dash
1929320.png,https://derpicdn.net/img/view/2019/1/7/1929320.png,0,0.941607118,220,142,582,504,362,362,rainbow dash
1934356.png,https://derpicdn.net/img/view/2019/1/13/1934356.png,0,0.985222399,834,0,1628,759,794,759,rainbow dash
1938484.png,https://derpicdn.net/img/view/2019/1/18/1938484.png,0,0.997481585,171,0,1387,1139,1216,1139,rainbow dash
1939185.png,https://derpicdn.net/img/view/2019/1/19/1939185.png,0,0.977000594,413,0,4689,3475,4276,3475,rainbow dash
1941624.png,https://derpicdn.net/img/view/2019/1/22/1941624.png,0,0.923521876,0,0,1538,1587,1538,1587,rainbow dash
1944090.png,https://derpicdn.net/img/view/2019/1/25/1944090.png,0,0.999701798,879,0,2799,1879,1920,1879,rainbow dash
1951874.png,https://derpicdn.net/img/view/2019/2/3/1951874.png,0,0.968433857,90,0,506,408,416,408,rainbow dash
196087.png,https://derpicdn.net/img/view/2012/12/28/196087.png,0,0.989259481,84,0,468,377,384,377,rainbow dash
1962585.png,https://derpicdn.net/img/view/2019/2/15/1962585.png,0,0.993976057,59,0,583,521,524,521,rainbow dash
1962959.png,https://derpicdn.net/img/view/2019/2/15/1962959.png,0,0.900999129,67,0,469,376,402,376,rainbow dash
1965734.png,https://derpicdn.net/img/view/2019/2/19/1965734.png,0,0.992546201,0,0,825,896,825,896,rainbow dash
1968021.png,https://derpicdn.net/img/view/2019/2/21/1968021.png,0,0.996040583,210,0,970,753,760,753,rainbow dash
1968024.png,https://derpicdn.net/img/view/2019/2/21/1968024.png,0,0.914160788,0,0,317,364,317,364,rainbow dash
1968381.png,https://derpicdn.net/img/view/2019/2/22/1968381.png,0,0.909253478,223,0,734,514,511,514,rainbow dash
1968493.png,https://derpicdn.net/img/view/2019/2/22/1968493.png,0,0.976931393,155,0,523,347,368,347,rainbow dash
1969783.png,https://derpicdn.net/img/view/2019/2/23/1969783.png,0,0.999749959,632,430,2420,2218,1788,1788,rainbow dash
1978468.png,https://derpicdn.net/img/view/2019/3/6/1978468.png,1,0.955391288,0,63,219,291,219,228,rainbow dash
1978692.png,https://derpicdn.net/img/view/2019/3/6/1978692.png,0,0.99056071,675,0,1763,827,1088,827,rainbow dash
1980384.png,https://derpicdn.net/img/view/2019/3/8/1980384.png,0,0.983539104,0,0,956,936,956,936,rainbow dash
1981442.png,https://derpicdn.net/img/view/2019/3/9/1981442.png,0,0.90941751,118,0,866,716,748,716,rainbow dash
1981673.png,https://derpicdn.net/img/view/2019/3/9/1981673.png,0,0.997164905,0,140,1027,1182,1027,1042,rainbow dash
1982747.png,https://derpicdn.net/img/view/2019/3/11/1982747.png,0,0.963665068,112,0,488,275,376,275,rainbow dash
1984206.png,https://derpicdn.net/img/view/2019/3/13/1984206.png,0,0.958932042,2231,9,3906,1733,1675,1724,rainbow dash
1984918.png,https://derpicdn.net/img/view/2019/3/14/1984918.png,0,0.977307737,81,0,1067,908,986,908,rainbow dash
1984927.png,https://derpicdn.net/img/view/2019/3/14/1984927.png,0,0.988593757,185,0,865,720,680,720,rainbow dash
1986774.png,https://derpicdn.net/img/view/2019/3/16/1986774.png,0,0.992537141,0,0,329,354,329,354,rainbow dash
1988697.png,https://derpicdn.net/img/view/2019/3/17/1988697.png,0,0.95654875,35,0,335,263,300,263,rainbow dash
1990213.png,https://derpicdn.net/img/view/2019/3/19/1990213.png,0,0.970118821,202,0,1027,800,825,800,rainbow dash
1994296.png,https://derpicdn.net/img/view/2019/3/25/1994296.png,0,0.98309505,185,0,963,726,778,726,rainbow dash
1994300.png,https://derpicdn.net/img/view/2019/3/25/1994300.png,0,0.983125389,142,41,698,597,556,556,rainbow dash
1996558.png,https://derpicdn.net/img/view/2019/3/28/1996558.png,0,0.999557316,91,190,795,894,704,704,rainbow dash
2000618.png,https://derpicdn.net/img/view/2019/4/2/2000618.png,0,0.993595243,54,0,324,256,270,256,rainbow dash
2002320.png,https://derpicdn.net/img/view/2019/4/4/2002320.png,0,0.988845527,59,0,431,372,372,372,rainbow dash
20041.jpg,https://derpicdn.net/img/view/2012/6/25/20041.jpg,0,0.996623755,347,0,645,298,298,298,rainbow dash
2006684.png,https://derpicdn.net/img/view/2019/4/8/2006684.png,0,0.999330223,343,389,779,825,436,436,rainbow dash
2006684.png,https://derpicdn.net/img/view/2019/4/8/2006684.png,1,0.994725168,629,310,971,652,342,342,rainbow dash
2007907.png,https://derpicdn.net/img/view/2019/4/10/2007907.png,0,0.983812571,24,39,424,439,400,400,rainbow dash
2018532.png,https://derpicdn.net/img/view/2019/4/21/2018532.png,0,0.990808129,143,0,1103,894,960,894,rainbow dash
2019722.png,https://derpicdn.net/img/view/2019/4/22/2019722.png,0,0.976789892,0,0,291,279,291,279,rainbow dash
2020104.png,https://derpicdn.net/img/view/2019/4/22/2020104.png,0,0.997277975,0,28,701,768,701,740,rainbow dash
2020594.png,https://derpicdn.net/img/view/2019/4/23/2020594.png,0,0.995908558,17,5,841,829,824,824,rainbow dash
2020614.png,https://derpicdn.net/img/view/2019/4/23/2020614.png,0,0.98447758,7,49,519,561,512,512,rainbow dash
2020620.png,https://derpicdn.net/img/view/2019/4/23/2020620.png,0,0.990675628,0,34,948,857,948,823,rainbow dash
2020620.png,https://derpicdn.net/img/view/2019/4/23/2020620.png,1,0.923666,65,0,843,703,778,703,rainbow dash
2021570.png,https://derpicdn.net/img/view/2019/4/24/2021570.png,0,0.975814462,0,19,205,295,205,276,rainbow dash
2021570.png,https://derpicdn.net/img/view/2019/4/24/2021570.png,1,0.936443388,0,0,205,225,205,225,rainbow dash
2023962.png,https://derpicdn.net/img/view/2019/4/27/2023962.png,0,0.977110088,0,0,4165,4352,4165,4352,rainbow dash
2024584.png,https://derpicdn.net/img/view/2019/4/27/2024584.png,0,0.922013819,137,0,811,665,674,665,rainbow dash
2029514.png,https://derpicdn.net/img/view/2019/5/3/2029514.png,0,0.963751554,567,179,1241,853,674,674,rainbow dash
2029597.png,https://derpicdn.net/img/view/2019/5/3/2029597.png,0,0.998947263,97,0,2491,2263,2394,2263,rainbow dash
2030687.png,https://derpicdn.net/img/view/2019/5/4/2030687.png,0,0.994819164,68,12,588,540,520,528,rainbow dash
2030754.png,https://derpicdn.net/img/view/2019/5/4/2030754.png,0,0.96531558,108,0,1216,720,1108,720,rainbow dash
2034353.png,https://derpicdn.net/img/view/2019/5/9/2034353.png,0,0.998900831,1008,9,2412,1413,1404,1404,rainbow dash
2035295.png,https://derpicdn.net/img/view/2019/5/10/2035295.png,0,0.94117409,0,0,588,576,588,576,rainbow dash
2035831.png,https://derpicdn.net/img/view/2019/5/10/2035831.png,0,0.908896804,5,1,335,331,330,330,rainbow dash
2038639.png,https://derpicdn.net/img/view/2019/5/14/2038639.png,0,0.974135876,634,67,928,361,294,294,rainbow dash
2039160.png,https://derpicdn.net/img/view/2019/5/15/2039160.png,0,0.982192993,29,98,2336,2618,2307,2520,rainbow dash
2040174.png,https://derpicdn.net/img/view/2019/5/16/2040174.png,0,0.986237407,28,0,504,427,476,427,rainbow dash
2041595.png,https://derpicdn.net/img/view/2019/5/17/2041595.png,0,0.968508422,85,0,803,681,718,681,rainbow dash
2051352.png,https://derpicdn.net/img/view/2019/5/28/2051352.png,0,0.986746132,63,0,443,343,380,343,rainbow dash
205263.png,https://derpicdn.net/img/view/2013/1/7/205263.png,0,0.995767474,22,0,576,500,554,500,rainbow dash
2054240.png,https://derpicdn.net/img/view/2019/5/31/2054240.png,0,0.981289983,0,5,365,393,365,388,rainbow dash
2055062.png,https://derpicdn.net/img/view/2019/6/1/2055062.png,0,0.974573553,527,0,917,342,390,342,rainbow dash
2057662.png,https://derpicdn.net/img/view/2019/6/4/2057662.png,0,0.937656343,140,0,612,461,472,461,rainbow dash
2058262.png,https://derpicdn.net/img/view/2019/6/5/2058262.png,0,0.994398415,1257,169,1991,903,734,734,rainbow dash
2058266.png,https://derpicdn.net/img/view/2019/6/5/2058266.png,0,0.942385077,1230,42,2024,882,794,840,rainbow dash
2059396.png,https://derpicdn.net/img/view/2019/6/6/2059396.png,0,0.99830687,376,0,764,384,388,384,rainbow dash
2061125.png,https://derpicdn.net/img/view/2019/6/9/2061125.png,0,0.995019317,74,363,2252,2541,2178,2178,rainbow dash
2068686.png,https://derpicdn.net/img/view/2019/6/18/2068686.png,0,0.991239309,0,0,477,510,477,510,rainbow dash
2068975.png,https://derpicdn.net/img/view/2019/6/18/2068975.png,0,0.913081408,94,0,662,502,568,502,rainbow dash
2072362.png,https://derpicdn.net/img/view/2019/6/22/2072362.png,0,0.986569107,66,20,512,526,446,506,rainbow dash
2078821.png,https://derpicdn.net/img/view/2019/6/29/2078821.png,0,0.989908695,440,0,894,381,454,381,rainbow dash
2079666.png,https://derpicdn.net/img/view/2019/6/30/2079666.png,0,0.995704293,374,7,938,571,564,564,rainbow dash
2081669.png,https://derpicdn.net/img/view/2019/7/3/2081669.png,0,0.983011127,37,0,747,726,710,726,rainbow dash
2088617.png,https://derpicdn.net/img/view/2019/7/11/2088617.png,0,0.994838297,23,0,261,203,238,203,rainbow dash
2094447.png,https://derpicdn.net/img/view/2019/7/18/2094447.png,0,0.905128896,362,181,946,765,584,584,rainbow dash
2096814.png,https://derpicdn.net/img/view/2019/7/20/2096814.png,0,0.993847311,902,52,2402,1552,1500,1500,rainbow dash
2099481.png,https://derpicdn.net/img/view/2019/7/23/2099481.png,0,0.968612313,849,382,1993,1526,1144,1144,rainbow dash
2099966.png,https://derpicdn.net/img/view/2019/7/24/2099966.png,0,0.942534566,620,32,906,318,286,286,rainbow dash
2111243.png,https://derpicdn.net/img/view/2019/8/7/2111243.png,0,0.907543838,72,63,888,879,816,816,rainbow dash
2112194.png,https://derpicdn.net/img/view/2019/8/8/2112194.png,0,0.938262224,174,0,722,545,548,545,rainbow dash
2113423.png,https://derpicdn.net/img/view/2019/8/9/2113423.png,0,0.971047699,105,0,857,681,752,681,rainbow dash
2119459.png,https://derpicdn.net/img/view/2019/8/16/2119459.png,0,0.996109664,4599,0,8427,3840,3828,3840,rainbow dash
2126743.png,https://derpicdn.net/img/view/2019/8/25/2126743.png,0,0.992700458,12,0,1112,1051,1100,1051,rainbow dash
2129968.png,https://derpicdn.net/img/view/2019/8/28/2129968.png,0,0.997975767,149,0,725,575,576,575,rainbow dash
2130966.png,https://derpicdn.net/img/view/2019/8/29/2130966.png,0,0.913155675,377,208,957,788,580,580,rainbow dash
2139120.png,https://derpicdn.net/img/view/2019/9/8/2139120.png,0,0.993610978,243,0,643,384,400,384,rainbow dash
2139955.png,https://derpicdn.net/img/view/2019/9/9/2139955.png,0,0.91121453,1228,57,2182,1011,954,954,rainbow dash
2142361.png,https://derpicdn.net/img/view/2019/9/12/2142361.png,0,0.980840743,2010,440,3152,1582,1142,1142,rainbow dash
2142594.png,https://derpicdn.net/img/view/2019/9/12/2142594.png,0,0.99678421,396,0,936,535,540,535,rainbow dash
2142968.png,https://derpicdn.net/img/view/2019/9/13/2142968.png,0,0.974675953,0,72,1002,1146,1002,1074,rainbow dash
2149805.png,https://derpicdn.net/img/view/2019/9/21/2149805.png,0,0.906358659,40,0,412,350,372,350,rainbow dash
215073.png,https://derpicdn.net/img/view/2013/1/17/215073.png,0,0.975379586,85,10,391,316,306,306,rainbow dash
2157393.png,https://derpicdn.net/img/view/2019/10/1/2157393.png,0,0.980716169,5,28,425,448,420,420,rainbow dash
2158196.png,https://derpicdn.net/img/view/2019/10/2/2158196.png,0,0.950810492,160,0,492,308,332,308,rainbow dash
2158585.png,https://derpicdn.net/img/view/2019/10/2/2158585.png,0,0.994256973,152,0,5824,5441,5672,5441,rainbow dash
2170892.png,https://derpicdn.net/img/view/2019/10/16/2170892.png,0,0.942726791,7,0,543,512,536,512,rainbow dash
2170892.png,https://derpicdn.net/img/view/2019/10/16/2170892.png,1,0.931408465,0,372,507,952,507,580,rainbow dash
2173282.png,https://derpicdn.net/img/view/2019/10/19/2173282.png,0,0.948750973,0,0,644,563,644,563,rainbow dash
2175290.png,https://derpicdn.net/img/view/2019/10/21/2175290.png,0,0.99231106,422,85,774,437,352,352,rainbow dash
2175290.png,https://derpicdn.net/img/view/2019/10/21/2175290.png,1,0.968300462,753,317,1259,823,506,506,rainbow dash
2181488.png,https://derpicdn.net/img/view/2019/10/28/2181488.png,0,0.990272284,1194,0,1846,631,652,631,rainbow dash
2181952.png,https://derpicdn.net/img/view/2019/10/29/2181952.png,0,0.999751508,256,6,798,548,542,542,rainbow dash
2189285.png,https://derpicdn.net/img/view/2019/11/7/2189285.png,0,0.992267311,217,0,3400,3464,3183,3464,rainbow dash
21930.png,https://derpicdn.net/img/view/2012/6/26/21930.png,0,0.922360897,143,0,509,361,366,361,rainbow dash
2194286.png,https://derpicdn.net/img/view/2019/11/12/2194286.png,0,0.998510242,0,324,492,820,492,496,rainbow dash
2194286.png,https://derpicdn.net/img/view/2019/11/12/2194286.png,1,0.974203169,393,0,1339,896,946,896,rainbow dash
2197133.png,https://derpicdn.net/img/view/2019/11/16/2197133.png,0,0.95132941,646,69,1142,565,496,496,rainbow dash
2203370.png,https://derpicdn.net/img/view/2019/11/23/2203370.png,0,0.917991579,0,25,388,439,388,414,rainbow dash
2205182.png,https://derpicdn.net/img/view/2019/11/25/2205182.png,0,0.99090153,819,447,1443,1071,624,624,rainbow dash
2209240.png,https://derpicdn.net/img/view/2019/11/30/2209240.png,0,0.992058575,1667,0,4494,2927,2827,2927,rainbow dash
2210934.png,https://derpicdn.net/img/view/2019/12/2/2210934.png,0,0.982156634,35,0,499,453,464,453,rainbow dash
2211261.png,https://derpicdn.net/img/view/2019/12/3/2211261.png,0,0.987774193,2,0,354,311,352,311,rainbow dash
2213006.png,https://derpicdn.net/img/view/2019/12/5/2213006.png,0,0.926978827,0,0,2092,2219,2092,2219,rainbow dash
2215082.png,https://derpicdn.net/img/view/2019/12/7/2215082.png,0,0.989151835,121,0,937,801,816,801,rainbow dash
2216991.png,https://derpicdn.net/img/view/2019/12/10/2216991.png,0,0.994642079,18,16,860,858,842,842,rainbow dash
2217767.png,https://derpicdn.net/img/view/2019/12/11/2217767.png,0,0.975996971,0,0,891,928,891,928,rainbow dash
2221792.png,https://derpicdn.net/img/view/2019/12/16/2221792.png,0,0.928662539,201,62,576,444,375,382,rainbow dash
2221836.png,https://derpicdn.net/img/view/2019/12/16/2221836.png,0,0.989088178,46,63,600,617,554,554,rainbow dash
2223491.png,https://derpicdn.net/img/view/2019/12/18/2223491.png,0,0.995813012,453,0,953,466,500,466,rainbow dash
2227208.png,https://derpicdn.net/img/view/2019/12/22/2227208.png,0,0.991099417,941,111,1763,933,822,822,rainbow dash
2227208.png,https://derpicdn.net/img/view/2019/12/22/2227208.png,1,0.98157239,333,2,1219,888,886,886,rainbow dash
2227522.png,https://derpicdn.net/img/view/2019/12/23/2227522.png,0,0.979315579,21,0,367,331,346,331,rainbow dash
2230205.png,https://derpicdn.net/img/view/2019/12/26/2230205.png,0,0.923011124,407,123,1597,1313,1190,1190,rainbow dash
2230415.jpg,https://derpicdn.net/img/view/2019/12/26/2230415.jpg,0,0.987305284,1100,976,1878,1754,778,778,rainbow dash
2231166.jpg,https://derpicdn.net/img/view/2019/12/27/2231166.jpg,0,0.923450768,0,0,427,447,427,447,rainbow dash
2231655.jpg,https://derpicdn.net/img/view/2019/12/28/2231655.jpg,0,0.998067737,311,113,791,593,480,480,rainbow dash
2234164.png,https://derpicdn.net/img/view/2019/12/30/2234164.png,0,0.998947382,0,0,1087,1091,1087,1091,rainbow dash
2234776.png,https://derpicdn.net/img/view/2019/12/31/2234776.png,0,0.944493055,0,15,527,603,527,588,rainbow dash
223580.png,https://derpicdn.net/img/view/2013/1/25/223580.png,0,0.949212372,88,0,920,801,832,801,rainbow dash
2238180.png,https://derpicdn.net/img/view/2020/1/4/2238180.png,0,0.940952659,0,0,2320,3002,2320,3002,rainbow dash
2239315.jpg,https://derpicdn.net/img/view/2020/1/5/2239315.jpg,0,0.963138044,396,8,1376,988,980,980,rainbow dash
2241864.png,https://derpicdn.net/img/view/2020/1/8/2241864.png,0,0.99613446,1386,74,2076,764,690,690,rainbow dash
2241864.png,https://derpicdn.net/img/view/2020/1/8/2241864.png,1,0.916065156,1785,0,2645,755,860,755,rainbow dash
224671.png,https://derpicdn.net/img/view/2013/1/26/224671.png,0,0.987044215,1206,199,1742,735,536,536,rainbow dash
2247328.png,https://derpicdn.net/img/view/2020/1/14/2247328.png,0,0.995370686,354,0,666,302,312,302,rainbow dash
2250096.png,https://derpicdn.net/img/view/2020/1/18/2250096.png,0,0.982857704,274,0,1044,714,770,714,rainbow dash
2255036.jpg,https://derpicdn.net/img/view/2020/1/23/2255036.jpg,0,0.992836535,100,73,754,727,654,654,rainbow dash
225506.jpg,https://derpicdn.net/img/view/2013/1/27/225506.jpg,0,0.984658539,192,0,472,279,280,279,rainbow dash
2256232.jpg,https://derpicdn.net/img/view/2020/1/25/2256232.jpg,0,0.980076909,27,4,401,378,374,374,rainbow dash
2257110.jpg,https://derpicdn.net/img/view/2020/1/26/2257110.jpg,0,0.986194432,95,131,679,715,584,584,rainbow dash
2257625.jpg,https://derpicdn.net/img/view/2020/1/26/2257625.jpg,0,0.956837535,412,66,1246,900,834,834,rainbow dash
2257673.jpg,https://derpicdn.net/img/view/2020/1/26/2257673.jpg,0,0.97464633,962,0,1602,608,640,608,rainbow dash
2259531.png,https://derpicdn.net/img/view/2020/1/28/2259531.png,0,0.999540031,167,95,707,635,540,540,rainbow dash
2259766.png,https://derpicdn.net/img/view/2020/1/28/2259766.png,0,0.978964269,0,6,644,710,644,704,rainbow dash
2259939.png,https://derpicdn.net/img/view/2020/1/29/2259939.png,0,0.979112625,0,24,759,854,759,830,rainbow dash
2260721.jpg,https://derpicdn.net/img/view/2020/1/29/2260721.jpg,0,0.973637104,0,338,2048,2662,2048,2324,rainbow dash
2261482.png,https://derpicdn.net/img/view/2020/1/30/2261482.png,0,0.984968543,13,0,2405,2384,2392,2384,rainbow dash
2264521.png,https://derpicdn.net/img/view/2020/2/3/2264521.png,0,0.996922314,127,1,641,515,514,514,rainbow dash
2268027.png,https://derpicdn.net/img/view/2020/2/7/2268027.png,0,0.995615304,92,77,974,959,882,882,rainbow dash
2268140.png,https://derpicdn.net/img/view/2020/2/7/2268140.png,0,0.978463829,31,77,665,711,634,634,rainbow dash
2268144.png,https://derpicdn.net/img/view/2020/2/7/2268144.png,0,0.959449351,0,38,596,660,596,622,rainbow dash
2268145.png,https://derpicdn.net/img/view/2020/2/7/2268145.png,0,0.963761926,151,0,991,826,840,826,rainbow dash
2268147.png,https://derpicdn.net/img/view/2020/2/7/2268147.png,0,0.983858705,57,42,840,844,783,802,rainbow dash
2268379.png,https://derpicdn.net/img/view/2020/2/8/2268379.png,0,0.941916287,114,791,624,1301,510,510,rainbow dash
2270008.jpg,https://derpicdn.net/img/view/2020/2/9/2270008.jpg,0,0.997246444,466,134,924,592,458,458,rainbow dash
2276362.png,https://derpicdn.net/img/view/2020/2/17/2276362.png,0,0.996998191,185,372,1039,1226,854,854,rainbow dash
2277015.jpg,https://derpicdn.net/img/view/2020/2/17/2277015.jpg,0,0.995388567,258,64,1056,862,798,798,rainbow dash
2278574.png,https://derpicdn.net/img/view/2020/2/19/2278574.png,0,0.987002969,132,7,630,505,498,498,rainbow dash
2281007.png,https://derpicdn.net/img/view/2020/2/22/2281007.png,0,0.999139726,10,86,654,730,644,644,rainbow dash
2283905.png,https://derpicdn.net/img/view/2020/2/26/2283905.png,0,0.99207747,289,0,643,292,354,292,rainbow dash
2284827.png,https://derpicdn.net/img/view/2020/2/27/2284827.png,0,0.994960189,1172,205,2332,1365,1160,1160,rainbow dash
2284827.png,https://derpicdn.net/img/view/2020/2/27/2284827.png,1,0.993693888,0,804,1069,1900,1069,1096,rainbow dash
2284942.jpg,https://derpicdn.net/img/view/2020/2/27/2284942.jpg,0,0.933559775,66,16,566,516,500,500,rainbow dash
2286379.jpg,https://derpicdn.net/img/view/2020/2/29/2286379.jpg,0,0.997730792,34,49,586,601,552,552,rainbow dash
2286382.png,https://derpicdn.net/img/view/2020/2/29/2286382.png,0,0.993151426,0,0,879,901,879,901,rainbow dash
2287389.png,https://derpicdn.net/img/view/2020/3/1/2287389.png,1,0.952880621,158,894,334,1070,176,176,rainbow dash
2291551.png,https://derpicdn.net/img/view/2020/3/6/2291551.png,0,0.953800499,178,215,522,559,344,344,rainbow dash
2293690.png,https://derpicdn.net/img/view/2020/3/9/2293690.png,0,0.98975569,1554,284,2244,974,690,690,rainbow dash
2293744.jpg,https://derpicdn.net/img/view/2020/3/9/2293744.jpg,0,0.98779583,137,1706,1025,2594,888,888,rainbow dash
2293744.jpg,https://derpicdn.net/img/view/2020/3/9/2293744.jpg,1,0.947380781,1005,272,1991,1258,986,986,rainbow dash
2297232.png,https://derpicdn.net/img/view/2020/3/14/2297232.png,0,0.962318003,72,72,718,670,646,598,rainbow dash
2299452.png,https://derpicdn.net/img/view/2020/3/17/2299452.png,0,0.988177359,768,0,1478,569,710,569,rainbow dash
2300616.png,https://derpicdn.net/img/view/2020/3/18/2300616.png,0,0.982209146,79,0,615,495,536,495,rainbow dash
2301502.jpg,https://derpicdn.net/img/view/2020/3/20/2301502.jpg,0,0.998561382,304,12,1280,988,976,976,rainbow dash
2301732.png,https://derpicdn.net/img/view/2020/3/20/2301732.png,0,0.986685872,58,0,604,481,546,481,rainbow dash
2303559.png,https://derpicdn.net/img/view/2020/3/22/2303559.png,0,0.953914165,605,0,901,295,296,295,rainbow dash
2306623.png,https://derpicdn.net/img/view/2020/3/26/2306623.png,0,0.977027774,72,0,2812,2658,2740,2658,rainbow dash
2308481.png,https://derpicdn.net/img/view/2020/3/28/2308481.png,0,0.969675899,370,392,1144,1166,774,774,rainbow dash
2309491.png,https://derpicdn.net/img/view/2020/3/30/2309491.png,0,0.942774236,0,13,572,601,572,588,rainbow dash
2315150.png,https://derpicdn.net/img/view/2020/4/6/2315150.png,0,0.929615736,353,0,1469,842,1116,842,rainbow dash
2319267.png,https://derpicdn.net/img/view/2020/4/11/2319267.png,0,0.999483466,326,0,796,460,470,460,rainbow dash
2319331.png,https://derpicdn.net/img/view/2020/4/11/2319331.png,0,0.914902449,11,35,975,999,964,964,rainbow dash
2324581.png,https://derpicdn.net/img/view/2020/4/17/2324581.png,0,0.998532772,534,2,1806,1274,1272,1272,rainbow dash
2324998.png,https://derpicdn.net/img/view/2020/4/17/2324998.png,0,0.979669571,0,0,454,415,454,415,rainbow dash
2328601.jpg,https://derpicdn.net/img/view/2020/4/22/2328601.jpg,0,0.975141466,0,0,464,321,464,321,rainbow dash
2330655.png,https://derpicdn.net/img/view/2020/4/24/2330655.png,0,0.993743539,0,0,442,412,442,412,rainbow dash
2331474.jpg,https://derpicdn.net/img/view/2020/4/25/2331474.jpg,0,0.977049589,194,0,516,315,322,315,rainbow dash
2332420.png,https://derpicdn.net/img/view/2020/4/26/2332420.png,0,0.998375177,35,0,1223,1170,1188,1170,rainbow dash
2333546.png,https://derpicdn.net/img/view/2020/4/28/2333546.png,0,0.963754773,22,0,450,403,428,403,rainbow dash
2334015.jpg,https://derpicdn.net/img/view/2020/4/28/2334015.jpg,0,0.997879088,1169,50,2013,894,844,844,rainbow dash
2340144.png,https://derpicdn.net/img/view/2020/5/5/2340144.png,0,0.998479068,0,100,690,840,690,740,rainbow dash
2342066.png,https://derpicdn.net/img/view/2020/5/7/2342066.png,0,0.982356369,184,36,768,620,584,584,rainbow dash
2344607.jpg,https://derpicdn.net/img/view/2020/5/10/2344607.jpg,0,0.97373265,245,22,531,308,286,286,rainbow dash
2344973.jpg,https://derpicdn.net/img/view/2020/5/10/2344973.jpg,0,0.971332729,23,38,533,514,510,476,rainbow dash
2345007.png,https://derpicdn.net/img/view/2020/5/10/2345007.png,0,0.997417927,136,9,472,345,336,336,rainbow dash
2345026.png,https://derpicdn.net/img/view/2020/5/10/2345026.png,0,0.982617497,0,0,657,746,657,746,rainbow dash
2345809.png,https://derpicdn.net/img/view/2020/5/11/2345809.png,0,0.905823529,107,34,1203,1130,1096,1096,rainbow dash
2346055.jpg,https://derpicdn.net/img/view/2020/5/12/2346055.jpg,0,0.983635485,165,45,695,575,530,530,rainbow dash
2346750.png,https://derpicdn.net/img/view/2020/5/12/2346750.png,0,0.93424046,2919,0,7277,4072,4358,4072,rainbow dash
2346957.jpg,https://derpicdn.net/img/view/2020/5/12/2346957.jpg,0,0.988228977,35,48,1811,1824,1776,1776,rainbow dash
2347238.png,https://derpicdn.net/img/view/2020/5/13/2347238.png,0,0.976882815,373,0,3000,2937,2627,2937,rainbow dash
2350034.jpg,https://derpicdn.net/img/view/2020/5/16/2350034.jpg,0,0.985317409,0,0,1363,1328,1363,1328,rainbow dash
2351235.png,https://derpicdn.net/img/view/2020/5/17/2351235.png,0,0.994237959,156,0,564,390,408,390,rainbow dash
2355027.png,https://derpicdn.net/img/view/2020/5/22/2355027.png,0,0.939646602,162,51,400,289,238,238,rainbow dash
2356216.jpg,https://derpicdn.net/img/view/2020/5/23/2356216.jpg,0,0.971739948,388,0,1192,743,804,743,rainbow dash
236786.png,https://derpicdn.net/img/view/2013/2/8/236786.png,0,0.998841226,604,59,2402,1857,1798,1798,rainbow dash
24196.png,https://derpicdn.net/img/view/2012/6/28/24196.png,0,0.949502468,450,55,720,325,270,270,rainbow dash
242353.jpg,https://derpicdn.net/img/view/2013/2/13/242353.jpg,0,0.943472922,54,0,462,399,408,399,rainbow dash
24475.png,https://derpicdn.net/img/view/2012/6/28/24475.png,0,0.98643744,107,27,367,287,260,260,rainbow dash
251369.png,https://derpicdn.net/img/view/2013/2/22/251369.png,0,0.986983418,187,3,899,715,712,712,rainbow dash
254033.png,https://derpicdn.net/img/view/2013/2/24/254033.png,0,0.99602592,387,32,779,424,392,392,rainbow dash
255840.png,https://derpicdn.net/img/view/2013/2/26/255840.png,0,0.984850407,847,70,1907,1130,1060,1060,rainbow dash
26051.png,https://derpicdn.net/img/view/2012/6/30/26051.png,0,0.975092292,0,0,719,821,719,821,rainbow dash
267855.png,https://derpicdn.net/img/view/2013/3/11/267855.png,0,0.934167743,73,14,311,252,238,238,rainbow dash
275462.png,https://derpicdn.net/img/view/2013/3/20/275462.png,0,0.986572802,150,0,1922,1758,1772,1758,rainbow dash
280798.png,https://derpicdn.net/img/view/2013/3/27/280798.png,0,0.997113407,121,6,473,358,352,352,rainbow dash
281276.png,https://derpicdn.net/img/view/2013/3/28/281276.png,0,0.905476987,91,149,500,600,409,451,rainbow dash
283387.png,https://derpicdn.net/img/view/2013/3/30/283387.png,0,0.967208087,39,4,613,578,574,574,rainbow dash
286767.jpg,https://derpicdn.net/img/view/2013/4/3/286767.jpg,0,0.978615463,0,25,299,329,299,304,rainbow dash
286878.png,https://derpicdn.net/img/view/2013/4/3/286878.png,0,0.952967107,335,0,877,463,542,463,rainbow dash
2898.png,https://derpicdn.net/img/view/2012/2/2/2898.png,0,0.997423589,392,66,798,472,406,406,rainbow dash
30502.png,https://derpicdn.net/img/view/2012/7/3/30502.png,0,0.965340793,114,20,480,386,366,366,rainbow dash
306697.jpg,https://derpicdn.net/img/view/2013/4/23/306697.jpg,0,0.999565303,36,57,586,607,550,550,rainbow dash
32051.png,https://derpicdn.net/img/view/2012/7/5/32051.png,0,0.989925742,34,0,236,200,202,200,rainbow dash
326330.png,https://derpicdn.net/img/view/2013/5/16/326330.png,0,0.92006135,1146,0,1920,690,774,690,rainbow dash
327466.png,https://derpicdn.net/img/view/2013/5/17/327466.png,0,0.984101653,0,0,684,684,684,684,rainbow dash
332805.png,https://derpicdn.net/img/view/2013/5/24/332805.png,0,0.920602679,411,34,777,400,366,366,rainbow dash
341799.jpg,https://derpicdn.net/img/view/2013/6/6/341799.jpg,0,0.98891741,0,86,573,610,573,524,rainbow dash
341799.jpg,https://derpicdn.net/img/view/2013/6/6/341799.jpg,1,0.967588425,95,0,582,522,487,522,rainbow dash
341799.jpg,https://derpicdn.net/img/view/2013/6/6/341799.jpg,2,0.933472693,0,0,474,505,474,505,rainbow dash
345232.png,https://derpicdn.net/img/view/2013/6/10/345232.png,0,0.997922242,645,45,1735,1135,1090,1090,rainbow dash
358332.png,https://derpicdn.net/img/view/2013/6/27/358332.png,0,0.998604059,57,0,405,337,348,337,rainbow dash
3646.png,https://derpicdn.net/img/view/2012/2/29/3646.png,0,0.940716803,445,244,793,592,348,348,rainbow dash
3646.png,https://derpicdn.net/img/view/2012/2/29/3646.png,1,0.936790347,306,107,596,397,290,290,rainbow dash
365654.jpg,https://derpicdn.net/img/view/2013/7/6/365654.jpg,0,0.990821481,301,0,743,399,442,399,rainbow dash
366448.png,https://derpicdn.net/img/view/2013/7/7/366448.png,0,0.986239672,1144,0,3000,1915,1856,1915,rainbow dash
373008.png,https://derpicdn.net/img/view/2013/7/13/373008.png,0,0.991517603,150,0,526,358,376,358,rainbow dash
378780.jpg,https://derpicdn.net/img/view/2013/7/19/378780.jpg,0,0.9494192,0,0,2160,2311,2160,2311,rainbow dash
37991.jpg,https://derpicdn.net/img/view/2012/7/9/37991.jpg,0,0.998581648,88,6,282,200,194,194,rainbow dash
396290.png,https://derpicdn.net/img/view/2013/8/10/396290.png,0,0.981818914,687,542,1305,1160,618,618,rainbow dash
404578.png,https://derpicdn.net/img/view/2013/8/19/404578.png,0,0.965079367,636,0,1326,642,690,642,rainbow dash
405171.png,https://derpicdn.net/img/view/2013/8/20/405171.png,0,0.996355832,729,174,1757,1202,1028,1028,rainbow dash
407514.png,https://derpicdn.net/img/view/2013/8/22/407514.png,0,0.996866465,3132,0,5652,2389,2520,2389,rainbow dash
41083.jpg,https://derpicdn.net/img/view/2012/7/12/41083.jpg,0,0.989488661,858,0,1316,445,458,445,rainbow dash
41083.jpg,https://derpicdn.net/img/view/2012/7/12/41083.jpg,1,0.961720288,303,402,631,730,328,328,rainbow dash
412502.png,https://derpicdn.net/img/view/2013/8/27/412502.png,0,0.998259068,112,0,1296,1180,1184,1180,rainbow dash
416144.png,https://derpicdn.net/img/view/2013/9/1/416144.png,0,0.981127203,1336,465,2256,1385,920,920,rainbow dash
424495.png,https://derpicdn.net/img/view/2013/9/10/424495.png,0,0.989098132,648,1,1502,855,854,854,rainbow dash
4245.png,https://derpicdn.net/img/view/2012/6/3/4245.png,0,0.979831278,190,9,880,699,690,690,rainbow dash
435970.png,https://derpicdn.net/img/view/2013/9/27/435970.png,0,0.962762058,647,1121,1143,1617,496,496,rainbow dash
439175.jpg,https://derpicdn.net/img/view/2013/10/1/439175.jpg,0,0.962676108,856,331,1244,719,388,388,rainbow dash
451869.png,https://derpicdn.net/img/view/2013/10/19/451869.png,0,0.982671797,434,0,928,492,494,492,rainbow dash
457901.png,https://derpicdn.net/img/view/2013/10/27/457901.png,0,0.987647474,25,0,543,498,518,498,rainbow dash
47664.jpg,https://derpicdn.net/img/view/2012/7/18/47664.jpg,0,0.998311222,271,470,611,810,340,340,rainbow dash
47664.jpg,https://derpicdn.net/img/view/2012/7/18/47664.jpg,1,0.912902176,330,0,618,261,288,261,rainbow dash
491814.png,https://derpicdn.net/img/view/2013/12/7/491814.png,0,0.980255961,163,57,797,691,634,634,rainbow dash
49343.png,https://derpicdn.net/img/view/2012/7/19/49343.png,0,0.966519237,3002,270,4136,1404,1134,1134,rainbow dash
493545.png,https://derpicdn.net/img/view/2013/12/9/493545.png,0,0.995462239,38,0,967,1024,929,1024,rainbow dash
494066.png,https://derpicdn.net/img/view/2013/12/10/494066.png,0,0.946233273,133,0,460,357,327,357,rainbow dash
496927.png,https://derpicdn.net/img/view/2013/12/14/496927.png,0,0.963206291,19,27,273,245,254,218,rainbow dash
500815.png,https://derpicdn.net/img/view/2013/12/19/500815.png,0,0.998814881,968,0,3032,1971,2064,1971,rainbow dash
508268.png,https://derpicdn.net/img/view/2013/12/28/508268.png,0,0.999520659,102,0,446,325,344,325,rainbow dash
509883.png,https://derpicdn.net/img/view/2013/12/30/509883.png,0,0.997376084,786,106,1052,372,266,266,rainbow dash
511372.png,https://derpicdn.net/img/view/2013/12/31/511372.png,0,0.952467561,807,744,1199,1136,392,392,rainbow dash
522748.png,https://derpicdn.net/img/view/2014/1/12/522748.png,0,0.964008093,177,5,977,805,800,800,rainbow dash
535188.jpg,https://derpicdn.net/img/view/2014/1/26/535188.jpg,0,0.933050811,166,0,574,406,408,406,rainbow dash
536093.png,https://derpicdn.net/img/view/2014/1/27/536093.png,0,0.985441685,375,325,771,721,396,396,rainbow dash
538014.jpg,https://derpicdn.net/img/view/2014/1/29/538014.jpg,0,0.991858661,0,78,2909,3082,2909,3004,rainbow dash
540402.png,https://derpicdn.net/img/view/2014/2/1/540402.png,0,0.998113155,184,0,592,402,408,402,rainbow dash
542948.png,https://derpicdn.net/img/view/2014/2/4/542948.png,0,0.992368579,159,49,853,720,694,671,rainbow dash
546163.png,https://derpicdn.net/img/view/2014/2/8/546163.png,0,0.982683063,9,34,735,760,726,726,rainbow dash
546877.png,https://derpicdn.net/img/view/2014/2/8/546877.png,0,0.915497541,592,245,842,495,250,250,rainbow dash
55717.png,https://derpicdn.net/img/view/2012/7/25/55717.png,0,0.989439368,0,0,588,623,588,623,rainbow dash
576146.png,https://derpicdn.net/img/view/2014/3/15/576146.png,0,0.996796727,237,0,565,306,328,306,rainbow dash
576248.png,https://derpicdn.net/img/view/2014/3/15/576248.png,1,0.943833768,0,0,270,249,270,249,rainbow dash
585032.png,https://derpicdn.net/img/view/2014/3/25/585032.png,0,0.986851096,760,104,1330,676,570,572,rainbow dash
596895.png,https://derpicdn.net/img/view/2014/4/10/596895.png,0,0.996155381,87,15,343,271,256,256,rainbow dash
604957.png,https://derpicdn.net/img/view/2014/4/19/604957.png,0,0.925087392,442,0,1380,705,938,705,rainbow dash
6116.png,https://derpicdn.net/img/view/2012/6/18/6116.png,0,0.942478001,0,0,608,558,608,558,rainbow dash
626500.png,https://derpicdn.net/img/view/2014/5/14/626500.png,0,0.994420409,407,0,1031,585,624,585,rainbow dash
632604.jpg,https://derpicdn.net/img/view/2014/5/21/632604.jpg,0,0.942164123,473,12,1299,838,826,826,rainbow dash
633967.jpg,https://derpicdn.net/img/view/2014/5/22/633967.jpg,0,0.970288634,284,0,936,628,652,628,rainbow dash
634124.png,https://derpicdn.net/img/view/2014/5/23/634124.png,0,0.98011744,715,0,1661,930,946,930,rainbow dash
636171.png,https://derpicdn.net/img/view/2014/5/25/636171.png,0,0.980123162,715,0,1661,930,946,930,rainbow dash
646376.png,https://derpicdn.net/img/view/2014/6/6/646376.png,0,0.995874763,136,0,1972,1828,1836,1828,rainbow dash
647456.png,https://derpicdn.net/img/view/2014/6/7/647456.png,0,0.91747421,280,36,562,318,282,282,rainbow dash
658144.jpg,https://derpicdn.net/img/view/2014/6/21/658144.jpg,0,0.986176848,477,47,879,449,402,402,rainbow dash
666649.png,https://derpicdn.net/img/view/2014/7/3/666649.png,0,0.989869177,89,29,485,425,396,396,rainbow dash
668135.png,https://derpicdn.net/img/view/2014/7/5/668135.png,0,0.975661755,714,0,1990,1233,1276,1233,rainbow dash
669819.png,https://derpicdn.net/img/view/2014/7/7/669819.png,0,0.944600642,176,0,1688,1080,1512,1080,rainbow dash
676190.png,https://derpicdn.net/img/view/2014/7/16/676190.png,0,0.999529541,4086,0,7768,3483,3682,3483,rainbow dash
676676.png,https://derpicdn.net/img/view/2014/7/17/676676.png,0,0.999758065,592,97,934,439,342,342,rainbow dash
698807.jpg,https://derpicdn.net/img/view/2014/8/13/698807.jpg,0,0.998206973,100,253,358,511,258,258,rainbow dash
7025.png,https://derpicdn.net/img/view/2012/6/18/7025.png,0,0.961211443,1467,253,2201,987,734,734,rainbow dash
702935.png,https://derpicdn.net/img/view/2014/8/19/702935.png,0,0.998681426,209,21,599,411,390,390,rainbow dash
7031.png,https://derpicdn.net/img/view/2012/6/18/7031.png,0,0.998789489,0,255,2058,2323,2058,2068,rainbow dash
704623.png,https://derpicdn.net/img/view/2014/8/21/704623.png,0,0.995877087,538,15,1470,947,932,932,rainbow dash
710517.png,https://derpicdn.net/img/view/2014/8/29/710517.png,0,0.994692206,414,302,608,496,194,194,rainbow dash
712821.png,https://derpicdn.net/img/view/2014/9/1/712821.png,0,0.983552456,468,153,760,445,292,292,rainbow dash
72663.png,https://derpicdn.net/img/view/2012/8/12/72663.png,0,0.998066664,55,106,389,440,334,334,rainbow dash
727295.png,https://derpicdn.net/img/view/2014/9/22/727295.png,0,0.923409462,170,0,1096,895,926,895,rainbow dash
729032.png,https://derpicdn.net/img/view/2014/9/25/729032.png,0,0.998440981,215,0,1059,814,844,814,rainbow dash
729132.png,https://derpicdn.net/img/view/2014/9/25/729132.png,0,0.938085496,231,81,453,303,222,222,rainbow dash
730041.png,https://derpicdn.net/img/view/2014/9/26/730041.png,0,0.9823277,91,3,367,279,276,276,rainbow dash
730045.png,https://derpicdn.net/img/view/2014/9/26/730045.png,0,0.994573474,1712,0,3918,2143,2206,2143,rainbow dash
746160.png,https://derpicdn.net/img/view/2014/10/19/746160.png,0,0.972200572,0,0,511,480,511,480,rainbow dash
747432.jpg,https://derpicdn.net/img/view/2014/10/21/747432.jpg,0,0.984873652,999,42,2056,1118,1057,1076,rainbow dash
764822.png,https://derpicdn.net/img/view/2014/11/15/764822.png,0,0.982116163,0,0,1450,1368,1450,1368,rainbow dash
765605.jpg,https://derpicdn.net/img/view/2014/11/16/765605.jpg,0,0.940047443,49,0,600,546,551,546,rainbow dash
767744.jpg,https://derpicdn.net/img/view/2014/11/19/767744.jpg,0,0.98897171,402,27,756,381,354,354,rainbow dash
768367.png,https://derpicdn.net/img/view/2014/11/20/768367.png,0,0.977654219,124,10,1000,886,876,876,rainbow dash
7705.png,https://derpicdn.net/img/view/2012/6/18/7705.png,0,0.989279628,466,405,870,809,404,404,rainbow dash
771591.png,https://derpicdn.net/img/view/2014/11/25/771591.png,0,0.994148374,0,573,582,1194,582,621,rainbow dash
772707.png,https://derpicdn.net/img/view/2014/11/27/772707.png,0,0.98880136,398,0,1498,1058,1100,1058,rainbow dash
79135.png,https://derpicdn.net/img/view/2012/8/21/79135.png,0,0.995641232,1,0,325,312,324,312,rainbow dash
792622.png,https://derpicdn.net/img/view/2014/12/25/792622.png,0,0.938325703,295,0,555,241,260,241,rainbow dash
794210.jpg,https://derpicdn.net/img/view/2014/12/28/794210.jpg,0,0.997104228,68,10,316,258,248,248,rainbow dash
795746.jpg,https://derpicdn.net/img/view/2014/12/30/795746.jpg,0,0.996159315,357,38,733,414,376,376,rainbow dash
796655.png,https://derpicdn.net/img/view/2014/12/31/796655.png,0,0.985209405,0,4,423,446,423,442,rainbow dash
802221.jpg,https://derpicdn.net/img/view/2015/1/8/802221.jpg,0,0.936971784,164,148,536,520,372,372,rainbow dash
802858.png,https://derpicdn.net/img/view/2015/1/9/802858.png,0,0.992509246,443,40,679,276,236,236,rainbow dash
803994.png,https://derpicdn.net/img/view/2015/1/11/803994.png,0,0.998685837,356,0,1028,671,672,671,rainbow dash
803996.jpg,https://derpicdn.net/img/view/2015/1/11/803996.jpg,0,0.984425247,70,0,516,440,446,440,rainbow dash
81228.jpg,https://derpicdn.net/img/view/2012/8/23/81228.jpg,0,0.989323795,191,0,877,672,686,672,rainbow dash
823855.png,https://derpicdn.net/img/view/2015/2/8/823855.png,0,0.933763742,276,194,1322,1240,1046,1046,rainbow dash
829258.jpg,https://derpicdn.net/img/view/2015/2/15/829258.jpg,0,0.969674349,114,31,532,449,418,418,rainbow dash
830212.png,https://derpicdn.net/img/view/2015/2/16/830212.png,0,0.975636005,184,13,1590,1419,1406,1406,rainbow dash
843689.png,https://derpicdn.net/img/view/2015/3/6/843689.png,0,0.901448488,77,0,409,346,332,346,rainbow dash
844380.png,https://derpicdn.net/img/view/2015/3/7/844380.png,0,0.996784389,148,147,504,503,356,356,rainbow dash
848787.png,https://derpicdn.net/img/view/2015/3/13/848787.png,0,0.996662557,430,0,740,259,310,259,rainbow dash
85553.jpg,https://derpicdn.net/img/view/2012/8/29/85553.jpg,0,0.986555934,647,20,2023,1396,1376,1376,rainbow dash
863833.png,https://derpicdn.net/img/view/2015/4/3/863833.png,0,0.93433851,0,0,814,815,814,815,rainbow dash
868321.png,https://derpicdn.net/img/view/2015/4/7/868321.png,0,0.987510741,123,292,461,630,338,338,rainbow dash
869194.png,https://derpicdn.net/img/view/2015/4/8/869194.png,0,0.995812237,342,0,772,409,430,409,rainbow dash
869229.png,https://derpicdn.net/img/view/2015/4/8/869229.png,0,0.984241843,1650,0,10000,8826,8350,8826,rainbow dash
872630.jpg,https://derpicdn.net/img/view/2015/4/12/872630.jpg,0,0.998078763,373,0,1051,660,678,660,rainbow dash
873394.png,https://derpicdn.net/img/view/2015/4/13/873394.png,0,0.981796026,315,1345,1209,2239,894,894,rainbow dash
88071.png,https://derpicdn.net/img/view/2012/9/1/88071.png,0,0.98941946,0,0,575,340,575,340,rainbow dash
882816.png,https://derpicdn.net/img/view/2015/4/25/882816.png,0,0.92420882,3368,0,7289,4075,3921,4075,rainbow dash
8933.png,https://derpicdn.net/img/view/2012/6/19/8933.png,0,0.997371256,37,0,495,453,458,453,rainbow dash
893802.png,https://derpicdn.net/img/view/2015/5/11/893802.png,0,0.990310669,244,0,626,375,382,375,rainbow dash
894115.png,https://derpicdn.net/img/view/2015/5/11/894115.png,0,0.972729504,715,0,1333,589,618,589,rainbow dash
898355.png,https://derpicdn.net/img/view/2015/5/17/898355.png,0,0.997543216,386,0,1142,636,756,636,rainbow dash
900728.png,https://derpicdn.net/img/view/2015/5/20/900728.png,0,0.994179904,564,171,1398,1005,834,834,rainbow dash
906413.png,https://derpicdn.net/img/view/2015/5/29/906413.png,0,0.97410661,973,976,1389,1392,416,416,rainbow dash
906413.png,https://derpicdn.net/img/view/2015/5/29/906413.png,1,0.963845968,1855,90,2313,548,458,458,rainbow dash
90782.png,https://derpicdn.net/img/view/2012/9/5/90782.png,0,0.999529064,383,635,853,1105,470,470,rainbow dash
90782.png,https://derpicdn.net/img/view/2012/9/5/90782.png,1,0.999243081,109,112,541,544,432,432,rainbow dash
925967.png,https://derpicdn.net/img/view/2015/6/29/925967.png,0,0.980838656,61,15,309,263,248,248,rainbow dash
926846.jpg,https://derpicdn.net/img/view/2015/6/30/926846.jpg,0,0.99533844,400,1043,1056,1717,656,674,rainbow dash
928178.png,https://derpicdn.net/img/view/2015/7/2/928178.png,0,0.935249031,491,0,1019,451,528,451,rainbow dash
954339.png,https://derpicdn.net/img/view/2015/8/9/954339.png,0,0.956146896,5261,0,7949,2653,2688,2653,rainbow dash
964111.png,https://derpicdn.net/img/view/2015/8/23/964111.png,0,0.928556085,505,83,739,317,234,234,rainbow dash
974842.png,https://derpicdn.net/img/view/2015/9/7/974842.png,0,0.999009967,210,201,544,535,334,334,rainbow dash
976462.png,https://derpicdn.net/img/view/2015/9/10/976462.png,0,0.93599081,439,144,1015,720,576,576,rainbow dash
1002185.jpeg,https://derpicdn.net/img/view/2015/10/14/1002185.jpeg,0,0.989434063,0,0,2886,2857,2886,2857,rainbow dash
1010033.jpeg,https://derpicdn.net/img/view/2015/10/25/1010033.jpeg,0,0.998919308,165,0,1249,902,1084,902,rainbow dash
1013509.jpeg,https://derpicdn.net/img/view/2015/10/31/1013509.jpeg,0,0.962858796,98,7,633,563,535,556,rainbow dash
1019351.jpeg,https://derpicdn.net/img/view/2015/11/9/1019351.jpeg,0,0.992640316,112,0,444,311,332,311,rainbow dash
1020657.jpeg,https://derpicdn.net/img/view/2015/11/11/1020657.jpeg,0,0.997310758,514,0,3304,2615,2790,2615,rainbow dash
1024081.jpeg,https://derpicdn.net/img/view/2015/11/16/1024081.jpeg,0,0.906876743,207,0,1431,1196,1224,1196,rainbow dash
1025515.jpeg,https://derpicdn.net/img/view/2015/11/18/1025515.jpeg,0,0.986176968,678,2,1362,686,684,684,rainbow dash
1027537.jpeg,https://derpicdn.net/img/view/2015/11/22/1027537.jpeg,0,0.995567918,56,918,2138,3000,2082,2082,rainbow dash
1028577.jpeg,https://derpicdn.net/img/view/2015/11/23/1028577.jpeg,0,0.998558581,32,0,424,357,392,357,rainbow dash
1030087.jpeg,https://derpicdn.net/img/view/2015/11/25/1030087.jpeg,0,0.993868649,19,9,775,765,756,756,rainbow dash
1030281.jpeg,https://derpicdn.net/img/view/2015/11/26/1030281.jpeg,0,0.973079801,239,59,505,325,266,266,rainbow dash
1031318.jpeg,https://derpicdn.net/img/view/2015/11/27/1031318.jpeg,0,0.995686352,164,0,550,351,386,351,rainbow dash
1032173.jpeg,https://derpicdn.net/img/view/2015/11/28/1032173.jpeg,0,0.996660411,816,43,1146,373,330,330,rainbow dash
1035836.jpeg,https://derpicdn.net/img/view/2015/12/3/1035836.jpeg,0,0.95696187,455,74,909,528,454,454,rainbow dash
1045224.jpeg,https://derpicdn.net/img/view/2015/12/15/1045224.jpeg,0,0.936064541,271,11,1235,975,964,964,rainbow dash
1055511.jpeg,https://derpicdn.net/img/view/2015/12/30/1055511.jpeg,0,0.994741738,740,740,1592,1592,852,852,rainbow dash
1066398.jpeg,https://derpicdn.net/img/view/2016/1/14/1066398.jpeg,0,0.992038846,329,0,1056,718,727,718,rainbow dash
1073751.jpeg,https://derpicdn.net/img/view/2016/1/25/1073751.jpeg,0,0.99944973,11,0,1931,1545,1920,1545,rainbow dash
1076003.jpeg,https://derpicdn.net/img/view/2016/1/29/1076003.jpeg,0,0.999282956,1075,238,3045,2208,1970,1970,rainbow dash
1078760.jpeg,https://derpicdn.net/img/view/2016/2/2/1078760.jpeg,0,0.99972564,760,0,1150,359,390,359,rainbow dash
1078762.jpeg,https://derpicdn.net/img/view/2016/2/2/1078762.jpeg,0,0.954696834,82,437,416,771,334,334,rainbow dash
1079965.jpeg,https://derpicdn.net/img/view/2016/2/4/1079965.jpeg,0,0.919148028,145,8,1065,928,920,920,rainbow dash
1082715.jpeg,https://derpicdn.net/img/view/2016/2/7/1082715.jpeg,0,0.999443233,740,195,1438,893,698,698,rainbow dash
1082745.jpeg,https://derpicdn.net/img/view/2016/2/7/1082745.jpeg,0,0.983973801,1528,22,3304,1798,1776,1776,rainbow dash
1088869.jpeg,https://derpicdn.net/img/view/2016/2/15/1088869.jpeg,0,0.999449134,333,46,1199,912,866,866,rainbow dash
1088873.jpeg,https://derpicdn.net/img/view/2016/2/15/1088873.jpeg,0,0.996291578,180,0,884,647,704,647,rainbow dash
1094448.jpeg,https://derpicdn.net/img/view/2016/2/22/1094448.jpeg,0,0.95777756,734,190,1538,994,804,804,rainbow dash
1099562.jpeg,https://derpicdn.net/img/view/2016/2/29/1099562.jpeg,0,0.994877696,191,2,467,278,276,276,rainbow dash
1104611.jpeg,https://derpicdn.net/img/view/2016/3/8/1104611.jpeg,0,0.999862075,1341,635,2309,1603,968,968,rainbow dash
1106099.jpeg,https://derpicdn.net/img/view/2016/3/10/1106099.jpeg,0,0.947656095,205,62,1627,1484,1422,1422,rainbow dash
1106187.jpeg,https://derpicdn.net/img/view/2016/3/10/1106187.jpeg,0,0.99885565,34,8,434,408,400,400,rainbow dash
1106692.jpeg,https://derpicdn.net/img/view/2016/3/11/1106692.jpeg,0,0.974127889,27,0,639,607,612,607,rainbow dash
1119056.jpeg,https://derpicdn.net/img/view/2016/3/28/1119056.jpeg,0,0.981048346,627,0,1255,545,628,545,rainbow dash
1122721.jpeg,https://derpicdn.net/img/view/2016/4/2/1122721.jpeg,0,0.993781865,1311,0,2500,1222,1189,1222,rainbow dash
1126164.jpeg,https://derpicdn.net/img/view/2016/4/6/1126164.jpeg,0,0.992443383,874,0,2388,1371,1514,1371,rainbow dash
1131081.jpeg,https://derpicdn.net/img/view/2016/4/13/1131081.jpeg,0,0.997369289,23,8,419,404,396,396,rainbow dash
1135517.jpeg,https://derpicdn.net/img/view/2016/4/19/1135517.jpeg,0,0.951794684,266,0,800,432,534,432,rainbow dash
1137872.jpeg,https://derpicdn.net/img/view/2016/4/22/1137872.jpeg,0,0.996991575,360,0,2330,1922,1970,1922,rainbow dash
1140129.jpeg,https://derpicdn.net/img/view/2016/4/26/1140129.jpeg,0,0.989553154,293,42,953,702,660,660,rainbow dash
1144024.jpeg,https://derpicdn.net/img/view/2016/5/1/1144024.jpeg,0,0.940267801,328,8,636,316,308,308,rainbow dash
1144024.jpeg,https://derpicdn.net/img/view/2016/5/1/1144024.jpeg,1,0.907943249,590,7,912,329,322,322,rainbow dash
1148402.jpeg,https://derpicdn.net/img/view/2016/5/7/1148402.jpeg,0,0.978458285,219,0,1403,925,1184,925,rainbow dash
1148618.jpeg,https://derpicdn.net/img/view/2016/5/7/1148618.jpeg,0,0.95383662,537,0,1065,469,528,469,rainbow dash
1149348.jpeg,https://derpicdn.net/img/view/2016/5/8/1149348.jpeg,0,0.98850131,771,0,1831,963,1060,963,rainbow dash
1150914.jpeg,https://derpicdn.net/img/view/2016/5/10/1150914.jpeg,0,0.982342839,350,0,902,551,552,551,rainbow dash
1153884.jpeg,https://derpicdn.net/img/view/2016/5/14/1153884.jpeg,0,0.983201385,139,0,2000,1950,1861,1950,rainbow dash
1169884.jpeg,https://derpicdn.net/img/view/2016/6/4/1169884.jpeg,0,0.989730656,630,0,1234,594,604,594,rainbow dash
1186622.jpeg,https://derpicdn.net/img/view/2016/6/25/1186622.jpeg,0,0.968527198,1116,121,4032,3037,2916,2916,rainbow dash
1202395.jpeg,https://derpicdn.net/img/view/2016/7/16/1202395.jpeg,0,0.992292464,223,0,597,366,374,366,rainbow dash
1203206.jpeg,https://derpicdn.net/img/view/2016/7/17/1203206.jpeg,0,0.915141046,211,9,707,505,496,496,rainbow dash
1204190.jpeg,https://derpicdn.net/img/view/2016/7/19/1204190.jpeg,0,0.984021068,508,0,1546,1029,1038,1029,rainbow dash
1208059.jpeg,https://derpicdn.net/img/view/2016/7/24/1208059.jpeg,0,0.996506453,719,0,1920,946,1201,946,rainbow dash
1212493.jpeg,https://derpicdn.net/img/view/2016/7/30/1212493.jpeg,0,0.986186385,51,0,783,662,732,662,rainbow dash
1212513.jpeg,https://derpicdn.net/img/view/2016/7/30/1212513.jpeg,0,0.962271512,613,98,971,456,358,358,rainbow dash
1212626.jpeg,https://derpicdn.net/img/view/2016/7/30/1212626.jpeg,0,0.957189322,171,0,729,534,558,534,rainbow dash
1212842.jpeg,https://derpicdn.net/img/view/2016/7/30/1212842.jpeg,0,0.94689393,1349,0,1979,497,630,497,rainbow dash
1214167.jpeg,https://derpicdn.net/img/view/2016/8/1/1214167.jpeg,0,0.997151971,387,0,823,434,436,434,rainbow dash
1214993.jpeg,https://derpicdn.net/img/view/2016/8/2/1214993.jpeg,0,0.998942196,297,0,887,561,590,561,rainbow dash
1214996.jpeg,https://derpicdn.net/img/view/2016/8/2/1214996.jpeg,1,0.9782601,654,0,1142,412,488,412,rainbow dash
1215773.jpeg,https://derpicdn.net/img/view/2016/8/3/1215773.jpeg,0,0.996147156,368,58,1576,1266,1208,1208,rainbow dash
1216842.jpeg,https://derpicdn.net/img/view/2016/8/4/1216842.jpeg,0,0.998287439,1629,45,3051,1467,1422,1422,rainbow dash
1217596.jpeg,https://derpicdn.net/img/view/2016/8/5/1217596.jpeg,0,0.966232717,0,0,2645,2258,2645,2258,rainbow dash
1218052.jpeg,https://derpicdn.net/img/view/2016/8/6/1218052.jpeg,0,0.995145977,0,37,558,621,558,584,rainbow dash
1222142.jpeg,https://derpicdn.net/img/view/2016/8/10/1222142.jpeg,0,0.996878922,554,0,1418,839,864,839,rainbow dash
1223040.jpeg,https://derpicdn.net/img/view/2016/8/12/1223040.jpeg,0,0.906833053,486,171,964,649,478,478,rainbow dash
1223393.jpeg,https://derpicdn.net/img/view/2016/8/12/1223393.jpeg,0,0.911328673,1033,77,1723,767,690,690,rainbow dash
1224706.jpeg,https://derpicdn.net/img/view/2016/8/14/1224706.jpeg,0,0.967523277,58,58,658,658,600,600,rainbow dash
1227793.jpeg,https://derpicdn.net/img/view/2016/8/18/1227793.jpeg,0,0.976723731,147,0,673,510,526,510,rainbow dash
1228442.jpeg,https://derpicdn.net/img/view/2016/8/19/1228442.jpeg,0,0.907009065,131,11,455,335,324,324,rainbow dash
1232745.jpeg,https://derpicdn.net/img/view/2016/8/24/1232745.jpeg,0,0.99965781,309,15,1127,833,818,818,rainbow dash
1235299.jpeg,https://derpicdn.net/img/view/2016/8/27/1235299.jpeg,0,0.986281097,520,286,2238,2004,1718,1718,rainbow dash
1244981.jpeg,https://derpicdn.net/img/view/2016/9/9/1244981.jpeg,0,0.997995555,472,0,1490,998,1018,998,rainbow dash
1249689.jpeg,https://derpicdn.net/img/view/2016/9/15/1249689.jpeg,0,0.998232543,30,0,482,410,452,410,rainbow dash
1249689.jpeg,https://derpicdn.net/img/view/2016/9/15/1249689.jpeg,1,0.907834649,395,0,1200,700,805,700,rainbow dash
1253148.jpeg,https://derpicdn.net/img/view/2016/9/19/1253148.jpeg,0,0.92054981,100,0,562,374,462,374,rainbow dash
1255191.jpeg,https://derpicdn.net/img/view/2016/9/22/1255191.jpeg,0,0.99716419,1033,167,1773,907,740,740,rainbow dash
1259211.jpeg,https://derpicdn.net/img/view/2016/9/27/1259211.jpeg,0,0.998153687,881,0,1839,908,958,908,rainbow dash
1263391.jpeg,https://derpicdn.net/img/view/2016/10/2/1263391.jpeg,0,0.941764295,316,0,1138,870,822,870,rainbow dash
1271971.jpeg,https://derpicdn.net/img/view/2016/10/13/1271971.jpeg,0,0.98602879,165,0,1141,902,976,902,rainbow dash
1281208.jpeg,https://derpicdn.net/img/view/2016/10/25/1281208.jpeg,0,0.96419251,133,5,763,635,630,630,rainbow dash
1284221.jpeg,https://derpicdn.net/img/view/2016/10/29/1284221.jpeg,0,0.958853722,1390,156,2132,898,742,742,rainbow dash
1284222.jpeg,https://derpicdn.net/img/view/2016/10/29/1284222.jpeg,0,0.946512759,1374,145,2138,909,764,764,rainbow dash
1284224.jpeg,https://derpicdn.net/img/view/2016/10/29/1284224.jpeg,0,0.95398277,1379,149,2137,907,758,758,rainbow dash
1284225.jpeg,https://derpicdn.net/img/view/2016/10/29/1284225.jpeg,0,0.957239866,1374,148,2132,906,758,758,rainbow dash
1286314.jpeg,https://derpicdn.net/img/view/2016/11/1/1286314.jpeg,0,0.976059794,164,0,668,445,504,445,rainbow dash
1286962.jpeg,https://derpicdn.net/img/view/2016/11/2/1286962.jpeg,0,0.998066783,656,0,1376,697,720,697,rainbow dash
1288679.jpeg,https://derpicdn.net/img/view/2016/11/4/1288679.jpeg,0,0.982453048,328,8,752,432,424,424,rainbow dash
1288679.jpeg,https://derpicdn.net/img/view/2016/11/4/1288679.jpeg,1,0.910697341,70,102,404,436,334,334,rainbow dash
1298286.jpeg,https://derpicdn.net/img/view/2016/11/18/1298286.jpeg,0,0.981119156,0,73,1219,1437,1219,1364,rainbow dash
1301659.jpeg,https://derpicdn.net/img/view/2016/11/23/1301659.jpeg,0,0.999110222,380,0,1048,655,668,655,rainbow dash
1302663.jpeg,https://derpicdn.net/img/view/2016/11/24/1302663.jpeg,0,0.999271095,149,5,677,533,528,528,rainbow dash
1305841.jpeg,https://derpicdn.net/img/view/2016/11/29/1305841.jpeg,0,0.92276299,2135,666,2671,1202,536,536,rainbow dash
1311487.jpeg,https://derpicdn.net/img/view/2016/12/6/1311487.jpeg,0,0.983148038,676,29,2092,1445,1416,1416,rainbow dash
1311683.jpeg,https://derpicdn.net/img/view/2016/12/7/1311683.jpeg,0,0.983869016,0,0,776,747,776,747,rainbow dash
1312101.jpeg,https://derpicdn.net/img/view/2016/12/7/1312101.jpeg,0,0.943173409,0,0,362,413,362,413,rainbow dash
1317087.jpeg,https://derpicdn.net/img/view/2016/12/14/1317087.jpeg,0,0.975270867,392,0,822,422,430,422,rainbow dash
1317712.jpeg,https://derpicdn.net/img/view/2016/12/15/1317712.jpeg,0,0.961128175,310,38,494,222,184,184,rainbow dash
1325820.jpeg,https://derpicdn.net/img/view/2016/12/26/1325820.jpeg,0,0.979255795,1003,0,4877,3810,3874,3810,rainbow dash
1329102.jpeg,https://derpicdn.net/img/view/2016/12/31/1329102.jpeg,0,0.935052693,45,0,527,394,482,394,rainbow dash
1332768.jpeg,https://derpicdn.net/img/view/2017/1/5/1332768.jpeg,0,0.988527656,99,20,481,402,382,382,rainbow dash
1333737.jpeg,https://derpicdn.net/img/view/2017/1/7/1333737.jpeg,0,0.977637827,143,11,425,293,282,282,rainbow dash
1337481.jpeg,https://derpicdn.net/img/view/2017/1/11/1337481.jpeg,0,0.981347442,0,0,448,451,448,451,rainbow dash
1340009.jpeg,https://derpicdn.net/img/view/2017/1/15/1340009.jpeg,0,0.96992439,1156,0,2014,823,858,823,rainbow dash
1342920.jpeg,https://derpicdn.net/img/view/2017/1/19/1342920.jpeg,0,0.996020555,713,44,1280,638,567,594,rainbow dash
1343095.jpeg,https://derpicdn.net/img/view/2017/1/19/1343095.jpeg,0,0.998182654,189,0,549,349,360,349,rainbow dash
1343095.jpeg,https://derpicdn.net/img/view/2017/1/19/1343095.jpeg,1,0.992012858,193,409,545,761,352,352,rainbow dash
1344309.jpeg,https://derpicdn.net/img/view/2017/1/21/1344309.jpeg,0,0.992233932,212,0,1978,1563,1766,1563,rainbow dash
1346784.jpeg,https://derpicdn.net/img/view/2017/1/24/1346784.jpeg,0,0.968388677,129,0,1641,1300,1512,1300,rainbow dash
1349571.jpeg,https://derpicdn.net/img/view/2017/1/28/1349571.jpeg,0,0.982540905,391,32,725,366,334,334,rainbow dash
1350525.jpeg,https://derpicdn.net/img/view/2017/1/29/1350525.jpeg,0,0.994991302,271,79,627,435,356,356,rainbow dash
1350721.jpeg,https://derpicdn.net/img/view/2017/1/29/1350721.jpeg,0,0.968872845,813,0,1557,650,744,650,rainbow dash
1350859.jpeg,https://derpicdn.net/img/view/2017/1/30/1350859.jpeg,0,0.969914556,134,0,748,555,614,555,rainbow dash
1351089.jpeg,https://derpicdn.net/img/view/2017/1/30/1351089.jpeg,0,0.990485609,1119,75,2951,1907,1832,1832,rainbow dash
1352477.jpeg,https://derpicdn.net/img/view/2017/2/1/1352477.jpeg,0,0.972176552,353,0,763,384,410,384,rainbow dash
1353820.jpeg,https://derpicdn.net/img/view/2017/2/2/1353820.jpeg,0,0.989991903,0,0,799,756,799,756,rainbow dash
1354970.jpeg,https://derpicdn.net/img/view/2017/2/4/1354970.jpeg,0,0.997043192,88,0,560,413,472,413,rainbow dash
1358563.jpeg,https://derpicdn.net/img/view/2017/2/9/1358563.jpeg,0,0.995929897,189,0,741,546,552,546,rainbow dash
1361271.jpeg,https://derpicdn.net/img/view/2017/2/12/1361271.jpeg,0,0.986736178,296,0,730,433,434,433,rainbow dash
1369236.jpeg,https://derpicdn.net/img/view/2017/2/21/1369236.jpeg,0,0.991902471,283,2,675,394,392,392,rainbow dash
1375115.jpeg,https://derpicdn.net/img/view/2017/2/27/1375115.jpeg,0,0.979668617,664,75,1242,653,578,578,rainbow dash
1375814.jpeg,https://derpicdn.net/img/view/2017/2/28/1375814.jpeg,0,0.998946726,202,0,1002,791,800,791,rainbow dash
1376898.jpeg,https://derpicdn.net/img/view/2017/3/1/1376898.jpeg,0,0.986432433,749,102,1277,630,528,528,rainbow dash
1379885.jpeg,https://derpicdn.net/img/view/2017/3/5/1379885.jpeg,0,0.954345822,252,0,982,726,730,726,rainbow dash
1379977.jpeg,https://derpicdn.net/img/view/2017/3/5/1379977.jpeg,0,0.98677212,50,67,792,809,742,742,rainbow dash
1380798.jpeg,https://derpicdn.net/img/view/2017/3/6/1380798.jpeg,0,0.982568145,186,0,1140,670,954,670,rainbow dash
1382759.jpeg,https://derpicdn.net/img/view/2017/3/9/1382759.jpeg,0,0.997107685,272,0,518,225,246,225,rainbow dash
1383702.jpeg,https://derpicdn.net/img/view/2017/3/10/1383702.jpeg,0,0.996910512,231,0,715,476,484,476,rainbow dash
1385379.jpeg,https://derpicdn.net/img/view/2017/3/12/1385379.jpeg,0,0.997420371,827,911,1745,1829,918,918,rainbow dash
1385887.jpeg,https://derpicdn.net/img/view/2017/3/13/1385887.jpeg,0,0.992361426,605,34,1181,610,576,576,rainbow dash
1386168.jpeg,https://derpicdn.net/img/view/2017/3/13/1386168.jpeg,0,0.990387917,283,0,2765,2157,2482,2157,rainbow dash
1390739.jpeg,https://derpicdn.net/img/view/2017/3/18/1390739.jpeg,0,0.997283161,1004,0,2934,1799,1930,1799,rainbow dash
1393241.jpeg,https://derpicdn.net/img/view/2017/3/21/1393241.jpeg,0,0.999403536,70,297,1596,1823,1526,1526,rainbow dash
1393313.jpeg,https://derpicdn.net/img/view/2017/3/21/1393313.jpeg,0,0.999290705,268,150,628,510,360,360,rainbow dash
1394398.jpeg,https://derpicdn.net/img/view/2017/3/23/1394398.jpeg,0,0.921625018,607,0,1407,765,800,765,rainbow dash
1394624.jpeg,https://derpicdn.net/img/view/2017/3/23/1394624.jpeg,0,0.99785918,807,0,1785,970,978,970,rainbow dash
1394667.jpeg,https://derpicdn.net/img/view/2017/3/23/1394667.jpeg,0,0.998103499,0,23,984,1031,984,1008,rainbow dash
1395187.jpeg,https://derpicdn.net/img/view/2017/3/24/1395187.jpeg,0,0.997033656,206,43,684,521,478,478,rainbow dash
1401787.jpeg,https://derpicdn.net/img/view/2017/4/2/1401787.jpeg,0,0.934634507,92,35,750,723,658,688,rainbow dash
1403689.jpeg,https://derpicdn.net/img/view/2017/4/4/1403689.jpeg,0,0.996328533,229,0,1109,858,880,858,rainbow dash
1403848.jpeg,https://derpicdn.net/img/view/2017/4/4/1403848.jpeg,0,0.999020994,286,62,620,396,334,334,rainbow dash
1408378.jpeg,https://derpicdn.net/img/view/2017/4/10/1408378.jpeg,0,0.986263335,0,0,1449,1453,1449,1453,rainbow dash
1409485.jpeg,https://derpicdn.net/img/view/2017/4/11/1409485.jpeg,0,0.991350353,0,0,428,429,428,429,rainbow dash
1409716.jpeg,https://derpicdn.net/img/view/2017/4/12/1409716.jpeg,0,0.972454369,158,43,582,467,424,424,rainbow dash
1410432.jpeg,https://derpicdn.net/img/view/2017/4/13/1410432.jpeg,0,0.997039735,174,110,424,360,250,250,rainbow dash
1410665.jpeg,https://derpicdn.net/img/view/2017/4/13/1410665.jpeg,0,0.980368793,51,113,1781,1843,1730,1730,rainbow dash
1411078.jpeg,https://derpicdn.net/img/view/2017/4/14/1411078.jpeg,0,0.979896963,0,0,962,971,962,971,rainbow dash
1411147.jpeg,https://derpicdn.net/img/view/2017/4/14/1411147.jpeg,0,0.998511732,313,0,1487,1041,1174,1041,rainbow dash
1415225.jpeg,https://derpicdn.net/img/view/2017/4/18/1415225.jpeg,1,0.97106266,1413,472,1753,812,340,340,rainbow dash
1416928.jpeg,https://derpicdn.net/img/view/2017/4/20/1416928.jpeg,0,0.989626467,999,0,2067,1040,1068,1040,rainbow dash
1418204.jpeg,https://derpicdn.net/img/view/2017/4/22/1418204.jpeg,1,0.996415973,152,64,560,472,408,408,rainbow dash
1418204.jpeg,https://derpicdn.net/img/view/2017/4/22/1418204.jpeg,2,0.992021978,715,240,1079,604,364,364,rainbow dash
1418351.jpeg,https://derpicdn.net/img/view/2017/4/22/1418351.jpeg,0,0.99603945,134,0,974,784,840,784,rainbow dash
1420573.jpeg,https://derpicdn.net/img/view/2017/4/24/1420573.jpeg,0,0.952356815,112,146,502,536,390,390,rainbow dash
1425640.jpeg,https://derpicdn.net/img/view/2017/4/30/1425640.jpeg,0,0.99794066,385,129,1067,811,682,682,rainbow dash
1426407.jpeg,https://derpicdn.net/img/view/2017/5/1/1426407.jpeg,0,0.983210206,0,0,428,446,428,446,rainbow dash
1426441.jpeg,https://derpicdn.net/img/view/2017/5/1/1426441.jpeg,0,0.982849538,88,0,806,653,718,653,rainbow dash
1427032.jpeg,https://derpicdn.net/img/view/2017/5/2/1427032.jpeg,0,0.98755002,812,0,1784,840,972,840,rainbow dash
1427245.jpeg,https://derpicdn.net/img/view/2017/5/2/1427245.jpeg,0,0.999151886,14,41,390,417,376,376,rainbow dash
1434812.jpeg,https://derpicdn.net/img/view/2017/5/12/1434812.jpeg,0,0.997908771,0,557,997,1555,997,998,rainbow dash
1436055.jpeg,https://derpicdn.net/img/view/2017/5/14/1436055.jpeg,0,0.997841299,160,0,898,712,738,712,rainbow dash
1436142.jpeg,https://derpicdn.net/img/view/2017/5/14/1436142.jpeg,0,0.980491281,112,0,780,657,668,657,rainbow dash
1436436.jpeg,https://derpicdn.net/img/view/2017/5/14/1436436.jpeg,0,0.995255947,83,0,653,545,570,545,rainbow dash
1436622.jpeg,https://derpicdn.net/img/view/2017/5/14/1436622.jpeg,0,0.97348398,23,25,1100,1197,1077,1172,rainbow dash
1436803.jpeg,https://derpicdn.net/img/view/2017/5/14/1436803.jpeg,0,0.992126882,211,0,1233,953,1022,953,rainbow dash
1440335.jpeg,https://derpicdn.net/img/view/2017/5/19/1440335.jpeg,0,0.956059217,439,114,4000,3678,3561,3564,rainbow dash
1449904.jpeg,https://derpicdn.net/img/view/2017/5/30/1449904.jpeg,0,0.951142609,40,0,682,637,642,637,rainbow dash
1451043.jpeg,https://derpicdn.net/img/view/2017/5/31/1451043.jpeg,0,0.998669386,69,0,529,445,460,445,rainbow dash
1451822.jpeg,https://derpicdn.net/img/view/2017/6/2/1451822.jpeg,0,0.995558619,257,0,555,298,298,298,rainbow dash
1452749.jpeg,https://derpicdn.net/img/view/2017/6/3/1452749.jpeg,0,0.989172041,912,0,2246,1274,1334,1274,rainbow dash
1455473.jpeg,https://derpicdn.net/img/view/2017/6/6/1455473.jpeg,0,0.99930644,1363,0,2969,1583,1606,1583,rainbow dash
1457917.jpeg,https://derpicdn.net/img/view/2017/6/10/1457917.jpeg,0,0.942461789,249,116,1487,1354,1238,1238,rainbow dash
1460188.jpeg,https://derpicdn.net/img/view/2017/6/12/1460188.jpeg,0,0.999272823,162,146,1284,1268,1122,1122,rainbow dash
1460798.jpeg,https://derpicdn.net/img/view/2017/6/13/1460798.jpeg,0,0.974022925,0,0,2227,2033,2227,2033,rainbow dash
1462672.jpeg,https://derpicdn.net/img/view/2017/6/15/1462672.jpeg,0,0.999221444,93,66,569,542,476,476,rainbow dash
1463775.jpeg,https://derpicdn.net/img/view/2017/6/17/1463775.jpeg,0,0.999808669,325,0,2135,1542,1810,1542,rainbow dash
1465420.jpeg,https://derpicdn.net/img/view/2017/6/19/1465420.jpeg,0,0.976370335,359,0,1073,683,714,683,rainbow dash
146653.jpeg,https://derpicdn.net/img/view/2012/11/9/146653.jpeg,0,0.956766129,875,300,2737,2162,1862,1862,rainbow dash
1467392.jpeg,https://derpicdn.net/img/view/2017/6/21/1467392.jpeg,0,0.999550283,108,0,608,498,500,498,rainbow dash
1467483.jpeg,https://derpicdn.net/img/view/2017/6/21/1467483.jpeg,0,0.905815065,434,0,980,543,546,543,rainbow dash
1467912.jpeg,https://derpicdn.net/img/view/2017/6/21/1467912.jpeg,0,0.907173336,46,0,290,168,244,168,rainbow dash
1470221.jpeg,https://derpicdn.net/img/view/2017/6/24/1470221.jpeg,0,0.983783484,118,0,1710,1080,1592,1080,rainbow dash
1474240.jpeg,https://derpicdn.net/img/view/2017/6/29/1474240.jpeg,0,0.958238482,240,98,812,670,572,572,rainbow dash
1474321.jpeg,https://derpicdn.net/img/view/2017/6/29/1474321.jpeg,0,0.983397365,1830,87,3150,1407,1320,1320,rainbow dash
1475533.jpeg,https://derpicdn.net/img/view/2017/6/30/1475533.jpeg,0,0.988098323,750,1303,1806,2359,1056,1056,rainbow dash
1475533.jpeg,https://derpicdn.net/img/view/2017/6/30/1475533.jpeg,1,0.978193462,565,248,2021,1704,1456,1456,rainbow dash
1476647.jpeg,https://derpicdn.net/img/view/2017/7/2/1476647.jpeg,0,0.958366036,0,33,777,897,777,864,rainbow dash
1477054.jpeg,https://derpicdn.net/img/view/2017/7/2/1477054.jpeg,0,0.972741485,287,59,1617,1389,1330,1330,rainbow dash
1477100.jpeg,https://derpicdn.net/img/view/2017/7/2/1477100.jpeg,0,0.944416225,0,77,1845,2009,1845,1932,rainbow dash
1477652.jpeg,https://derpicdn.net/img/view/2017/7/3/1477652.jpeg,0,0.99308157,307,0,717,383,410,383,rainbow dash
1481239.jpeg,https://derpicdn.net/img/view/2017/7/8/1481239.jpeg,0,0.91444999,745,111,941,307,196,196,rainbow dash
1486307.jpeg,https://derpicdn.net/img/view/2017/7/14/1486307.jpeg,0,0.914572477,78,104,298,324,220,220,rainbow dash
1487363.jpeg,https://derpicdn.net/img/view/2017/7/16/1487363.jpeg,0,0.970621109,395,261,1005,871,610,610,rainbow dash
1492162.jpeg,https://derpicdn.net/img/view/2017/7/22/1492162.jpeg,0,0.976155639,0,0,2539,2544,2539,2544,rainbow dash
1495347.jpeg,https://derpicdn.net/img/view/2017/7/26/1495347.jpeg,0,0.939829767,0,75,717,885,717,810,rainbow dash
1501929.jpeg,https://derpicdn.net/img/view/2017/8/3/1501929.jpeg,0,0.923567653,538,1753,1846,3061,1308,1308,rainbow dash
1501998.jpeg,https://derpicdn.net/img/view/2017/8/3/1501998.jpeg,0,0.949324012,0,194,1942,2200,1942,2006,rainbow dash
1503238.jpeg,https://derpicdn.net/img/view/2017/8/5/1503238.jpeg,0,0.92550838,0,31,894,959,894,928,rainbow dash
1508017.jpeg,https://derpicdn.net/img/view/2017/8/11/1508017.jpeg,0,0.951927006,2049,132,3061,1144,1012,1012,rainbow dash
1508368.jpeg,https://derpicdn.net/img/view/2017/8/11/1508368.jpeg,0,0.997635305,390,212,944,766,554,554,rainbow dash
1511089.jpeg,https://derpicdn.net/img/view/2017/8/15/1511089.jpeg,0,0.965377033,86,0,600,400,514,400,rainbow dash
1511690.jpeg,https://derpicdn.net/img/view/2017/8/15/1511690.jpeg,0,0.986120999,106,329,1978,2201,1872,1872,rainbow dash
1512601.jpeg,https://derpicdn.net/img/view/2017/8/17/1512601.jpeg,0,0.985505998,1328,122,2278,1072,950,950,rainbow dash
1515488.jpeg,https://derpicdn.net/img/view/2017/8/20/1515488.jpeg,0,0.98029536,215,200,611,596,396,396,rainbow dash
1516223.jpeg,https://derpicdn.net/img/view/2017/8/21/1516223.jpeg,0,0.950466037,71,13,999,941,928,928,rainbow dash
1516540.jpeg,https://derpicdn.net/img/view/2017/8/21/1516540.jpeg,0,0.993799329,0,0,264,237,264,237,rainbow dash
1520690.jpeg,https://derpicdn.net/img/view/2017/8/27/1520690.jpeg,0,0.978783906,0,0,607,699,607,699,rainbow dash
1525153.jpeg,https://derpicdn.net/img/view/2017/9/1/1525153.jpeg,0,0.976020634,205,0,1129,720,924,720,rainbow dash
1528560.jpeg,https://derpicdn.net/img/view/2017/9/5/1528560.jpeg,0,0.915940166,660,0,1028,284,368,284,rainbow dash
1533060.jpeg,https://derpicdn.net/img/view/2017/9/11/1533060.jpeg,0,0.994217217,619,46,1629,1056,1010,1010,rainbow dash
1534467.jpeg,https://derpicdn.net/img/view/2017/9/13/1534467.jpeg,0,0.946332812,399,61,733,395,334,334,rainbow dash
1536350.jpeg,https://derpicdn.net/img/view/2017/9/16/1536350.jpeg,1,0.969389856,1668,0,2916,1178,1248,1178,rainbow dash
1542217.jpeg,https://derpicdn.net/img/view/2017/9/23/1542217.jpeg,0,0.947706103,86,90,422,426,336,336,rainbow dash
1542894.jpeg,https://derpicdn.net/img/view/2017/9/23/1542894.jpeg,0,0.991750181,1236,357,3154,2275,1918,1918,rainbow dash
1546961.jpeg,https://derpicdn.net/img/view/2017/9/28/1546961.jpeg,0,0.997706711,192,0,700,502,508,502,rainbow dash
1549963.jpeg,https://derpicdn.net/img/view/2017/10/2/1549963.jpeg,0,0.93544209,288,25,1338,1075,1050,1050,rainbow dash
1550981.jpeg,https://derpicdn.net/img/view/2017/10/3/1550981.jpeg,0,0.9922809,1186,519,2760,2093,1574,1574,rainbow dash
1555387.jpeg,https://derpicdn.net/img/view/2017/10/8/1555387.jpeg,0,0.917138815,381,0,1439,931,1058,931,rainbow dash
1556314.jpeg,https://derpicdn.net/img/view/2017/10/9/1556314.jpeg,0,0.918249905,1239,273,1589,623,350,350,rainbow dash
1560540.jpeg,https://derpicdn.net/img/view/2017/10/14/1560540.jpeg,0,0.966693044,459,153,1395,1089,936,936,rainbow dash
1562748.jpeg,https://derpicdn.net/img/view/2017/10/16/1562748.jpeg,0,0.984707654,1265,1665,2989,3389,1724,1724,rainbow dash
1563015.jpeg,https://derpicdn.net/img/view/2017/10/16/1563015.jpeg,0,0.989405096,494,301,1012,819,518,518,rainbow dash
1564735.jpeg,https://derpicdn.net/img/view/2017/10/18/1564735.jpeg,0,0.999685466,351,7,1017,673,666,666,rainbow dash
1564941.jpeg,https://derpicdn.net/img/view/2017/10/19/1564941.jpeg,0,0.979688942,194,0,764,516,570,516,rainbow dash
1570436.jpeg,https://derpicdn.net/img/view/2017/10/26/1570436.jpeg,0,0.998168051,0,0,519,551,519,551,rainbow dash
1570819.jpeg,https://derpicdn.net/img/view/2017/10/26/1570819.jpeg,0,0.99264735,2018,402,3114,1498,1096,1096,rainbow dash
1570964.jpeg,https://derpicdn.net/img/view/2017/10/27/1570964.jpeg,0,0.985260427,0,0,2491,2656,2491,2656,rainbow dash
1571296.jpeg,https://derpicdn.net/img/view/2017/10/27/1571296.jpeg,0,0.965946317,0,157,542,771,542,614,rainbow dash
1576972.jpeg,https://derpicdn.net/img/view/2017/11/3/1576972.jpeg,0,0.975009918,0,0,600,760,600,760,rainbow dash
1576972.jpeg,https://derpicdn.net/img/view/2017/11/3/1576972.jpeg,1,0.903800249,10,0,600,761,590,761,rainbow dash
1577161.jpeg,https://derpicdn.net/img/view/2017/11/3/1577161.jpeg,0,0.994257987,159,0,499,325,340,325,rainbow dash
1584029.jpeg,https://derpicdn.net/img/view/2017/11/11/1584029.jpeg,0,0.99369359,115,0,1500,1501,1385,1501,rainbow dash
1584633.jpeg,https://derpicdn.net/img/view/2017/11/12/1584633.jpeg,0,0.961070061,0,0,1613,1511,1613,1511,rainbow dash
1585015.jpeg,https://derpicdn.net/img/view/2017/11/13/1585015.jpeg,0,0.962169468,279,86,759,566,480,480,rainbow dash
1585197.jpeg,https://derpicdn.net/img/view/2017/11/13/1585197.jpeg,0,0.939370692,29,257,1161,1389,1132,1132,rainbow dash
1586059.jpeg,https://derpicdn.net/img/view/2017/11/14/1586059.jpeg,0,0.966518402,691,1178,1815,2302,1124,1124,rainbow dash
1586059.jpeg,https://derpicdn.net/img/view/2017/11/14/1586059.jpeg,1,0.913681507,2095,1743,2829,2477,734,734,rainbow dash
1587374.jpeg,https://derpicdn.net/img/view/2017/11/16/1587374.jpeg,0,0.993952334,184,0,604,398,420,398,rainbow dash
1589252.jpeg,https://derpicdn.net/img/view/2017/11/18/1589252.jpeg,0,0.99989152,204,0,536,332,332,332,rainbow dash
1589486.jpeg,https://derpicdn.net/img/view/2017/11/19/1589486.jpeg,0,0.993337572,34,0,1106,1119,1072,1119,rainbow dash
1592723.jpeg,https://derpicdn.net/img/view/2017/11/23/1592723.jpeg,0,0.997411728,125,0,953,808,828,808,rainbow dash
1595928.jpeg,https://derpicdn.net/img/view/2017/11/28/1595928.jpeg,0,0.996907353,168,0,754,560,586,560,rainbow dash
1596350.jpeg,https://derpicdn.net/img/view/2017/11/28/1596350.jpeg,0,0.928298771,173,0,2347,2080,2174,2080,rainbow dash
1597456.jpeg,https://derpicdn.net/img/view/2017/11/30/1597456.jpeg,0,0.992249429,29,0,587,514,558,514,rainbow dash
1598851.jpeg,https://derpicdn.net/img/view/2017/12/2/1598851.jpeg,0,0.984110296,92,47,508,463,416,416,rainbow dash
1599592.jpeg,https://derpicdn.net/img/view/2017/12/3/1599592.jpeg,0,0.995516956,558,0,1380,710,822,710,rainbow dash
1599736.jpeg,https://derpicdn.net/img/view/2017/12/3/1599736.jpeg,0,0.998296499,202,44,522,364,320,320,rainbow dash
1601972.jpeg,https://derpicdn.net/img/view/2017/12/6/1601972.jpeg,0,0.966831088,54,63,890,957,836,894,rainbow dash
1603249.jpeg,https://derpicdn.net/img/view/2017/12/8/1603249.jpeg,0,0.980183959,0,242,791,1000,791,758,rainbow dash
1603980.jpeg,https://derpicdn.net/img/view/2017/12/9/1603980.jpeg,0,0.949646831,256,0,2512,1951,2256,1951,rainbow dash
1604462.jpeg,https://derpicdn.net/img/view/2017/12/10/1604462.jpeg,0,0.986636877,0,193,382,575,382,382,rainbow dash
1604483.jpeg,https://derpicdn.net/img/view/2017/12/10/1604483.jpeg,0,0.979312837,537,0,765,216,228,216,rainbow dash
1605906.jpeg,https://derpicdn.net/img/view/2017/12/12/1605906.jpeg,0,0.998050153,811,0,1595,701,784,701,rainbow dash
1606846.jpeg,https://derpicdn.net/img/view/2017/12/13/1606846.jpeg,0,0.98947978,845,0,2327,1420,1482,1420,rainbow dash
1606890.jpeg,https://derpicdn.net/img/view/2017/12/13/1606890.jpeg,1,0.948765993,378,0,1906,1528,1528,1528,rainbow dash
1607581.jpeg,https://derpicdn.net/img/view/2017/12/14/1607581.jpeg,0,0.906404555,231,112,1647,1528,1416,1416,rainbow dash
1607606.jpeg,https://derpicdn.net/img/view/2017/12/14/1607606.jpeg,0,0.925488055,129,0,813,629,684,629,rainbow dash
1611535.jpeg,https://derpicdn.net/img/view/2017/12/19/1611535.jpeg,0,0.995498955,514,0,806,247,292,247,rainbow dash
1612637.jpeg,https://derpicdn.net/img/view/2017/12/21/1612637.jpeg,0,0.946143448,247,122,2485,2121,2238,1999,rainbow dash
1615840.jpeg,https://derpicdn.net/img/view/2017/12/25/1615840.jpeg,0,0.988656521,142,0,508,346,366,346,rainbow dash
1618536.jpeg,https://derpicdn.net/img/view/2017/12/29/1618536.jpeg,0,0.981085777,455,155,863,563,408,408,rainbow dash
1619799.jpeg,https://derpicdn.net/img/view/2017/12/30/1619799.jpeg,0,0.950696111,1270,269,2030,1029,760,760,rainbow dash
1619958.jpeg,https://derpicdn.net/img/view/2017/12/30/1619958.jpeg,0,0.998346031,152,58,1000,906,848,848,rainbow dash
1621164.jpeg,https://derpicdn.net/img/view/2018/1/1/1621164.jpeg,0,0.976506114,226,68,558,400,332,332,rainbow dash
1622343.jpeg,https://derpicdn.net/img/view/2018/1/2/1622343.jpeg,0,0.944225729,235,1451,1043,2259,808,808,rainbow dash
1623042.jpeg,https://derpicdn.net/img/view/2018/1/3/1623042.jpeg,0,0.942052901,173,58,2149,2034,1976,1976,rainbow dash
1626991.jpeg,https://derpicdn.net/img/view/2018/1/8/1626991.jpeg,0,0.994242847,55,29,437,411,382,382,rainbow dash
1628647.jpeg,https://derpicdn.net/img/view/2018/1/10/1628647.jpeg,0,0.98749119,448,0,854,371,406,371,rainbow dash
1629342.jpeg,https://derpicdn.net/img/view/2018/1/11/1629342.jpeg,0,0.951295137,377,0,1600,1041,1223,1041,rainbow dash
1629342.jpeg,https://derpicdn.net/img/view/2018/1/11/1629342.jpeg,1,0.945294142,198,0,960,664,762,664,rainbow dash
1631610.jpeg,https://derpicdn.net/img/view/2018/1/14/1631610.jpeg,0,0.997484326,850,0,2258,1244,1408,1244,rainbow dash
1632972.jpeg,https://derpicdn.net/img/view/2018/1/15/1632972.jpeg,0,0.914337695,155,0,1263,720,1108,720,rainbow dash
1633336.jpeg,https://derpicdn.net/img/view/2018/1/16/1633336.jpeg,0,0.985711515,196,0,1784,1080,1588,1080,rainbow dash
1635245.jpeg,https://derpicdn.net/img/view/2018/1/18/1635245.jpeg,0,0.997053981,27,74,667,714,640,640,rainbow dash
1636233.jpeg,https://derpicdn.net/img/view/2018/1/19/1636233.jpeg,0,0.997300684,171,0,463,279,292,279,rainbow dash
1638358.jpeg,https://derpicdn.net/img/view/2018/1/22/1638358.jpeg,0,0.9831056,423,205,1439,1221,1016,1016,rainbow dash
1639331.jpeg,https://derpicdn.net/img/view/2018/1/23/1639331.jpeg,0,0.987581611,1463,0,3165,1471,1702,1471,rainbow dash
1639800.jpeg,https://derpicdn.net/img/view/2018/1/24/1639800.jpeg,0,0.987817049,0,0,2102,2099,2102,2099,rainbow dash
1643640.jpeg,https://derpicdn.net/img/view/2018/1/29/1643640.jpeg,0,0.988050222,288,30,722,464,434,434,rainbow dash
1644154.jpeg,https://derpicdn.net/img/view/2018/1/30/1644154.jpeg,0,0.962888181,233,51,475,293,242,242,rainbow dash
1644155.jpeg,https://derpicdn.net/img/view/2018/1/30/1644155.jpeg,0,0.96619308,179,50,413,284,234,234,rainbow dash
1644710.jpeg,https://derpicdn.net/img/view/2018/1/30/1644710.jpeg,0,0.993045032,951,0,1649,644,698,644,rainbow dash
1645328.jpeg,https://derpicdn.net/img/view/2018/1/31/1645328.jpeg,0,0.991680622,135,0,1279,1090,1144,1090,rainbow dash
1645772.jpeg,https://derpicdn.net/img/view/2018/2/1/1645772.jpeg,0,0.999054909,196,0,924,679,728,679,rainbow dash
1645785.jpeg,https://derpicdn.net/img/view/2018/2/1/1645785.jpeg,0,0.987703443,41,0,327,252,286,252,rainbow dash
1645910.jpeg,https://derpicdn.net/img/view/2018/2/1/1645910.jpeg,0,0.997376204,97,167,723,793,626,626,rainbow dash
1646770.jpeg,https://derpicdn.net/img/view/2018/2/2/1646770.jpeg,0,0.961706579,6,0,378,339,372,339,rainbow dash
1646954.jpeg,https://derpicdn.net/img/view/2018/2/2/1646954.jpeg,0,0.97550422,390,74,716,400,326,326,rainbow dash
1648676.jpeg,https://derpicdn.net/img/view/2018/2/5/1648676.jpeg,0,0.999512613,198,0,982,767,784,767,rainbow dash
1652024.jpeg,https://derpicdn.net/img/view/2018/2/9/1652024.jpeg,0,0.996916652,104,0,1444,1184,1340,1184,rainbow dash
1652418.jpeg,https://derpicdn.net/img/view/2018/2/10/1652418.jpeg,0,0.998687267,118,20,576,478,458,458,rainbow dash
1654741.jpeg,https://derpicdn.net/img/view/2018/2/13/1654741.jpeg,0,0.963873088,259,836,849,1426,590,590,rainbow dash
1655039.jpeg,https://derpicdn.net/img/view/2018/2/13/1655039.jpeg,0,0.991391957,662,75,1268,681,606,606,rainbow dash
1660963.jpeg,https://derpicdn.net/img/view/2018/2/20/1660963.jpeg,0,0.985411227,207,8,495,296,288,288,rainbow dash
1661008.jpeg,https://derpicdn.net/img/view/2018/2/20/1661008.jpeg,0,0.999437034,337,0,579,226,242,226,rainbow dash
1663053.jpeg,https://derpicdn.net/img/view/2018/2/22/1663053.jpeg,0,0.96952039,0,1,1817,1887,1817,1886,rainbow dash
1663217.jpeg,https://derpicdn.net/img/view/2018/2/23/1663217.jpeg,0,0.971305072,60,0,526,404,466,404,rainbow dash
1663289.jpeg,https://derpicdn.net/img/view/2018/2/23/1663289.jpeg,0,0.975960672,264,0,1076,788,812,788,rainbow dash
1663423.jpeg,https://derpicdn.net/img/view/2018/2/23/1663423.jpeg,0,0.932135344,44,0,686,574,642,574,rainbow dash
1663845.jpeg,https://derpicdn.net/img/view/2018/2/23/1663845.jpeg,0,0.941482246,313,237,539,463,226,226,rainbow dash
1665156.jpeg,https://derpicdn.net/img/view/2018/2/25/1665156.jpeg,0,0.99592334,798,0,1454,567,656,567,rainbow dash
1665194.jpeg,https://derpicdn.net/img/view/2018/2/25/1665194.jpeg,0,0.985926211,164,0,678,500,514,500,rainbow dash
1665480.jpeg,https://derpicdn.net/img/view/2018/2/25/1665480.jpeg,0,0.999028623,217,32,1359,1174,1142,1142,rainbow dash
1665606.jpeg,https://derpicdn.net/img/view/2018/2/25/1665606.jpeg,0,0.978529096,87,0,571,462,484,462,rainbow dash
1665899.jpeg,https://derpicdn.net/img/view/2018/2/25/1665899.jpeg,0,0.994002879,0,0,682,659,682,659,rainbow dash
1666138.jpeg,https://derpicdn.net/img/view/2018/2/26/1666138.jpeg,1,0.913400769,86,99,436,449,350,350,rainbow dash
1668379.jpeg,https://derpicdn.net/img/view/2018/2/28/1668379.jpeg,0,0.964024663,355,14,897,556,542,542,rainbow dash
1670441.jpeg,https://derpicdn.net/img/view/2018/3/3/1670441.jpeg,0,0.999576032,625,0,1649,970,1024,970,rainbow dash
1670497.jpeg,https://derpicdn.net/img/view/2018/3/3/1670497.jpeg,0,0.982397556,0,32,541,624,541,592,rainbow dash
1671055.jpeg,https://derpicdn.net/img/view/2018/3/4/1671055.jpeg,0,0.993177056,17,0,731,695,714,695,rainbow dash
1673011.jpeg,https://derpicdn.net/img/view/2018/3/6/1673011.jpeg,0,0.98843962,600,302,1380,1082,780,780,rainbow dash
1673873.jpeg,https://derpicdn.net/img/view/2018/3/7/1673873.jpeg,0,0.995115221,234,0,1528,1118,1294,1118,rainbow dash
1673873.jpeg,https://derpicdn.net/img/view/2018/3/7/1673873.jpeg,1,0.985219061,563,667,1483,1587,920,920,rainbow dash
1674564.jpeg,https://derpicdn.net/img/view/2018/3/8/1674564.jpeg,0,0.996957242,131,45,539,453,408,408,rainbow dash
1674985.jpeg,https://derpicdn.net/img/view/2018/3/9/1674985.jpeg,0,0.967796385,678,115,906,343,228,228,rainbow dash
1675266.jpeg,https://derpicdn.net/img/view/2018/3/9/1675266.jpeg,0,0.990558088,237,1,523,287,286,286,rainbow dash
1679640.jpeg,https://derpicdn.net/img/view/2018/3/14/1679640.jpeg,0,0.997324526,526,0,1444,903,918,903,rainbow dash
1681806.jpeg,https://derpicdn.net/img/view/2018/3/16/1681806.jpeg,0,0.997695267,247,0,1015,663,768,663,rainbow dash
1682223.jpeg,https://derpicdn.net/img/view/2018/3/16/1682223.jpeg,0,0.986204743,101,38,639,576,538,538,rainbow dash
1686066.jpeg,https://derpicdn.net/img/view/2018/3/20/1686066.jpeg,0,0.992916048,359,0,811,402,452,402,rainbow dash
1686550.jpeg,https://derpicdn.net/img/view/2018/3/21/1686550.jpeg,0,0.998319507,281,15,703,437,422,422,rainbow dash
1688862.jpeg,https://derpicdn.net/img/view/2018/3/24/1688862.jpeg,0,0.972488582,109,31,763,685,654,654,rainbow dash
1690951.jpeg,https://derpicdn.net/img/view/2018/3/26/1690951.jpeg,0,0.98899883,28,0,1340,1238,1312,1238,rainbow dash
1693493.jpeg,https://derpicdn.net/img/view/2018/3/29/1693493.jpeg,0,0.958358824,0,0,404,420,404,420,rainbow dash
1696766.jpeg,https://derpicdn.net/img/view/2018/4/1/1696766.jpeg,0,0.980366886,205,73,1085,953,880,880,rainbow dash
1702395.jpeg,https://derpicdn.net/img/view/2018/4/8/1702395.jpeg,0,0.99038136,180,0,764,509,584,509,rainbow dash
1704232.jpeg,https://derpicdn.net/img/view/2018/4/10/1704232.jpeg,0,0.982790589,0,0,897,934,897,934,rainbow dash
1705012.jpeg,https://derpicdn.net/img/view/2018/4/11/1705012.jpeg,1,0.996348143,598,0,1176,475,578,475,rainbow dash
1706642.jpeg,https://derpicdn.net/img/view/2018/4/13/1706642.jpeg,0,0.943987489,567,0,759,168,192,168,rainbow dash
1706642.jpeg,https://derpicdn.net/img/view/2018/4/13/1706642.jpeg,1,0.937018573,23,0,365,317,342,317,rainbow dash
1709827.jpeg,https://derpicdn.net/img/view/2018/4/17/1709827.jpeg,0,0.947007418,0,86,684,820,684,734,rainbow dash
1710716.jpeg,https://derpicdn.net/img/view/2018/4/18/1710716.jpeg,0,0.975944757,261,19,789,547,528,528,rainbow dash
1718572.jpeg,https://derpicdn.net/img/view/2018/4/27/1718572.jpeg,0,0.999134898,491,507,1077,1093,586,586,rainbow dash
1720174.jpeg,https://derpicdn.net/img/view/2018/4/29/1720174.jpeg,0,0.999181032,588,0,1172,506,584,506,rainbow dash
1720679.jpeg,https://derpicdn.net/img/view/2018/4/30/1720679.jpeg,0,0.946436405,244,501,618,931,374,430,rainbow dash
1726393.jpeg,https://derpicdn.net/img/view/2018/5/7/1726393.jpeg,0,0.997915149,163,14,937,788,774,774,rainbow dash
1727995.jpeg,https://derpicdn.net/img/view/2018/5/9/1727995.jpeg,0,0.977715015,282,0,1796,1492,1514,1492,rainbow dash
1729688.jpeg,https://derpicdn.net/img/view/2018/5/11/1729688.jpeg,0,0.994083881,301,0,601,291,300,291,rainbow dash
1730181.jpeg,https://derpicdn.net/img/view/2018/5/11/1730181.jpeg,1,0.983044207,332,179,752,599,420,420,rainbow dash
1730536.jpeg,https://derpicdn.net/img/view/2018/5/12/1730536.jpeg,0,0.995775282,155,38,649,532,494,494,rainbow dash
1730809.jpeg,https://derpicdn.net/img/view/2018/5/12/1730809.jpeg,0,0.990659833,533,21,1241,729,708,708,rainbow dash
1731317.jpeg,https://derpicdn.net/img/view/2018/5/12/1731317.jpeg,0,0.922689199,1000,0,2734,1479,1734,1479,rainbow dash
1731663.jpeg,https://derpicdn.net/img/view/2018/5/13/1731663.jpeg,0,0.985189915,108,28,1408,1328,1300,1300,rainbow dash
1731813.jpeg,https://derpicdn.net/img/view/2018/5/13/1731813.jpeg,0,0.998710155,310,0,632,320,322,320,rainbow dash
1733757.jpeg,https://derpicdn.net/img/view/2018/5/16/1733757.jpeg,0,0.987583578,92,217,940,1065,848,848,rainbow dash
1740362.jpeg,https://derpicdn.net/img/view/2018/5/24/1740362.jpeg,0,0.962791264,376,0,860,453,484,453,rainbow dash
1740565.jpeg,https://derpicdn.net/img/view/2018/5/24/1740565.jpeg,0,0.920260489,115,0,387,253,272,253,rainbow dash
1742711.jpeg,https://derpicdn.net/img/view/2018/5/27/1742711.jpeg,0,0.997404516,90,0,1238,1128,1148,1128,rainbow dash
1744330.jpeg,https://derpicdn.net/img/view/2018/5/29/1744330.jpeg,0,0.991422296,0,0,777,778,777,778,rainbow dash
1745046.jpeg,https://derpicdn.net/img/view/2018/5/30/1745046.jpeg,0,0.997426808,94,0,602,430,508,430,rainbow dash
1746549.jpeg,https://derpicdn.net/img/view/2018/6/1/1746549.jpeg,0,0.984768569,24,183,404,563,380,380,rainbow dash
1755594.jpeg,https://derpicdn.net/img/view/2018/6/11/1755594.jpeg,0,0.999094725,874,214,1716,1056,842,842,rainbow dash
1755595.jpeg,https://derpicdn.net/img/view/2018/6/11/1755595.jpeg,0,0.961789906,1162,783,2296,1917,1134,1134,rainbow dash
1756173.jpeg,https://derpicdn.net/img/view/2018/6/12/1756173.jpeg,0,0.992750347,107,0,1365,1186,1258,1186,rainbow dash
1756346.jpeg,https://derpicdn.net/img/view/2018/6/12/1756346.jpeg,0,0.988411605,98,0,490,377,392,377,rainbow dash
1757354.jpeg,https://derpicdn.net/img/view/2018/6/14/1757354.jpeg,0,0.995357454,143,0,2321,1437,2178,1437,rainbow dash
1758987.jpeg,https://derpicdn.net/img/view/2018/6/16/1758987.jpeg,0,0.998905838,265,143,1161,1039,896,896,rainbow dash
1761223.jpeg,https://derpicdn.net/img/view/2018/6/19/1761223.jpeg,0,0.928293467,0,0,720,812,720,812,rainbow dash
1762834.jpeg,https://derpicdn.net/img/view/2018/6/21/1762834.jpeg,0,0.999221027,243,178,877,812,634,634,rainbow dash
1763312.jpeg,https://derpicdn.net/img/view/2018/6/22/1763312.jpeg,0,0.983472049,26,0,1110,833,1084,833,rainbow dash
1763415.jpeg,https://derpicdn.net/img/view/2018/6/22/1763415.jpeg,0,0.993756771,674,112,1932,1370,1258,1258,rainbow dash
1764187.jpeg,https://derpicdn.net/img/view/2018/6/23/1764187.jpeg,0,0.900806129,5,351,429,775,424,424,rainbow dash
1766410.jpeg,https://derpicdn.net/img/view/2018/6/26/1766410.jpeg,0,0.997954488,339,0,761,410,422,410,rainbow dash
1766929.jpeg,https://derpicdn.net/img/view/2018/6/27/1766929.jpeg,0,0.996139228,339,0,903,479,564,479,rainbow dash
1770056.jpeg,https://derpicdn.net/img/view/2018/7/1/1770056.jpeg,0,0.942502022,1602,204,2204,806,602,602,rainbow dash
1770264.jpeg,https://derpicdn.net/img/view/2018/7/1/1770264.jpeg,0,0.99728781,0,126,894,1038,894,912,rainbow dash
1774456.jpeg,https://derpicdn.net/img/view/2018/7/6/1774456.jpeg,0,0.993005872,55,0,531,458,476,458,rainbow dash
1776721.jpeg,https://derpicdn.net/img/view/2018/7/9/1776721.jpeg,0,0.948159099,351,51,1079,779,728,728,rainbow dash
1776731.jpeg,https://derpicdn.net/img/view/2018/7/9/1776731.jpeg,0,0.94067347,0,0,1307,1528,1307,1528,rainbow dash
1777274.jpeg,https://derpicdn.net/img/view/2018/7/10/1777274.jpeg,0,0.992862105,105,0,1275,1161,1170,1161,rainbow dash
1777578.jpeg,https://derpicdn.net/img/view/2018/7/10/1777578.jpeg,0,0.989916682,129,0,1520,1357,1391,1357,rainbow dash
1778332.jpeg,https://derpicdn.net/img/view/2018/7/11/1778332.jpeg,0,0.977779865,132,0,1442,1135,1310,1135,rainbow dash
1778838.jpeg,https://derpicdn.net/img/view/2018/7/11/1778838.jpeg,0,0.97901994,34,0,1538,1348,1504,1348,rainbow dash
1781505.jpeg,https://derpicdn.net/img/view/2018/7/15/1781505.jpeg,0,0.993463099,271,0,1075,797,804,797,rainbow dash
1782296.jpeg,https://derpicdn.net/img/view/2018/7/16/1782296.jpeg,0,0.984511852,302,0,2000,1690,1698,1690,rainbow dash
1782498.jpeg,https://derpicdn.net/img/view/2018/7/16/1782498.jpeg,0,0.995307028,213,0,713,428,500,428,rainbow dash
1783828.jpeg,https://derpicdn.net/img/view/2018/7/18/1783828.jpeg,0,0.997963965,284,72,682,470,398,398,rainbow dash
1784714.jpeg,https://derpicdn.net/img/view/2018/7/19/1784714.jpeg,0,0.981535375,247,0,973,670,726,670,rainbow dash
1787070.jpeg,https://derpicdn.net/img/view/2018/7/22/1787070.jpeg,0,0.951137185,314,34,942,662,628,628,rainbow dash
1789388.jpeg,https://derpicdn.net/img/view/2018/7/25/1789388.jpeg,0,0.928804576,79,27,1053,1001,974,974,rainbow dash
1789503.jpeg,https://derpicdn.net/img/view/2018/7/25/1789503.jpeg,0,0.993657708,88,0,644,510,556,510,rainbow dash
1790038.jpeg,https://derpicdn.net/img/view/2018/7/26/1790038.jpeg,0,0.999869466,204,239,1016,1051,812,812,rainbow dash
1794957.jpeg,https://derpicdn.net/img/view/2018/8/1/1794957.jpeg,0,0.995887756,172,12,606,446,434,434,rainbow dash
1795266.jpeg,https://derpicdn.net/img/view/2018/8/1/1795266.jpeg,0,0.989732742,229,9,1525,1357,1296,1348,rainbow dash
1799128.jpeg,https://derpicdn.net/img/view/2018/8/5/1799128.jpeg,0,0.965298772,115,61,800,885,685,824,rainbow dash
1799359.jpeg,https://derpicdn.net/img/view/2018/8/6/1799359.jpeg,0,0.957518876,792,51,1920,1080,1128,1029,rainbow dash
1800080.jpeg,https://derpicdn.net/img/view/2018/8/6/1800080.jpeg,0,0.918764651,0,0,482,587,482,587,rainbow dash
1802570.jpeg,https://derpicdn.net/img/view/2018/8/9/1802570.jpeg,0,0.930251896,1053,0,1805,719,752,719,rainbow dash
1803223.jpeg,https://derpicdn.net/img/view/2018/8/10/1803223.jpeg,0,0.98504287,18,27,552,561,534,534,rainbow dash
1809841.jpeg,https://derpicdn.net/img/view/2018/8/18/1809841.jpeg,0,0.987325311,1031,209,2007,1185,976,976,rainbow dash
1812230.jpeg,https://derpicdn.net/img/view/2018/8/21/1812230.jpeg,0,0.916387141,138,1,672,535,534,534,rainbow dash
1812382.jpeg,https://derpicdn.net/img/view/2018/8/21/1812382.jpeg,0,0.983908594,84,0,422,338,338,338,rainbow dash
1813037.jpeg,https://derpicdn.net/img/view/2018/8/22/1813037.jpeg,0,0.926756203,432,0,1302,794,870,794,rainbow dash
1813457.jpeg,https://derpicdn.net/img/view/2018/8/22/1813457.jpeg,0,0.997008502,779,947,1489,1657,710,710,rainbow dash
1813853.jpeg,https://derpicdn.net/img/view/2018/8/23/1813853.jpeg,0,0.992332041,329,150,573,394,244,244,rainbow dash
1815370.jpeg,https://derpicdn.net/img/view/2018/8/25/1815370.jpeg,0,0.957233787,29,220,531,722,502,502,rainbow dash
1817469.jpeg,https://derpicdn.net/img/view/2018/8/27/1817469.jpeg,0,0.985778034,16,0,888,789,872,789,rainbow dash
1817956.jpeg,https://derpicdn.net/img/view/2018/8/27/1817956.jpeg,0,0.997380495,116,44,954,882,838,838,rainbow dash
1818525.jpeg,https://derpicdn.net/img/view/2018/8/28/1818525.jpeg,0,0.998298705,119,0,565,418,446,418,rainbow dash
1823580.jpeg,https://derpicdn.net/img/view/2018/9/3/1823580.jpeg,0,0.995702267,100,0,630,483,530,483,rainbow dash
1823581.jpeg,https://derpicdn.net/img/view/2018/9/3/1823581.jpeg,0,0.992079735,204,0,1096,779,892,779,rainbow dash
1823710.jpeg,https://derpicdn.net/img/view/2018/9/3/1823710.jpeg,0,0.946885884,0,146,2940,3800,2940,3654,rainbow dash
1824916.jpeg,https://derpicdn.net/img/view/2018/9/4/1824916.jpeg,0,0.978449523,0,169,2523,2775,2523,2606,rainbow dash
1824916.jpeg,https://derpicdn.net/img/view/2018/9/4/1824916.jpeg,1,0.94276154,698,0,2814,2039,2116,2039,rainbow dash
1826555.jpeg,https://derpicdn.net/img/view/2018/9/6/1826555.jpeg,0,0.98399657,166,62,1384,1280,1218,1218,rainbow dash
1829916.jpeg,https://derpicdn.net/img/view/2018/9/11/1829916.jpeg,0,0.989626467,24,0,712,580,688,580,rainbow dash
1832418.jpeg,https://derpicdn.net/img/view/2018/9/14/1832418.jpeg,0,0.997764111,219,0,925,693,706,693,rainbow dash
1835737.jpeg,https://derpicdn.net/img/view/2018/9/18/1835737.jpeg,0,0.999874353,731,26,1000,306,269,280,rainbow dash
1835737.jpeg,https://derpicdn.net/img/view/2018/9/18/1835737.jpeg,1,0.999633431,359,599,593,833,234,234,rainbow dash
1835737.jpeg,https://derpicdn.net/img/view/2018/9/18/1835737.jpeg,2,0.997815192,0,0,358,327,358,327,rainbow dash
1835737.jpeg,https://derpicdn.net/img/view/2018/9/18/1835737.jpeg,5,0.963712394,492,403,752,663,260,260,rainbow dash
1836144.jpeg,https://derpicdn.net/img/view/2018/9/19/1836144.jpeg,0,0.971842766,25,0,451,409,426,409,rainbow dash
1837655.jpeg,https://derpicdn.net/img/view/2018/9/21/1837655.jpeg,0,0.993985832,191,0,517,326,326,326,rainbow dash
1838416.jpeg,https://derpicdn.net/img/view/2018/9/22/1838416.jpeg,0,0.998257577,23,206,975,1158,952,952,rainbow dash
1843039.jpeg,https://derpicdn.net/img/view/2018/9/28/1843039.jpeg,0,0.989237189,68,0,1888,1730,1820,1730,rainbow dash
1843611.jpeg,https://derpicdn.net/img/view/2018/9/29/1843611.jpeg,0,0.997675538,709,0,1531,704,822,704,rainbow dash
1843616.jpeg,https://derpicdn.net/img/view/2018/9/29/1843616.jpeg,0,0.92991215,45,22,283,260,238,238,rainbow dash
184523.jpeg,https://derpicdn.net/img/view/2012/12/16/184523.jpeg,0,0.991522014,287,7,793,513,506,506,rainbow dash
1845588.jpeg,https://derpicdn.net/img/view/2018/10/1/1845588.jpeg,0,0.979845941,530,18,1038,530,508,512,rainbow dash
1848462.jpeg,https://derpicdn.net/img/view/2018/10/5/1848462.jpeg,0,0.998970211,376,142,662,428,286,286,rainbow dash
1848730.jpeg,https://derpicdn.net/img/view/2018/10/5/1848730.jpeg,1,0.993050337,23,14,247,238,224,224,rainbow dash
1848730.jpeg,https://derpicdn.net/img/view/2018/10/5/1848730.jpeg,3,0.972062588,582,0,860,250,278,250,rainbow dash
1848730.jpeg,https://derpicdn.net/img/view/2018/10/5/1848730.jpeg,5,0.959617198,137,460,405,728,268,268,rainbow dash
1850480.jpeg,https://derpicdn.net/img/view/2018/10/7/1850480.jpeg,0,0.99610275,49,47,293,291,244,244,rainbow dash
1853115.jpeg,https://derpicdn.net/img/view/2018/10/10/1853115.jpeg,0,0.980011702,917,218,1327,628,410,410,rainbow dash
1858734.jpeg,https://derpicdn.net/img/view/2018/10/17/1858734.jpeg,2,0.985179186,2016,2536,4100,4864,2084,2328,rainbow dash
1859339.jpeg,https://derpicdn.net/img/view/2018/10/18/1859339.jpeg,0,0.99679929,189,0,669,446,480,446,rainbow dash
1859944.jpeg,https://derpicdn.net/img/view/2018/10/18/1859944.jpeg,0,0.993872404,933,138,1417,622,484,484,rainbow dash
1866033.jpeg,https://derpicdn.net/img/view/2018/10/25/1866033.jpeg,0,0.992633343,697,0,1105,386,408,386,rainbow dash
1873039.jpeg,https://derpicdn.net/img/view/2018/11/2/1873039.jpeg,0,0.992455363,0,0,545,539,545,539,rainbow dash
1874419.jpeg,https://derpicdn.net/img/view/2018/11/3/1874419.jpeg,0,0.965993166,108,20,930,842,822,822,rainbow dash
1876129.jpeg,https://derpicdn.net/img/view/2018/11/6/1876129.jpeg,0,0.956123352,160,104,1242,1186,1082,1082,rainbow dash
1878423.jpeg,https://derpicdn.net/img/view/2018/11/9/1878423.jpeg,0,0.971832156,0,33,482,517,482,484,rainbow dash
1878423.jpeg,https://derpicdn.net/img/view/2018/11/9/1878423.jpeg,1,0.941563487,77,452,439,814,362,362,rainbow dash
1881557.jpeg,https://derpicdn.net/img/view/2018/11/13/1881557.jpeg,0,0.981776536,0,29,863,1009,863,980,rainbow dash
1882248.jpeg,https://derpicdn.net/img/view/2018/11/14/1882248.jpeg,0,0.944631994,664,0,2148,1380,1484,1380,rainbow dash
1883287.jpeg,https://derpicdn.net/img/view/2018/11/16/1883287.jpeg,0,0.964751482,4,344,1530,1870,1526,1526,rainbow dash
1884155.jpeg,https://derpicdn.net/img/view/2018/11/17/1884155.jpeg,0,0.985144556,98,30,466,398,368,368,rainbow dash
1885118.jpeg,https://derpicdn.net/img/view/2018/11/18/1885118.jpeg,0,0.905416369,5,0,1035,1012,1030,1012,rainbow dash
1886119.jpeg,https://derpicdn.net/img/view/2018/11/19/1886119.jpeg,0,0.928957999,0,0,583,577,583,577,rainbow dash
1887635.jpeg,https://derpicdn.net/img/view/2018/11/21/1887635.jpeg,0,0.981792688,222,14,662,454,440,440,rainbow dash
1887747.jpeg,https://derpicdn.net/img/view/2018/11/21/1887747.jpeg,0,0.9989869,198,14,634,450,436,436,rainbow dash
1887750.jpeg,https://derpicdn.net/img/view/2018/11/21/1887750.jpeg,0,0.998660862,422,0,848,386,426,386,rainbow dash
1888460.jpeg,https://derpicdn.net/img/view/2018/11/22/1888460.jpeg,0,0.998731196,1024,141,1534,651,510,510,rainbow dash
1888460.jpeg,https://derpicdn.net/img/view/2018/11/22/1888460.jpeg,2,0.996954083,1428,55,2048,699,620,644,rainbow dash
1888460.jpeg,https://derpicdn.net/img/view/2018/11/22/1888460.jpeg,4,0.995108664,558,667,1218,1327,660,660,rainbow dash
1888460.jpeg,https://derpicdn.net/img/view/2018/11/22/1888460.jpeg,5,0.993791819,147,0,709,514,562,514,rainbow dash
1888467.jpeg,https://derpicdn.net/img/view/2018/11/22/1888467.jpeg,0,0.999761283,17,32,493,508,476,476,rainbow dash
1888469.jpeg,https://derpicdn.net/img/view/2018/11/22/1888469.jpeg,0,0.98299545,0,0,1168,1407,1168,1407,rainbow dash
1888469.jpeg,https://derpicdn.net/img/view/2018/11/22/1888469.jpeg,1,0.967433631,0,0,1277,1586,1277,1586,rainbow dash
1889323.jpeg,https://derpicdn.net/img/view/2018/11/23/1889323.jpeg,0,0.995535731,94,0,628,516,534,516,rainbow dash
1889537.jpeg,https://derpicdn.net/img/view/2018/11/24/1889537.jpeg,0,0.9958722,119,0,475,337,356,337,rainbow dash
1891907.jpeg,https://derpicdn.net/img/view/2018/11/27/1891907.jpeg,0,0.982406318,0,0,553,553,553,553,rainbow dash
1893193.jpeg,https://derpicdn.net/img/view/2018/11/28/1893193.jpeg,0,0.99770242,225,45,459,279,234,234,rainbow dash
1893646.jpeg,https://derpicdn.net/img/view/2018/11/29/1893646.jpeg,0,0.944406807,453,0,4845,3360,4392,3360,rainbow dash
1893734.jpeg,https://derpicdn.net/img/view/2018/11/29/1893734.jpeg,0,0.975780964,0,15,439,459,439,444,rainbow dash
1893837.jpeg,https://derpicdn.net/img/view/2018/11/29/1893837.jpeg,0,0.994383633,214,0,986,821,772,821,rainbow dash
1895249.jpeg,https://derpicdn.net/img/view/2018/12/1/1895249.jpeg,0,0.984491825,108,0,1044,896,936,896,rainbow dash
1896456.jpeg,https://derpicdn.net/img/view/2018/12/2/1896456.jpeg,0,0.981065691,146,10,1504,1368,1358,1358,rainbow dash
1898418.jpeg,https://derpicdn.net/img/view/2018/12/4/1898418.jpeg,0,0.99925524,809,26,1819,1036,1010,1010,rainbow dash
1899854.jpeg,https://derpicdn.net/img/view/2018/12/6/1899854.jpeg,0,0.992045999,202,194,1680,1672,1478,1478,rainbow dash
1900131.jpeg,https://derpicdn.net/img/view/2018/12/6/1900131.jpeg,0,0.96757102,345,0,1835,1423,1490,1423,rainbow dash
1901052.jpeg,https://derpicdn.net/img/view/2018/12/7/1901052.jpeg,0,0.91212368,0,0,1490,1591,1490,1591,rainbow dash
1902450.jpeg,https://derpicdn.net/img/view/2018/12/8/1902450.jpeg,0,0.976347566,249,62,481,294,232,232,rainbow dash
1903453.jpeg,https://derpicdn.net/img/view/2018/12/9/1903453.jpeg,0,0.999781549,1816,310,2788,1282,972,972,rainbow dash
1908103.jpeg,https://derpicdn.net/img/view/2018/12/14/1908103.jpeg,0,0.98581183,318,56,730,468,412,412,rainbow dash
1909422.jpeg,https://derpicdn.net/img/view/2018/12/15/1909422.jpeg,0,0.988795519,1728,142,3050,1464,1322,1322,rainbow dash
1910040.jpeg,https://derpicdn.net/img/view/2018/12/16/1910040.jpeg,0,0.99935174,253,0,663,397,410,397,rainbow dash
1910044.jpeg,https://derpicdn.net/img/view/2018/12/16/1910044.jpeg,0,0.995723009,163,26,425,288,262,262,rainbow dash
1914378.jpeg,https://derpicdn.net/img/view/2018/12/21/1914378.jpeg,0,0.969076455,231,220,1271,1260,1040,1040,rainbow dash
1916719.jpeg,https://derpicdn.net/img/view/2018/12/23/1916719.jpeg,0,0.999295831,340,0,1268,898,928,898,rainbow dash
1917314.jpeg,https://derpicdn.net/img/view/2018/12/24/1917314.jpeg,0,0.969314992,284,0,3068,1935,2784,1935,rainbow dash
1921390.jpeg,https://derpicdn.net/img/view/2018/12/29/1921390.jpeg,0,0.91689229,424,78,1030,684,606,606,rainbow dash
1924057.jpeg,https://derpicdn.net/img/view/2019/1/1/1924057.jpeg,0,0.998850524,564,0,1200,626,636,626,rainbow dash
1926791.jpeg,https://derpicdn.net/img/view/2019/1/5/1926791.jpeg,0,0.986051977,575,183,1763,1371,1188,1188,rainbow dash
1929166.jpeg,https://derpicdn.net/img/view/2019/1/7/1929166.jpeg,0,0.980943024,963,530,1773,1340,810,810,rainbow dash
1930050.jpeg,https://derpicdn.net/img/view/2019/1/8/1930050.jpeg,0,0.998394668,186,0,960,686,774,686,rainbow dash
1933125.jpeg,https://derpicdn.net/img/view/2019/1/12/1933125.jpeg,0,0.980657637,0,0,1741,2284,1741,2284,rainbow dash
1933211.jpeg,https://derpicdn.net/img/view/2019/1/12/1933211.jpeg,0,0.969074309,0,11,652,683,652,672,rainbow dash
1933295.jpeg,https://derpicdn.net/img/view/2019/1/12/1933295.jpeg,0,0.994706392,215,0,553,284,338,284,rainbow dash
1934124.jpeg,https://derpicdn.net/img/view/2019/1/13/1934124.jpeg,0,0.998465896,150,0,848,673,698,673,rainbow dash
1934309.jpeg,https://derpicdn.net/img/view/2019/1/13/1934309.jpeg,0,0.951433122,193,4,525,336,332,332,rainbow dash
1934329.jpeg,https://derpicdn.net/img/view/2019/1/13/1934329.jpeg,0,0.997605741,187,0,585,386,398,386,rainbow dash
1936022.jpeg,https://derpicdn.net/img/view/2019/1/15/1936022.jpeg,0,0.991259933,36,0,550,529,514,529,rainbow dash
1936701.jpeg,https://derpicdn.net/img/view/2019/1/16/1936701.jpeg,0,0.959781587,1142,0,2342,966,1200,966,rainbow dash
1936916.jpeg,https://derpicdn.net/img/view/2019/1/16/1936916.jpeg,0,0.997895241,134,0,1186,1012,1052,1012,rainbow dash
1938774.jpeg,https://derpicdn.net/img/view/2019/1/18/1938774.jpeg,0,0.997347414,1891,86,3837,2032,1946,1946,rainbow dash
1940486.jpeg,https://derpicdn.net/img/view/2019/1/20/1940486.jpeg,0,0.972060561,390,0,1602,1078,1212,1078,rainbow dash
1941091.jpeg,https://derpicdn.net/img/view/2019/1/21/1941091.jpeg,0,0.939721107,570,26,890,346,320,320,rainbow dash
1941200.jpeg,https://derpicdn.net/img/view/2019/1/21/1941200.jpeg,0,0.984957337,629,463,1267,1101,638,638,rainbow dash
1942156.jpeg,https://derpicdn.net/img/view/2019/1/23/1942156.jpeg,0,0.97281456,0,0,720,913,720,913,rainbow dash
1944570.jpeg,https://derpicdn.net/img/view/2019/1/26/1944570.jpeg,0,0.993097365,222,20,786,584,564,564,rainbow dash
1947123.jpeg,https://derpicdn.net/img/view/2019/1/28/1947123.jpeg,0,0.900006294,194,10,614,430,420,420,rainbow dash
1947264.jpeg,https://derpicdn.net/img/view/2019/1/29/1947264.jpeg,0,0.979800761,109,177,1203,1234,1094,1057,rainbow dash
1950244.jpeg,https://derpicdn.net/img/view/2019/2/1/1950244.jpeg,1,0.960158348,473,0,1620,985,1147,985,rainbow dash
1950275.jpeg,https://derpicdn.net/img/view/2019/2/1/1950275.jpeg,0,0.992102623,567,47,917,397,350,350,rainbow dash
1950307.jpeg,https://derpicdn.net/img/view/2019/2/1/1950307.jpeg,0,0.986942053,266,41,862,637,596,596,rainbow dash
1950365.jpeg,https://derpicdn.net/img/view/2019/2/1/1950365.jpeg,0,0.999084771,125,0,1039,893,914,893,rainbow dash
1950449.jpeg,https://derpicdn.net/img/view/2019/2/1/1950449.jpeg,0,0.982203305,226,38,854,666,628,628,rainbow dash
1951342.jpeg,https://derpicdn.net/img/view/2019/2/2/1951342.jpeg,0,0.980917454,57,0,707,591,650,591,rainbow dash
1951686.jpeg,https://derpicdn.net/img/view/2019/2/3/1951686.jpeg,0,0.989900589,33,85,479,531,446,446,rainbow dash
1953182.jpeg,https://derpicdn.net/img/view/2019/2/4/1953182.jpeg,0,0.99530822,0,0,801,710,801,710,rainbow dash
1953244.jpeg,https://derpicdn.net/img/view/2019/2/4/1953244.jpeg,0,0.995015562,393,106,657,370,264,264,rainbow dash
1953374.jpeg,https://derpicdn.net/img/view/2019/2/4/1953374.jpeg,0,0.978448033,248,0,1920,1450,1672,1450,rainbow dash
1953626.jpeg,https://derpicdn.net/img/view/2019/2/4/1953626.jpeg,0,0.998559117,109,12,1229,1132,1120,1120,rainbow dash
1956557.jpeg,https://derpicdn.net/img/view/2019/2/8/1956557.jpeg,0,0.961816609,181,242,597,658,416,416,rainbow dash
1956561.jpeg,https://derpicdn.net/img/view/2019/2/8/1956561.jpeg,0,0.983684838,270,0,682,362,412,362,rainbow dash
1957460.jpeg,https://derpicdn.net/img/view/2019/2/9/1957460.jpeg,0,0.995645106,86,32,902,848,816,816,rainbow dash
1958473.jpeg,https://derpicdn.net/img/view/2019/2/10/1958473.jpeg,0,0.997701108,203,31,455,283,252,252,rainbow dash
1961273.jpeg,https://derpicdn.net/img/view/2019/2/13/1961273.jpeg,0,0.995806515,0,0,1504,1757,1504,1757,rainbow dash
1961522.jpeg,https://derpicdn.net/img/view/2019/2/14/1961522.jpeg,0,0.976685882,52,8,2466,2422,2414,2414,rainbow dash
1961622.jpeg,https://derpicdn.net/img/view/2019/2/14/1961622.jpeg,0,0.999328256,196,0,704,477,508,477,rainbow dash
1963321.jpeg,https://derpicdn.net/img/view/2019/2/16/1963321.jpeg,0,0.998946428,181,70,635,524,454,454,rainbow dash
1965000.jpeg,https://derpicdn.net/img/view/2019/2/18/1965000.jpeg,0,0.955566049,0,696,751,1484,751,788,rainbow dash
1968178.jpeg,https://derpicdn.net/img/view/2019/2/21/1968178.jpeg,0,0.998096049,256,0,858,548,602,548,rainbow dash
1969258.jpeg,https://derpicdn.net/img/view/2019/2/23/1969258.jpeg,0,0.993044257,1678,0,3716,1885,2038,1885,rainbow dash
1970944.jpeg,https://derpicdn.net/img/view/2019/2/24/1970944.jpeg,0,0.98798126,201,4,507,310,306,306,rainbow dash
1971028.jpeg,https://derpicdn.net/img/view/2019/2/25/1971028.jpeg,0,0.989273548,2219,0,2963,729,744,729,rainbow dash
1971620.jpeg,https://derpicdn.net/img/view/2019/2/25/1971620.jpeg,0,0.998759806,516,17,1334,835,818,818,rainbow dash
1972267.jpeg,https://derpicdn.net/img/view/2019/2/26/1972267.jpeg,0,0.999862671,0,79,476,561,476,482,rainbow dash
1972304.jpeg,https://derpicdn.net/img/view/2019/2/26/1972304.jpeg,0,0.97457999,68,85,800,941,732,856,rainbow dash
1972911.jpeg,https://derpicdn.net/img/view/2019/2/27/1972911.jpeg,0,0.973688841,199,0,1795,1379,1596,1379,rainbow dash
1973331.jpeg,https://derpicdn.net/img/view/2019/2/28/1973331.jpeg,1,0.994989693,21,447,527,953,506,506,rainbow dash
1975113.jpeg,https://derpicdn.net/img/view/2019/3/2/1975113.jpeg,0,0.99571681,132,159,711,745,579,586,rainbow dash
1977234.jpeg,https://derpicdn.net/img/view/2019/3/4/1977234.jpeg,0,0.995535314,952,139,1798,985,846,846,rainbow dash
1977697.jpeg,https://derpicdn.net/img/view/2019/3/4/1977697.jpeg,0,0.996329665,207,0,1671,1207,1464,1207,rainbow dash
1979315.jpeg,https://derpicdn.net/img/view/2019/3/7/1979315.jpeg,0,0.993779778,205,0,1041,819,836,819,rainbow dash
1980629.jpeg,https://derpicdn.net/img/view/2019/3/8/1980629.jpeg,0,0.998272538,421,78,1229,886,808,808,rainbow dash
1982569.jpeg,https://derpicdn.net/img/view/2019/3/10/1982569.jpeg,0,0.985437989,36,0,928,875,892,875,rainbow dash
1987715.jpeg,https://derpicdn.net/img/view/2019/3/16/1987715.jpeg,0,0.936441243,844,73,3910,3139,3066,3066,rainbow dash
1988331.jpeg,https://derpicdn.net/img/view/2019/3/17/1988331.jpeg,0,0.974084556,493,4,1643,1115,1150,1111,rainbow dash
1988535.jpeg,https://derpicdn.net/img/view/2019/3/17/1988535.jpeg,0,0.915251017,37,0,2120,1992,2083,1992,rainbow dash
1989992.jpeg,https://derpicdn.net/img/view/2019/3/19/1989992.jpeg,0,0.99950403,763,0,1689,842,926,842,rainbow dash
1990968.jpeg,https://derpicdn.net/img/view/2019/3/20/1990968.jpeg,0,0.914013505,869,344,2359,1834,1490,1490,rainbow dash
1991010.jpeg,https://derpicdn.net/img/view/2019/3/20/1991010.jpeg,0,0.979841948,193,67,1467,1200,1274,1133,rainbow dash
1991959.jpeg,https://derpicdn.net/img/view/2019/3/22/1991959.jpeg,0,0.996829808,121,0,749,556,628,556,rainbow dash
199333.jpeg,https://derpicdn.net/img/view/2013/1/1/199333.jpeg,0,0.998948574,116,0,406,272,290,272,rainbow dash
1993880.jpeg,https://derpicdn.net/img/view/2019/3/24/1993880.jpeg,0,0.991795063,144,0,656,500,512,500,rainbow dash
1993913.jpeg,https://derpicdn.net/img/view/2019/3/24/1993913.jpeg,0,0.967357516,151,0,757,585,606,585,rainbow dash
1996586.jpeg,https://derpicdn.net/img/view/2019/3/28/1996586.jpeg,0,0.998114169,334,35,1214,915,880,880,rainbow dash
1997606.jpeg,https://derpicdn.net/img/view/2019/3/29/1997606.jpeg,0,0.998808026,408,41,1284,917,876,876,rainbow dash
2000342.jpeg,https://derpicdn.net/img/view/2019/4/1/2000342.jpeg,0,0.980962038,18,38,628,648,610,610,rainbow dash
2000466.jpeg,https://derpicdn.net/img/view/2019/4/2/2000466.jpeg,0,0.904411733,768,0,1260,463,492,463,rainbow dash
2000962.jpeg,https://derpicdn.net/img/view/2019/4/2/2000962.jpeg,0,0.966160536,74,0,1214,1129,1140,1129,rainbow dash
2001366.jpeg,https://derpicdn.net/img/view/2019/4/2/2001366.jpeg,0,0.993635058,649,0,2307,1341,1658,1341,rainbow dash
2001366.jpeg,https://derpicdn.net/img/view/2019/4/2/2001366.jpeg,1,0.992010117,1853,0,3455,1314,1602,1314,rainbow dash
2001633.jpeg,https://derpicdn.net/img/view/2019/4/3/2001633.jpeg,0,0.935896397,0,190,402,608,402,418,rainbow dash
2001783.jpeg,https://derpicdn.net/img/view/2019/4/3/2001783.jpeg,0,0.935734868,493,38,869,414,376,376,rainbow dash
2002203.jpeg,https://derpicdn.net/img/view/2019/4/3/2002203.jpeg,0,0.967828155,676,147,1394,865,718,718,rainbow dash
2004756.jpeg,https://derpicdn.net/img/view/2019/4/6/2004756.jpeg,0,0.998312473,344,3,1204,863,860,860,rainbow dash
2004854.jpeg,https://derpicdn.net/img/view/2019/4/6/2004854.jpeg,0,0.975246966,98,0,1156,934,1058,934,rainbow dash
2005387.jpeg,https://derpicdn.net/img/view/2019/4/7/2005387.jpeg,0,0.996889949,141,0,993,775,852,775,rainbow dash
2006960.jpeg,https://derpicdn.net/img/view/2019/4/8/2006960.jpeg,0,0.946163356,296,134,2102,1940,1806,1806,rainbow dash
2008276.jpeg,https://derpicdn.net/img/view/2019/4/10/2008276.jpeg,1,0.932220817,146,0,1010,821,864,821,rainbow dash
2008988.jpeg,https://derpicdn.net/img/view/2019/4/11/2008988.jpeg,0,0.925379336,91,31,501,441,410,410,rainbow dash
2011347.jpeg,https://derpicdn.net/img/view/2019/4/13/2011347.jpeg,0,0.996813357,16,27,306,317,290,290,rainbow dash
2012050.jpeg,https://derpicdn.net/img/view/2019/4/14/2012050.jpeg,0,0.997726202,0,0,786,745,786,745,rainbow dash
2012328.jpeg,https://derpicdn.net/img/view/2019/4/14/2012328.jpeg,0,0.99901557,26,23,364,361,338,338,rainbow dash
2014109.jpeg,https://derpicdn.net/img/view/2019/4/16/2014109.jpeg,0,0.988133848,34,0,1688,1637,1654,1637,rainbow dash
2015034.jpeg,https://derpicdn.net/img/view/2019/4/17/2015034.jpeg,0,0.920525908,48,49,450,451,402,402,rainbow dash
2017731.jpeg,https://derpicdn.net/img/view/2019/4/20/2017731.jpeg,0,0.916876972,916,0,1842,850,926,850,rainbow dash
2017966.jpeg,https://derpicdn.net/img/view/2019/4/20/2017966.jpeg,0,0.997253656,132,16,426,310,294,294,rainbow dash
2018554.jpeg,https://derpicdn.net/img/view/2019/4/21/2018554.jpeg,0,0.988890231,276,0,750,456,474,456,rainbow dash
2018720.jpeg,https://derpicdn.net/img/view/2019/4/21/2018720.jpeg,0,0.975542367,0,0,1066,1022,1066,1022,rainbow dash
2018891.jpeg,https://derpicdn.net/img/view/2019/4/21/2018891.jpeg,0,0.948680401,37,0,1017,970,980,970,rainbow dash
2021564.jpeg,https://derpicdn.net/img/view/2019/4/24/2021564.jpeg,1,0.991241038,44,94,170,220,126,126,rainbow dash
2021564.jpeg,https://derpicdn.net/img/view/2019/4/24/2021564.jpeg,2,0.967113793,229,35,421,227,192,192,rainbow dash
2022027.jpeg,https://derpicdn.net/img/view/2019/4/24/2022027.jpeg,0,0.992462575,0,0,304,297,304,297,rainbow dash
2022357.jpeg,https://derpicdn.net/img/view/2019/4/25/2022357.jpeg,0,0.95763129,0,0,1914,1895,1914,1895,rainbow dash
2023020.jpeg,https://derpicdn.net/img/view/2019/4/26/2023020.jpeg,0,0.986110866,41,0,989,926,948,926,rainbow dash
2023433.jpeg,https://derpicdn.net/img/view/2019/4/26/2023433.jpeg,0,0.983791947,114,18,488,392,374,374,rainbow dash
2023776.jpeg,https://derpicdn.net/img/view/2019/4/27/2023776.jpeg,0,0.997231722,313,0,1245,887,932,887,rainbow dash
2024102.jpeg,https://derpicdn.net/img/view/2019/4/27/2024102.jpeg,0,0.994141817,0,18,322,350,322,332,rainbow dash
2024562.jpeg,https://derpicdn.net/img/view/2019/4/27/2024562.jpeg,0,0.993494093,0,0,1829,1536,1829,1536,rainbow dash
2026021.jpeg,https://derpicdn.net/img/view/2019/4/28/2026021.jpeg,0,0.994483411,189,0,733,523,544,523,rainbow dash
2029920.jpeg,https://derpicdn.net/img/view/2019/5/3/2029920.jpeg,0,0.979180992,123,334,273,484,150,150,rainbow dash
2031214.jpeg,https://derpicdn.net/img/view/2019/5/5/2031214.jpeg,0,0.914205134,305,0,791,472,486,472,rainbow dash
2032025.jpeg,https://derpicdn.net/img/view/2019/5/6/2032025.jpeg,0,0.946267903,91,27,717,653,626,626,rainbow dash
2032872.jpeg,https://derpicdn.net/img/view/2019/5/7/2032872.jpeg,0,0.988609135,332,0,1038,482,706,482,rainbow dash
2033160.jpeg,https://derpicdn.net/img/view/2019/5/7/2033160.jpeg,0,0.999586821,373,201,1883,1711,1510,1510,rainbow dash
2033427.jpeg,https://derpicdn.net/img/view/2019/5/7/2033427.jpeg,0,0.9921996,25,0,493,468,468,468,rainbow dash
2035540.jpeg,https://derpicdn.net/img/view/2019/5/10/2035540.jpeg,0,0.997471631,418,28,772,382,354,354,rainbow dash
2035703.jpeg,https://derpicdn.net/img/view/2019/5/10/2035703.jpeg,0,0.984321356,199,451,979,1200,780,749,rainbow dash
2035703.jpeg,https://derpicdn.net/img/view/2019/5/10/2035703.jpeg,1,0.973419487,41,0,627,515,586,515,rainbow dash
2035703.jpeg,https://derpicdn.net/img/view/2019/5/10/2035703.jpeg,2,0.94754678,739,0,1447,587,708,587,rainbow dash
2036188.jpeg,https://derpicdn.net/img/view/2019/5/11/2036188.jpeg,0,0.978482664,179,82,459,362,280,280,rainbow dash
2039282.jpeg,https://derpicdn.net/img/view/2019/5/15/2039282.jpeg,0,0.995884895,145,0,877,703,732,703,rainbow dash
2039289.jpeg,https://derpicdn.net/img/view/2019/5/15/2039289.jpeg,0,0.997980177,60,0,1296,1073,1236,1073,rainbow dash
2040075.jpeg,https://derpicdn.net/img/view/2019/5/16/2040075.jpeg,0,0.989880145,259,28,857,626,598,598,rainbow dash
2040981.jpeg,https://derpicdn.net/img/view/2019/5/17/2040981.jpeg,0,0.981137455,92,0,1134,986,1042,986,rainbow dash
2041728.jpeg,https://derpicdn.net/img/view/2019/5/17/2041728.jpeg,0,0.998412907,53,135,577,659,524,524,rainbow dash
2048516.jpeg,https://derpicdn.net/img/view/2019/5/25/2048516.jpeg,0,0.992821693,43,1,420,383,377,382,rainbow dash
2051716.jpeg,https://derpicdn.net/img/view/2019/5/28/2051716.jpeg,0,0.999567866,360,0,982,616,622,616,rainbow dash
2051757.jpeg,https://derpicdn.net/img/view/2019/5/28/2051757.jpeg,0,0.99729389,188,10,1058,880,870,870,rainbow dash
2051886.jpeg,https://derpicdn.net/img/view/2019/5/28/2051886.jpeg,0,0.964064777,58,0,598,467,540,467,rainbow dash
2052789.jpeg,https://derpicdn.net/img/view/2019/5/29/2052789.jpeg,0,0.99575901,271,0,851,502,580,502,rainbow dash
2054800.jpeg,https://derpicdn.net/img/view/2019/6/1/2054800.jpeg,0,0.999435961,650,9,2132,1491,1482,1482,rainbow dash
2056139.jpeg,https://derpicdn.net/img/view/2019/6/2/2056139.jpeg,0,0.972388208,269,107,933,771,664,664,rainbow dash
2056859.jpeg,https://derpicdn.net/img/view/2019/6/3/2056859.jpeg,0,0.939147294,2183,284,2595,696,412,412,rainbow dash
2058412.jpeg,https://derpicdn.net/img/view/2019/6/5/2058412.jpeg,0,0.983746886,6,0,662,633,656,633,rainbow dash
2058886.jpeg,https://derpicdn.net/img/view/2019/6/6/2058886.jpeg,0,0.998325884,20,4,476,460,456,456,rainbow dash
2061117.jpeg,https://derpicdn.net/img/view/2019/6/9/2061117.jpeg,0,0.971629441,17,0,989,875,972,875,rainbow dash
2061117.jpeg,https://derpicdn.net/img/view/2019/6/9/2061117.jpeg,2,0.909370661,730,0,2038,1102,1308,1102,rainbow dash
2062764.jpeg,https://derpicdn.net/img/view/2019/6/11/2062764.jpeg,0,0.911227286,999,180,2347,1528,1348,1348,rainbow dash
2063675.jpeg,https://derpicdn.net/img/view/2019/6/12/2063675.jpeg,0,0.997392356,0,0,537,540,537,540,rainbow dash
2064938.jpeg,https://derpicdn.net/img/view/2019/6/14/2064938.jpeg,0,0.999649405,473,0,1169,683,696,683,rainbow dash
2068460.jpeg,https://derpicdn.net/img/view/2019/6/18/2068460.jpeg,0,0.997273445,1457,1377,1949,1869,492,492,rainbow dash
2068460.jpeg,https://derpicdn.net/img/view/2019/6/18/2068460.jpeg,1,0.982529044,321,0,1923,1598,1602,1598,rainbow dash
2068639.jpeg,https://derpicdn.net/img/view/2019/6/18/2068639.jpeg,0,0.992470682,529,20,1603,1094,1074,1074,rainbow dash
2068683.jpeg,https://derpicdn.net/img/view/2019/6/18/2068683.jpeg,0,0.981949031,0,0,479,611,479,611,rainbow dash
2069799.jpeg,https://derpicdn.net/img/view/2019/6/19/2069799.jpeg,1,0.99856317,624,463,756,595,132,132,rainbow dash
2070091.jpeg,https://derpicdn.net/img/view/2019/6/19/2070091.jpeg,0,0.965918422,460,0,1718,1247,1258,1247,rainbow dash
2070506.jpeg,https://derpicdn.net/img/view/2019/6/20/2070506.jpeg,0,0.98318392,54,44,750,760,696,716,rainbow dash
2074175.jpeg,https://derpicdn.net/img/view/2019/6/24/2074175.jpeg,0,0.999713719,22,214,690,882,668,668,rainbow dash
2075467.jpeg,https://derpicdn.net/img/view/2019/6/26/2075467.jpeg,0,0.956230462,395,23,871,499,476,476,rainbow dash
2076318.jpeg,https://derpicdn.net/img/view/2019/6/27/2076318.jpeg,0,0.946080983,992,1021,1468,1497,476,476,rainbow dash
2077277.jpeg,https://derpicdn.net/img/view/2019/6/28/2077277.jpeg,0,0.985391796,15,71,1635,1729,1620,1658,rainbow dash
2079154.jpeg,https://derpicdn.net/img/view/2019/6/30/2079154.jpeg,0,0.966665506,174,0,642,451,468,451,rainbow dash
2083583.jpeg,https://derpicdn.net/img/view/2019/7/5/2083583.jpeg,0,0.999195814,157,0,821,618,664,618,rainbow dash
2086838.jpeg,https://derpicdn.net/img/view/2019/7/9/2086838.jpeg,0,0.999109805,322,0,818,482,496,482,rainbow dash
2086990.jpeg,https://derpicdn.net/img/view/2019/7/9/2086990.jpeg,0,0.970002592,448,776,882,1210,434,434,rainbow dash
2087130.jpeg,https://derpicdn.net/img/view/2019/7/9/2087130.jpeg,0,0.984636188,214,0,542,330,328,330,rainbow dash
2087692.jpeg,https://derpicdn.net/img/view/2019/7/10/2087692.jpeg,0,0.994057834,194,3,825,669,631,666,rainbow dash
2090136.jpeg,https://derpicdn.net/img/view/2019/7/12/2090136.jpeg,0,0.997250855,99,0,1233,1083,1134,1083,rainbow dash
2090229.jpeg,https://derpicdn.net/img/view/2019/7/13/2090229.jpeg,0,0.98175776,61,0,921,783,860,783,rainbow dash
2092044.jpeg,https://derpicdn.net/img/view/2019/7/15/2092044.jpeg,0,0.978406966,0,0,1024,1083,1024,1083,rainbow dash
2092952.jpeg,https://derpicdn.net/img/view/2019/7/16/2092952.jpeg,0,0.963115275,189,5,403,219,214,214,rainbow dash
2093262.jpeg,https://derpicdn.net/img/view/2019/7/16/2093262.jpeg,0,0.99742645,248,0,810,532,562,532,rainbow dash
2093368.jpeg,https://derpicdn.net/img/view/2019/7/16/2093368.jpeg,0,0.969697416,101,75,383,357,282,282,rainbow dash
2093373.jpeg,https://derpicdn.net/img/view/2019/7/16/2093373.jpeg,0,0.995260537,724,0,1640,875,916,875,rainbow dash
2093744.jpeg,https://derpicdn.net/img/view/2019/7/16/2093744.jpeg,0,0.988266766,20,0,520,495,500,495,rainbow dash
2095159.jpeg,https://derpicdn.net/img/view/2019/7/18/2095159.jpeg,0,0.999106109,494,23,1046,575,552,552,rainbow dash
2095813.jpeg,https://derpicdn.net/img/view/2019/7/19/2095813.jpeg,0,0.987721026,134,53,1356,1275,1222,1222,rainbow dash
2096549.jpeg,https://derpicdn.net/img/view/2019/7/20/2096549.jpeg,0,0.987588644,1007,550,2929,2472,1922,1922,rainbow dash
2096681.jpeg,https://derpicdn.net/img/view/2019/7/20/2096681.jpeg,0,0.996968031,156,10,600,454,444,444,rainbow dash
2098278.jpeg,https://derpicdn.net/img/view/2019/7/22/2098278.jpeg,0,0.940485239,140,14,564,438,424,424,rainbow dash
2100410.jpeg,https://derpicdn.net/img/view/2019/7/24/2100410.jpeg,0,0.931088865,844,0,1829,1005,985,1005,rainbow dash
2100951.jpeg,https://derpicdn.net/img/view/2019/7/25/2100951.jpeg,0,0.969963431,604,63,1046,505,442,442,rainbow dash
2101813.jpeg,https://derpicdn.net/img/view/2019/7/26/2101813.jpeg,0,0.982683957,909,0,2400,1276,1491,1276,rainbow dash
2104184.jpeg,https://derpicdn.net/img/view/2019/7/29/2104184.jpeg,0,0.934715271,580,0,1420,651,840,651,rainbow dash
2105617.jpeg,https://derpicdn.net/img/view/2019/7/31/2105617.jpeg,0,0.962464511,564,0,1358,761,794,761,rainbow dash
2106586.jpeg,https://derpicdn.net/img/view/2019/8/1/2106586.jpeg,0,0.919556558,11,49,435,473,424,424,rainbow dash
2106775.jpeg,https://derpicdn.net/img/view/2019/8/2/2106775.jpeg,0,0.983936787,0,24,733,844,733,820,rainbow dash
2106801.jpeg,https://derpicdn.net/img/view/2019/8/2/2106801.jpeg,0,0.998756826,236,0,820,561,584,561,rainbow dash
2108428.jpeg,https://derpicdn.net/img/view/2019/8/4/2108428.jpeg,0,0.999452651,594,0,1232,604,638,604,rainbow dash
2108524.jpeg,https://derpicdn.net/img/view/2019/8/4/2108524.jpeg,0,0.993285358,262,0,1828,1534,1566,1534,rainbow dash
2109487.jpeg,https://derpicdn.net/img/view/2019/8/5/2109487.jpeg,0,0.999103308,368,18,854,504,486,486,rainbow dash
2111849.jpeg,https://derpicdn.net/img/view/2019/8/8/2111849.jpeg,0,0.998511255,64,0,428,311,364,311,rainbow dash
2112080.jpeg,https://derpicdn.net/img/view/2019/8/8/2112080.jpeg,0,0.986769021,88,25,1466,1298,1378,1273,rainbow dash
2113114.jpeg,https://derpicdn.net/img/view/2019/8/9/2113114.jpeg,0,0.994500875,0,237,696,979,696,742,rainbow dash
2113114.jpeg,https://derpicdn.net/img/view/2019/8/9/2113114.jpeg,1,0.985677779,651,8,1517,874,866,866,rainbow dash
2113114.jpeg,https://derpicdn.net/img/view/2019/8/9/2113114.jpeg,2,0.978758693,917,1958,1389,2430,472,472,rainbow dash
2113114.jpeg,https://derpicdn.net/img/view/2019/8/9/2113114.jpeg,3,0.965853453,83,1102,857,1876,774,774,rainbow dash
2113209.jpeg,https://derpicdn.net/img/view/2019/8/9/2113209.jpeg,0,0.965292752,0,0,470,577,470,577,rainbow dash
2113209.jpeg,https://derpicdn.net/img/view/2019/8/9/2113209.jpeg,1,0.923502088,0,0,474,591,474,591,rainbow dash
2113238.jpeg,https://derpicdn.net/img/view/2019/8/9/2113238.jpeg,0,0.963401854,78,0,724,617,646,617,rainbow dash
2113240.jpeg,https://derpicdn.net/img/view/2019/8/9/2113240.jpeg,0,0.996299446,573,3,1063,493,490,490,rainbow dash
2113252.jpeg,https://derpicdn.net/img/view/2019/8/9/2113252.jpeg,0,0.96906209,341,0,1649,1161,1308,1161,rainbow dash
2113701.jpeg,https://derpicdn.net/img/view/2019/8/10/2113701.jpeg,0,0.981782496,126,25,382,281,256,256,rainbow dash
2114949.jpeg,https://derpicdn.net/img/view/2019/8/11/2114949.jpeg,0,0.995964408,10,79,370,439,360,360,rainbow dash
2118248.jpeg,https://derpicdn.net/img/view/2019/8/14/2118248.jpeg,0,0.953444719,517,69,1629,1181,1112,1112,rainbow dash
2119711.jpeg,https://derpicdn.net/img/view/2019/8/16/2119711.jpeg,0,0.998232722,358,0,700,335,342,335,rainbow dash
2121329.jpeg,https://derpicdn.net/img/view/2019/8/18/2121329.jpeg,0,0.996422172,1961,0,4459,2244,2498,2244,rainbow dash
2122310.jpeg,https://derpicdn.net/img/view/2019/8/19/2122310.jpeg,0,0.996940315,105,0,1061,938,956,938,rainbow dash
2122865.jpeg,https://derpicdn.net/img/view/2019/8/20/2122865.jpeg,0,0.970401824,1202,179,3516,2493,2314,2314,rainbow dash
2123813.jpeg,https://derpicdn.net/img/view/2019/8/21/2123813.jpeg,0,0.998080254,261,5,839,583,578,578,rainbow dash
2124201.jpeg,https://derpicdn.net/img/view/2019/8/21/2124201.jpeg,0,0.984557807,266,0,1818,1489,1552,1489,rainbow dash
2124788.jpeg,https://derpicdn.net/img/view/2019/8/22/2124788.jpeg,0,0.975035191,495,3,1271,779,776,776,rainbow dash
2125298.jpeg,https://derpicdn.net/img/view/2019/8/23/2125298.jpeg,0,0.975548208,1127,25,1769,667,642,642,rainbow dash
2126221.jpeg,https://derpicdn.net/img/view/2019/8/24/2126221.jpeg,0,0.989281833,0,30,675,736,675,706,rainbow dash
2126860.jpeg,https://derpicdn.net/img/view/2019/8/25/2126860.jpeg,0,0.994972289,276,0,950,643,674,643,rainbow dash
2127092.jpeg,https://derpicdn.net/img/view/2019/8/25/2127092.jpeg,0,0.984821856,768,390,1040,662,272,272,rainbow dash
2127092.jpeg,https://derpicdn.net/img/view/2019/8/25/2127092.jpeg,1,0.972530544,969,315,1283,629,314,314,rainbow dash
2127131.jpeg,https://derpicdn.net/img/view/2019/8/25/2127131.jpeg,0,0.98962301,250,0,718,449,468,449,rainbow dash
2133067.jpeg,https://derpicdn.net/img/view/2019/9/1/2133067.jpeg,0,0.993203521,128,0,840,591,712,591,rainbow dash
2134082.jpeg,https://derpicdn.net/img/view/2019/9/2/2134082.jpeg,0,0.998977602,374,0,750,325,376,325,rainbow dash
2134086.jpeg,https://derpicdn.net/img/view/2019/9/2/2134086.jpeg,0,0.908328593,498,9,882,393,384,384,rainbow dash
2140895.jpeg,https://derpicdn.net/img/view/2019/9/10/2140895.jpeg,0,0.968961537,0,0,2830,2318,2830,2318,rainbow dash
2142552.jpeg,https://derpicdn.net/img/view/2019/9/12/2142552.jpeg,0,0.981044114,203,11,507,315,304,304,rainbow dash
2142759.jpeg,https://derpicdn.net/img/view/2019/9/13/2142759.jpeg,0,0.997397959,42,30,846,834,804,804,rainbow dash
2146243.jpeg,https://derpicdn.net/img/view/2019/9/17/2146243.jpeg,0,0.979477823,14,0,394,378,380,378,rainbow dash
2148242.jpeg,https://derpicdn.net/img/view/2019/9/20/2148242.jpeg,0,0.998559654,413,148,815,550,402,402,rainbow dash
2148704.jpeg,https://derpicdn.net/img/view/2019/9/20/2148704.jpeg,0,0.999844313,311,0,667,341,356,341,rainbow dash
2148705.jpeg,https://derpicdn.net/img/view/2019/9/20/2148705.jpeg,0,0.998722732,67,0,691,614,624,614,rainbow dash
2148709.jpeg,https://derpicdn.net/img/view/2019/9/20/2148709.jpeg,0,0.999123394,203,0,861,618,658,618,rainbow dash
2148852.jpeg,https://derpicdn.net/img/view/2019/9/20/2148852.jpeg,0,0.972008765,0,4,636,670,636,666,rainbow dash
2149475.jpeg,https://derpicdn.net/img/view/2019/9/21/2149475.jpeg,0,0.995435834,0,0,1205,1313,1205,1313,rainbow dash
2149652.jpeg,https://derpicdn.net/img/view/2019/9/21/2149652.jpeg,0,0.983030558,85,0,719,580,634,580,rainbow dash
2151439.jpeg,https://derpicdn.net/img/view/2019/9/23/2151439.jpeg,0,0.987445951,255,91,665,501,410,410,rainbow dash
2151793.jpeg,https://derpicdn.net/img/view/2019/9/24/2151793.jpeg,0,0.996226728,123,185,1089,1151,966,966,rainbow dash
2153626.jpeg,https://derpicdn.net/img/view/2019/9/26/2153626.jpeg,0,0.97636044,2407,893,4289,2775,1882,1882,rainbow dash
2153814.jpeg,https://derpicdn.net/img/view/2019/9/26/2153814.jpeg,0,0.9429093,451,17,869,435,418,418,rainbow dash
215494.jpeg,https://derpicdn.net/img/view/2013/1/17/215494.jpeg,0,0.988038182,123,0,285,160,162,160,rainbow dash
2157094.jpeg,https://derpicdn.net/img/view/2019/9/30/2157094.jpeg,0,0.926878214,581,15,819,253,238,238,rainbow dash
2159182.jpeg,https://derpicdn.net/img/view/2019/10/3/2159182.jpeg,0,0.937558115,812,0,2328,1439,1516,1439,rainbow dash
2159986.jpeg,https://derpicdn.net/img/view/2019/10/4/2159986.jpeg,0,0.991272449,93,0,677,544,584,544,rainbow dash
2162073.jpeg,https://derpicdn.net/img/view/2019/10/6/2162073.jpeg,0,0.993562758,357,0,789,402,432,402,rainbow dash
2162552.jpeg,https://derpicdn.net/img/view/2019/10/7/2162552.jpeg,0,0.995733023,95,30,367,302,272,272,rainbow dash
2162616.jpeg,https://derpicdn.net/img/view/2019/10/7/2162616.jpeg,0,0.991639674,325,66,2117,1858,1792,1792,rainbow dash
2162617.jpeg,https://derpicdn.net/img/view/2019/10/7/2162617.jpeg,0,0.987692952,420,0,2792,2224,2372,2224,rainbow dash
2163889.jpeg,https://derpicdn.net/img/view/2019/10/9/2163889.jpeg,0,0.993369699,288,0,1700,1187,1412,1187,rainbow dash
2164511.jpeg,https://derpicdn.net/img/view/2019/10/10/2164511.jpeg,0,0.993831992,183,48,509,374,326,326,rainbow dash
2165981.jpeg,https://derpicdn.net/img/view/2019/10/12/2165981.jpeg,0,0.980618954,0,59,1251,1331,1251,1272,rainbow dash
2166511.jpeg,https://derpicdn.net/img/view/2019/10/12/2166511.jpeg,0,0.984882236,378,74,1264,960,886,886,rainbow dash
2170113.jpeg,https://derpicdn.net/img/view/2019/10/16/2170113.jpeg,0,0.986989081,598,0,1110,455,512,455,rainbow dash
2170794.jpeg,https://derpicdn.net/img/view/2019/10/16/2170794.jpeg,0,0.977338314,485,497,709,713,224,216,rainbow dash
2171601.jpeg,https://derpicdn.net/img/view/2019/10/17/2171601.jpeg,0,0.907555819,49,0,617,564,568,564,rainbow dash
2173434.jpeg,https://derpicdn.net/img/view/2019/10/19/2173434.jpeg,0,0.987308502,24,31,210,231,186,200,rainbow dash
2174399.jpeg,https://derpicdn.net/img/view/2019/10/20/2174399.jpeg,0,0.980837762,313,105,617,409,304,304,rainbow dash
2174991.jpeg,https://derpicdn.net/img/view/2019/10/21/2174991.jpeg,0,0.943121076,209,3,959,753,750,750,rainbow dash
2176811.jpeg,https://derpicdn.net/img/view/2019/10/23/2176811.jpeg,0,0.992262423,940,0,2002,984,1062,984,rainbow dash
2176833.jpeg,https://derpicdn.net/img/view/2019/10/23/2176833.jpeg,0,0.94016999,24,0,988,937,964,937,rainbow dash
2177761.jpeg,https://derpicdn.net/img/view/2019/10/24/2177761.jpeg,0,0.998264253,321,0,909,562,588,562,rainbow dash
2177850.jpeg,https://derpicdn.net/img/view/2019/10/24/2177850.jpeg,0,0.992617786,119,0,816,695,697,695,rainbow dash
2178800.jpeg,https://derpicdn.net/img/view/2019/10/25/2178800.jpeg,0,0.931320071,87,223,263,399,176,176,rainbow dash
2180277.jpeg,https://derpicdn.net/img/view/2019/10/27/2180277.jpeg,0,0.92041105,563,0,2453,1599,1890,1599,rainbow dash
2180824.jpeg,https://derpicdn.net/img/view/2019/10/28/2180824.jpeg,0,0.998367131,529,0,1069,528,540,528,rainbow dash
2181547.jpeg,https://derpicdn.net/img/view/2019/10/28/2181547.jpeg,0,0.997830868,609,484,1375,1250,766,766,rainbow dash
2181751.jpeg,https://derpicdn.net/img/view/2019/10/29/2181751.jpeg,0,0.969453096,64,0,537,331,473,331,rainbow dash
2182521.jpeg,https://derpicdn.net/img/view/2019/10/30/2182521.jpeg,0,0.991596878,297,182,1757,1642,1460,1460,rainbow dash
2183405.jpeg,https://derpicdn.net/img/view/2019/10/31/2183405.jpeg,0,0.990844965,884,1104,2088,2308,1204,1204,rainbow dash
2183405.jpeg,https://derpicdn.net/img/view/2019/10/31/2183405.jpeg,1,0.9763574,150,199,1348,1397,1198,1198,rainbow dash
2184036.jpeg,https://derpicdn.net/img/view/2019/10/31/2184036.jpeg,0,0.997942209,462,50,778,366,316,316,rainbow dash
2184039.jpeg,https://derpicdn.net/img/view/2019/10/31/2184039.jpeg,0,0.977322519,315,0,879,553,564,553,rainbow dash
2184131.jpeg,https://derpicdn.net/img/view/2019/11/1/2184131.jpeg,0,0.990470827,317,0,1037,668,720,668,rainbow dash
2186523.jpeg,https://derpicdn.net/img/view/2019/11/3/2186523.jpeg,0,0.981219351,676,867,1384,1575,708,708,rainbow dash
2187701.jpeg,https://derpicdn.net/img/view/2019/11/4/2187701.jpeg,0,0.981063843,51,0,1415,1334,1364,1334,rainbow dash
2187709.jpeg,https://derpicdn.net/img/view/2019/11/4/2187709.jpeg,0,0.987277627,894,0,2128,1185,1234,1185,rainbow dash
2187932.jpeg,https://derpicdn.net/img/view/2019/11/5/2187932.jpeg,0,0.988446236,520,21,1086,587,566,566,rainbow dash
2190300.jpeg,https://derpicdn.net/img/view/2019/11/8/2190300.jpeg,0,0.991429687,198,0,682,420,484,420,rainbow dash
2193621.jpeg,https://derpicdn.net/img/view/2019/11/11/2193621.jpeg,0,0.98792094,69,43,775,749,706,706,rainbow dash
2198619.jpeg,https://derpicdn.net/img/view/2019/11/17/2198619.jpeg,0,0.979564905,398,207,1008,817,610,610,rainbow dash
2198798.jpeg,https://derpicdn.net/img/view/2019/11/17/2198798.jpeg,0,0.985847831,626,280,2730,2384,2104,2104,rainbow dash
2199630.jpeg,https://derpicdn.net/img/view/2019/11/18/2199630.jpeg,0,0.971581519,1571,106,1885,420,314,314,rainbow dash
2199630.jpeg,https://derpicdn.net/img/view/2019/11/18/2199630.jpeg,1,0.902279913,41,113,381,453,340,340,rainbow dash
2199878.jpeg,https://derpicdn.net/img/view/2019/11/19/2199878.jpeg,0,0.992573321,64,0,498,342,434,342,rainbow dash
2200575.jpeg,https://derpicdn.net/img/view/2019/11/20/2200575.jpeg,0,0.96766746,91,24,767,700,676,676,rainbow dash
2203494.jpeg,https://derpicdn.net/img/view/2019/11/23/2203494.jpeg,0,0.975894809,528,0,2162,1221,1634,1221,rainbow dash
2203684.jpeg,https://derpicdn.net/img/view/2019/11/23/2203684.jpeg,0,0.999820471,937,0,1947,983,1010,983,rainbow dash
2203895.jpeg,https://derpicdn.net/img/view/2019/11/23/2203895.jpeg,0,0.997388601,452,0,1378,906,926,906,rainbow dash
2203965.jpeg,https://derpicdn.net/img/view/2019/11/23/2203965.jpeg,0,0.981365681,279,10,793,524,514,514,rainbow dash
2204454.jpeg,https://derpicdn.net/img/view/2019/11/24/2204454.jpeg,0,0.998629391,64,0,362,295,298,295,rainbow dash
2206227.jpeg,https://derpicdn.net/img/view/2019/11/26/2206227.jpeg,0,0.999411702,2145,147,3083,1085,938,938,rainbow dash
2207694.jpeg,https://derpicdn.net/img/view/2019/11/28/2207694.jpeg,0,0.987302423,567,690,2533,2656,1966,1966,rainbow dash
2209699.jpeg,https://derpicdn.net/img/view/2019/12/1/2209699.jpeg,0,0.997560918,300,0,894,498,594,498,rainbow dash
2210431.jpeg,https://derpicdn.net/img/view/2019/12/1/2210431.jpeg,0,0.966620028,80,0,722,600,642,600,rainbow dash
2211201.jpeg,https://derpicdn.net/img/view/2019/12/2/2211201.jpeg,0,0.997655034,174,0,696,501,522,501,rainbow dash
2211972.jpeg,https://derpicdn.net/img/view/2019/12/4/2211972.jpeg,0,0.945528388,423,392,1891,1860,1468,1468,rainbow dash
2212512.jpeg,https://derpicdn.net/img/view/2019/12/4/2212512.jpeg,0,0.997818649,70,0,708,612,638,612,rainbow dash
2213071.jpeg,https://derpicdn.net/img/view/2019/12/5/2213071.jpeg,0,0.959548116,38,1,624,587,586,586,rainbow dash
2214469.jpeg,https://derpicdn.net/img/view/2019/12/7/2214469.jpeg,0,0.998589337,426,0,1178,747,752,747,rainbow dash
2215137.jpeg,https://derpicdn.net/img/view/2019/12/7/2215137.jpeg,0,0.953474998,1070,417,2114,1461,1044,1044,rainbow dash
2215167.jpeg,https://derpicdn.net/img/view/2019/12/7/2215167.jpeg,0,0.974107563,56,142,302,388,246,246,rainbow dash
2217775.jpeg,https://derpicdn.net/img/view/2019/12/11/2217775.jpeg,0,0.970688403,309,0,657,298,348,298,rainbow dash
2218723.jpeg,https://derpicdn.net/img/view/2019/12/12/2218723.jpeg,0,0.9969697,349,78,873,602,524,524,rainbow dash
2220364.jpeg,https://derpicdn.net/img/view/2019/12/14/2220364.jpeg,0,0.972986341,508,0,1138,598,630,598,rainbow dash
2221676.jpeg,https://derpicdn.net/img/view/2019/12/15/2221676.jpeg,0,0.900697649,253,62,711,520,458,458,rainbow dash
2224930.jpeg,https://derpicdn.net/img/view/2019/12/20/2224930.jpeg,0,0.994287491,410,0,802,326,392,326,rainbow dash
225482.jpeg,https://derpicdn.net/img/view/2013/1/27/225482.jpeg,0,0.997768521,55,4,357,306,302,302,rainbow dash
226190.jpeg,https://derpicdn.net/img/view/2013/1/28/226190.jpeg,0,0.996461153,81,0,500,418,419,418,rainbow dash
229274.jpeg,https://derpicdn.net/img/view/2013/1/31/229274.jpeg,0,0.981377363,36,0,600,560,564,560,rainbow dash
232797.jpeg,https://derpicdn.net/img/view/2013/2/4/232797.jpeg,3,0.90221566,1314,51,1850,587,536,536,rainbow dash
239878.jpeg,https://derpicdn.net/img/view/2013/2/11/239878.jpeg,0,0.999276876,441,0,957,477,516,477,rainbow dash
250173.jpeg,https://derpicdn.net/img/view/2013/2/20/250173.jpeg,0,0.997300148,287,0,1197,759,910,759,rainbow dash
271364.jpeg,https://derpicdn.net/img/view/2013/3/15/271364.jpeg,0,0.990727484,324,0,662,328,338,328,rainbow dash
275503.jpeg,https://derpicdn.net/img/view/2013/3/20/275503.jpeg,0,0.996250927,0,6,482,496,482,490,rainbow dash
276811.jpeg,https://derpicdn.net/img/view/2013/3/22/276811.jpeg,0,0.99870646,310,0,538,218,228,218,rainbow dash
281508.jpeg,https://derpicdn.net/img/view/2013/3/28/281508.jpeg,0,0.988834441,245,0,657,397,412,397,rainbow dash
286980.jpeg,https://derpicdn.net/img/view/2013/4/3/286980.jpeg,0,0.986903667,0,0,584,584,584,584,rainbow dash
287069.jpeg,https://derpicdn.net/img/view/2013/4/3/287069.jpeg,0,0.993671119,0,0,862,834,862,834,rainbow dash
287934.jpeg,https://derpicdn.net/img/view/2013/4/4/287934.jpeg,0,0.940506518,168,0,436,262,268,262,rainbow dash
291902.jpeg,https://derpicdn.net/img/view/2013/4/8/291902.jpeg,0,0.991760671,496,0,852,332,356,332,rainbow dash
296026.jpeg,https://derpicdn.net/img/view/2013/4/12/296026.jpeg,0,0.98268944,245,3,535,293,290,290,rainbow dash
313777.jpeg,https://derpicdn.net/img/view/2013/5/1/313777.jpeg,0,0.96963346,188,20,668,500,480,480,rainbow dash
337355.jpeg,https://derpicdn.net/img/view/2013/5/31/337355.jpeg,0,0.999607086,434,0,782,348,348,348,rainbow dash
361035.jpeg,https://derpicdn.net/img/view/2013/6/30/361035.jpeg,0,0.967394352,122,764,1180,1822,1058,1058,rainbow dash
365827.jpeg,https://derpicdn.net/img/view/2013/7/6/365827.jpeg,0,0.912745118,0,202,989,1324,989,1122,rainbow dash
376453.jpeg,https://derpicdn.net/img/view/2013/7/17/376453.jpeg,0,0.99678129,143,0,733,579,590,579,rainbow dash
376689.jpeg,https://derpicdn.net/img/view/2013/7/17/376689.jpeg,0,0.994934201,70,0,548,463,478,463,rainbow dash
379493.jpeg,https://derpicdn.net/img/view/2013/7/20/379493.jpeg,0,0.994302571,25,35,717,727,692,692,rainbow dash
382823.jpeg,https://derpicdn.net/img/view/2013/7/24/382823.jpeg,0,0.999287605,854,44,1882,1072,1028,1028,rainbow dash
385276.jpeg,https://derpicdn.net/img/view/2013/7/29/385276.jpeg,0,0.949740469,0,37,496,637,496,600,rainbow dash
390121.jpeg,https://derpicdn.net/img/view/2013/8/3/390121.jpeg,0,0.995143235,672,478,850,670,178,192,rainbow dash
391696.jpeg,https://derpicdn.net/img/view/2013/8/5/391696.jpeg,0,0.961102426,188,284,1234,1280,1046,996,rainbow dash
398073.jpeg,https://derpicdn.net/img/view/2013/8/12/398073.jpeg,0,0.986400127,148,408,470,730,322,322,rainbow dash
399137.jpeg,https://derpicdn.net/img/view/2013/8/13/399137.jpeg,0,0.999757946,275,0,1513,1045,1238,1045,rainbow dash
400211.jpeg,https://derpicdn.net/img/view/2013/8/14/400211.jpeg,0,0.995375574,215,60,1379,1224,1164,1164,rainbow dash
401351.jpeg,https://derpicdn.net/img/view/2013/8/15/401351.jpeg,0,0.972846389,65,0,419,342,354,342,rainbow dash
404343.jpeg,https://derpicdn.net/img/view/2013/8/19/404343.jpeg,0,0.999557436,447,0,909,392,462,392,rainbow dash
411366.jpeg,https://derpicdn.net/img/view/2013/8/26/411366.jpeg,0,0.989608943,108,103,400,395,292,292,rainbow dash
412587.jpeg,https://derpicdn.net/img/view/2013/8/28/412587.jpeg,0,0.981806993,552,23,1450,921,898,898,rainbow dash
414606.jpeg,https://derpicdn.net/img/view/2013/8/30/414606.jpeg,0,0.947536111,4,6,250,252,246,246,rainbow dash
422647.jpeg,https://derpicdn.net/img/view/2013/9/8/422647.jpeg,0,0.914016128,278,107,866,695,588,588,rainbow dash
428987.jpeg,https://derpicdn.net/img/view/2013/9/16/428987.jpeg,0,0.995961249,422,11,792,381,370,370,rainbow dash
430245.jpeg,https://derpicdn.net/img/view/2013/9/18/430245.jpeg,0,0.993817747,102,7,350,255,248,248,rainbow dash
435212.jpeg,https://derpicdn.net/img/view/2013/9/26/435212.jpeg,0,0.973424494,175,88,587,500,412,412,rainbow dash
437577.jpeg,https://derpicdn.net/img/view/2013/9/29/437577.jpeg,0,0.999110103,180,0,508,314,328,314,rainbow dash
448456.jpeg,https://derpicdn.net/img/view/2013/10/14/448456.jpeg,0,0.994612873,33,0,493,402,460,402,rainbow dash
448899.jpeg,https://derpicdn.net/img/view/2013/10/14/448899.jpeg,0,0.9908728,29,0,329,290,300,290,rainbow dash
473357.jpeg,https://derpicdn.net/img/view/2013/11/15/473357.jpeg,0,0.991826296,336,3,1080,747,744,744,rainbow dash
477046.jpeg,https://derpicdn.net/img/view/2013/11/20/477046.jpeg,0,0.993456244,91,79,733,721,642,642,rainbow dash
495524.jpeg,https://derpicdn.net/img/view/2013/12/12/495524.jpeg,0,0.998948932,257,0,859,553,602,553,rainbow dash
505904.jpeg,https://derpicdn.net/img/view/2013/12/25/505904.jpeg,0,0.982249379,121,123,523,525,402,402,rainbow dash
506253.jpeg,https://derpicdn.net/img/view/2013/12/25/506253.jpeg,0,0.999897838,299,633,907,1241,608,608,rainbow dash
507483.jpeg,https://derpicdn.net/img/view/2013/12/27/507483.jpeg,0,0.996803999,668,104,994,430,326,326,rainbow dash
513718.jpeg,https://derpicdn.net/img/view/2014/1/3/513718.jpeg,0,0.981803775,0,10,957,1012,957,1002,rainbow dash
519882.jpeg,https://derpicdn.net/img/view/2014/1/9/519882.jpeg,0,0.990751028,169,6,725,562,556,556,rainbow dash
535727.jpeg,https://derpicdn.net/img/view/2014/1/27/535727.jpeg,0,0.900933444,583,203,1220,849,637,646,rainbow dash
559206.jpeg,https://derpicdn.net/img/view/2014/2/22/559206.jpeg,0,0.937934279,746,503,1066,823,320,320,rainbow dash
561411.jpeg,https://derpicdn.net/img/view/2014/2/25/561411.jpeg,0,0.997659266,685,613,900,855,215,242,rainbow dash
572003.jpeg,https://derpicdn.net/img/view/2014/3/11/572003.jpeg,0,0.918980002,284,14,576,306,292,292,rainbow dash
575624.jpeg,https://derpicdn.net/img/view/2014/3/15/575624.jpeg,0,0.954817235,259,0,881,608,622,608,rainbow dash
585541.jpeg,https://derpicdn.net/img/view/2014/3/26/585541.jpeg,0,0.997882962,80,0,1326,1227,1246,1227,rainbow dash
585541.jpeg,https://derpicdn.net/img/view/2014/3/26/585541.jpeg,1,0.976488411,1380,1347,2348,2315,968,968,rainbow dash
594594.jpeg,https://derpicdn.net/img/view/2014/4/6/594594.jpeg,0,0.94757086,0,100,462,594,462,494,rainbow dash
602516.jpeg,https://derpicdn.net/img/view/2014/4/17/602516.jpeg,0,0.98877883,1969,2522,2751,3304,782,782,rainbow dash
610209.jpeg,https://derpicdn.net/img/view/2014/4/26/610209.jpeg,0,0.999533832,328,0,1354,941,1026,941,rainbow dash
613646.jpeg,https://derpicdn.net/img/view/2014/4/30/613646.jpeg,0,0.986226022,256,0,912,512,656,512,rainbow dash
616497.jpeg,https://derpicdn.net/img/view/2014/5/3/616497.jpeg,0,0.99947083,63,0,481,415,418,415,rainbow dash
634175.jpeg,https://derpicdn.net/img/view/2014/5/23/634175.jpeg,0,0.989596426,0,0,682,652,682,652,rainbow dash
635632.jpeg,https://derpicdn.net/img/view/2014/5/24/635632.jpeg,0,0.998979688,253,0,697,426,444,426,rainbow dash
635677.jpeg,https://derpicdn.net/img/view/2014/5/24/635677.jpeg,0,0.994797945,26,0,464,429,438,429,rainbow dash
644598.jpeg,https://derpicdn.net/img/view/2014/6/4/644598.jpeg,0,0.99968636,254,0,668,391,414,391,rainbow dash
646078.jpeg,https://derpicdn.net/img/view/2014/6/6/646078.jpeg,0,0.995092809,121,464,725,1068,604,604,rainbow dash
648326.jpeg,https://derpicdn.net/img/view/2014/6/8/648326.jpeg,0,0.973953307,16,0,858,842,842,842,rainbow dash
652102.jpeg,https://derpicdn.net/img/view/2014/6/13/652102.jpeg,0,0.963317931,292,0,738,420,446,420,rainbow dash
657310.jpeg,https://derpicdn.net/img/view/2014/6/20/657310.jpeg,0,0.987628579,290,31,756,497,466,466,rainbow dash
664153.jpeg,https://derpicdn.net/img/view/2014/6/29/664153.jpeg,0,0.998824418,173,31,641,499,468,468,rainbow dash
671750.jpeg,https://derpicdn.net/img/view/2014/7/10/671750.jpeg,0,0.978579938,284,9,476,201,192,192,rainbow dash
672414.jpeg,https://derpicdn.net/img/view/2014/7/11/672414.jpeg,1,0.936701298,1590,958,2640,2000,1050,1042,rainbow dash
679394.jpeg,https://derpicdn.net/img/view/2014/7/20/679394.jpeg,0,0.961445153,101,14,415,328,314,314,rainbow dash
681259.jpeg,https://derpicdn.net/img/view/2014/7/23/681259.jpeg,0,0.961229861,52,160,950,1066,898,906,rainbow dash
684494.jpeg,https://derpicdn.net/img/view/2014/7/27/684494.jpeg,0,0.99602288,759,0,1936,1124,1177,1124,rainbow dash
686926.jpeg,https://derpicdn.net/img/view/2014/7/30/686926.jpeg,0,0.965204179,860,188,1180,508,320,320,rainbow dash
690066.jpeg,https://derpicdn.net/img/view/2014/8/3/690066.jpeg,0,0.999679744,84,0,276,189,192,189,rainbow dash
690275.jpeg,https://derpicdn.net/img/view/2014/8/3/690275.jpeg,0,0.996871352,484,26,1182,724,698,698,rainbow dash
690275.jpeg,https://derpicdn.net/img/view/2014/8/3/690275.jpeg,1,0.99627012,1579,241,2297,959,718,718,rainbow dash
690275.jpeg,https://derpicdn.net/img/view/2014/8/3/690275.jpeg,2,0.992951334,1878,1250,2536,1908,658,658,rainbow dash
690275.jpeg,https://derpicdn.net/img/view/2014/8/3/690275.jpeg,3,0.989122868,331,1117,1075,1861,744,744,rainbow dash
693180.jpeg,https://derpicdn.net/img/view/2014/8/6/693180.jpeg,0,0.996304274,1090,158,2054,1122,964,964,rainbow dash
698861.jpeg,https://derpicdn.net/img/view/2014/8/13/698861.jpeg,0,0.927635431,107,0,943,832,836,832,rainbow dash
702987.jpeg,https://derpicdn.net/img/view/2014/8/19/702987.jpeg,0,0.997425795,488,61,986,559,498,498,rainbow dash
708640.jpeg,https://derpicdn.net/img/view/2014/8/26/708640.jpeg,0,0.988946974,0,0,652,669,652,669,rainbow dash
714429.jpeg,https://derpicdn.net/img/view/2014/9/4/714429.jpeg,0,0.990675807,147,182,829,864,682,682,rainbow dash
719951.jpeg,https://derpicdn.net/img/view/2014/9/11/719951.jpeg,0,0.988169611,406,424,818,836,412,412,rainbow dash
722655.jpeg,https://derpicdn.net/img/view/2014/9/15/722655.jpeg,0,0.994538546,83,70,863,850,780,780,rainbow dash
723060.jpeg,https://derpicdn.net/img/view/2014/9/16/723060.jpeg,0,0.998602867,322,0,858,475,536,475,rainbow dash
725328.jpeg,https://derpicdn.net/img/view/2014/9/19/725328.jpeg,0,0.96358943,731,471,900,677,169,206,rainbow dash
737312.jpeg,https://derpicdn.net/img/view/2014/10/6/737312.jpeg,0,0.996441662,0,0,467,481,467,481,rainbow dash
742034.jpeg,https://derpicdn.net/img/view/2014/10/13/742034.jpeg,0,0.999587953,320,0,736,399,416,399,rainbow dash
742243.jpeg,https://derpicdn.net/img/view/2014/10/13/742243.jpeg,0,0.999487519,221,0,633,382,412,382,rainbow dash
743486.jpeg,https://derpicdn.net/img/view/2014/10/15/743486.jpeg,0,0.998671532,117,0,715,548,598,548,rainbow dash
754189.jpeg,https://derpicdn.net/img/view/2014/10/30/754189.jpeg,0,0.993251562,116,0,668,486,552,486,rainbow dash
755507.jpeg,https://derpicdn.net/img/view/2014/11/1/755507.jpeg,0,0.988424838,694,23,1184,513,490,490,rainbow dash
759597.jpeg,https://derpicdn.net/img/view/2014/11/7/759597.jpeg,0,0.968520522,99,0,431,306,332,306,rainbow dash
764923.jpeg,https://derpicdn.net/img/view/2014/11/15/764923.jpeg,0,0.937397957,0,42,1925,1984,1925,1942,rainbow dash
765766.jpeg,https://derpicdn.net/img/view/2014/11/16/765766.jpeg,0,0.928176939,241,0,2000,1948,1759,1948,rainbow dash
769214.jpeg,https://derpicdn.net/img/view/2014/11/22/769214.jpeg,0,0.987748921,205,44,789,628,584,584,rainbow dash
774192.jpeg,https://derpicdn.net/img/view/2014/11/29/774192.jpeg,0,0.989080608,22,38,952,968,930,930,rainbow dash
782839.jpeg,https://derpicdn.net/img/view/2014/12/11/782839.jpeg,0,0.999310732,1284,0,2356,1057,1072,1057,rainbow dash
789916.jpeg,https://derpicdn.net/img/view/2014/12/22/789916.jpeg,0,0.995915353,260,0,904,573,644,573,rainbow dash
794946.jpeg,https://derpicdn.net/img/view/2014/12/29/794946.jpeg,0,0.995871663,388,2,686,300,298,298,rainbow dash
795656.jpeg,https://derpicdn.net/img/view/2014/12/30/795656.jpeg,0,0.998501182,305,137,1949,1781,1644,1644,rainbow dash
795981.jpeg,https://derpicdn.net/img/view/2014/12/30/795981.jpeg,0,0.998273909,424,9,704,289,280,280,rainbow dash
800390.jpeg,https://derpicdn.net/img/view/2015/1/6/800390.jpeg,0,0.988818228,2699,404,3881,1586,1182,1182,rainbow dash
801619.jpeg,https://derpicdn.net/img/view/2015/1/7/801619.jpeg,0,0.995615125,81,8,775,702,694,694,rainbow dash
805387.jpeg,https://derpicdn.net/img/view/2015/1/13/805387.jpeg,0,0.987992525,192,5,460,273,268,268,rainbow dash
806510.jpeg,https://derpicdn.net/img/view/2015/1/14/806510.jpeg,0,0.98710376,25,47,389,411,364,364,rainbow dash
810425.jpeg,https://derpicdn.net/img/view/2015/1/19/810425.jpeg,0,0.981667697,102,0,694,556,592,556,rainbow dash
811534.jpeg,https://derpicdn.net/img/view/2015/1/21/811534.jpeg,0,0.981565475,0,71,533,625,533,554,rainbow dash
813647.jpeg,https://derpicdn.net/img/view/2015/1/24/813647.jpeg,0,0.961603761,505,51,1803,1349,1298,1298,rainbow dash
816498.jpeg,https://derpicdn.net/img/view/2015/1/28/816498.jpeg,0,0.994842529,62,47,690,675,628,628,rainbow dash
817155.jpeg,https://derpicdn.net/img/view/2015/1/29/817155.jpeg,0,0.978085041,57,120,645,708,588,588,rainbow dash
818187.jpeg,https://derpicdn.net/img/view/2015/1/31/818187.jpeg,0,0.920547187,496,64,914,482,418,418,rainbow dash
818675.jpeg,https://derpicdn.net/img/view/2015/1/31/818675.jpeg,0,0.989617884,247,408,767,928,520,520,rainbow dash
824904.jpeg,https://derpicdn.net/img/view/2015/2/9/824904.jpeg,0,0.904830992,342,0,674,312,332,312,rainbow dash
828101.jpeg,https://derpicdn.net/img/view/2015/2/14/828101.jpeg,0,0.993892133,200,0,900,681,700,681,rainbow dash
830672.jpeg,https://derpicdn.net/img/view/2015/2/17/830672.jpeg,0,0.983506858,42,0,718,612,676,612,rainbow dash
832231.jpeg,https://derpicdn.net/img/view/2015/2/19/832231.jpeg,0,0.980057538,650,0,1156,437,506,437,rainbow dash
832276.jpeg,https://derpicdn.net/img/view/2015/2/19/832276.jpeg,0,0.907165587,135,0,843,650,708,650,rainbow dash
832609.jpeg,https://derpicdn.net/img/view/2015/2/19/832609.jpeg,0,0.987065732,938,229,1474,765,536,536,rainbow dash
841083.jpeg,https://derpicdn.net/img/view/2015/3/2/841083.jpeg,0,0.984740496,843,0,1989,1115,1146,1115,rainbow dash
849109.jpeg,https://derpicdn.net/img/view/2015/3/14/849109.jpeg,0,0.9891119,885,0,2141,1045,1256,1045,rainbow dash
849259.jpeg,https://derpicdn.net/img/view/2015/3/14/849259.jpeg,0,0.986589134,8,13,576,581,568,568,rainbow dash
849927.jpeg,https://derpicdn.net/img/view/2015/3/15/849927.jpeg,0,0.992772341,164,0,538,367,374,367,rainbow dash
852890.jpeg,https://derpicdn.net/img/view/2015/3/19/852890.jpeg,0,0.991199493,186,6,760,580,574,574,rainbow dash
859555.jpeg,https://derpicdn.net/img/view/2015/3/29/859555.jpeg,0,0.997687995,324,61,580,317,256,256,rainbow dash
864032.jpeg,https://derpicdn.net/img/view/2015/4/3/864032.jpeg,0,0.940517247,117,0,871,664,754,664,rainbow dash
866065.jpeg,https://derpicdn.net/img/view/2015/4/5/866065.jpeg,0,0.998149872,190,44,720,574,530,530,rainbow dash
868064.jpeg,https://derpicdn.net/img/view/2015/4/7/868064.jpeg,0,0.952836812,439,76,1244,886,805,810,rainbow dash
869910.jpeg,https://derpicdn.net/img/view/2015/4/9/869910.jpeg,0,0.997052372,0,19,409,447,409,428,rainbow dash
874262.jpeg,https://derpicdn.net/img/view/2015/4/15/874262.jpeg,0,0.999654055,274,0,946,667,672,667,rainbow dash
87777.jpeg,https://derpicdn.net/img/view/2012/9/1/87777.jpeg,0,0.968441367,1377,223,1983,829,606,606,rainbow dash
87777.jpeg,https://derpicdn.net/img/view/2012/9/1/87777.jpeg,1,0.924438298,689,0,1369,676,680,676,rainbow dash
885066.jpeg,https://derpicdn.net/img/view/2015/4/28/885066.jpeg,0,0.946928561,0,0,666,692,666,692,rainbow dash
893057.jpeg,https://derpicdn.net/img/view/2015/5/10/893057.jpeg,0,0.993853748,47,7,719,679,672,672,rainbow dash
899416.jpeg,https://derpicdn.net/img/view/2015/5/18/899416.jpeg,0,0.962317765,510,29,1134,653,624,624,rainbow dash
900626.jpeg,https://derpicdn.net/img/view/2015/5/20/900626.jpeg,0,0.982733965,526,78,1214,766,688,688,rainbow dash
901160.jpeg,https://derpicdn.net/img/view/2015/5/21/901160.jpeg,0,0.995265305,49,8,511,470,462,462,rainbow dash
903072.jpeg,https://derpicdn.net/img/view/2015/5/24/903072.jpeg,0,0.992658138,425,390,729,694,304,304,rainbow dash
904984.jpeg,https://derpicdn.net/img/view/2015/5/27/904984.jpeg,0,0.995819509,114,136,590,612,476,476,rainbow dash
909447.jpeg,https://derpicdn.net/img/view/2015/6/3/909447.jpeg,0,0.981844783,263,0,951,569,688,569,rainbow dash
910865.jpeg,https://derpicdn.net/img/view/2015/6/5/910865.jpeg,0,0.999490261,481,0,1207,695,726,695,rainbow dash
916135.jpeg,https://derpicdn.net/img/view/2015/6/13/916135.jpeg,0,0.95840174,125,248,577,700,452,452,rainbow dash
918037.jpeg,https://derpicdn.net/img/view/2015/6/16/918037.jpeg,0,0.991954327,1309,2565,1823,3079,514,514,rainbow dash
918037.jpeg,https://derpicdn.net/img/view/2015/6/16/918037.jpeg,1,0.989200473,942,1248,1502,1808,560,560,rainbow dash
918037.jpeg,https://derpicdn.net/img/view/2015/6/16/918037.jpeg,2,0.96842134,1733,879,2181,1327,448,448,rainbow dash
924775.jpeg,https://derpicdn.net/img/view/2015/6/27/924775.jpeg,0,0.941739321,506,127,1012,633,506,506,rainbow dash
925489.jpeg,https://derpicdn.net/img/view/2015/6/28/925489.jpeg,0,0.996353865,484,151,820,487,336,336,rainbow dash
948500.jpeg,https://derpicdn.net/img/view/2015/8/1/948500.jpeg,0,0.970120251,697,65,1713,1081,1016,1016,rainbow dash
949258.jpeg,https://derpicdn.net/img/view/2015/8/2/949258.jpeg,0,0.967203498,1073,592,1497,1016,424,424,rainbow dash
950146.jpeg,https://derpicdn.net/img/view/2015/8/4/950146.jpeg,0,0.984131634,132,15,636,519,504,504,rainbow dash
950485.jpeg,https://derpicdn.net/img/view/2015/8/4/950485.jpeg,0,0.963793397,0,0,556,578,556,578,rainbow dash
954941.jpeg,https://derpicdn.net/img/view/2015/8/10/954941.jpeg,0,0.994059503,0,0,767,833,767,833,rainbow dash
959916.jpeg,https://derpicdn.net/img/view/2015/8/17/959916.jpeg,0,0.925272048,837,267,1499,929,662,662,rainbow dash
962547.jpeg,https://derpicdn.net/img/view/2015/8/21/962547.jpeg,0,0.968274951,507,0,2073,1540,1566,1540,rainbow dash
962884.jpeg,https://derpicdn.net/img/view/2015/8/21/962884.jpeg,0,0.937410593,833,104,2033,1304,1200,1200,rainbow dash
967457.jpeg,https://derpicdn.net/img/view/2015/8/28/967457.jpeg,0,0.992774606,453,0,1315,860,862,860,rainbow dash
968818.jpeg,https://derpicdn.net/img/view/2015/8/30/968818.jpeg,0,0.994052529,1052,142,1808,898,756,756,rainbow dash
969848.jpeg,https://derpicdn.net/img/view/2015/8/31/969848.jpeg,0,0.987124681,938,0,1868,858,930,858,rainbow dash
975305.jpeg,https://derpicdn.net/img/view/2015/9/8/975305.jpeg,0,0.944846749,68,32,466,430,398,398,rainbow dash
977411.jpeg,https://derpicdn.net/img/view/2015/9/11/977411.jpeg,0,0.988191783,246,0,1198,859,952,859,rainbow dash
991228.jpeg,https://derpicdn.net/img/view/2015/9/30/991228.jpeg,0,0.979643881,0,302,1182,1600,1182,1298,rainbow dash
994076.jpeg,https://derpicdn.net/img/view/2015/10/3/994076.jpeg,0,0.916972637,222,0,1926,1515,1704,1515,rainbow dash
996214.jpeg,https://derpicdn.net/img/view/2015/10/6/996214.jpeg,0,0.993605971,2,6,290,294,288,288,rainbow dash
1006496.png,https://derpicdn.net/img/view/2015/10/20/1006496.png,0,0.957897782,0,0,927,856,927,856,rarity
1006496.png,https://derpicdn.net/img/view/2015/10/20/1006496.png,0,0.957897782,0,0,883,828,883,828,rarity
1006496.png,https://derpicdn.net/img/view/2015/10/20/1006496.png,0,0.957897782,0,0,883,828,883,828,rarity
1008113.png,https://derpicdn.net/img/view/2015/10/23/1008113.png,0,0.974484503,21,0,743,631,722,631,rarity
1008113.png,https://derpicdn.net/img/view/2015/10/23/1008113.png,0,0.974484503,54,0,710,585,656,585,rarity
1008113.png,https://derpicdn.net/img/view/2015/10/23/1008113.png,0,0.974484503,54,0,710,585,656,585,rarity
1011257.png,https://derpicdn.net/img/view/2015/10/28/1011257.png,0,0.995513916,139,0,517,361,378,361,rarity
1011257.png,https://derpicdn.net/img/view/2015/10/28/1011257.png,0,0.995513916,151,0,505,343,354,343,rarity
1011257.png,https://derpicdn.net/img/view/2015/10/28/1011257.png,0,0.995513916,151,0,505,343,354,343,rarity
1020716.png,https://derpicdn.net/img/view/2015/11/11/1020716.png,0,0.985318005,222,24,768,570,546,546,rarity
1020716.png,https://derpicdn.net/img/view/2015/11/11/1020716.png,0,0.985318005,247,50,743,546,496,496,rarity
1020716.png,https://derpicdn.net/img/view/2015/11/11/1020716.png,0,0.985318005,247,50,743,546,496,496,rarity
1020722.png,https://derpicdn.net/img/view/2015/11/11/1020722.png,0,0.972385943,83,100,573,590,490,490,rarity
1020722.png,https://derpicdn.net/img/view/2015/11/11/1020722.png,0,0.972385943,106,123,550,567,444,444,rarity
1020722.png,https://derpicdn.net/img/view/2015/11/11/1020722.png,0,0.972385943,106,123,550,567,444,444,rarity
1022479.png,https://derpicdn.net/img/view/2015/11/14/1022479.png,0,0.986206293,205,0,785,513,580,513,rarity
1022479.png,https://derpicdn.net/img/view/2015/11/14/1022479.png,0,0.986206293,233,0,759,486,526,486,rarity
1022479.png,https://derpicdn.net/img/view/2015/11/14/1022479.png,0,0.986206293,233,0,759,486,526,486,rarity
1022842.png,https://derpicdn.net/img/view/2015/11/14/1022842.png,0,0.942831933,704,0,1974,1247,1270,1247,rarity
1022842.png,https://derpicdn.net/img/view/2015/11/14/1022842.png,0,0.942831933,678,0,2000,1273,1322,1273,rarity
1022842.png,https://derpicdn.net/img/view/2015/11/14/1022842.png,0,0.942831933,678,0,2000,1273,1322,1273,rarity
1025341.png,https://derpicdn.net/img/view/2015/11/18/1025341.png,0,0.933291793,437,364,1029,956,592,592,rarity
1025341.png,https://derpicdn.net/img/view/2015/11/18/1025341.png,0,0.933291793,462,390,1002,930,540,540,rarity
1025341.png,https://derpicdn.net/img/view/2015/11/18/1025341.png,0,0.933291793,462,390,1002,930,540,540,rarity
1032995.png,https://derpicdn.net/img/view/2015/11/29/1032995.png,0,0.968235135,325,606,965,1246,640,640,rarity
1033023.png,https://derpicdn.net/img/view/2015/11/29/1033023.png,0,0.999277949,350,0,1098,716,748,716,rarity
1034812.png,https://derpicdn.net/img/view/2015/12/1/1034812.png,0,0.983881295,928,265,1360,697,432,432,rarity
1036319.png,https://derpicdn.net/img/view/2015/12/3/1036319.png,0,0.989892483,144,0,1944,1760,1800,1760,rarity
1037136.png,https://derpicdn.net/img/view/2015/12/5/1037136.png,0,0.951425016,610,588,1372,1350,762,762,rarity
1037625.png,https://derpicdn.net/img/view/2015/12/5/1037625.png,0,0.983235717,737,47,1367,677,630,630,rarity
1039209.png,https://derpicdn.net/img/view/2015/12/7/1039209.png,0,0.988411307,36,0,568,486,532,486,rarity
1039700.png,https://derpicdn.net/img/view/2015/12/8/1039700.png,0,0.987688959,469,0,887,412,418,412,rarity
1039700.png,https://derpicdn.net/img/view/2015/12/8/1039700.png,1,0.979378045,145,50,445,350,300,300,rarity
1039700.png,https://derpicdn.net/img/view/2015/12/8/1039700.png,2,0.970746815,622,690,1108,1176,486,486,rarity
1040297.png,https://derpicdn.net/img/view/2015/12/9/1040297.png,0,0.988290071,1691,296,3000,1608,1309,1312,rarity
1052002.png,https://derpicdn.net/img/view/2015/12/24/1052002.png,0,0.904006004,158,134,494,470,336,336,rarity
1058376.png,https://derpicdn.net/img/view/2016/1/2/1058376.png,0,0.973228693,179,0,751,569,572,569,rarity
1061231.png,https://derpicdn.net/img/view/2016/1/7/1061231.png,1,0.952945352,90,33,464,407,374,374,rarity
1063744.png,https://derpicdn.net/img/view/2016/1/10/1063744.png,0,0.930861056,687,0,1317,588,630,588,rarity
1064008.png,https://derpicdn.net/img/view/2016/1/10/1064008.png,0,0.944726527,299,128,537,366,238,238,rarity
1067927.png,https://derpicdn.net/img/view/2016/1/16/1067927.png,0,0.923957944,13,0,1239,1209,1226,1209,rarity
1070537.png,https://derpicdn.net/img/view/2016/1/20/1070537.png,0,0.999590099,442,129,1064,751,622,622,rarity
1070823.jpg,https://derpicdn.net/img/view/2016/1/21/1070823.jpg,0,0.996013105,317,0,901,493,584,493,rarity
1072052.png,https://derpicdn.net/img/view/2016/1/23/1072052.png,0,0.947898626,33,91,1700,1793,1667,1702,rarity
1072931.png,https://derpicdn.net/img/view/2016/1/24/1072931.png,0,0.958272099,219,0,589,356,370,356,rarity
1073697.png,https://derpicdn.net/img/view/2016/1/25/1073697.png,0,0.907546401,668,365,1728,1425,1060,1060,rarity
1078207.png,https://derpicdn.net/img/view/2016/2/1/1078207.png,0,0.991923094,556,912,1804,2160,1248,1248,rarity
1078223.png,https://derpicdn.net/img/view/2016/2/1/1078223.png,0,0.995463729,147,251,591,695,444,444,rarity
1079946.png,https://derpicdn.net/img/view/2016/2/4/1079946.png,0,0.997792542,417,29,1275,887,858,858,rarity
1080710.png,https://derpicdn.net/img/view/2016/2/5/1080710.png,0,0.995121539,542,0,1614,1026,1072,1026,rarity
1082209.png,https://derpicdn.net/img/view/2016/2/7/1082209.png,0,0.991588414,601,0,2497,1835,1896,1835,rarity
1082825.png,https://derpicdn.net/img/view/2016/2/7/1082825.png,0,0.99785006,2412,0,4802,2170,2390,2170,rarity
1083598.png,https://derpicdn.net/img/view/2016/2/9/1083598.png,0,0.949068666,110,0,696,563,586,563,rarity
1083817.png,https://derpicdn.net/img/view/2016/2/9/1083817.png,0,0.921824932,171,0,3411,3120,3240,3120,rarity
1086041.png,https://derpicdn.net/img/view/2016/2/12/1086041.png,0,0.970784962,308,0,714,360,406,360,rarity
1088696.png,https://derpicdn.net/img/view/2016/2/15/1088696.png,0,0.989725888,87,0,655,517,568,517,rarity
1091287.png,https://derpicdn.net/img/view/2016/2/18/1091287.png,0,0.989129245,91,0,749,573,658,573,rarity
1091590.png,https://derpicdn.net/img/view/2016/2/18/1091590.png,0,0.976748765,189,308,803,922,614,614,rarity
1091839.png,https://derpicdn.net/img/view/2016/2/19/1091839.png,0,0.975317299,478,258,1218,998,740,740,rarity
1092200.jpg,https://derpicdn.net/img/view/2016/2/19/1092200.jpg,0,0.985393465,133,0,503,366,370,366,rarity
1093660.png,https://derpicdn.net/img/view/2016/2/21/1093660.png,0,0.999653339,806,102,1418,714,612,612,rarity
1094794.png,https://derpicdn.net/img/view/2016/2/23/1094794.png,0,0.97401464,309,20,1905,1616,1596,1596,rarity
1095759.jpg,https://derpicdn.net/img/view/2016/2/24/1095759.jpg,0,0.998878717,744,46,1552,854,808,808,rarity
1095759.jpg,https://derpicdn.net/img/view/2016/2/24/1095759.jpg,1,0.997150779,141,94,871,824,730,730,rarity
1097353.png,https://derpicdn.net/img/view/2016/2/26/1097353.png,0,0.998587728,575,34,1103,562,528,528,rarity
1097623.jpg,https://derpicdn.net/img/view/2016/2/27/1097623.jpg,0,0.962516963,134,8,651,556,517,548,rarity
1097754.png,https://derpicdn.net/img/view/2016/2/27/1097754.png,0,0.917411625,0,0,901,982,901,982,rarity
1100842.png,https://derpicdn.net/img/view/2016/3/2/1100842.png,0,0.990470529,0,0,1133,1216,1133,1216,rarity
1101008.jpg,https://derpicdn.net/img/view/2016/3/3/1101008.jpg,0,0.995561242,278,18,752,492,474,474,rarity
1102555.png,https://derpicdn.net/img/view/2016/3/5/1102555.png,0,0.997152388,315,0,803,463,488,463,rarity
1102916.jpg,https://derpicdn.net/img/view/2016/3/6/1102916.jpg,0,0.999395728,95,0,461,338,366,338,rarity
1106019.png,https://derpicdn.net/img/view/2016/3/10/1106019.png,0,0.961344421,677,0,1607,871,930,871,rarity
110799.jpg,https://derpicdn.net/img/view/2012/9/30/110799.jpg,0,0.997591496,541,35,1247,741,706,706,rarity
1111533.jpg,https://derpicdn.net/img/view/2016/3/18/1111533.jpg,0,0.945978522,169,0,1159,804,990,804,rarity
1116120.jpg,https://derpicdn.net/img/view/2016/3/24/1116120.jpg,0,0.977805853,724,0,1670,757,946,757,rarity
1126319.png,https://derpicdn.net/img/view/2016/4/7/1126319.png,0,0.997645319,216,0,782,551,566,551,rarity
1127325.png,https://derpicdn.net/img/view/2016/4/8/1127325.png,0,0.987021446,685,1767,1439,2521,754,754,rarity
1127325.png,https://derpicdn.net/img/view/2016/4/8/1127325.png,1,0.985718787,1814,47,2784,1017,970,970,rarity
1129574.png,https://derpicdn.net/img/view/2016/4/11/1129574.png,0,0.99099791,1629,42,2085,498,456,456,rarity
1131532.jpg,https://derpicdn.net/img/view/2016/4/14/1131532.jpg,0,0.995476246,579,0,1587,860,1008,860,rarity
1132208.png,https://derpicdn.net/img/view/2016/4/15/1132208.png,0,0.942998707,0,17,558,585,558,568,rarity
1133685.png,https://derpicdn.net/img/view/2016/4/17/1133685.png,0,0.985592365,220,0,1014,765,794,765,rarity
1135423.png,https://derpicdn.net/img/view/2016/4/19/1135423.png,0,0.938293159,73,0,599,520,526,520,rarity
1145031.png,https://derpicdn.net/img/view/2016/5/2/1145031.png,0,0.953983545,104,0,676,534,572,534,rarity
1146292.png,https://derpicdn.net/img/view/2016/5/4/1146292.png,0,0.97172755,323,41,719,437,396,396,rarity
1147963.jpg,https://derpicdn.net/img/view/2016/5/6/1147963.jpg,0,0.98996067,412,0,1656,1192,1244,1192,rarity
1150048.png,https://derpicdn.net/img/view/2016/5/9/1150048.png,0,0.983177483,54,374,3416,3736,3362,3362,rarity
1155000.png,https://derpicdn.net/img/view/2016/5/15/1155000.png,0,0.941597402,247,219,619,591,372,372,rarity
1155133.png,https://derpicdn.net/img/view/2016/5/15/1155133.png,0,0.997163415,348,686,582,920,234,234,rarity
1155133.png,https://derpicdn.net/img/view/2016/5/15/1155133.png,1,0.982634306,798,422,1252,876,454,454,rarity
1155133.png,https://derpicdn.net/img/view/2016/5/15/1155133.png,2,0.935479343,0,0,337,388,337,388,rarity
1157867.png,https://derpicdn.net/img/view/2016/5/19/1157867.png,0,0.989856422,361,0,1689,1268,1328,1268,rarity
1161109.png,https://derpicdn.net/img/view/2016/5/23/1161109.png,0,0.958316088,240,0,484,238,244,238,rarity
116203.png,https://derpicdn.net/img/view/2012/10/7/116203.png,0,0.999716818,274,0,584,307,310,307,rarity
1163066.png,https://derpicdn.net/img/view/2016/5/26/1163066.png,0,0.9973616,320,11,526,217,206,206,rarity
1163626.jpg,https://derpicdn.net/img/view/2016/5/26/1163626.jpg,0,0.983157754,637,0,1481,837,844,837,rarity
1163626.jpg,https://derpicdn.net/img/view/2016/5/26/1163626.jpg,1,0.981699884,1615,10,2455,850,840,840,rarity
1163785.png,https://derpicdn.net/img/view/2016/5/26/1163785.png,0,0.986864328,247,0,685,409,438,409,rarity
1165954.png,https://derpicdn.net/img/view/2016/5/29/1165954.png,0,0.991931736,147,80,567,500,420,420,rarity
1169547.png,https://derpicdn.net/img/view/2016/6/4/1169547.png,0,0.952596128,144,9,336,201,192,192,rarity
1172975.png,https://derpicdn.net/img/view/2016/6/7/1172975.png,0,0.966442227,1572,419,2116,963,544,544,rarity
1174724.jpg,https://derpicdn.net/img/view/2016/6/10/1174724.jpg,0,0.99407047,160,0,548,380,388,380,rarity
1177655.jpg,https://derpicdn.net/img/view/2016/6/13/1177655.jpg,0,0.964330554,324,50,1122,848,798,798,rarity
1180871.png,https://derpicdn.net/img/view/2016/6/18/1180871.png,0,0.988520384,186,13,508,335,322,322,rarity
1185251.png,https://derpicdn.net/img/view/2016/6/23/1185251.png,0,0.961602449,244,43,816,615,572,572,rarity
1188649.png,https://derpicdn.net/img/view/2016/6/28/1188649.png,0,0.963115931,23,44,631,652,608,608,rarity
1196510.png,https://derpicdn.net/img/view/2016/7/8/1196510.png,0,0.994165123,58,0,566,470,508,470,rarity
1197351.png,https://derpicdn.net/img/view/2016/7/10/1197351.png,0,0.994352043,493,0,1145,623,652,623,rarity
1199160.png,https://derpicdn.net/img/view/2016/7/12/1199160.png,0,0.990725279,330,3,612,285,282,282,rarity
1200762.png,https://derpicdn.net/img/view/2016/7/14/1200762.png,0,0.956756413,441,0,1987,1338,1546,1338,rarity
1206343.png,https://derpicdn.net/img/view/2016/7/22/1206343.png,0,0.984484255,901,573,2007,1679,1106,1106,rarity
1209953.png,https://derpicdn.net/img/view/2016/7/26/1209953.png,0,0.95233649,872,0,1630,670,758,670,rarity
1210101.png,https://derpicdn.net/img/view/2016/7/27/1210101.png,0,0.998449862,17,0,415,358,398,358,rarity
1214829.png,https://derpicdn.net/img/view/2016/8/1/1214829.png,0,0.994176209,100,0,302,192,202,192,rarity
1215.jpg,https://derpicdn.net/img/view/2012/1/22/1215.jpg,0,0.99474889,126,0,600,439,474,439,rarity
1220566.png,https://derpicdn.net/img/view/2016/8/8/1220566.png,0,0.970953941,0,0,1567,1763,1567,1763,rarity
1220566.png,https://derpicdn.net/img/view/2016/8/8/1220566.png,1,0.9516204,217,242,1951,1976,1734,1734,rarity
1227799.png,https://derpicdn.net/img/view/2016/8/18/1227799.png,0,0.939810693,699,0,1467,765,768,765,rarity
1228934.png,https://derpicdn.net/img/view/2016/8/19/1228934.png,0,0.916128993,225,62,795,632,570,570,rarity
1230999.png,https://derpicdn.net/img/view/2016/8/22/1230999.png,0,0.994966745,0,0,809,874,809,874,rarity
1234014.png,https://derpicdn.net/img/view/2016/8/26/1234014.png,0,0.978367031,358,56,852,550,494,494,rarity
1235630.png,https://derpicdn.net/img/view/2016/8/28/1235630.png,0,0.966399908,0,74,484,638,484,564,rarity
1236338.png,https://derpicdn.net/img/view/2016/8/28/1236338.png,0,0.945834816,860,120,1228,488,368,368,rarity
1237507.png,https://derpicdn.net/img/view/2016/8/30/1237507.png,0,0.990414858,422,44,788,410,366,366,rarity
1239715.png,https://derpicdn.net/img/view/2016/9/2/1239715.png,1,0.974834979,118,64,1466,1412,1348,1348,rarity
1240462.png,https://derpicdn.net/img/view/2016/9/3/1240462.png,0,0.998046041,496,0,1134,610,638,610,rarity
1241758.png,https://derpicdn.net/img/view/2016/9/4/1241758.png,0,0.964560091,90,0,2004,1575,1914,1575,rarity
1248002.png,https://derpicdn.net/img/view/2016/9/12/1248002.png,0,0.997533739,146,23,468,345,322,322,rarity
1248821.png,https://derpicdn.net/img/view/2016/9/14/1248821.png,0,0.993962228,116,0,610,465,494,465,rarity
1260031.png,https://derpicdn.net/img/view/2016/9/28/1260031.png,0,0.998385966,140,0,716,554,576,554,rarity
1263336.png,https://derpicdn.net/img/view/2016/10/2/1263336.png,0,0.960179865,91,17,519,445,428,428,rarity
1265511.png,https://derpicdn.net/img/view/2016/10/5/1265511.png,0,0.971660376,344,29,610,295,266,266,rarity
1269166.png,https://derpicdn.net/img/view/2016/10/9/1269166.png,0,0.980396748,416,0,1500,1022,1084,1022,rarity
1271542.png,https://derpicdn.net/img/view/2016/10/12/1271542.png,0,0.95534718,324,70,898,644,574,574,rarity
1274354.png,https://derpicdn.net/img/view/2016/10/16/1274354.png,0,0.996885121,940,610,2560,2230,1620,1620,rarity
1277314.png,https://derpicdn.net/img/view/2016/10/20/1277314.png,0,0.996482253,1028,288,3686,2946,2658,2658,rarity
1294978.png,https://derpicdn.net/img/view/2016/11/13/1294978.png,0,0.973186851,505,1,711,207,206,206,rarity
1299103.png,https://derpicdn.net/img/view/2016/11/19/1299103.png,0,0.997699142,361,46,1189,874,828,828,rarity
1304846.png,https://derpicdn.net/img/view/2016/11/27/1304846.png,0,0.983830988,125,242,587,704,462,462,rarity
1307954.png,https://derpicdn.net/img/view/2016/12/1/1307954.png,0,0.995194912,411,26,757,372,346,346,rarity
1320729.png,https://derpicdn.net/img/view/2016/12/19/1320729.png,0,0.914744735,248,0,1728,1447,1480,1447,rarity
1320794.png,https://derpicdn.net/img/view/2016/12/19/1320794.png,0,0.988885283,198,16,368,186,170,170,rarity
1322975.png,https://derpicdn.net/img/view/2016/12/22/1322975.png,0,0.998306394,659,7,1359,707,700,700,rarity
1324401.png,https://derpicdn.net/img/view/2016/12/24/1324401.png,0,0.999056756,650,4,1326,680,676,676,rarity
1325411.png,https://derpicdn.net/img/view/2016/12/26/1325411.png,0,0.988250732,0,0,1137,958,1137,958,rarity
1334501.png,https://derpicdn.net/img/view/2017/1/8/1334501.png,0,0.993930757,240,0,1022,780,782,780,rarity
1339437.png,https://derpicdn.net/img/view/2017/1/14/1339437.png,0,0.993394971,693,0,1943,1161,1250,1161,rarity
1339437.png,https://derpicdn.net/img/view/2017/1/14/1339437.png,1,0.984809101,3101,954,3850,1928,749,974,rarity
1339437.png,https://derpicdn.net/img/view/2017/1/14/1339437.png,2,0.982753754,2813,1835,3850,2877,1037,1042,rarity
1339579.png,https://derpicdn.net/img/view/2017/1/14/1339579.png,0,0.92371124,103,0,555,443,452,443,rarity
1343303.png,https://derpicdn.net/img/view/2017/1/20/1343303.png,0,0.968410909,142,0,400,256,258,256,rarity
1343303.png,https://derpicdn.net/img/view/2017/1/20/1343303.png,2,0.922430515,594,149,776,331,182,182,rarity
1349311.png,https://derpicdn.net/img/view/2017/1/27/1349311.png,0,0.990990222,1902,609,4104,2811,2202,2202,rarity
1349317.png,https://derpicdn.net/img/view/2017/1/27/1349317.png,0,0.968460381,328,246,2456,2374,2128,2128,rarity
1349575.png,https://derpicdn.net/img/view/2017/1/28/1349575.png,0,0.997900963,843,0,2107,1258,1264,1258,rarity
1351451.png,https://derpicdn.net/img/view/2017/1/30/1351451.png,0,0.961009264,776,0,2018,1025,1242,1025,rarity
1352358.png,https://derpicdn.net/img/view/2017/1/31/1352358.png,0,0.937666774,64,135,1408,1479,1344,1344,rarity
1355983.png,https://derpicdn.net/img/view/2017/2/5/1355983.png,0,0.995585144,139,0,901,741,762,741,rarity
1360009.png,https://derpicdn.net/img/view/2017/2/11/1360009.png,0,0.977359474,1281,578,2859,2156,1578,1578,rarity
1362622.png,https://derpicdn.net/img/view/2017/2/14/1362622.png,0,0.993803024,126,2,588,464,462,462,rarity
1363372.png,https://derpicdn.net/img/view/2017/2/15/1363372.png,0,0.997832239,396,107,702,413,306,306,rarity
1376507.png,https://derpicdn.net/img/view/2017/3/1/1376507.png,0,0.913347363,84,308,886,1110,802,802,rarity
1379742.png,https://derpicdn.net/img/view/2017/3/5/1379742.png,0,0.953720212,178,32,704,558,526,526,rarity
1379847.png,https://derpicdn.net/img/view/2017/3/5/1379847.png,0,0.970660985,584,53,1326,795,742,742,rarity
1382250.png,https://derpicdn.net/img/view/2017/3/8/1382250.png,0,0.993898332,236,0,786,534,550,534,rarity
1382842.png,https://derpicdn.net/img/view/2017/3/9/1382842.png,0,0.973136663,528,425,1228,1125,700,700,rarity
1382843.png,https://derpicdn.net/img/view/2017/3/9/1382843.png,0,0.973143995,528,426,1226,1124,698,698,rarity
1384927.png,https://derpicdn.net/img/view/2017/3/12/1384927.png,0,0.977057517,186,0,768,516,582,516,rarity
1385531.png,https://derpicdn.net/img/view/2017/3/12/1385531.png,0,0.996879578,138,45,3064,2971,2926,2926,rarity
1396146.png,https://derpicdn.net/img/view/2017/3/25/1396146.png,0,0.97928381,138,0,1280,1177,1142,1177,rarity
1397284.png,https://derpicdn.net/img/view/2017/3/26/1397284.png,0,0.994291544,311,92,885,666,574,574,rarity
1401256.png,https://derpicdn.net/img/view/2017/4/1/1401256.png,0,0.985507667,682,0,1270,480,588,480,rarity
1402713.png,https://derpicdn.net/img/view/2017/4/3/1402713.png,0,0.996637464,1698,110,3884,2296,2186,2186,rarity
1405280.png,https://derpicdn.net/img/view/2017/4/6/1405280.png,0,0.931701839,38,82,946,990,908,908,rarity
1406106.png,https://derpicdn.net/img/view/2017/4/7/1406106.png,0,0.992425084,290,137,844,691,554,554,rarity
1418940.png,https://derpicdn.net/img/view/2017/4/22/1418940.png,0,0.970783472,103,62,369,328,266,266,rarity
1419317.png,https://derpicdn.net/img/view/2017/4/23/1419317.png,0,0.949899673,745,0,1939,1395,1194,1395,rarity
1423395.png,https://derpicdn.net/img/view/2017/4/28/1423395.png,0,0.93871218,292,192,1786,1686,1494,1494,rarity
1424488.png,https://derpicdn.net/img/view/2017/4/29/1424488.png,0,0.951828361,459,172,1315,1028,856,856,rarity
1424489.png,https://derpicdn.net/img/view/2017/4/29/1424489.png,0,0.990253329,496,0,906,386,410,386,rarity
1425374.png,https://derpicdn.net/img/view/2017/4/30/1425374.png,0,0.991202772,611,78,1829,1296,1218,1218,rarity
1430235.png,https://derpicdn.net/img/view/2017/5/6/1430235.png,0,0.945214212,2132,183,3890,1941,1758,1758,rarity
1436675.png,https://derpicdn.net/img/view/2017/5/14/1436675.png,0,0.934945166,1067,271,1973,1177,906,906,rarity
1439663.png,https://derpicdn.net/img/view/2017/5/18/1439663.png,0,0.998269677,295,0,973,661,678,661,rarity
1441806.png,https://derpicdn.net/img/view/2017/5/21/1441806.png,0,0.984975755,1776,30,2780,1034,1004,1004,rarity
1441806.png,https://derpicdn.net/img/view/2017/5/21/1441806.png,1,0.981405795,716,1791,1412,2487,696,696,rarity
1441919.png,https://derpicdn.net/img/view/2017/5/21/1441919.png,0,0.994473577,172,0,642,468,470,468,rarity
1442665.png,https://derpicdn.net/img/view/2017/5/21/1442665.png,0,0.990953386,0,0,2318,2523,2318,2523,rarity
1448520.png,https://derpicdn.net/img/view/2017/5/28/1448520.png,0,0.933938384,17,0,703,588,686,588,rarity
1454330.png,https://derpicdn.net/img/view/2017/6/5/1454330.png,0,0.906140804,16,5,628,617,612,612,rarity
1455917.png,https://derpicdn.net/img/view/2017/6/7/1455917.png,0,0.9910236,0,0,641,604,641,604,rarity
1466115.png,https://derpicdn.net/img/view/2017/6/19/1466115.png,0,0.984746277,501,28,1529,1056,1028,1028,rarity
1473186.png,https://derpicdn.net/img/view/2017/6/28/1473186.png,0,0.996202826,288,0,578,277,290,277,rarity
1475351.png,https://derpicdn.net/img/view/2017/6/30/1475351.png,0,0.982927918,200,173,2338,2311,2138,2138,rarity
1478363.png,https://derpicdn.net/img/view/2017/7/4/1478363.png,0,0.997931898,144,8,426,290,282,282,rarity
148062.jpg,https://derpicdn.net/img/view/2012/11/11/148062.jpg,0,0.982324779,95,0,547,432,452,432,rarity
1482148.png,https://derpicdn.net/img/view/2017/7/9/1482148.png,0,0.993637145,77,6,903,768,826,762,rarity
1488240.png,https://derpicdn.net/img/view/2017/7/17/1488240.png,0,0.994676232,260,8,1034,782,774,774,rarity
1490359.png,https://derpicdn.net/img/view/2017/7/20/1490359.png,0,0.958166599,1166,89,1828,751,662,662,rarity
1490633.png,https://derpicdn.net/img/view/2017/7/20/1490633.png,0,0.945963502,0,19,1198,1221,1198,1202,rarity
1490968.png,https://derpicdn.net/img/view/2017/7/20/1490968.png,0,0.994784772,561,0,1247,677,686,677,rarity
1491957.png,https://derpicdn.net/img/view/2017/7/22/1491957.png,0,0.989800394,153,2,521,370,368,368,rarity
1496632.png,https://derpicdn.net/img/view/2017/7/28/1496632.png,0,0.997659624,63,0,523,442,460,442,rarity
1506251.png,https://derpicdn.net/img/view/2017/8/9/1506251.png,0,0.99792695,1491,15,2167,691,676,676,rarity
1506652.png,https://derpicdn.net/img/view/2017/8/9/1506652.png,0,0.99951303,237,0,591,347,354,347,rarity
1506657.png,https://derpicdn.net/img/view/2017/8/9/1506657.png,0,0.986334801,115,11,857,753,742,742,rarity
1507948.png,https://derpicdn.net/img/view/2017/8/11/1507948.png,0,0.968478739,527,0,1489,909,962,909,rarity
1511396.png,https://derpicdn.net/img/view/2017/8/15/1511396.png,0,0.991697371,118,0,686,538,568,538,rarity
1513266.png,https://derpicdn.net/img/view/2017/8/18/1513266.png,0,0.98513484,0,291,624,935,624,644,rarity
1518499.png,https://derpicdn.net/img/view/2017/8/24/1518499.png,0,0.988819659,958,0,1528,509,570,509,rarity
1520825.png,https://derpicdn.net/img/view/2017/8/27/1520825.png,0,0.993260026,558,0,1508,906,950,906,rarity
1522317.png,https://derpicdn.net/img/view/2017/8/29/1522317.png,0,0.999281883,5417,4636,6707,5926,1290,1290,rarity
1526448.png,https://derpicdn.net/img/view/2017/9/3/1526448.png,0,0.920449376,0,50,813,868,813,818,rarity
1529805.png,https://derpicdn.net/img/view/2017/9/7/1529805.png,0,0.909629703,266,61,1644,1439,1378,1378,rarity
1531090.png,https://derpicdn.net/img/view/2017/9/9/1531090.png,0,0.998625875,230,0,678,441,448,441,rarity
1531807.png,https://derpicdn.net/img/view/2017/9/10/1531807.png,0,0.97041297,365,0,1791,1407,1426,1407,rarity
1536737.png,https://derpicdn.net/img/view/2017/9/16/1536737.png,0,0.990278959,0,18,569,616,569,598,rarity
1537040.png,https://derpicdn.net/img/view/2017/9/16/1537040.png,0,0.965587318,34,26,630,622,596,596,rarity
1537154.png,https://derpicdn.net/img/view/2017/9/16/1537154.png,0,0.967479825,20,11,616,607,596,596,rarity
1537412.png,https://derpicdn.net/img/view/2017/9/17/1537412.png,0,0.980962753,0,0,1862,1973,1862,1973,rarity
1537417.png,https://derpicdn.net/img/view/2017/9/17/1537417.png,0,0.929660559,777,121,1131,475,354,354,rarity
1537593.png,https://derpicdn.net/img/view/2017/9/17/1537593.png,0,0.968089759,506,0,1510,816,1004,816,rarity
1537795.png,https://derpicdn.net/img/view/2017/9/17/1537795.png,0,0.976851463,0,268,3970,4328,3970,4060,rarity
1537936.png,https://derpicdn.net/img/view/2017/9/17/1537936.png,0,0.96847564,1021,0,1981,950,960,950,rarity
1538313.png,https://derpicdn.net/img/view/2017/9/18/1538313.png,0,0.9165169,0,25,770,1000,770,975,rarity
1538352.png,https://derpicdn.net/img/view/2017/9/18/1538352.png,0,0.993415236,555,111,1173,729,618,618,rarity
1538514.png,https://derpicdn.net/img/view/2017/9/18/1538514.png,0,0.999444902,169,25,445,301,276,276,rarity
1538654.png,https://derpicdn.net/img/view/2017/9/18/1538654.png,0,0.968223155,0,0,1956,1923,1956,1923,rarity
1538840.png,https://derpicdn.net/img/view/2017/9/18/1538840.png,0,0.98665297,0,0,3206,3446,3206,3446,rarity
1538985.png,https://derpicdn.net/img/view/2017/9/18/1538985.png,0,0.98596704,431,8,1823,1400,1392,1392,rarity
1539271.png,https://derpicdn.net/img/view/2017/9/19/1539271.png,0,0.996378958,40,0,574,454,534,454,rarity
1539381.png,https://derpicdn.net/img/view/2017/9/19/1539381.png,0,0.972506702,272,0,1134,854,862,854,rarity
1539399.png,https://derpicdn.net/img/view/2017/9/19/1539399.png,0,0.984336376,34,26,1400,1392,1366,1366,rarity
1539403.png,https://derpicdn.net/img/view/2017/9/19/1539403.png,0,0.987532377,88,0,688,575,600,575,rarity
1539506.png,https://derpicdn.net/img/view/2017/9/19/1539506.png,0,0.93173635,87,0,1247,1146,1160,1146,rarity
1539624.png,https://derpicdn.net/img/view/2017/9/19/1539624.png,0,0.923144639,108,40,1730,1662,1622,1622,rarity
1540251.png,https://derpicdn.net/img/view/2017/9/20/1540251.png,0,0.950492978,424,0,1318,878,894,878,rarity
1540595.png,https://derpicdn.net/img/view/2017/9/21/1540595.png,0,0.975740731,0,16,653,726,653,710,rarity
1541113.png,https://derpicdn.net/img/view/2017/9/21/1541113.png,0,0.985310674,68,0,1172,1024,1104,1024,rarity
1544555.png,https://derpicdn.net/img/view/2017/9/25/1544555.png,0,0.951230645,146,30,802,686,656,656,rarity
1545077.png,https://derpicdn.net/img/view/2017/9/26/1545077.png,0,0.961366117,748,0,2068,1261,1320,1261,rarity
1545585.png,https://derpicdn.net/img/view/2017/9/26/1545585.png,0,0.983682573,949,67,2145,1263,1196,1196,rarity
1545586.png,https://derpicdn.net/img/view/2017/9/26/1545586.png,0,0.981199086,1690,51,2518,879,828,828,rarity
1549238.png,https://derpicdn.net/img/view/2017/10/1/1549238.png,0,0.993001044,141,97,1300,1300,1159,1203,rarity
1550441.png,https://derpicdn.net/img/view/2017/10/2/1550441.png,0,0.989875913,215,9,1111,905,896,896,rarity
1552220.png,https://derpicdn.net/img/view/2017/10/4/1552220.png,0,0.984355509,324,161,636,473,312,312,rarity
1553754.png,https://derpicdn.net/img/view/2017/10/6/1553754.png,0,0.988177717,290,20,1020,750,730,730,rarity
1554195.png,https://derpicdn.net/img/view/2017/10/7/1554195.png,0,0.989649296,246,192,2466,2412,2220,2220,rarity
1555838.png,https://derpicdn.net/img/view/2017/10/8/1555838.png,0,0.959087372,421,57,883,519,462,462,rarity
1555882.png,https://derpicdn.net/img/view/2017/10/9/1555882.png,0,0.996929467,150,1,518,369,368,368,rarity
1557474.png,https://derpicdn.net/img/view/2017/10/10/1557474.png,0,0.986383855,133,57,2967,2891,2834,2834,rarity
1559453.png,https://derpicdn.net/img/view/2017/10/12/1559453.png,0,0.901651502,309,60,1281,1032,972,972,rarity
1559704.png,https://derpicdn.net/img/view/2017/10/13/1559704.png,0,0.99709928,380,115,784,519,404,404,rarity
1559707.png,https://derpicdn.net/img/view/2017/10/13/1559707.png,0,0.997098327,380,115,784,519,404,404,rarity
1560159.png,https://derpicdn.net/img/view/2017/10/13/1560159.png,0,0.980112553,424,70,1482,1128,1058,1058,rarity
1563927.png,https://derpicdn.net/img/view/2017/10/17/1563927.png,0,0.968230546,151,152,1279,1280,1128,1128,rarity
1565775.png,https://derpicdn.net/img/view/2017/10/20/1565775.png,0,0.976071477,38,0,984,800,946,800,rarity
156612.png,https://derpicdn.net/img/view/2012/11/18/156612.png,0,0.995787144,466,0,734,262,268,262,rarity
1569740.png,https://derpicdn.net/img/view/2017/10/25/1569740.png,0,0.98730588,1291,29,2333,1071,1042,1042,rarity
1571784.png,https://derpicdn.net/img/view/2017/10/28/1571784.png,0,0.984428644,0,0,1047,1025,1047,1025,rarity
1571785.png,https://derpicdn.net/img/view/2017/10/28/1571785.png,0,0.988472462,0,0,1029,962,1029,962,rarity
1574225.png,https://derpicdn.net/img/view/2017/10/31/1574225.png,0,0.997764051,1005,0,1907,804,902,804,rarity
1574889.png,https://derpicdn.net/img/view/2017/10/31/1574889.png,0,0.986550093,174,53,368,247,194,194,rarity
1576380.png,https://derpicdn.net/img/view/2017/11/2/1576380.png,0,0.949078679,606,0,1984,1322,1378,1322,rarity
1579469.png,https://derpicdn.net/img/view/2017/11/6/1579469.png,0,0.967133224,493,0,1145,642,652,642,rarity
1582006.png,https://derpicdn.net/img/view/2017/11/9/1582006.png,0,0.996077716,592,15,2152,1575,1560,1560,rarity
15829.png,https://derpicdn.net/img/view/2012/6/22/15829.png,0,0.993885159,272,0,896,617,624,617,rarity
1588120.png,https://derpicdn.net/img/view/2017/11/17/1588120.png,0,0.911373794,343,84,677,418,334,334,rarity
1590578.png,https://derpicdn.net/img/view/2017/11/20/1590578.png,0,0.998942792,214,56,712,554,498,498,rarity
1592017.png,https://derpicdn.net/img/view/2017/11/22/1592017.png,0,0.980542719,152,3,940,791,788,788,rarity
1592018.png,https://derpicdn.net/img/view/2017/11/22/1592018.png,0,0.992163002,206,75,654,523,448,448,rarity
1592137.png,https://derpicdn.net/img/view/2017/11/22/1592137.png,0,0.960201979,78,0,800,625,722,625,rarity
159317.png,https://derpicdn.net/img/view/2012/11/21/159317.png,0,0.993458509,513,0,1045,493,532,493,rarity
1596048.png,https://derpicdn.net/img/view/2017/11/28/1596048.png,0,0.998494804,199,27,999,827,800,800,rarity
1597768.png,https://derpicdn.net/img/view/2017/11/30/1597768.png,0,0.966921151,260,0,1010,738,750,738,rarity
1602406.png,https://derpicdn.net/img/view/2017/12/7/1602406.png,0,0.998103976,1012,192,1442,622,430,430,rarity
1602657.png,https://derpicdn.net/img/view/2017/12/7/1602657.png,0,0.983522832,0,0,800,764,800,764,rarity
1604107.png,https://derpicdn.net/img/view/2017/12/9/1604107.png,0,0.942739487,72,0,728,634,656,634,rarity
1604329.png,https://derpicdn.net/img/view/2017/12/10/1604329.png,0,0.921962678,485,263,857,635,372,372,rarity
1606918.png,https://derpicdn.net/img/view/2017/12/13/1606918.png,0,0.991287649,122,0,1080,880,958,880,rarity
1607284.png,https://derpicdn.net/img/view/2017/12/14/1607284.png,0,0.996292412,310,141,838,669,528,528,rarity
160755.png,https://derpicdn.net/img/view/2012/11/23/160755.png,0,0.99936676,572,20,1532,980,960,960,rarity
1609611.png,https://derpicdn.net/img/view/2017/12/17/1609611.png,0,0.99615401,90,0,554,411,464,411,rarity
1610226.png,https://derpicdn.net/img/view/2017/12/18/1610226.png,0,0.998076856,619,132,2155,1668,1536,1536,rarity
1610372.png,https://derpicdn.net/img/view/2017/12/18/1610372.png,0,0.995058417,399,26,1479,1106,1080,1080,rarity
1625383.png,https://derpicdn.net/img/view/2018/1/6/1625383.png,0,0.985785723,0,529,334,867,334,338,rarity
1625398.png,https://derpicdn.net/img/view/2018/1/6/1625398.png,0,0.992292047,101,16,423,338,322,322,rarity
1628082.png,https://derpicdn.net/img/view/2018/1/9/1628082.png,0,0.995521307,237,126,573,462,336,336,rarity
1634090.png,https://derpicdn.net/img/view/2018/1/17/1634090.png,0,0.983238995,334,166,1012,844,678,678,rarity
1635642.png,https://derpicdn.net/img/view/2018/1/19/1635642.png,1,0.997738898,1489,264,2557,1332,1068,1068,rarity
1636848.png,https://derpicdn.net/img/view/2018/1/20/1636848.png,0,0.905444801,175,112,935,872,760,760,rarity
163771.png,https://derpicdn.net/img/view/2012/11/26/163771.png,0,0.995023966,733,298,1187,752,454,454,rarity
1642030.png,https://derpicdn.net/img/view/2018/1/27/1642030.png,0,0.994087875,425,69,1341,985,916,916,rarity
1642778.png,https://derpicdn.net/img/view/2018/1/28/1642778.png,0,0.952823222,44,0,564,509,520,509,rarity
1649529.png,https://derpicdn.net/img/view/2018/2/6/1649529.png,0,0.985831439,756,334,1446,1024,690,690,rarity
1650020.png,https://derpicdn.net/img/view/2018/2/6/1650020.png,0,0.948526919,269,86,693,510,424,424,rarity
1652058.png,https://derpicdn.net/img/view/2018/2/9/1652058.png,0,0.972372532,528,5,1014,491,486,486,rarity
1671194.png,https://derpicdn.net/img/view/2018/3/4/1671194.png,0,0.951310635,682,418,1638,1374,956,956,rarity
1672329.png,https://derpicdn.net/img/view/2018/3/5/1672329.png,0,0.971741617,501,21,891,411,390,390,rarity
1672431.png,https://derpicdn.net/img/view/2018/3/5/1672431.png,0,0.971380651,0,16,602,646,602,630,rarity
1680279.png,https://derpicdn.net/img/view/2018/3/14/1680279.png,0,0.998951435,410,8,602,200,192,192,rarity
1685683.png,https://derpicdn.net/img/view/2018/3/20/1685683.png,0,0.98296088,18,1,316,299,298,298,rarity
1686047.png,https://derpicdn.net/img/view/2018/3/20/1686047.png,0,0.967345297,212,0,806,587,594,587,rarity
1690054.png,https://derpicdn.net/img/view/2018/3/25/1690054.png,0,0.957104087,130,13,433,327,303,314,rarity
1690507.png,https://derpicdn.net/img/view/2018/3/25/1690507.png,0,0.980220437,279,0,1100,808,821,808,rarity
1690891.png,https://derpicdn.net/img/view/2018/3/26/1690891.png,0,0.953223765,59,89,1027,1057,968,968,rarity
1691788.png,https://derpicdn.net/img/view/2018/3/27/1691788.png,0,0.991723299,167,0,987,804,820,804,rarity
1691832.png,https://derpicdn.net/img/view/2018/3/27/1691832.png,0,0.974123061,73,7,777,711,704,704,rarity
1692007.png,https://derpicdn.net/img/view/2018/3/27/1692007.png,0,0.994220495,434,0,1380,916,946,916,rarity
1692856.png,https://derpicdn.net/img/view/2018/3/28/1692856.png,0,0.992920876,520,34,1346,860,826,826,rarity
1694136.png,https://derpicdn.net/img/view/2018/3/29/1694136.png,0,0.987460554,652,6,2608,1962,1956,1956,rarity
1694291.png,https://derpicdn.net/img/view/2018/3/30/1694291.png,0,0.999165058,16,44,814,842,798,798,rarity
1695522.png,https://derpicdn.net/img/view/2018/3/31/1695522.png,0,0.974151313,177,350,1353,1526,1176,1176,rarity
1700756.png,https://derpicdn.net/img/view/2018/4/6/1700756.png,0,0.974922419,51,51,1157,1157,1106,1106,rarity
1701624.png,https://derpicdn.net/img/view/2018/4/7/1701624.png,0,0.914253056,389,35,895,541,506,506,rarity
1701768.png,https://derpicdn.net/img/view/2018/4/7/1701768.png,0,0.99511677,50,0,394,342,344,342,rarity
1703485.png,https://derpicdn.net/img/view/2018/4/9/1703485.png,0,0.999609888,953,0,1685,709,732,709,rarity
1706184.png,https://derpicdn.net/img/view/2018/4/12/1706184.png,0,0.963809431,229,21,757,549,528,528,rarity
1708355.png,https://derpicdn.net/img/view/2018/4/15/1708355.png,0,0.965636432,552,452,1622,1522,1070,1070,rarity
1710114.png,https://derpicdn.net/img/view/2018/4/17/1710114.png,0,0.998598874,423,74,1531,1182,1108,1108,rarity
1714743.png,https://derpicdn.net/img/view/2018/4/22/1714743.png,0,0.933233261,663,74,1631,1042,968,968,rarity
1715691.png,https://derpicdn.net/img/view/2018/4/24/1715691.png,0,0.992423773,380,99,832,551,452,452,rarity
1720311.png,https://derpicdn.net/img/view/2018/4/29/1720311.png,0,0.990158319,300,29,1582,1311,1282,1282,rarity
1722184.png,https://derpicdn.net/img/view/2018/5/2/1722184.png,0,0.973131776,31,0,411,375,380,375,rarity
1722201.png,https://derpicdn.net/img/view/2018/5/2/1722201.png,0,0.967651784,76,4,654,582,578,578,rarity
1725007.png,https://derpicdn.net/img/view/2018/5/5/1725007.png,0,0.981933951,1610,895,2232,1517,622,622,rarity
1725038.png,https://derpicdn.net/img/view/2018/5/5/1725038.png,0,0.993272305,452,273,1110,931,658,658,rarity
1725348.png,https://derpicdn.net/img/view/2018/5/5/1725348.png,0,0.996771157,1018,1349,2234,2565,1216,1216,rarity
1726298.png,https://derpicdn.net/img/view/2018/5/6/1726298.png,0,0.988269091,1329,189,3174,2173,1845,1984,rarity
1726299.png,https://derpicdn.net/img/view/2018/5/6/1726299.png,0,0.998611569,797,1217,1421,1841,624,624,rarity
1729288.png,https://derpicdn.net/img/view/2018/5/10/1729288.png,0,0.999379277,215,0,549,325,334,325,rarity
1730037.png,https://derpicdn.net/img/view/2018/5/11/1730037.png,0,0.998965204,244,56,1080,892,836,836,rarity
1732597.png,https://derpicdn.net/img/view/2018/5/14/1732597.png,0,0.98448807,308,0,1000,672,692,672,rarity
1740458.png,https://derpicdn.net/img/view/2018/5/24/1740458.png,0,0.992242515,55,0,946,1050,891,1050,rarity
1744163.png,https://derpicdn.net/img/view/2018/5/29/1744163.png,0,0.984285116,264,0,3120,2727,2856,2727,rarity
1744165.png,https://derpicdn.net/img/view/2018/5/29/1744165.png,0,0.999396324,1634,752,2730,1848,1096,1096,rarity
1745626.png,https://derpicdn.net/img/view/2018/5/30/1745626.png,0,0.937296689,528,163,950,585,422,422,rarity
1764123.png,https://derpicdn.net/img/view/2018/6/23/1764123.png,0,0.996178269,138,9,524,395,386,386,rarity
1767201.png,https://derpicdn.net/img/view/2018/6/27/1767201.png,0,0.992680669,393,59,813,479,420,420,rarity
1767211.png,https://derpicdn.net/img/view/2018/6/27/1767211.png,0,0.987978101,391,55,815,479,424,424,rarity
1773208.png,https://derpicdn.net/img/view/2018/7/5/1773208.png,0,0.979966462,137,0,1209,1038,1072,1038,rarity
1773213.png,https://derpicdn.net/img/view/2018/7/5/1773213.png,0,0.996235132,239,1,1189,951,950,950,rarity
1774741.png,https://derpicdn.net/img/view/2018/7/7/1774741.png,0,0.996066153,496,25,980,509,484,484,rarity
1777665.png,https://derpicdn.net/img/view/2018/7/10/1777665.png,0,0.996133983,197,8,509,320,312,312,rarity
1777969.png,https://derpicdn.net/img/view/2018/7/10/1777969.png,0,0.994324327,301,7,3253,2959,2952,2952,rarity
1780135.png,https://derpicdn.net/img/view/2018/7/13/1780135.png,0,0.99947542,353,92,787,526,434,434,rarity
1780135.png,https://derpicdn.net/img/view/2018/7/13/1780135.png,1,0.997655451,735,212,1117,594,382,382,rarity
1784589.png,https://derpicdn.net/img/view/2018/7/19/1784589.png,0,0.998111367,460,0,1604,1059,1144,1059,rarity
1787368.png,https://derpicdn.net/img/view/2018/7/23/1787368.png,0,0.988184094,782,20,1844,1082,1062,1062,rarity
1788042.png,https://derpicdn.net/img/view/2018/7/23/1788042.png,0,0.995360136,266,89,920,743,654,654,rarity
1790083.png,https://derpicdn.net/img/view/2018/7/26/1790083.png,0,0.963300288,134,9,1194,1069,1060,1060,rarity
1796984.png,https://derpicdn.net/img/view/2018/8/3/1796984.png,0,0.932861984,83,18,295,230,212,212,rarity
1797629.png,https://derpicdn.net/img/view/2018/8/4/1797629.png,0,0.983023524,1749,71,3261,1583,1512,1512,rarity
1797829.png,https://derpicdn.net/img/view/2018/8/4/1797829.png,0,0.93707937,126,17,1076,969,950,952,rarity
1798655.png,https://derpicdn.net/img/view/2018/8/5/1798655.png,0,0.991133511,125,0,857,644,732,644,rarity
1799431.png,https://derpicdn.net/img/view/2018/8/6/1799431.png,0,0.964510739,954,338,1630,1014,676,676,rarity
1800671.png,https://derpicdn.net/img/view/2018/8/7/1800671.png,0,0.917417645,0,167,956,1327,956,1160,rarity
1802022.png,https://derpicdn.net/img/view/2018/8/9/1802022.png,0,0.996636093,0,19,2681,2759,2681,2740,rarity
1802024.png,https://derpicdn.net/img/view/2018/8/9/1802024.png,0,0.999294281,1103,193,2177,1267,1074,1074,rarity
1802079.png,https://derpicdn.net/img/view/2018/8/9/1802079.png,0,0.96433866,37,80,3500,3644,3463,3564,rarity
1804598.png,https://derpicdn.net/img/view/2018/8/12/1804598.png,0,0.938532352,250,58,812,620,562,562,rarity
1805374.png,https://derpicdn.net/img/view/2018/8/13/1805374.png,0,0.995968759,813,2,1179,368,366,366,rarity
1805374.png,https://derpicdn.net/img/view/2018/8/13/1805374.png,1,0.987731457,87,508,517,938,430,430,rarity
1807048.png,https://derpicdn.net/img/view/2018/8/15/1807048.png,0,0.991862595,475,1,945,471,470,470,rarity
1807942.png,https://derpicdn.net/img/view/2018/8/16/1807942.png,0,0.967551291,360,31,890,561,530,530,rarity
1808487.png,https://derpicdn.net/img/view/2018/8/16/1808487.png,0,0.921121061,455,0,1437,981,982,981,rarity
1809418.png,https://derpicdn.net/img/view/2018/8/17/1809418.png,0,0.990625381,169,0,893,600,724,600,rarity
1809542.png,https://derpicdn.net/img/view/2018/8/17/1809542.png,0,0.966709673,163,36,625,498,462,462,rarity
1809876.png,https://derpicdn.net/img/view/2018/8/18/1809876.png,0,0.995435178,365,124,701,460,336,336,rarity
1810125.png,https://derpicdn.net/img/view/2018/8/18/1810125.png,0,0.984251559,328,0,1056,652,728,652,rarity
1810125.png,https://derpicdn.net/img/view/2018/8/18/1810125.png,1,0.974419177,800,0,1526,691,726,691,rarity
1811497.png,https://derpicdn.net/img/view/2018/8/20/1811497.png,0,0.966581166,415,0,1641,1180,1226,1180,rarity
181443.jpg,https://derpicdn.net/img/view/2012/12/13/181443.jpg,0,0.994188786,274,41,716,483,442,442,rarity
1815218.png,https://derpicdn.net/img/view/2018/8/24/1815218.png,0,0.970687926,128,7,708,587,580,580,rarity
1817611.png,https://derpicdn.net/img/view/2018/8/27/1817611.png,0,0.91308862,36,65,594,623,558,558,rarity
1820.png,https://derpicdn.net/img/view/2012/1/23/1820.png,0,0.971679628,168,0,800,683,632,683,rarity
1820673.png,https://derpicdn.net/img/view/2018/8/30/1820673.png,0,0.999244869,1056,95,2790,1829,1734,1734,rarity
1823040.png,https://derpicdn.net/img/view/2018/9/2/1823040.png,0,0.967238247,0,0,820,897,820,897,rarity
1824702.png,https://derpicdn.net/img/view/2018/9/4/1824702.png,0,0.989820957,1170,70,2208,1108,1038,1038,rarity
1825986.png,https://derpicdn.net/img/view/2018/9/6/1825986.png,1,0.9386217,795,797,1397,1399,602,602,rarity
1827369.png,https://derpicdn.net/img/view/2018/9/8/1827369.png,0,0.998574853,192,0,1992,1668,1800,1668,rarity
1829989.png,https://derpicdn.net/img/view/2018/9/11/1829989.png,0,0.957583964,322,7,608,293,286,286,rarity
1830592.png,https://derpicdn.net/img/view/2018/9/11/1830592.png,0,0.998441517,428,31,1312,937,884,906,rarity
1839742.png,https://derpicdn.net/img/view/2018/9/23/1839742.png,0,0.967249691,345,271,953,879,608,608,rarity
1842154.png,https://derpicdn.net/img/view/2018/9/27/1842154.png,0,0.951940119,535,438,1177,1080,642,642,rarity
1843236.png,https://derpicdn.net/img/view/2018/9/28/1843236.png,0,0.983298063,344,27,744,427,400,400,rarity
1848289.png,https://derpicdn.net/img/view/2018/10/5/1848289.png,0,0.973510444,395,91,971,667,576,576,rarity
1849600.png,https://derpicdn.net/img/view/2018/10/6/1849600.png,0,0.956014693,0,0,565,564,565,564,rarity
1849805.png,https://derpicdn.net/img/view/2018/10/6/1849805.png,0,0.960925639,325,17,1280,1003,955,986,rarity
1850702.png,https://derpicdn.net/img/view/2018/10/7/1850702.png,0,0.996399939,283,1191,919,1827,636,636,rarity
1850702.png,https://derpicdn.net/img/view/2018/10/7/1850702.png,1,0.936365247,2848,304,3338,794,490,490,rarity
1850702.png,https://derpicdn.net/img/view/2018/10/7/1850702.png,2,0.919160604,1273,2468,1611,2806,338,338,rarity
1851492.png,https://derpicdn.net/img/view/2018/10/8/1851492.png,0,0.998647511,113,0,627,496,514,496,rarity
1853640.png,https://derpicdn.net/img/view/2018/10/11/1853640.png,0,0.998472154,213,0,1125,895,912,895,rarity
1862983.png,https://derpicdn.net/img/view/2018/10/22/1862983.png,0,0.971775472,1177,127,2359,1309,1182,1182,rarity
1868003.png,https://derpicdn.net/img/view/2018/10/28/1868003.png,0,0.981637299,116,176,740,800,624,624,rarity
1871080.png,https://derpicdn.net/img/view/2018/10/31/1871080.png,0,0.958408117,41,0,1927,1538,1886,1538,rarity
1872969.png,https://derpicdn.net/img/view/2018/11/2/1872969.png,1,0.955302656,785,787,1397,1399,612,612,rarity
1873544.png,https://derpicdn.net/img/view/2018/11/2/1873544.png,0,0.986009538,1077,358,1653,934,576,576,rarity
1886720.png,https://derpicdn.net/img/view/2018/11/20/1886720.png,0,0.984951437,0,11,163,221,163,210,rarity
1886720.png,https://derpicdn.net/img/view/2018/11/20/1886720.png,1,0.956399739,0,0,163,222,163,222,rarity
1888931.png,https://derpicdn.net/img/view/2018/11/23/1888931.png,0,0.979052067,282,11,1398,1127,1116,1116,rarity
1888932.png,https://derpicdn.net/img/view/2018/11/23/1888932.png,0,0.996095359,514,134,1490,1110,976,976,rarity
1889497.png,https://derpicdn.net/img/view/2018/11/23/1889497.png,0,0.979768753,55,40,709,694,654,654,rarity
1890768.png,https://derpicdn.net/img/view/2018/11/25/1890768.png,0,0.997036815,47,37,285,275,238,238,rarity
1890768.png,https://derpicdn.net/img/view/2018/11/25/1890768.png,1,0.983186245,399,440,687,728,288,288,rarity
1891472.png,https://derpicdn.net/img/view/2018/11/26/1891472.png,0,0.996006966,847,300,1243,696,396,396,rarity
1895878.png,https://derpicdn.net/img/view/2018/12/2/1895878.png,1,0.999587119,297,0,659,345,362,345,rarity
1895878.png,https://derpicdn.net/img/view/2018/12/2/1895878.png,2,0.987075388,179,490,487,798,308,308,rarity
1899125.png,https://derpicdn.net/img/view/2018/12/5/1899125.png,0,0.928483844,260,168,1142,1050,882,882,rarity
1904172.png,https://derpicdn.net/img/view/2018/12/10/1904172.png,0,0.994929135,876,0,1640,741,764,741,rarity
1904532.png,https://derpicdn.net/img/view/2018/12/10/1904532.png,0,0.998070598,641,0,1933,1253,1292,1253,rarity
1904957.png,https://derpicdn.net/img/view/2018/12/11/1904957.png,0,0.964985669,722,217,1918,1413,1196,1196,rarity
1905117.png,https://derpicdn.net/img/view/2018/12/11/1905117.png,0,0.993123591,672,212,1732,1272,1060,1060,rarity
1906830.png,https://derpicdn.net/img/view/2018/12/13/1906830.png,0,0.960079551,708,0,2068,1152,1360,1152,rarity
1909784.png,https://derpicdn.net/img/view/2018/12/16/1909784.png,0,0.979082525,69,0,481,373,412,373,rarity
1911811.png,https://derpicdn.net/img/view/2018/12/18/1911811.png,0,0.947018445,309,423,1685,1799,1376,1376,rarity
1912943.png,https://derpicdn.net/img/view/2018/12/19/1912943.png,0,0.993070364,226,5,932,711,706,706,rarity
1913086.png,https://derpicdn.net/img/view/2018/12/19/1913086.png,0,0.943342388,0,0,1003,898,1003,898,rarity
1917115.png,https://derpicdn.net/img/view/2018/12/24/1917115.png,0,0.995554686,118,15,616,513,498,498,rarity
1918549.png,https://derpicdn.net/img/view/2018/12/25/1918549.png,0,0.956222892,275,0,809,520,534,520,rarity
1918895.png,https://derpicdn.net/img/view/2018/12/26/1918895.png,0,0.989686906,201,61,763,623,562,562,rarity
1920116.png,https://derpicdn.net/img/view/2018/12/27/1920116.png,0,0.991527498,424,0,992,568,568,568,rarity
1925252.png,https://derpicdn.net/img/view/2019/1/2/1925252.png,0,0.992407858,1432,402,2402,1372,970,970,rarity
1925255.png,https://derpicdn.net/img/view/2019/1/2/1925255.png,0,0.990634084,1430,403,2396,1369,966,966,rarity
1930105.png,https://derpicdn.net/img/view/2019/1/8/1930105.png,0,0.996196926,476,0,1064,566,588,566,rarity
1935662.png,https://derpicdn.net/img/view/2019/1/15/1935662.png,0,0.980659127,0,0,1797,1811,1797,1811,rarity
1940363.png,https://derpicdn.net/img/view/2019/1/20/1940363.png,0,0.995514572,149,0,823,622,674,622,rarity
1942814.png,https://derpicdn.net/img/view/2019/1/23/1942814.png,0,0.998188972,219,0,583,364,364,364,rarity
1943788.png,https://derpicdn.net/img/view/2019/1/25/1943788.png,0,0.942520559,2314,78,3634,1398,1320,1320,rarity
1947014.png,https://derpicdn.net/img/view/2019/1/28/1947014.png,0,0.999412239,350,31,1006,687,656,656,rarity
1952229.png,https://derpicdn.net/img/view/2019/2/3/1952229.png,0,0.970840633,96,61,1000,1000,904,939,rarity
1955050.png,https://derpicdn.net/img/view/2019/2/6/1955050.png,0,0.998010814,385,0,1413,984,1028,984,rarity
1955699.png,https://derpicdn.net/img/view/2019/2/7/1955699.png,0,0.997784138,498,76,1306,884,808,808,rarity
1959521.png,https://derpicdn.net/img/view/2019/2/11/1959521.png,0,0.977876961,1407,42,2453,1088,1046,1046,rarity
1960472.png,https://derpicdn.net/img/view/2019/2/12/1960472.png,0,0.99969244,424,156,1360,1092,936,936,rarity
1966958.png,https://derpicdn.net/img/view/2019/2/20/1966958.png,0,0.980772555,140,0,1509,1323,1369,1323,rarity
1968962.png,https://derpicdn.net/img/view/2019/2/22/1968962.png,0,0.986127257,47,0,685,619,638,619,rarity
1971384.png,https://derpicdn.net/img/view/2019/2/25/1971384.png,0,0.997991383,14,0,3428,3394,3414,3394,rarity
1973957.png,https://derpicdn.net/img/view/2019/2/28/1973957.png,0,0.986471951,190,0,756,559,566,559,rarity
1976193.png,https://derpicdn.net/img/view/2019/3/3/1976193.png,0,0.97986722,0,87,403,513,403,426,rarity
1976620.png,https://derpicdn.net/img/view/2019/3/3/1976620.png,0,0.960570157,48,498,282,732,234,234,rarity
1979153.png,https://derpicdn.net/img/view/2019/3/7/1979153.png,0,0.972951949,2764,0,5602,2715,2838,2715,rarity
1983953.png,https://derpicdn.net/img/view/2019/3/12/1983953.png,0,0.994181454,231,452,997,1218,766,766,rarity
1997863.png,https://derpicdn.net/img/view/2019/3/29/1997863.png,0,0.989701629,1493,0,2437,892,944,892,rarity
1998475.png,https://derpicdn.net/img/view/2019/3/30/1998475.png,0,0.991232693,138,4,356,222,218,218,rarity
2002072.png,https://derpicdn.net/img/view/2019/4/3/2002072.png,0,0.959755182,0,0,851,890,851,890,rarity
2002921.png,https://derpicdn.net/img/view/2019/4/4/2002921.png,0,0.99883312,308,0,1864,1397,1556,1397,rarity
2004927.png,https://derpicdn.net/img/view/2019/4/6/2004927.png,0,0.993488669,1335,667,3727,3059,2392,2392,rarity
2009102.png,https://derpicdn.net/img/view/2019/4/11/2009102.png,0,0.999150276,168,174,676,682,508,508,rarity
2015509.png,https://derpicdn.net/img/view/2019/4/18/2015509.png,0,0.970894456,205,0,829,558,624,558,rarity
2018100.png,https://derpicdn.net/img/view/2019/4/20/2018100.png,0,0.965904772,133,42,902,906,769,864,rarity
2018100.png,https://derpicdn.net/img/view/2019/4/20/2018100.png,1,0.915172398,0,0,764,810,764,810,rarity
2019363.png,https://derpicdn.net/img/view/2019/4/22/2019363.png,0,0.983517945,125,41,681,597,556,556,rarity
2020323.png,https://derpicdn.net/img/view/2019/4/22/2020323.png,0,0.99747473,287,0,839,486,552,486,rarity
2020323.png,https://derpicdn.net/img/view/2019/4/22/2020323.png,1,0.992376328,340,539,838,1037,498,498,rarity
2021182.png,https://derpicdn.net/img/view/2019/4/23/2021182.png,0,0.969193995,88,28,582,522,494,494,rarity
2023271.png,https://derpicdn.net/img/view/2019/4/26/2023271.png,0,0.997092009,755,0,1523,738,768,738,rarity
2023275.png,https://derpicdn.net/img/view/2019/4/26/2023275.png,0,0.991478562,323,0,1067,726,744,726,rarity
2027092.png,https://derpicdn.net/img/view/2019/4/30/2027092.png,0,0.99345082,21,0,329,307,308,307,rarity
2035490.png,https://derpicdn.net/img/view/2019/5/10/2035490.png,0,0.981617391,456,0,1338,792,882,792,rarity
2035494.png,https://derpicdn.net/img/view/2019/5/10/2035494.png,0,0.954178929,445,0,1333,811,888,811,rarity
2035498.png,https://derpicdn.net/img/view/2019/5/10/2035498.png,0,0.961289644,1400,0,1858,453,458,453,rarity
2035498.png,https://derpicdn.net/img/view/2019/5/10/2035498.png,1,0.924330115,483,35,883,435,400,400,rarity
2037086.png,https://derpicdn.net/img/view/2019/5/12/2037086.png,0,0.986042619,641,106,1787,1252,1146,1146,rarity
2039702.png,https://derpicdn.net/img/view/2019/5/15/2039702.png,0,0.990645885,22,0,1066,1031,1044,1031,rarity
2039710.png,https://derpicdn.net/img/view/2019/5/15/2039710.png,0,0.906689227,266,0,1990,1651,1724,1651,rarity
2047292.png,https://derpicdn.net/img/view/2019/5/24/2047292.png,0,0.99617821,1491,0,4503,2792,3012,2792,rarity
2047738.png,https://derpicdn.net/img/view/2019/5/24/2047738.png,0,0.954459667,94,39,884,829,790,790,rarity
2048079.png,https://derpicdn.net/img/view/2019/5/25/2048079.png,0,0.994370639,204,43,880,719,676,676,rarity
2058229.png,https://derpicdn.net/img/view/2019/6/5/2058229.png,0,0.957036555,606,0,4078,3199,3472,3199,rarity
2058793.png,https://derpicdn.net/img/view/2019/6/5/2058793.png,0,0.994334757,270,85,508,323,238,238,rarity
2061317.png,https://derpicdn.net/img/view/2019/6/9/2061317.png,0,0.998687804,402,0,1020,590,618,590,rarity
2062524.png,https://derpicdn.net/img/view/2019/6/10/2062524.png,0,0.991186261,180,0,660,480,480,480,rarity
2063217.png,https://derpicdn.net/img/view/2019/6/11/2063217.png,0,0.996772468,12,0,602,553,590,553,rarity
2071462.png,https://derpicdn.net/img/view/2019/6/21/2071462.png,0,0.983994603,24,29,1491,1539,1467,1510,rarity
2073760.png,https://derpicdn.net/img/view/2019/6/24/2073760.png,0,0.984091699,122,0,418,293,296,293,rarity
2074746.png,https://derpicdn.net/img/view/2019/6/25/2074746.png,0,0.998509526,103,563,1553,2013,1450,1450,rarity
2076704.png,https://derpicdn.net/img/view/2019/6/27/2076704.png,0,0.975141704,55,0,741,663,686,663,rarity
2083696.png,https://derpicdn.net/img/view/2019/7/5/2083696.png,0,0.900876522,220,0,1606,1384,1386,1384,rarity
210.jpg,https://derpicdn.net/img/view/2012/1/13/210.jpg,0,0.974550068,0,57,493,615,493,558,rarity
2113156.png,https://derpicdn.net/img/view/2019/8/9/2113156.png,0,0.996459424,281,0,687,385,406,385,rarity
2113827.png,https://derpicdn.net/img/view/2019/8/10/2113827.png,0,0.9168697,101,261,2473,2633,2372,2372,rarity
2117656.png,https://derpicdn.net/img/view/2019/8/14/2117656.png,0,0.999451697,257,249,1027,1019,770,770,rarity
2119463.png,https://derpicdn.net/img/view/2019/8/16/2119463.png,0,0.998409867,269,13,731,475,462,462,rarity
2123635.png,https://derpicdn.net/img/view/2019/8/21/2123635.png,0,0.932602167,5246,55,5666,475,420,420,rarity
2125900.png,https://derpicdn.net/img/view/2019/8/24/2125900.png,0,0.991085827,0,0,3595,3590,3595,3590,rarity
2136509.png,https://derpicdn.net/img/view/2019/9/4/2136509.png,0,0.99875176,238,0,654,394,416,394,rarity
2139456.png,https://derpicdn.net/img/view/2019/9/8/2139456.png,0,0.997855008,352,199,1522,1369,1170,1170,rarity
2140878.png,https://derpicdn.net/img/view/2019/9/10/2140878.png,0,0.937639177,0,153,770,987,770,834,rarity
2141994.png,https://derpicdn.net/img/view/2019/9/11/2141994.png,0,0.976535916,491,52,825,474,334,422,rarity
2143759.png,https://derpicdn.net/img/view/2019/9/14/2143759.png,0,0.916529357,366,329,790,753,424,424,rarity
2145992.png,https://derpicdn.net/img/view/2019/9/17/2145992.png,0,0.994379759,1291,396,3859,2964,2568,2568,rarity
2153894.png,https://derpicdn.net/img/view/2019/9/27/2153894.png,0,0.986002684,2211,0,4841,2566,2630,2566,rarity
2155471.png,https://derpicdn.net/img/view/2019/9/29/2155471.png,0,0.989607751,918,0,1574,547,656,547,rarity
2156788.png,https://derpicdn.net/img/view/2019/9/30/2156788.png,0,0.998607576,1207,56,1651,500,444,444,rarity
2156788.png,https://derpicdn.net/img/view/2019/9/30/2156788.png,1,0.99601233,272,83,678,489,406,406,rarity
2157521.png,https://derpicdn.net/img/view/2019/10/1/2157521.png,0,0.92574209,0,178,1754,1986,1754,1808,rarity
2158284.png,https://derpicdn.net/img/view/2019/10/2/2158284.png,0,0.992992103,319,0,1280,977,961,977,rarity
2162053.png,https://derpicdn.net/img/view/2019/10/6/2162053.png,0,0.999851346,1287,82,2741,1536,1454,1454,rarity
2171884.png,https://derpicdn.net/img/view/2019/10/17/2171884.png,0,0.992912292,266,0,942,640,676,640,rarity
2175656.png,https://derpicdn.net/img/view/2019/10/21/2175656.png,0,0.982683599,124,0,1194,943,1070,943,rarity
2176730.png,https://derpicdn.net/img/view/2019/10/23/2176730.png,0,0.976661444,154,0,1746,1531,1592,1531,rarity
2177581.png,https://derpicdn.net/img/view/2019/10/24/2177581.png,0,0.980352521,95,84,801,790,706,706,rarity
2178254.png,https://derpicdn.net/img/view/2019/10/25/2178254.png,0,0.99945724,502,353,1270,1121,768,768,rarity
2184793.png,https://derpicdn.net/img/view/2019/11/1/2184793.png,0,0.909022331,292,0,1506,900,1214,900,rarity
2185639.png,https://derpicdn.net/img/view/2019/11/2/2185639.png,0,0.981172264,44,20,800,928,756,908,rarity
2187299.png,https://derpicdn.net/img/view/2019/11/4/2187299.png,0,0.98932302,87,18,929,860,842,842,rarity
2188910.png,https://derpicdn.net/img/view/2019/11/6/2188910.png,0,0.999007046,96,11,388,303,292,292,rarity
2189323.png,https://derpicdn.net/img/view/2019/11/7/2189323.png,0,0.963134527,435,15,1001,581,566,566,rarity
2191351.png,https://derpicdn.net/img/view/2019/11/9/2191351.png,0,0.938129246,203,16,1273,1086,1070,1070,rarity
2193162.png,https://derpicdn.net/img/view/2019/11/11/2193162.png,0,0.967157781,1653,298,2461,1106,808,808,rarity
2193499.png,https://derpicdn.net/img/view/2019/11/11/2193499.png,0,0.957905114,123,67,681,625,558,558,rarity
2194159.png,https://derpicdn.net/img/view/2019/11/12/2194159.png,0,0.964823127,246,0,852,584,606,584,rarity
2202095.png,https://derpicdn.net/img/view/2019/11/21/2202095.png,0,0.97132647,170,2,642,474,472,472,rarity
2204883.png,https://derpicdn.net/img/view/2019/11/24/2204883.png,0,0.967022598,754,17,2018,1281,1264,1264,rarity
2210884.png,https://derpicdn.net/img/view/2019/12/2/2210884.png,0,0.919303,306,31,722,447,416,416,rarity
2219849.png,https://derpicdn.net/img/view/2019/12/13/2219849.png,0,0.984512866,1782,0,2324,525,542,525,rarity
2223110.png,https://derpicdn.net/img/view/2019/12/17/2223110.png,0,0.994264066,292,58,518,284,226,226,rarity
2226247.png,https://derpicdn.net/img/view/2019/12/21/2226247.png,0,0.994275272,46,30,632,616,586,586,rarity
2228340.png,https://derpicdn.net/img/view/2019/12/24/2228340.png,0,0.99838829,246,36,550,340,304,304,rarity
2233386.jpg,https://derpicdn.net/img/view/2019/12/29/2233386.jpg,0,0.965914607,577,0,2271,1690,1694,1690,rarity
2235199.png,https://derpicdn.net/img/view/2020/1/1/2235199.png,0,0.990647554,511,395,967,851,456,456,rarity
2235199.png,https://derpicdn.net/img/view/2020/1/1/2235199.png,1,0.980884373,921,243,1431,753,510,510,rarity
2235985.png,https://derpicdn.net/img/view/2020/1/1/2235985.png,0,0.993484139,706,0,1920,991,1214,991,rarity
2237896.png,https://derpicdn.net/img/view/2020/1/3/2237896.png,0,0.998838186,809,0,1181,294,372,294,rarity
2237896.png,https://derpicdn.net/img/view/2020/1/3/2237896.png,1,0.994302452,199,0,553,290,354,290,rarity
2240040.jpg,https://derpicdn.net/img/view/2020/1/6/2240040.jpg,0,0.906189024,1651,56,2477,882,826,826,rarity
2242131.jpg,https://derpicdn.net/img/view/2020/1/8/2242131.jpg,0,0.998284936,226,72,886,732,660,660,rarity
2243348.jpg,https://derpicdn.net/img/view/2020/1/10/2243348.jpg,0,0.987112582,0,0,1316,1213,1316,1213,rarity
2246633.png,https://derpicdn.net/img/view/2020/1/13/2246633.png,0,0.988369226,271,4,669,402,398,398,rarity
2247104.png,https://derpicdn.net/img/view/2020/1/14/2247104.png,0,0.973439693,582,96,2306,1820,1724,1724,rarity
2247334.jpg,https://derpicdn.net/img/view/2020/1/14/2247334.jpg,0,0.960214913,144,0,590,409,446,409,rarity
2249841.png,https://derpicdn.net/img/view/2020/1/17/2249841.png,0,0.99825573,318,56,1110,848,792,792,rarity
2252519.png,https://derpicdn.net/img/view/2020/1/20/2252519.png,0,0.99916476,1285,0,3001,1643,1716,1643,rarity
2252634.png,https://derpicdn.net/img/view/2020/1/20/2252634.png,0,0.957286417,260,91,990,821,730,730,rarity
2254985.png,https://derpicdn.net/img/view/2020/1/23/2254985.png,0,0.993296444,1186,142,2524,1480,1338,1338,rarity
2257071.png,https://derpicdn.net/img/view/2020/1/25/2257071.png,0,0.998693705,483,70,881,468,398,398,rarity
2257833.png,https://derpicdn.net/img/view/2020/1/26/2257833.png,0,0.986035645,1012,45,2102,1135,1090,1090,rarity
2260614.png,https://derpicdn.net/img/view/2020/1/29/2260614.png,0,0.941657782,1914,75,3276,1437,1362,1362,rarity
2263196.png,https://derpicdn.net/img/view/2020/2/1/2263196.png,0,0.92947638,688,304,1560,1176,872,872,rarity
2265373.jpg,https://derpicdn.net/img/view/2020/2/4/2265373.jpg,0,0.915357053,239,0,1285,953,1046,953,rarity
2265807.png,https://derpicdn.net/img/view/2020/2/4/2265807.png,0,0.995770872,1470,339,2754,1623,1284,1284,rarity
22678.png,https://derpicdn.net/img/view/2012/6/27/22678.png,0,0.943983793,159,87,493,421,334,334,rarity
2272144.png,https://derpicdn.net/img/view/2020/2/12/2272144.png,1,0.986321986,117,63,349,295,232,232,rarity
2272146.png,https://derpicdn.net/img/view/2020/2/12/2272146.png,1,0.981673479,116,63,350,297,234,234,rarity
2272148.png,https://derpicdn.net/img/view/2020/2/12/2272148.png,1,0.969609559,117,62,349,294,232,232,rarity
2275796.png,https://derpicdn.net/img/view/2020/2/16/2275796.png,0,0.972127855,178,0,1436,900,1258,900,rarity
2275796.png,https://derpicdn.net/img/view/2020/2/16/2275796.png,1,0.937759221,191,0,1207,827,1016,827,rarity
2278130.jpg,https://derpicdn.net/img/view/2020/2/19/2278130.jpg,0,0.900182068,486,49,1140,703,654,654,rarity
2278837.png,https://derpicdn.net/img/view/2020/2/20/2278837.png,0,0.990912139,694,12,2004,1322,1310,1310,rarity
2278973.jpg,https://derpicdn.net/img/view/2020/2/20/2278973.jpg,0,0.968722582,0,0,1434,1545,1434,1545,rarity
2278973.jpg,https://derpicdn.net/img/view/2020/2/20/2278973.jpg,1,0.923446059,187,0,1745,1790,1558,1790,rarity
2280053.png,https://derpicdn.net/img/view/2020/2/21/2280053.png,0,0.998145401,241,0,633,374,392,374,rarity
2281215.png,https://derpicdn.net/img/view/2020/2/22/2281215.png,0,0.952038229,0,0,889,962,889,962,rarity
2281775.jpg,https://derpicdn.net/img/view/2020/2/23/2281775.jpg,0,0.976411402,216,96,1034,914,818,818,rarity
2285213.jpg,https://derpicdn.net/img/view/2020/2/28/2285213.jpg,0,0.998719513,460,116,1146,802,686,686,rarity
2286342.png,https://derpicdn.net/img/view/2020/2/29/2286342.png,0,0.989086449,365,919,2741,3295,2376,2376,rarity
2288787.jpg,https://derpicdn.net/img/view/2020/3/3/2288787.jpg,0,0.999642432,0,114,1052,1178,1052,1064,rarity
2288787.jpg,https://derpicdn.net/img/view/2020/3/3/2288787.jpg,1,0.997485101,1223,0,2245,974,1022,974,rarity
2295253.png,https://derpicdn.net/img/view/2020/3/11/2295253.png,0,0.921822906,146,67,860,781,714,714,rarity
2296736.jpg,https://derpicdn.net/img/view/2020/3/13/2296736.jpg,0,0.978819489,339,71,1045,777,706,706,rarity
2297262.png,https://derpicdn.net/img/view/2020/3/14/2297262.png,0,0.97383368,306,105,688,487,382,382,rarity
2298014.png,https://derpicdn.net/img/view/2020/3/15/2298014.png,0,0.994717062,456,0,2298,1835,1842,1835,rarity
2301213.jpg,https://derpicdn.net/img/view/2020/3/19/2301213.jpg,0,0.996120393,893,0,2149,1112,1256,1112,rarity
2307466.png,https://derpicdn.net/img/view/2020/3/27/2307466.png,0,0.99934572,483,63,1035,615,552,552,rarity
2321012.png,https://derpicdn.net/img/view/2020/4/13/2321012.png,0,0.992196202,317,132,1883,1698,1566,1566,rarity
2322693.jpg,https://derpicdn.net/img/view/2020/4/14/2322693.jpg,0,0.99121511,189,138,1417,1366,1228,1228,rarity
2324442.png,https://derpicdn.net/img/view/2020/4/17/2324442.png,0,0.978657246,217,68,459,310,242,242,rarity
2327076.png,https://derpicdn.net/img/view/2020/4/20/2327076.png,0,0.98733592,113,0,1132,847,1019,847,rarity
2330021.jpg,https://derpicdn.net/img/view/2020/4/24/2330021.jpg,0,0.996485472,484,0,1140,571,656,571,rarity
2332302.jpg,https://derpicdn.net/img/view/2020/4/26/2332302.jpg,0,0.967475176,849,0,1893,1041,1044,1041,rarity
2332612.jpg,https://derpicdn.net/img/view/2020/4/26/2332612.jpg,0,0.999072611,406,2,1074,670,668,668,rarity
2334740.png,https://derpicdn.net/img/view/2020/4/29/2334740.png,0,0.999169946,785,86,1589,890,804,804,rarity
2340622.jpg,https://derpicdn.net/img/view/2020/5/6/2340622.jpg,0,0.980018377,29,34,1119,1124,1090,1090,rarity
2340794.png,https://derpicdn.net/img/view/2020/5/6/2340794.png,0,0.998467147,696,53,1558,915,862,862,rarity
2343548.png,https://derpicdn.net/img/view/2020/5/9/2343548.png,0,0.997237682,631,35,1243,647,612,612,rarity
2343548.png,https://derpicdn.net/img/view/2020/5/9/2343548.png,1,0.994367123,1521,114,2109,702,588,588,rarity
2346791.jpg,https://derpicdn.net/img/view/2020/5/12/2346791.jpg,0,0.991980851,150,0,454,292,304,292,rarity
2354087.jpg,https://derpicdn.net/img/view/2020/5/21/2354087.jpg,0,0.999391556,267,2,707,442,440,440,rarity
236207.png,https://derpicdn.net/img/view/2013/2/7/236207.png,0,0.976714551,238,572,1222,1556,984,984,rarity
237494.png,https://derpicdn.net/img/view/2013/2/9/237494.png,0,0.915180624,1847,0,3263,1263,1416,1263,rarity
237554.png,https://derpicdn.net/img/view/2013/2/9/237554.png,0,0.991986752,0,77,1311,1525,1311,1448,rarity
247293.png,https://derpicdn.net/img/view/2013/2/18/247293.png,0,0.998181403,597,670,1019,1092,422,422,rarity
2525.png,https://derpicdn.net/img/view/2012/1/28/2525.png,0,0.959658325,543,0,1251,579,708,579,rarity
255356.png,https://derpicdn.net/img/view/2013/2/25/255356.png,0,0.997552812,181,0,845,661,664,661,rarity
275268.jpg,https://derpicdn.net/img/view/2013/3/20/275268.jpg,0,0.941304922,289,26,829,566,540,540,rarity
290131.png,https://derpicdn.net/img/view/2013/4/6/290131.png,0,0.968189418,152,0,680,526,528,526,rarity
292438.png,https://derpicdn.net/img/view/2013/4/9/292438.png,0,0.997027397,1398,0,2294,824,896,824,rarity
2998.jpg,https://derpicdn.net/img/view/2012/2/12/2998.jpg,0,0.987701952,349,11,791,453,442,442,rarity
306378.png,https://derpicdn.net/img/view/2013/4/23/306378.png,0,0.964236498,242,0,544,286,302,286,rarity
307324.png,https://derpicdn.net/img/view/2013/4/24/307324.png,0,0.913539827,665,120,1101,556,436,436,rarity
318553.png,https://derpicdn.net/img/view/2013/5/7/318553.png,0,0.987273395,93,0,905,811,812,811,rarity
324694.png,https://derpicdn.net/img/view/2013/5/14/324694.png,0,0.994735539,1284,0,1814,455,530,455,rarity
324694.png,https://derpicdn.net/img/view/2013/5/14/324694.png,1,0.994562149,682,0,1070,316,388,316,rarity
324694.png,https://derpicdn.net/img/view/2013/5/14/324694.png,2,0.991501987,99,0,467,322,368,322,rarity
324694.png,https://derpicdn.net/img/view/2013/5/14/324694.png,3,0.944037855,1344,843,1938,1437,594,594,rarity
340803.png,https://derpicdn.net/img/view/2013/6/5/340803.png,0,0.999641716,229,65,703,539,474,474,rarity
340931.png,https://derpicdn.net/img/view/2013/6/5/340931.png,0,0.999567807,231,65,701,535,470,470,rarity
342456.png,https://derpicdn.net/img/view/2013/6/7/342456.png,0,0.993869245,296,3,1526,1233,1230,1230,rarity
349652.png,https://derpicdn.net/img/view/2013/6/16/349652.png,0,0.998532355,181,104,675,598,494,494,rarity
366607.jpg,https://derpicdn.net/img/view/2013/7/7/366607.jpg,0,0.991215587,176,0,608,432,432,432,rarity
370811.png,https://derpicdn.net/img/view/2013/7/12/370811.png,0,0.991282642,469,253,2007,1791,1538,1538,rarity
387310.png,https://derpicdn.net/img/view/2013/7/31/387310.png,0,0.982070267,27,0,451,416,424,416,rarity
389636.png,https://derpicdn.net/img/view/2013/8/2/389636.png,0,0.99944675,27,0,491,453,464,453,rarity
404315.jpg,https://derpicdn.net/img/view/2013/8/19/404315.jpg,0,0.990730822,50,20,1048,1018,998,998,rarity
407260.png,https://derpicdn.net/img/view/2013/8/22/407260.png,0,0.994175911,121,0,811,618,690,618,rarity
410.jpg,https://derpicdn.net/img/view/2012/1/16/410.jpg,0,0.995844901,466,246,1036,816,570,570,rarity
414548.jpg,https://derpicdn.net/img/view/2013/8/30/414548.jpg,0,0.997207761,282,0,568,278,286,278,rarity
422476.png,https://derpicdn.net/img/view/2013/9/8/422476.png,1,0.963409364,0,0,342,271,342,271,rarity
4248.png,https://derpicdn.net/img/view/2012/6/3/4248.png,0,0.99335897,285,0,619,317,334,317,rarity
426699.png,https://derpicdn.net/img/view/2013/9/13/426699.png,0,0.997298956,232,149,960,877,728,728,rarity
427216.png,https://derpicdn.net/img/view/2013/9/14/427216.png,0,0.988318205,567,38,1329,800,762,762,rarity
437072.png,https://derpicdn.net/img/view/2013/9/28/437072.png,0,0.997015059,400,0,756,324,356,324,rarity
442514.png,https://derpicdn.net/img/view/2013/10/6/442514.png,0,0.96130687,107,0,971,743,864,743,rarity
442688.jpg,https://derpicdn.net/img/view/2013/10/6/442688.jpg,0,0.96312803,121,0,467,329,346,329,rarity
445944.png,https://derpicdn.net/img/view/2013/10/10/445944.png,0,0.918607414,1898,111,3732,1945,1834,1834,rarity
454805.png,https://derpicdn.net/img/view/2013/10/23/454805.png,0,0.970520377,762,104,1552,894,790,790,rarity
456690.png,https://derpicdn.net/img/view/2013/10/26/456690.png,0,0.956841409,104,6,516,418,412,412,rarity
462666.png,https://derpicdn.net/img/view/2013/11/2/462666.png,0,0.990426719,738,27,1434,723,696,696,rarity
475009.png,https://derpicdn.net/img/view/2013/11/17/475009.png,0,0.984264493,368,92,804,528,436,436,rarity
475752.png,https://derpicdn.net/img/view/2013/11/19/475752.png,0,0.98491919,769,253,1509,993,740,740,rarity
476096.png,https://derpicdn.net/img/view/2013/11/19/476096.png,0,0.995462298,1,0,1083,1063,1082,1063,rarity
47869.png,https://derpicdn.net/img/view/2012/7/18/47869.png,0,0.907220662,0,115,792,923,792,808,rarity
481.jpg,https://derpicdn.net/img/view/2012/1/16/481.jpg,0,0.99321425,258,112,774,628,516,516,rarity
482543.png,https://derpicdn.net/img/view/2013/11/26/482543.png,0,0.995363891,723,0,1403,672,680,672,rarity
500162.png,https://derpicdn.net/img/view/2013/12/18/500162.png,0,0.924895942,540,32,1174,666,634,634,rarity
500281.png,https://derpicdn.net/img/view/2013/12/18/500281.png,0,0.993759751,1095,1167,2289,2361,1194,1194,rarity
515436.png,https://derpicdn.net/img/view/2014/1/5/515436.png,0,0.972623408,0,0,420,383,420,383,rarity
524881.png,https://derpicdn.net/img/view/2014/1/15/524881.png,0,0.976713121,177,15,493,331,316,316,rarity
526703.jpg,https://derpicdn.net/img/view/2014/1/17/526703.jpg,0,0.994798481,487,180,743,436,256,256,rarity
528631.jpg,https://derpicdn.net/img/view/2014/1/19/528631.jpg,0,0.986600339,58,290,1540,1772,1482,1482,rarity
530576.jpg,https://derpicdn.net/img/view/2014/1/21/530576.jpg,0,0.958916545,1171,660,1779,1268,608,608,rarity
537577.png,https://derpicdn.net/img/view/2014/1/29/537577.png,0,0.997476816,117,0,685,538,568,538,rarity
538663.png,https://derpicdn.net/img/view/2014/1/30/538663.png,0,0.934839666,112,0,422,288,310,288,rarity
540374.png,https://derpicdn.net/img/view/2014/2/1/540374.png,0,0.977282643,225,339,1427,1541,1202,1202,rarity
547330.png,https://derpicdn.net/img/view/2014/2/9/547330.png,0,0.961054802,210,57,588,435,378,378,rarity
551039.png,https://derpicdn.net/img/view/2014/2/13/551039.png,0,0.98561728,456,632,636,812,180,180,rarity
551773.png,https://derpicdn.net/img/view/2014/2/14/551773.png,0,0.958273768,291,302,1497,1508,1206,1206,rarity
556565.png,https://derpicdn.net/img/view/2014/2/19/556565.png,0,0.954213738,18,51,400,433,382,382,rarity
557064.png,https://derpicdn.net/img/view/2014/2/20/557064.png,0,0.934533894,156,7,526,377,370,370,rarity
558940.jpg,https://derpicdn.net/img/view/2014/2/22/558940.jpg,0,0.984996915,514,0,1600,1033,1086,1033,rarity
558948.jpg,https://derpicdn.net/img/view/2014/2/22/558948.jpg,0,0.923152924,373,161,1069,857,696,696,rarity
560149.png,https://derpicdn.net/img/view/2014/2/23/560149.png,0,0.992972851,30,0,850,811,820,811,rarity
568987.png,https://derpicdn.net/img/view/2014/3/8/568987.png,0,0.99317342,196,0,670,461,474,461,rarity
571296.jpg,https://derpicdn.net/img/view/2014/3/10/571296.jpg,0,0.996771097,234,56,550,372,316,316,rarity
573251.jpg,https://derpicdn.net/img/view/2014/3/12/573251.jpg,0,0.998126864,531,49,1473,991,942,942,rarity
574320.png,https://derpicdn.net/img/view/2014/3/13/574320.png,0,0.99227494,147,81,565,499,418,418,rarity
575587.png,https://derpicdn.net/img/view/2014/3/15/575587.png,0,0.997291684,699,332,2131,1764,1432,1432,rarity
578974.png,https://derpicdn.net/img/view/2014/3/18/578974.png,0,0.958383441,3,7,264,331,261,324,rarity
592319.png,https://derpicdn.net/img/view/2014/4/4/592319.png,0,0.98403877,118,0,498,342,380,342,rarity
593885.png,https://derpicdn.net/img/view/2014/4/5/593885.png,0,0.949046671,393,136,659,402,266,266,rarity
596449.png,https://derpicdn.net/img/view/2014/4/9/596449.png,0,0.942513466,303,0,743,400,440,400,rarity
598525.png,https://derpicdn.net/img/view/2014/4/12/598525.png,0,0.998241723,211,8,565,362,354,354,rarity
598880.png,https://derpicdn.net/img/view/2014/4/12/598880.png,0,0.987074256,219,1318,4715,5814,4496,4496,rarity
601923.png,https://derpicdn.net/img/view/2014/4/16/601923.png,0,0.940291762,261,0,1205,919,944,919,rarity
602357.png,https://derpicdn.net/img/view/2014/4/17/602357.png,0,0.983656287,76,17,520,461,444,444,rarity
602904.png,https://derpicdn.net/img/view/2014/4/17/602904.png,0,0.968710423,129,0,549,402,420,402,rarity
605270.png,https://derpicdn.net/img/view/2014/4/20/605270.png,0,0.95759064,435,196,1023,784,588,588,rarity
610605.jpg,https://derpicdn.net/img/view/2014/4/26/610605.jpg,0,0.974575579,0,256,795,1052,795,796,rarity
615207.png,https://derpicdn.net/img/view/2014/5/2/615207.png,0,0.957705498,1171,660,1779,1268,608,608,rarity
635197.png,https://derpicdn.net/img/view/2014/5/24/635197.png,0,0.983680844,544,93,978,527,434,434,rarity
635729.png,https://derpicdn.net/img/view/2014/5/25/635729.png,0,0.946504176,456,0,3748,3048,3292,3048,rarity
654702.png,https://derpicdn.net/img/view/2014/6/16/654702.png,0,0.995715022,0,0,703,734,703,734,rarity
657311.png,https://derpicdn.net/img/view/2014/6/20/657311.png,0,0.999181986,186,0,2060,1670,1874,1670,rarity
659625.png,https://derpicdn.net/img/view/2014/6/23/659625.png,0,0.996679783,94,0,716,505,622,505,rarity
662920.jpg,https://derpicdn.net/img/view/2014/6/28/662920.jpg,0,0.999422252,1509,0,4623,2931,3114,2931,rarity
664572.png,https://derpicdn.net/img/view/2014/6/30/664572.png,0,0.983013391,135,7,417,289,282,282,rarity
665404.png,https://derpicdn.net/img/view/2014/7/1/665404.png,0,0.997765183,1351,21,2143,813,792,792,rarity
665542.png,https://derpicdn.net/img/view/2014/7/1/665542.png,0,0.995788276,105,0,477,370,372,370,rarity
666593.png,https://derpicdn.net/img/view/2014/7/3/666593.png,0,0.954189837,0,0,520,538,520,538,rarity
666745.jpg,https://derpicdn.net/img/view/2014/7/3/666745.jpg,0,0.950747192,124,298,630,804,506,506,rarity
672709.png,https://derpicdn.net/img/view/2014/7/11/672709.png,0,0.950172603,470,279,1478,1287,1008,1008,rarity
677159.jpg,https://derpicdn.net/img/view/2014/7/17/677159.jpg,0,0.994647861,1028,0,1732,686,704,686,rarity
678583.jpg,https://derpicdn.net/img/view/2014/7/19/678583.jpg,0,0.995972514,239,0,1119,787,880,787,rarity
685106.png,https://derpicdn.net/img/view/2014/7/28/685106.png,0,0.974359214,0,0,442,494,442,494,rarity
688538.png,https://derpicdn.net/img/view/2014/8/1/688538.png,0,0.999341547,439,0,815,362,376,362,rarity
708535.png,https://derpicdn.net/img/view/2014/8/26/708535.png,0,0.982130826,1729,301,2733,1305,1004,1004,rarity
710345.jpg,https://derpicdn.net/img/view/2014/8/29/710345.jpg,0,0.983398914,1576,549,2494,1467,918,918,rarity
713224.png,https://derpicdn.net/img/view/2014/9/1/713224.png,0,0.924473166,417,441,779,803,362,362,rarity
721425.png,https://derpicdn.net/img/view/2014/9/13/721425.png,0,0.983004153,673,8,1137,472,464,464,rarity
721788.jpg,https://derpicdn.net/img/view/2014/9/14/721788.jpg,0,0.932610452,1404,1601,1930,2127,526,526,rarity
722045.png,https://derpicdn.net/img/view/2014/9/14/722045.png,0,0.969338119,102,100,550,548,448,448,rarity
722870.jpg,https://derpicdn.net/img/view/2014/9/15/722870.jpg,0,0.972084701,575,348,1127,900,552,552,rarity
723416.png,https://derpicdn.net/img/view/2014/9/16/723416.png,0,0.963496804,419,0,1009,567,590,567,rarity
730564.png,https://derpicdn.net/img/view/2014/9/27/730564.png,0,0.980177462,1308,292,1828,812,520,520,rarity
732662.png,https://derpicdn.net/img/view/2014/9/30/732662.png,0,0.976563573,219,12,493,286,274,274,rarity
738721.png,https://derpicdn.net/img/view/2014/10/8/738721.png,0,0.942917347,520,0,900,346,380,346,rarity
746445.png,https://derpicdn.net/img/view/2014/10/20/746445.png,0,0.991845131,332,221,1672,1561,1340,1340,rarity
747566.png,https://derpicdn.net/img/view/2014/10/21/747566.png,0,0.953685224,98,0,590,469,492,469,rarity
747734.png,https://derpicdn.net/img/view/2014/10/21/747734.png,0,0.989497423,13,0,321,286,308,286,rarity
749405.png,https://derpicdn.net/img/view/2014/10/24/749405.png,0,0.996108174,538,11,1102,575,564,564,rarity
766807.jpg,https://derpicdn.net/img/view/2014/11/18/766807.jpg,0,0.917974293,112,0,580,446,468,446,rarity
771199.png,https://derpicdn.net/img/view/2014/11/24/771199.png,0,0.922432244,0,146,577,724,577,578,rarity
785105.png,https://derpicdn.net/img/view/2014/12/14/785105.png,0,0.999229908,544,133,1072,661,528,528,rarity
790166.png,https://derpicdn.net/img/view/2014/12/22/790166.png,0,0.999558628,493,20,1151,678,658,658,rarity
790166.png,https://derpicdn.net/img/view/2014/12/22/790166.png,1,0.999037206,1850,0,2480,629,630,629,rarity
794411.png,https://derpicdn.net/img/view/2014/12/28/794411.png,0,0.999025226,266,0,896,623,630,623,rarity
796273.png,https://derpicdn.net/img/view/2014/12/31/796273.png,0,0.978712916,245,15,873,643,628,628,rarity
802863.png,https://derpicdn.net/img/view/2015/1/9/802863.png,0,0.98060292,2574,898,3530,1854,956,956,rarity
807095.png,https://derpicdn.net/img/view/2015/1/15/807095.png,0,0.968430877,0,64,431,496,431,432,rarity
807135.png,https://derpicdn.net/img/view/2015/1/15/807135.png,0,0.999314249,195,26,515,346,320,320,rarity
808594.png,https://derpicdn.net/img/view/2015/1/17/808594.png,0,0.996431112,209,0,501,288,292,288,rarity
809746.png,https://derpicdn.net/img/view/2015/1/19/809746.png,0,0.971964538,282,175,916,809,634,634,rarity
809881.png,https://derpicdn.net/img/view/2015/1/19/809881.png,0,0.992091179,353,0,768,379,415,379,rarity
810060.png,https://derpicdn.net/img/view/2015/1/19/810060.png,0,0.994399488,344,0,768,387,424,387,rarity
814404.png,https://derpicdn.net/img/view/2015/1/25/814404.png,0,0.939394116,114,0,1112,980,998,980,rarity
8189.jpg,https://derpicdn.net/img/view/2012/6/18/8189.jpg,0,0.971881747,0,156,789,1020,789,864,rarity
819257.png,https://derpicdn.net/img/view/2015/2/1/819257.png,0,0.987926066,3,6,1111,1114,1108,1108,rarity
827373.png,https://derpicdn.net/img/view/2015/2/13/827373.png,0,0.985893309,0,0,440,441,440,441,rarity
832406.png,https://derpicdn.net/img/view/2015/2/19/832406.png,0,0.975650966,257,64,1127,934,870,870,rarity
834044.jpg,https://derpicdn.net/img/view/2015/2/21/834044.jpg,0,0.964755774,0,0,460,499,460,499,rarity
835882.jpg,https://derpicdn.net/img/view/2015/2/23/835882.jpg,0,0.999066472,595,41,973,419,378,378,rarity
836377.png,https://derpicdn.net/img/view/2015/2/24/836377.png,0,0.998006105,778,0,2582,1723,1804,1723,rarity
840870.png,https://derpicdn.net/img/view/2015/3/2/840870.png,0,0.978928566,855,57,1031,233,176,176,rarity
840870.png,https://derpicdn.net/img/view/2015/3/2/840870.png,1,0.975741148,593,29,817,253,224,224,rarity
840870.png,https://derpicdn.net/img/view/2015/3/2/840870.png,2,0.970958412,349,33,565,249,216,216,rarity
840870.png,https://derpicdn.net/img/view/2015/3/2/840870.png,3,0.90838927,104,45,306,247,202,202,rarity
842373.png,https://derpicdn.net/img/view/2015/3/4/842373.png,0,0.968146741,291,549,455,713,164,164,rarity
846179.jpg,https://derpicdn.net/img/view/2015/3/9/846179.jpg,0,0.933412552,341,152,645,456,304,304,rarity
846549.png,https://derpicdn.net/img/view/2015/3/10/846549.png,0,0.973517358,201,60,637,496,436,436,rarity
847226.jpg,https://derpicdn.net/img/view/2015/3/11/847226.jpg,0,0.993951559,137,12,351,226,214,214,rarity
84763.png,https://derpicdn.net/img/view/2012/8/28/84763.png,0,0.988082886,72,0,460,367,388,367,rarity
851119.jpg,https://derpicdn.net/img/view/2015/3/16/851119.jpg,0,0.964970291,90,128,640,678,550,550,rarity
852322.png,https://derpicdn.net/img/view/2015/3/18/852322.png,0,0.954086006,89,27,371,309,282,282,rarity
8556.png,https://derpicdn.net/img/view/2012/6/18/8556.png,0,0.978681207,728,427,1226,925,498,498,rarity
85635.png,https://derpicdn.net/img/view/2012/8/29/85635.png,0,0.98173517,408,0,700,243,292,243,rarity
858116.png,https://derpicdn.net/img/view/2015/3/27/858116.png,0,0.999485493,212,0,522,309,310,309,rarity
858559.png,https://derpicdn.net/img/view/2015/3/28/858559.png,0,0.997893035,491,106,867,482,376,376,rarity
858579.png,https://derpicdn.net/img/view/2015/3/28/858579.png,0,0.985221028,233,20,477,264,244,244,rarity
859472.png,https://derpicdn.net/img/view/2015/3/29/859472.png,0,0.959528327,68,0,410,315,342,315,rarity
86237.png,https://derpicdn.net/img/view/2012/8/30/86237.png,0,0.993371725,432,0,818,377,386,377,rarity
867989.png,https://derpicdn.net/img/view/2015/4/7/867989.png,0,0.945852697,345,215,5301,4300,4956,4085,rarity
877658.png,https://derpicdn.net/img/view/2015/4/19/877658.png,0,0.98312366,479,182,921,624,442,442,rarity
877658.png,https://derpicdn.net/img/view/2015/4/19/877658.png,1,0.928917468,775,177,1237,639,462,462,rarity
881542.png,https://derpicdn.net/img/view/2015/4/24/881542.png,0,0.974606872,106,7,380,281,274,274,rarity
884019.png,https://derpicdn.net/img/view/2015/4/27/884019.png,0,0.991102457,153,7,571,425,418,418,rarity
886157.jpg,https://derpicdn.net/img/view/2015/4/30/886157.jpg,0,0.993590355,388,0,1422,1006,1034,1006,rarity
887005.png,https://derpicdn.net/img/view/2015/5/2/887005.png,0,0.999228477,230,4,462,236,232,232,rarity
8929.jpg,https://derpicdn.net/img/view/2012/6/19/8929.jpg,0,0.995876729,198,0,802,579,604,579,rarity
895503.png,https://derpicdn.net/img/view/2015/5/14/895503.png,0,0.994782507,180,8,560,388,380,380,rarity
897494.png,https://derpicdn.net/img/view/2015/5/16/897494.png,0,0.985517859,503,0,1207,638,704,638,rarity
897629.png,https://derpicdn.net/img/view/2015/5/16/897629.png,0,0.999602795,1417,34,4603,3220,3186,3186,rarity
898467.png,https://derpicdn.net/img/view/2015/5/17/898467.png,0,0.992655337,714,0,2112,1362,1398,1362,rarity
899434.png,https://derpicdn.net/img/view/2015/5/18/899434.png,0,0.953552008,0,0,576,644,576,644,rarity
902397.png,https://derpicdn.net/img/view/2015/5/23/902397.png,0,0.999593973,1085,3,3763,2681,2678,2678,rarity
910191.png,https://derpicdn.net/img/view/2015/6/4/910191.png,0,0.997078061,8,0,274,265,266,265,rarity
911613.png,https://derpicdn.net/img/view/2015/6/6/911613.png,0,0.997519851,314,0,1110,779,796,779,rarity
912188.png,https://derpicdn.net/img/view/2015/6/7/912188.png,0,0.999128103,736,215,1282,761,546,546,rarity
913169.png,https://derpicdn.net/img/view/2015/6/8/913169.png,0,0.972038805,209,27,683,501,474,474,rarity
918741.jpg,https://derpicdn.net/img/view/2015/6/17/918741.jpg,0,0.996270716,1595,603,4961,4025,3366,3422,rarity
918897.png,https://derpicdn.net/img/view/2015/6/17/918897.png,0,0.993047774,335,16,869,550,534,534,rarity
920204.png,https://derpicdn.net/img/view/2015/6/20/920204.png,0,0.999166727,474,0,1222,748,748,748,rarity
925214.png,https://derpicdn.net/img/view/2015/6/28/925214.png,0,0.956136286,1093,173,1659,739,566,566,rarity
927513.png,https://derpicdn.net/img/view/2015/7/1/927513.png,0,0.997419953,324,282,732,690,408,408,rarity
927513.png,https://derpicdn.net/img/view/2015/7/1/927513.png,2,0.982637107,695,295,1024,705,329,410,rarity
929560.png,https://derpicdn.net/img/view/2015/7/4/929560.png,0,0.973017752,154,0,1414,1208,1260,1208,rarity
932828.png,https://derpicdn.net/img/view/2015/7/8/932828.png,0,0.995743573,76,5,406,335,330,330,rarity
933138.png,https://derpicdn.net/img/view/2015/7/9/933138.png,0,0.999013424,345,16,609,280,264,264,rarity
937293.png,https://derpicdn.net/img/view/2015/7/15/937293.png,0,0.993813217,495,6,1235,746,740,740,rarity
939856.png,https://derpicdn.net/img/view/2015/7/19/939856.png,0,0.998112977,58,0,304,246,246,246,rarity
946810.png,https://derpicdn.net/img/view/2015/7/29/946810.png,0,0.98127389,479,0,1183,623,704,623,rarity
9503.png,https://derpicdn.net/img/view/2012/6/19/9503.png,0,0.984428823,1201,231,2015,1045,814,814,rarity
950414.png,https://derpicdn.net/img/view/2015/8/4/950414.png,0,0.998655319,232,0,1336,1063,1104,1063,rarity
952748.png,https://derpicdn.net/img/view/2015/8/7/952748.png,0,0.971022427,868,276,1996,1404,1128,1128,rarity
964110.png,https://derpicdn.net/img/view/2015/8/23/964110.png,0,0.938490331,0,0,384,390,384,390,rarity
964867.jpg,https://derpicdn.net/img/view/2015/8/24/964867.jpg,0,0.956478119,66,0,552,456,486,456,rarity
967848.png,https://derpicdn.net/img/view/2015/8/29/967848.png,0,0.996164799,100,8,570,478,470,470,rarity
971454.png,https://derpicdn.net/img/view/2015/9/2/971454.png,0,0.9709723,0,125,308,443,308,318,rarity
971840.jpg,https://derpicdn.net/img/view/2015/9/3/971840.jpg,0,0.998216271,134,42,362,270,228,228,rarity
973879.png,https://derpicdn.net/img/view/2015/9/6/973879.png,0,0.997431755,183,83,883,783,700,700,rarity
974882.jpg,https://derpicdn.net/img/view/2015/9/7/974882.jpg,0,0.99648428,982,107,1826,951,844,844,rarity
975957.jpg,https://derpicdn.net/img/view/2015/9/9/975957.jpg,0,0.972658932,414,0,804,367,390,367,rarity
979919.png,https://derpicdn.net/img/view/2015/9/14/979919.png,0,0.941536486,61,0,671,583,610,583,rarity
982716.png,https://derpicdn.net/img/view/2015/9/19/982716.png,0,0.992364287,310,154,604,448,294,294,rarity
982716.png,https://derpicdn.net/img/view/2015/9/19/982716.png,1,0.992284358,671,262,949,540,278,278,rarity
986204.jpg,https://derpicdn.net/img/view/2015/9/23/986204.jpg,0,0.976372719,101,0,953,811,852,811,rarity
987511.png,https://derpicdn.net/img/view/2015/9/25/987511.png,0,0.964870512,141,108,677,644,536,536,rarity
987605.png,https://derpicdn.net/img/view/2015/9/25/987605.png,0,0.960701346,271,9,587,325,316,316,rarity
990733.jpg,https://derpicdn.net/img/view/2015/9/29/990733.jpg,0,0.994803429,841,208,1427,794,586,586,rarity
994019.png,https://derpicdn.net/img/view/2015/10/3/994019.png,0,0.962613523,255,17,713,475,458,458,rarity
1005165.png,https://derpicdn.net/img/view/2015/10/18/1005165.png,0,0.99854368,1308,0,2028,688,720,688,rarity
1011757.png,https://derpicdn.net/img/view/2015/10/29/1011757.png,0,0.977040052,379,16,981,618,602,602,rarity
1013310.png,https://derpicdn.net/img/view/2015/10/31/1013310.png,0,0.998029768,217,0,605,386,388,386,rarity
1014769.png,https://derpicdn.net/img/view/2015/11/2/1014769.png,0,0.998852968,753,260,1687,1194,934,934,rarity
1015295.png,https://derpicdn.net/img/view/2015/11/3/1015295.png,0,0.994467616,755,80,2055,1380,1300,1300,rarity
1020439.png,https://derpicdn.net/img/view/2015/11/10/1020439.png,0,0.971361518,86,2,600,516,514,514,rarity
1028706.png,https://derpicdn.net/img/view/2015/11/23/1028706.png,0,0.997330487,515,35,1833,1353,1318,1318,rarity
1038852.png,https://derpicdn.net/img/view/2015/12/7/1038852.png,0,0.99854368,1308,0,2028,688,720,688,rarity
1039883.png,https://derpicdn.net/img/view/2015/12/8/1039883.png,0,0.997181356,127,0,941,800,814,800,rarity
1039950.png,https://derpicdn.net/img/view/2015/12/8/1039950.png,0,0.993531048,697,125,1867,1295,1170,1170,rarity
1042408.png,https://derpicdn.net/img/view/2015/12/12/1042408.png,0,0.999615669,764,0,2090,1205,1326,1205,rarity
1045510.png,https://derpicdn.net/img/view/2015/12/16/1045510.png,0,0.933397114,570,0,2794,2153,2224,2153,rarity
1056026.png,https://derpicdn.net/img/view/2015/12/30/1056026.png,0,0.98660928,147,15,889,757,742,742,rarity
1058131.png,https://derpicdn.net/img/view/2016/1/2/1058131.png,0,0.987771988,35,0,545,494,510,494,rarity
1060369.png,https://derpicdn.net/img/view/2016/1/5/1060369.png,0,0.989685833,126,0,1220,1057,1094,1057,rarity
1064954.png,https://derpicdn.net/img/view/2016/1/12/1064954.png,0,0.989220798,478,198,680,400,202,202,rarity
1066468.png,https://derpicdn.net/img/view/2016/1/14/1066468.png,0,0.980718851,252,41,792,581,540,540,rarity
1072652.jpg,https://derpicdn.net/img/view/2016/1/24/1072652.jpg,0,0.990004599,308,353,678,723,370,370,rarity
1072652.jpg,https://derpicdn.net/img/view/2016/1/24/1072652.jpg,1,0.978445649,244,0,744,500,500,500,rarity
1074868.png,https://derpicdn.net/img/view/2016/1/27/1074868.png,0,0.996544302,127,0,865,705,738,705,rarity
1077490.png,https://derpicdn.net/img/view/2016/1/31/1077490.png,0,0.986646116,340,9,776,445,436,436,rarity
1077952.png,https://derpicdn.net/img/view/2016/2/1/1077952.png,0,0.933913529,33,0,411,384,378,384,rarity
1079047.jpg,https://derpicdn.net/img/view/2016/2/2/1079047.jpg,0,0.999844909,308,14,554,260,246,246,rarity
1081934.png,https://derpicdn.net/img/view/2016/2/6/1081934.png,0,0.986267984,203,195,1113,1105,910,910,rarity
1083939.png,https://derpicdn.net/img/view/2016/2/9/1083939.png,0,0.956733406,831,3,1181,353,350,350,rarity
1083939.png,https://derpicdn.net/img/view/2016/2/9/1083939.png,0,0.956733406,831,3,1181,353,350,350,rarity
1084726.png,https://derpicdn.net/img/view/2016/2/10/1084726.png,0,0.994616687,1399,221,2405,1227,1006,1006,rarity
1088054.png,https://derpicdn.net/img/view/2016/2/14/1088054.png,0,0.990112722,351,44,739,432,388,388,rarity
108860.png,https://derpicdn.net/img/view/2012/9/29/108860.png,0,0.981679857,114,247,480,613,366,366,rarity
1089814.png,https://derpicdn.net/img/view/2016/2/16/1089814.png,0,0.999231935,268,5,526,263,258,258,rarity
1093916.png,https://derpicdn.net/img/view/2016/2/22/1093916.png,0,0.996243179,270,7,618,355,348,348,rarity
1095027.png,https://derpicdn.net/img/view/2016/2/23/1095027.png,0,0.920382798,466,3,3860,3397,3394,3394,rarity
1102915.jpg,https://derpicdn.net/img/view/2016/3/6/1102915.jpg,0,0.999457836,104,0,460,332,356,332,rarity
1109947.png,https://derpicdn.net/img/view/2016/3/16/1109947.png,0,0.99571979,31,67,351,387,320,320,rarity
1109947.png,https://derpicdn.net/img/view/2016/3/16/1109947.png,1,0.971903205,240,77,508,345,268,268,rarity
111178.png,https://derpicdn.net/img/view/2012/10/1/111178.png,0,0.96354413,431,85,843,497,412,412,rarity
1127584.png,https://derpicdn.net/img/view/2016/4/8/1127584.png,0,0.922693074,125,60,683,618,558,558,rarity
112770.png,https://derpicdn.net/img/view/2012/10/3/112770.png,0,0.986467361,469,119,967,617,498,498,rarity
1129449.png,https://derpicdn.net/img/view/2016/4/10/1129449.png,0,0.997551143,393,6,1025,638,632,632,rarity
1130346.png,https://derpicdn.net/img/view/2016/4/12/1130346.png,0,0.90995872,855,93,1803,1041,948,948,rarity
1141236.png,https://derpicdn.net/img/view/2016/4/27/1141236.png,0,0.958433032,12,0,868,818,856,818,rarity
1154904.png,https://derpicdn.net/img/view/2016/5/15/1154904.png,0,0.988214076,1238,450,2708,1920,1470,1470,rarity
1162800.png,https://derpicdn.net/img/view/2016/5/25/1162800.png,0,0.965380132,0,0,1000,1057,1000,1057,rarity
1169337.jpg,https://derpicdn.net/img/view/2016/6/3/1169337.jpg,0,0.988787293,193,0,387,193,194,193,rarity
1169339.png,https://derpicdn.net/img/view/2016/6/3/1169339.png,0,0.984994352,207,3,519,315,312,312,rarity
1169345.png,https://derpicdn.net/img/view/2016/6/3/1169345.png,0,0.999042094,344,15,558,229,214,214,rarity
1169349.png,https://derpicdn.net/img/view/2016/6/3/1169349.png,0,0.995461106,261,0,471,188,210,188,rarity
1169350.jpg,https://derpicdn.net/img/view/2016/6/3/1169350.jpg,0,0.998178542,125,91,345,311,220,220,rarity
1169353.jpg,https://derpicdn.net/img/view/2016/6/3/1169353.jpg,0,0.979733527,187,88,411,312,224,224,rarity
1169651.jpg,https://derpicdn.net/img/view/2016/6/4/1169651.jpg,0,0.99584192,752,201,1204,653,452,452,rarity
1169651.jpg,https://derpicdn.net/img/view/2016/6/4/1169651.jpg,1,0.953628898,228,94,626,492,398,398,rarity
1192234.png,https://derpicdn.net/img/view/2016/7/3/1192234.png,0,0.997376978,359,0,1593,1178,1234,1178,rarity
119488.png,https://derpicdn.net/img/view/2012/10/11/119488.png,0,0.984784544,2752,889,3608,1745,856,856,rarity
119488.png,https://derpicdn.net/img/view/2012/10/11/119488.png,1,0.939103901,1210,2423,1840,3053,630,630,rarity
119488.png,https://derpicdn.net/img/view/2012/10/11/119488.png,2,0.92250222,2504,1734,3116,2346,612,612,rarity
119488.png,https://derpicdn.net/img/view/2012/10/11/119488.png,3,0.922497749,1488,1012,2200,1724,712,712,rarity
119488.png,https://derpicdn.net/img/view/2012/10/11/119488.png,4,0.91336,3379,870,4133,1624,754,754,rarity
1196127.png,https://derpicdn.net/img/view/2016/7/8/1196127.png,0,0.970677912,195,374,469,648,274,274,rarity
1198135.png,https://derpicdn.net/img/view/2016/7/11/1198135.png,0,0.994709015,323,73,759,509,436,436,rarity
1203388.png,https://derpicdn.net/img/view/2016/7/18/1203388.png,0,0.996754706,1417,115,2325,1023,908,908,rarity
1212859.png,https://derpicdn.net/img/view/2016/7/30/1212859.png,0,0.999348879,330,72,908,650,578,578,rarity
1217275.png,https://derpicdn.net/img/view/2016/8/5/1217275.png,0,0.992875099,33,0,497,439,464,439,rarity
1232585.png,https://derpicdn.net/img/view/2016/8/24/1232585.png,0,0.961123765,407,199,3211,3003,2804,2804,rarity
1234987.png,https://derpicdn.net/img/view/2016/8/27/1234987.png,0,0.99456358,872,0,1538,661,666,661,rarity
1236620.png,https://derpicdn.net/img/view/2016/8/29/1236620.png,0,0.999083698,0,22,386,442,386,420,rarity
1240416.png,https://derpicdn.net/img/view/2016/9/3/1240416.png,0,0.998167515,118,6,318,206,200,200,rarity
1243860.png,https://derpicdn.net/img/view/2016/9/7/1243860.png,0,0.998357117,0,25,384,439,384,414,rarity
1243860.png,https://derpicdn.net/img/view/2016/9/7/1243860.png,1,0.975278199,342,9,813,605,471,596,rarity
1243860.png,https://derpicdn.net/img/view/2016/9/7/1243860.png,0,0.998357117,0,25,384,439,384,414,rarity
1243860.png,https://derpicdn.net/img/view/2016/9/7/1243860.png,1,0.975278199,342,9,813,605,471,596,rarity
1249027.png,https://derpicdn.net/img/view/2016/9/14/1249027.png,0,0.990732312,64,0,630,557,566,557,rarity
1249206.png,https://derpicdn.net/img/view/2016/9/14/1249206.png,0,0.915690839,658,500,1936,1778,1278,1278,rarity
12525.png,https://derpicdn.net/img/view/2012/6/20/12525.png,0,0.999581039,13,736,511,1234,498,498,rarity
1255039.png,https://derpicdn.net/img/view/2016/9/21/1255039.png,0,0.923890769,385,34,1305,954,920,920,rarity
125839.jpg,https://derpicdn.net/img/view/2012/10/18/125839.jpg,0,0.998486161,300,131,714,545,414,414,rarity
1262664.png,https://derpicdn.net/img/view/2016/10/1/1262664.png,0,0.910831153,99,50,943,894,844,844,rarity
1268284.png,https://derpicdn.net/img/view/2016/10/8/1268284.png,0,0.967158496,295,0,1281,968,986,968,rarity
127045.jpg,https://derpicdn.net/img/view/2012/10/19/127045.jpg,0,0.998017788,269,0,557,256,288,256,rarity
1274513.png,https://derpicdn.net/img/view/2016/10/16/1274513.png,0,0.981248081,24,0,282,254,258,254,rarity
1278563.png,https://derpicdn.net/img/view/2016/10/22/1278563.png,0,0.998935997,174,26,616,468,442,442,rarity
1287433.png,https://derpicdn.net/img/view/2016/11/2/1287433.png,0,0.990522921,386,78,850,542,464,464,rarity
129929.png,https://derpicdn.net/img/view/2012/10/22/129929.png,0,0.952023029,92,300,308,516,216,216,rarity
1301127.png,https://derpicdn.net/img/view/2016/11/22/1301127.png,0,0.940116346,382,4,768,390,386,386,rarity
1304162.png,https://derpicdn.net/img/view/2016/11/26/1304162.png,0,0.9495821,916,143,1778,1005,862,862,rarity
1327012.png,https://derpicdn.net/img/view/2016/12/28/1327012.png,0,0.96239084,109,0,621,489,512,489,rarity
1327880.png,https://derpicdn.net/img/view/2016/12/29/1327880.png,0,0.99438256,3,0,1707,1693,1704,1693,rarity
1328895.png,https://derpicdn.net/img/view/2016/12/31/1328895.png,0,0.9967888,204,0,858,649,654,649,rarity
1329076.png,https://derpicdn.net/img/view/2016/12/31/1329076.png,0,0.996099591,3567,0,7621,3990,4054,3990,rarity
1336277.png,https://derpicdn.net/img/view/2017/1/10/1336277.png,0,0.964838862,2134,663,4240,2769,2106,2106,rarity
1338882.png,https://derpicdn.net/img/view/2017/1/14/1338882.png,0,0.990714908,617,235,1115,733,498,498,rarity
1345059.png,https://derpicdn.net/img/view/2017/1/22/1345059.png,0,0.909975231,146,0,1728,1511,1582,1511,rarity
1345922.png,https://derpicdn.net/img/view/2017/1/23/1345922.png,0,0.997064888,163,86,477,400,314,314,rarity
1349747.png,https://derpicdn.net/img/view/2017/1/28/1349747.png,0,0.954972923,0,0,432,427,432,427,rarity
1356331.png,https://derpicdn.net/img/view/2017/2/6/1356331.png,0,0.97249037,19,0,1026,577,1007,577,rarity
1356331.png,https://derpicdn.net/img/view/2017/2/6/1356331.png,0,0.97249037,19,0,1026,577,1007,577,rarity
1358716.png,https://derpicdn.net/img/view/2017/2/9/1358716.png,0,0.997922957,0,0,1464,1352,1464,1352,rarity
1359830.png,https://derpicdn.net/img/view/2017/2/11/1359830.png,0,0.988368094,426,43,1180,797,754,754,rarity
1365583.png,https://derpicdn.net/img/view/2017/2/17/1365583.png,0,0.925031126,0,0,1200,1276,1200,1276,rarity
1365583.png,https://derpicdn.net/img/view/2017/2/17/1365583.png,0,0.925031126,0,0,1200,1276,1200,1276,rarity
1371836.png,https://derpicdn.net/img/view/2017/2/24/1371836.png,0,0.998013377,381,140,725,484,344,344,rarity
1380956.png,https://derpicdn.net/img/view/2017/3/6/1380956.png,0,0.98856473,554,179,888,513,334,334,rarity
1381472.png,https://derpicdn.net/img/view/2017/3/7/1381472.png,0,0.938788652,610,196,1512,1098,902,902,rarity
1382602.png,https://derpicdn.net/img/view/2017/3/9/1382602.png,0,0.9899984,220,86,664,530,444,444,rarity
1383720.png,https://derpicdn.net/img/view/2017/3/10/1383720.png,0,0.995962501,0,36,479,516,479,480,rarity
1383720.png,https://derpicdn.net/img/view/2017/3/10/1383720.png,1,0.921849549,362,24,846,508,484,484,rarity
1386931.png,https://derpicdn.net/img/view/2017/3/14/1386931.png,0,0.998934925,294,82,1196,984,902,902,rarity
1397522.png,https://derpicdn.net/img/view/2017/3/27/1397522.png,0,0.972520649,35,0,1203,1125,1168,1125,rarity
1404864.png,https://derpicdn.net/img/view/2017/4/5/1404864.png,0,0.933148026,339,0,1049,683,710,683,rarity
1407052.png,https://derpicdn.net/img/view/2017/4/8/1407052.png,0,0.933530211,247,0,813,458,566,458,rarity
1408669.png,https://derpicdn.net/img/view/2017/4/11/1408669.png,0,0.996656477,114,445,642,973,528,528,rarity
1415815.png,https://derpicdn.net/img/view/2017/4/19/1415815.png,0,0.963598311,70,0,1842,1607,1772,1607,rarity
1416500.png,https://derpicdn.net/img/view/2017/4/20/1416500.png,0,0.990989089,394,0,672,266,278,266,rarity
1419923.png,https://derpicdn.net/img/view/2017/4/23/1419923.png,0,0.999507308,1172,56,1562,446,390,390,rarity
1419923.png,https://derpicdn.net/img/view/2017/4/23/1419923.png,1,0.990357876,267,500,913,1146,646,646,rarity
1419923.png,https://derpicdn.net/img/view/2017/4/23/1419923.png,0,0.999507308,1172,56,1562,446,390,390,rarity
1419923.png,https://derpicdn.net/img/view/2017/4/23/1419923.png,1,0.990357876,267,500,913,1146,646,646,rarity
142223.png,https://derpicdn.net/img/view/2012/11/4/142223.png,0,0.998157918,1130,0,2544,1193,1414,1193,rarity
1426937.png,https://derpicdn.net/img/view/2017/5/2/1426937.png,1,0.978140831,483,588,861,966,378,378,rarity
1428022.png,https://derpicdn.net/img/view/2017/5/3/1428022.png,0,0.982767761,111,0,465,352,354,352,rarity
1430185.png,https://derpicdn.net/img/view/2017/5/6/1430185.png,0,0.97363019,877,48,1231,402,354,354,rarity
1431794.png,https://derpicdn.net/img/view/2017/5/8/1431794.png,0,0.92519629,95,125,563,593,468,468,rarity
1435231.png,https://derpicdn.net/img/view/2017/5/13/1435231.png,0,0.974014521,157,0,900,738,743,738,rarity
1436360.png,https://derpicdn.net/img/view/2017/5/14/1436360.png,0,0.985901833,840,37,1760,957,920,920,rarity
1437823.png,https://derpicdn.net/img/view/2017/5/16/1437823.png,0,0.90942651,130,59,676,605,546,546,rarity
1449558.png,https://derpicdn.net/img/view/2017/5/30/1449558.png,0,0.907431304,369,69,1647,1347,1278,1278,rarity
1457630.png,https://derpicdn.net/img/view/2017/6/9/1457630.png,0,0.916234076,711,0,2247,1497,1536,1497,rarity
1459714.png,https://derpicdn.net/img/view/2017/6/12/1459714.png,1,0.976774931,107,0,463,348,356,348,rarity
1469193.png,https://derpicdn.net/img/view/2017/6/22/1469193.png,0,0.999444962,643,132,1383,872,740,740,rarity
1472497.png,https://derpicdn.net/img/view/2017/6/27/1472497.png,0,0.970353425,9,0,681,623,672,623,rarity
147403.jpg,https://derpicdn.net/img/view/2012/11/10/147403.jpg,0,0.990810633,62,42,1028,1008,966,966,rarity
1482270.png,https://derpicdn.net/img/view/2017/7/9/1482270.png,0,0.999235749,499,152,825,478,326,326,rarity
1485.jpg,https://derpicdn.net/img/view/2012/1/22/1485.jpg,0,0.989539742,309,14,741,446,432,432,rarity
1485419.png,https://derpicdn.net/img/view/2017/7/13/1485419.png,0,0.989721656,0,0,1465,1370,1465,1370,rarity
1485754.png,https://derpicdn.net/img/view/2017/7/14/1485754.png,0,0.96293962,974,99,1356,481,382,382,rarity
1496945.png,https://derpicdn.net/img/view/2017/7/28/1496945.png,0,0.998900592,230,47,1412,1229,1182,1182,rarity
1498423.png,https://derpicdn.net/img/view/2017/7/30/1498423.png,0,0.907645285,0,9,481,499,481,490,rarity
1500416.png,https://derpicdn.net/img/view/2017/8/1/1500416.png,0,0.956554353,0,44,3350,3740,3350,3696,rarity
1502131.png,https://derpicdn.net/img/view/2017/8/3/1502131.png,0,0.991337359,305,461,509,665,204,204,rarity
1504658.png,https://derpicdn.net/img/view/2017/8/6/1504658.png,0,0.979071617,274,42,902,670,628,628,rarity
1504661.png,https://derpicdn.net/img/view/2017/8/6/1504661.png,0,0.974934697,264,30,912,678,648,648,rarity
1508063.png,https://derpicdn.net/img/view/2017/8/11/1508063.png,0,0.994933486,41,236,375,570,334,334,rarity
1508063.png,https://derpicdn.net/img/view/2017/8/11/1508063.png,1,0.975610733,717,93,997,373,280,280,rarity
1509100.png,https://derpicdn.net/img/view/2017/8/12/1509100.png,0,0.949267685,68,0,672,536,604,536,rarity
1510446.png,https://derpicdn.net/img/view/2017/8/14/1510446.png,0,0.961119115,57,0,1491,1080,1434,1080,rarity
1513.jpg,https://derpicdn.net/img/view/2012/1/22/1513.jpg,0,0.96497792,344,23,754,433,410,410,rarity
1514757.png,https://derpicdn.net/img/view/2017/8/19/1514757.png,0,0.986180484,6,0,450,405,444,405,rarity
1515.jpg,https://derpicdn.net/img/view/2012/1/22/1515.jpg,0,0.92471683,123,224,529,630,406,406,rarity
1519594.png,https://derpicdn.net/img/view/2017/8/25/1519594.png,0,0.971428275,791,54,1811,1074,1020,1020,rarity
1520021.png,https://derpicdn.net/img/view/2017/8/26/1520021.png,0,0.990640998,115,0,621,485,506,485,rarity
1520103.png,https://derpicdn.net/img/view/2017/8/26/1520103.png,0,0.953193903,115,0,743,607,628,607,rarity
1520645.png,https://derpicdn.net/img/view/2017/8/27/1520645.png,0,0.990386605,0,0,844,856,844,856,rarity
1520856.png,https://derpicdn.net/img/view/2017/8/27/1520856.png,0,0.9914217,361,215,895,749,534,534,rarity
1521061.png,https://derpicdn.net/img/view/2017/8/27/1521061.png,0,0.945663214,378,107,964,693,586,586,rarity
1525028.png,https://derpicdn.net/img/view/2017/9/1/1525028.png,0,0.973804295,278,0,1220,918,942,918,rarity
1528175.png,https://derpicdn.net/img/view/2017/9/5/1528175.png,0,0.976719797,126,12,438,324,312,312,rarity
1530946.png,https://derpicdn.net/img/view/2017/9/8/1530946.png,0,0.948456168,238,2827,3330,5836,3092,3009,rarity
1531056.png,https://derpicdn.net/img/view/2017/9/8/1531056.png,0,0.984452069,308,35,656,383,348,348,rarity
1531999.png,https://derpicdn.net/img/view/2017/9/10/1531999.png,0,0.989631057,232,139,674,581,442,442,rarity
1532387.png,https://derpicdn.net/img/view/2017/9/10/1532387.png,0,0.999501467,172,69,660,557,488,488,rarity
1533875.png,https://derpicdn.net/img/view/2017/9/12/1533875.png,0,0.959286869,46,0,900,722,854,722,rarity
1536772.png,https://derpicdn.net/img/view/2017/9/16/1536772.png,0,0.92334193,123,0,1845,1080,1722,1080,rarity
1536830.png,https://derpicdn.net/img/view/2017/9/16/1536830.png,0,0.989835739,0,0,769,856,769,856,rarity
1536852.png,https://derpicdn.net/img/view/2017/9/16/1536852.png,0,0.995596468,90,17,774,701,684,684,rarity
1536973.png,https://derpicdn.net/img/view/2017/9/16/1536973.png,0,0.960523844,0,1,359,377,359,376,rarity
1536973.png,https://derpicdn.net/img/view/2017/9/16/1536973.png,0,0.960523844,0,1,359,377,359,376,rarity
1537238.png,https://derpicdn.net/img/view/2017/9/17/1537238.png,0,0.985397756,0,46,382,416,382,370,rarity
1537308.png,https://derpicdn.net/img/view/2017/9/17/1537308.png,0,0.950095475,33,840,993,1800,960,960,rarity
1537459.png,https://derpicdn.net/img/view/2017/9/17/1537459.png,0,0.984454513,0,4,386,438,386,434,rarity
1537524.png,https://derpicdn.net/img/view/2017/9/17/1537524.png,0,0.98242557,103,0,789,658,686,658,rarity
1537526.png,https://derpicdn.net/img/view/2017/9/17/1537526.png,0,0.984976828,104,0,804,697,700,697,rarity
1537614.png,https://derpicdn.net/img/view/2017/9/17/1537614.png,0,0.995411813,169,59,1797,1687,1628,1628,rarity
1537614.png,https://derpicdn.net/img/view/2017/9/17/1537614.png,0,0.995411813,169,59,1797,1687,1628,1628,rarity
1537743.png,https://derpicdn.net/img/view/2017/9/17/1537743.png,0,0.995714128,211,51,1353,1193,1142,1142,rarity
1537769.png,https://derpicdn.net/img/view/2017/9/17/1537769.png,0,0.936667144,217,7,900,709,683,702,rarity
1537885.png,https://derpicdn.net/img/view/2017/9/17/1537885.png,0,0.993261874,1075,0,2695,1401,1620,1401,rarity
1537938.png,https://derpicdn.net/img/view/2017/9/17/1537938.png,0,0.980720758,0,0,947,1043,947,1043,rarity
1537946.png,https://derpicdn.net/img/view/2017/9/17/1537946.png,0,0.989498675,279,0,1080,816,801,816,rarity
1537946.png,https://derpicdn.net/img/view/2017/9/17/1537946.png,0,0.989498675,279,0,1080,816,801,816,rarity
1538758.png,https://derpicdn.net/img/view/2017/9/18/1538758.png,0,0.963742256,110,64,1712,1666,1602,1602,rarity
1538844.png,https://derpicdn.net/img/view/2017/9/18/1538844.png,0,0.909514904,24,52,952,980,928,928,rarity
1538953.png,https://derpicdn.net/img/view/2017/9/18/1538953.png,0,0.939639091,427,0,3177,2626,2750,2626,rarity
1539147.png,https://derpicdn.net/img/view/2017/9/19/1539147.png,0,0.961005509,0,0,901,929,901,929,rarity
1540247.png,https://derpicdn.net/img/view/2017/9/20/1540247.png,0,0.982769132,0,0,1251,1230,1251,1230,rarity
1540302.png,https://derpicdn.net/img/view/2017/9/20/1540302.png,0,0.976676226,123,181,1811,1869,1688,1688,rarity
1540824.png,https://derpicdn.net/img/view/2017/9/21/1540824.png,0,0.982083619,0,158,3797,4486,3797,4328,rarity
1540889.png,https://derpicdn.net/img/view/2017/9/21/1540889.png,0,0.986086726,704,21,1184,501,480,480,rarity
1541222.png,https://derpicdn.net/img/view/2017/9/21/1541222.png,0,0.986599624,138,59,2054,1975,1916,1916,rarity
1541565.png,https://derpicdn.net/img/view/2017/9/22/1541565.png,0,0.991124749,182,0,2553,2401,2371,2401,rarity
15422.png,https://derpicdn.net/img/view/2012/6/22/15422.png,0,0.993249714,727,23,1491,787,764,764,rarity
1542470.png,https://derpicdn.net/img/view/2017/9/23/1542470.png,0,0.980896175,39,0,589,533,550,533,rarity
1542485.png,https://derpicdn.net/img/view/2017/9/23/1542485.png,0,0.966390014,21,0,1521,1401,1500,1401,rarity
1542872.png,https://derpicdn.net/img/view/2017/9/23/1542872.png,0,0.980163097,809,432,1247,870,438,438,rarity
1543908.png,https://derpicdn.net/img/view/2017/9/24/1543908.png,0,0.961052775,0,223,2727,3091,2727,2868,rarity
1545459.png,https://derpicdn.net/img/view/2017/9/26/1545459.png,0,0.940638006,48,0,754,699,706,699,rarity
1545577.png,https://derpicdn.net/img/view/2017/9/26/1545577.png,0,0.985814273,243,0,2795,2340,2552,2340,rarity
1546809.png,https://derpicdn.net/img/view/2017/9/28/1546809.png,0,0.983618915,47,17,835,805,788,788,rarity
1547069.png,https://derpicdn.net/img/view/2017/9/28/1547069.png,0,0.911674559,359,0,1131,744,772,744,rarity
1547083.png,https://derpicdn.net/img/view/2017/9/28/1547083.png,0,0.976816297,739,389,3197,2847,2458,2458,rarity
1547737.png,https://derpicdn.net/img/view/2017/9/29/1547737.png,0,0.9094823,161,9,1259,1107,1098,1098,rarity
1552121.png,https://derpicdn.net/img/view/2017/10/4/1552121.png,0,0.9921453,81,0,2799,2662,2718,2662,rarity
1556565.png,https://derpicdn.net/img/view/2017/10/9/1556565.png,0,0.971555531,98,0,1226,1095,1128,1095,rarity
1557473.png,https://derpicdn.net/img/view/2017/10/10/1557473.png,0,0.946481407,2708,0,5066,2358,2358,2358,rarity
1558225.png,https://derpicdn.net/img/view/2017/10/11/1558225.png,0,0.972810566,29,297,3000,3293,2971,2996,rarity
1558225.png,https://derpicdn.net/img/view/2017/10/11/1558225.png,0,0.972810566,29,297,3000,3293,2971,2996,rarity
1558376.png,https://derpicdn.net/img/view/2017/10/11/1558376.png,0,0.998064101,842,60,1924,1142,1082,1082,rarity
1559966.png,https://derpicdn.net/img/view/2017/10/13/1559966.png,0,0.987134874,1586,634,2230,1278,644,644,rarity
1559966.png,https://derpicdn.net/img/view/2017/10/13/1559966.png,1,0.98085916,850,149,1600,899,750,750,rarity
1559966.png,https://derpicdn.net/img/view/2017/10/13/1559966.png,0,0.987134874,1586,634,2230,1278,644,644,rarity
1559966.png,https://derpicdn.net/img/view/2017/10/13/1559966.png,1,0.98085916,850,149,1600,899,750,750,rarity
1575793.png,https://derpicdn.net/img/view/2017/11/1/1575793.png,0,0.99503994,938,86,1522,670,584,584,rarity
1580036.png,https://derpicdn.net/img/view/2017/11/6/1580036.png,0,0.970267057,401,82,1013,694,612,612,rarity
1580036.png,https://derpicdn.net/img/view/2017/11/6/1580036.png,0,0.970267057,401,82,1013,694,612,612,rarity
1580164.png,https://derpicdn.net/img/view/2017/11/7/1580164.png,0,0.97275126,124,0,1776,1628,1652,1628,rarity
1580676.png,https://derpicdn.net/img/view/2017/11/7/1580676.png,0,0.985072434,387,31,919,563,532,532,rarity
1590733.png,https://derpicdn.net/img/view/2017/11/20/1590733.png,0,0.998772442,989,0,2243,1158,1254,1158,rarity
1590733.png,https://derpicdn.net/img/view/2017/11/20/1590733.png,0,0.998772442,989,0,2243,1158,1254,1158,rarity
1592879.png,https://derpicdn.net/img/view/2017/11/23/1592879.png,0,0.942655027,302,0,1890,1561,1588,1561,rarity
1593432.png,https://derpicdn.net/img/view/2017/11/24/1593432.png,0,0.986733377,800,0,1740,777,940,777,rarity
159415.png,https://derpicdn.net/img/view/2012/11/22/159415.png,0,0.994743407,393,13,1063,683,670,670,rarity
1595014.png,https://derpicdn.net/img/view/2017/11/26/1595014.png,0,0.917083502,177,0,793,614,616,614,rarity
1604109.png,https://derpicdn.net/img/view/2017/12/9/1604109.png,0,0.979035676,73,0,729,639,656,639,rarity
1604270.png,https://derpicdn.net/img/view/2017/12/10/1604270.png,0,0.918209255,76,41,1028,993,952,952,rarity
1606509.png,https://derpicdn.net/img/view/2017/12/13/1606509.png,0,0.991553664,446,0,920,423,474,423,rarity
1606607.png,https://derpicdn.net/img/view/2017/12/13/1606607.png,0,0.995470583,285,123,829,667,544,544,rarity
1608246.png,https://derpicdn.net/img/view/2017/12/15/1608246.png,0,0.968641579,0,0,633,614,633,614,rarity
1612813.png,https://derpicdn.net/img/view/2017/12/21/1612813.png,0,0.993744433,81,0,1351,1153,1270,1153,rarity
1613095.png,https://derpicdn.net/img/view/2017/12/22/1613095.png,0,0.998419762,161,253,547,639,386,386,rarity
1616286.png,https://derpicdn.net/img/view/2017/12/26/1616286.png,0,0.999411523,117,0,569,450,452,450,rarity
1616289.png,https://derpicdn.net/img/view/2017/12/26/1616289.png,0,0.984372497,154,49,634,529,480,480,rarity
1618517.png,https://derpicdn.net/img/view/2017/12/29/1618517.png,0,0.993832827,154,74,508,428,354,354,rarity
1618625.png,https://derpicdn.net/img/view/2017/12/29/1618625.png,0,0.98678422,580,228,1108,756,528,528,rarity
1622230.png,https://derpicdn.net/img/view/2018/1/2/1622230.png,0,0.97202915,0,0,1015,1003,1015,1003,rarity
1627333.png,https://derpicdn.net/img/view/2018/1/8/1627333.png,0,0.91273576,1103,89,1819,805,716,716,rarity
1629384.png,https://derpicdn.net/img/view/2018/1/11/1629384.png,0,0.999529481,1380,97,3244,1961,1864,1864,rarity
1630613.png,https://derpicdn.net/img/view/2018/1/12/1630613.png,0,0.989937484,106,0,836,653,730,653,rarity
1630613.png,https://derpicdn.net/img/view/2018/1/12/1630613.png,0,0.989937484,106,0,836,653,730,653,rarity
1635900.png,https://derpicdn.net/img/view/2018/1/19/1635900.png,0,0.989707589,172,0,588,411,416,411,rarity
1636330.png,https://derpicdn.net/img/view/2018/1/20/1636330.png,0,0.99314791,847,9,1449,611,602,602,rarity
1638960.png,https://derpicdn.net/img/view/2018/1/23/1638960.png,0,0.94904691,258,0,840,534,582,534,rarity
1638960.png,https://derpicdn.net/img/view/2018/1/23/1638960.png,0,0.94904691,258,0,840,534,582,534,rarity
1642964.png,https://derpicdn.net/img/view/2018/1/28/1642964.png,0,0.997544467,89,0,569,440,480,440,rarity
1643169.png,https://derpicdn.net/img/view/2018/1/28/1643169.png,0,0.929076314,136,0,1366,1177,1230,1177,rarity
1644305.png,https://derpicdn.net/img/view/2018/1/30/1644305.png,0,0.955512345,125,91,2957,2923,2832,2832,rarity
1645023.png,https://derpicdn.net/img/view/2018/1/31/1645023.png,0,0.99918437,1178,242,3190,2254,2012,2012,rarity
1655893.png,https://derpicdn.net/img/view/2018/2/14/1655893.png,0,0.996869028,509,215,739,445,230,230,rarity
1655893.png,https://derpicdn.net/img/view/2018/2/14/1655893.png,1,0.99410677,740,159,1018,437,278,278,rarity
1655893.png,https://derpicdn.net/img/view/2018/2/14/1655893.png,2,0.991770148,1119,115,1343,339,224,224,rarity
1661170.png,https://derpicdn.net/img/view/2018/2/20/1661170.png,0,0.986655772,0,78,489,570,489,492,rarity
1666508.png,https://derpicdn.net/img/view/2018/2/26/1666508.png,0,0.985902786,77,0,1024,938,947,938,rarity
1667503.png,https://derpicdn.net/img/view/2018/2/27/1667503.png,0,0.999435246,44,47,340,343,296,296,rarity
1673889.png,https://derpicdn.net/img/view/2018/3/7/1673889.png,0,0.972726703,327,0,741,408,414,408,rarity
1673929.png,https://derpicdn.net/img/view/2018/3/7/1673929.png,0,0.920324206,923,93,1965,1135,1042,1042,rarity
1676562.png,https://derpicdn.net/img/view/2018/3/10/1676562.png,0,0.955523252,345,366,1863,1884,1518,1518,rarity
1678453.png,https://derpicdn.net/img/view/2018/3/12/1678453.png,0,0.951439679,113,8,441,336,328,328,rarity
1679773.png,https://derpicdn.net/img/view/2018/3/14/1679773.png,0,0.988937199,638,45,1068,475,430,430,rarity
1681658.png,https://derpicdn.net/img/view/2018/3/16/1681658.png,0,0.977922082,23,53,425,455,402,402,rarity
1685699.png,https://derpicdn.net/img/view/2018/3/20/1685699.png,0,0.947087586,28,0,616,547,588,547,rarity
1686980.png,https://derpicdn.net/img/view/2018/3/21/1686980.png,0,0.983662963,335,11,733,409,398,398,rarity
1689098.png,https://derpicdn.net/img/view/2018/3/24/1689098.png,0,0.912262797,529,12,1085,568,556,556,rarity
1689373.png,https://derpicdn.net/img/view/2018/3/24/1689373.png,0,0.997540653,701,0,1823,1009,1122,1009,rarity
1699864.png,https://derpicdn.net/img/view/2018/4/5/1699864.png,0,0.991905689,414,12,732,330,318,318,rarity
1706212.png,https://derpicdn.net/img/view/2018/4/12/1706212.png,0,0.996219516,1537,106,4061,2630,2524,2524,rarity
1707310.png,https://derpicdn.net/img/view/2018/4/14/1707310.png,0,0.985616982,1687,0,3139,1432,1452,1432,rarity
1707310.png,https://derpicdn.net/img/view/2018/4/14/1707310.png,0,0.985616982,1687,0,3139,1432,1452,1432,rarity
1713538.png,https://derpicdn.net/img/view/2018/4/21/1713538.png,0,0.998501122,216,41,948,773,732,732,rarity
1716040.png,https://derpicdn.net/img/view/2018/4/24/1716040.png,0,0.927096546,547,39,947,439,400,400,rarity
1720742.png,https://derpicdn.net/img/view/2018/4/30/1720742.png,0,0.996547103,10,0,640,506,630,506,rarity
1721213.png,https://derpicdn.net/img/view/2018/4/30/1721213.png,0,0.987477243,0,119,3700,4243,3700,4124,rarity
1721406.png,https://derpicdn.net/img/view/2018/5/1/1721406.png,0,0.979257882,41,0,627,570,586,570,rarity
1722304.png,https://derpicdn.net/img/view/2018/5/2/1722304.png,0,0.992906809,398,12,1216,830,818,818,rarity
1723920.png,https://derpicdn.net/img/view/2018/5/4/1723920.png,0,0.993186116,883,80,1633,830,750,750,rarity
1728863.png,https://derpicdn.net/img/view/2018/5/10/1728863.png,0,0.923711836,308,0,1620,1214,1312,1214,rarity
1731613.png,https://derpicdn.net/img/view/2018/5/13/1731613.png,0,0.988843322,431,0,1981,1517,1550,1517,rarity
1735785.png,https://derpicdn.net/img/view/2018/5/18/1735785.png,0,0.996213436,0,0,962,1138,962,1138,rarity
1737413.png,https://derpicdn.net/img/view/2018/5/20/1737413.png,0,0.972448289,275,16,627,368,352,352,rarity
1737814.png,https://derpicdn.net/img/view/2018/5/21/1737814.png,0,0.994625688,361,0,2311,1885,1950,1885,rarity
1745787.png,https://derpicdn.net/img/view/2018/5/31/1745787.png,0,0.969815016,37,0,320,260,283,260,rarity
175095.png,https://derpicdn.net/img/view/2012/12/7/175095.png,0,0.987056077,627,174,997,544,370,370,rarity
1753924.png,https://derpicdn.net/img/view/2018/6/9/1753924.png,0,0.954839945,299,0,1919,1609,1620,1609,rarity
1754428.png,https://derpicdn.net/img/view/2018/6/10/1754428.png,0,0.9376055,912,22,1686,796,774,774,rarity
1754429.png,https://derpicdn.net/img/view/2018/6/10/1754429.png,0,0.973941565,827,0,1715,874,888,874,rarity
1755061.png,https://derpicdn.net/img/view/2018/6/11/1755061.png,0,0.991086543,22,0,510,414,488,414,rarity
1755658.png,https://derpicdn.net/img/view/2018/6/11/1755658.png,0,0.939834952,556,13,1112,569,556,556,rarity
1757873.png,https://derpicdn.net/img/view/2018/6/15/1757873.png,0,0.925509155,167,0,903,735,736,735,rarity
1758355.png,https://derpicdn.net/img/view/2018/6/15/1758355.png,0,0.998121321,215,70,671,526,456,456,rarity
1759063.png,https://derpicdn.net/img/view/2018/6/16/1759063.png,0,0.955833077,673,0,1357,643,684,643,rarity
1759686.png,https://derpicdn.net/img/view/2018/6/17/1759686.png,0,0.993611872,0,0,1178,1227,1178,1227,rarity
1759858.png,https://derpicdn.net/img/view/2018/6/17/1759858.png,0,0.998399079,972,0,1878,890,906,890,rarity
1762344.png,https://derpicdn.net/img/view/2018/6/20/1762344.png,0,0.916397333,0,0,308,322,308,322,rarity
1763176.png,https://derpicdn.net/img/view/2018/6/22/1763176.png,0,0.996872246,373,176,3181,2984,2808,2808,rarity
1765803.png,https://derpicdn.net/img/view/2018/6/25/1765803.png,0,0.996343076,231,96,717,582,486,486,rarity
1768187.png,https://derpicdn.net/img/view/2018/6/28/1768187.png,0,0.994160533,148,0,1528,1317,1380,1317,rarity
1768595.png,https://derpicdn.net/img/view/2018/6/29/1768595.png,0,0.934694529,68,107,1052,1091,984,984,rarity
1768595.png,https://derpicdn.net/img/view/2018/6/29/1768595.png,0,0.934694529,68,107,1052,1091,984,984,rarity
1772547.png,https://derpicdn.net/img/view/2018/7/4/1772547.png,0,0.921130896,522,384,1026,888,504,504,rarity
1773307.png,https://derpicdn.net/img/view/2018/7/5/1773307.png,0,0.986726761,240,0,1208,815,968,815,rarity
1776197.png,https://derpicdn.net/img/view/2018/7/8/1776197.png,0,0.979824424,2193,0,4059,1743,1866,1743,rarity
1776802.png,https://derpicdn.net/img/view/2018/7/9/1776802.png,0,0.994831979,1057,398,3943,3284,2886,2886,rarity
1780238.png,https://derpicdn.net/img/view/2018/7/13/1780238.png,0,0.991484821,1890,388,3228,1726,1338,1338,rarity
1780526.png,https://derpicdn.net/img/view/2018/7/14/1780526.png,0,0.994655252,320,12,1130,822,810,810,rarity
1784120.png,https://derpicdn.net/img/view/2018/7/18/1784120.png,0,0.930468857,52,0,1248,1115,1196,1115,rarity
1784120.png,https://derpicdn.net/img/view/2018/7/18/1784120.png,0,0.930468857,52,0,1248,1115,1196,1115,rarity
1788136.png,https://derpicdn.net/img/view/2018/7/24/1788136.png,0,0.981723547,56,0,1736,1581,1680,1581,rarity
1789281.png,https://derpicdn.net/img/view/2018/7/25/1789281.png,0,0.970615327,176,0,566,375,390,375,rarity
1789605.png,https://derpicdn.net/img/view/2018/7/25/1789605.png,0,0.948960245,478,106,848,476,370,370,rarity
1790739.png,https://derpicdn.net/img/view/2018/7/27/1790739.png,0,0.999135971,164,0,500,336,336,336,rarity
1795857.png,https://derpicdn.net/img/view/2018/8/2/1795857.png,0,0.996996403,335,0,1571,1210,1236,1210,rarity
1797744.png,https://derpicdn.net/img/view/2018/8/4/1797744.png,0,0.959183693,1581,4,2683,1106,1102,1102,rarity
1799377.png,https://derpicdn.net/img/view/2018/8/6/1799377.png,0,0.905164003,355,97,925,667,570,570,rarity
1802320.png,https://derpicdn.net/img/view/2018/8/9/1802320.png,0,0.931341588,1332,602,4029,3376,2697,2774,rarity
1802665.png,https://derpicdn.net/img/view/2018/8/9/1802665.png,0,0.924366593,1147,239,2823,1915,1676,1676,rarity
1803364.png,https://derpicdn.net/img/view/2018/8/10/1803364.png,0,0.974042714,0,0,1186,1238,1186,1238,rarity
1804.png,https://derpicdn.net/img/view/2012/1/23/1804.png,0,0.983374596,450,202,770,522,320,320,rarity
1804061.png,https://derpicdn.net/img/view/2018/8/11/1804061.png,0,0.955975056,794,244,1380,830,586,586,rarity
180530.jpg,https://derpicdn.net/img/view/2012/12/12/180530.jpg,0,0.928402781,1057,0,1955,880,898,880,rarity
1808739.png,https://derpicdn.net/img/view/2018/8/16/1808739.png,0,0.996224523,242,0,1104,851,862,851,rarity
1813526.png,https://derpicdn.net/img/view/2018/8/22/1813526.png,0,0.995297968,62,318,2130,2386,2068,2068,rarity
1814090.png,https://derpicdn.net/img/view/2018/8/23/1814090.png,0,0.995468259,180,0,962,764,782,764,rarity
1814092.png,https://derpicdn.net/img/view/2018/8/23/1814092.png,0,0.997544646,331,37,1233,939,902,902,rarity
1814269.png,https://derpicdn.net/img/view/2018/8/23/1814269.png,0,0.998142481,1,0,283,265,282,265,rarity
1816130.png,https://derpicdn.net/img/view/2018/8/25/1816130.png,0,0.996094227,212,0,1080,841,868,841,rarity
1828009.png,https://derpicdn.net/img/view/2018/9/8/1828009.png,0,0.984812915,935,0,2879,1713,1944,1713,rarity
1830217.png,https://derpicdn.net/img/view/2018/9/11/1830217.png,0,0.986200154,303,0,863,532,560,532,rarity
1831396.png,https://derpicdn.net/img/view/2018/9/13/1831396.png,0,0.989582002,329,470,1135,1276,806,806,rarity
1831396.png,https://derpicdn.net/img/view/2018/9/13/1831396.png,1,0.905446529,1710,1170,2550,2148,840,978,rarity
1833108.png,https://derpicdn.net/img/view/2018/9/15/1833108.png,0,0.996801317,409,24,991,606,582,582,rarity
1835022.png,https://derpicdn.net/img/view/2018/9/17/1835022.png,0,0.990520418,62,0,858,753,796,753,rarity
1836380.png,https://derpicdn.net/img/view/2018/9/19/1836380.png,0,0.992429435,2895,19,5195,2319,2300,2300,rarity
1842.png,https://derpicdn.net/img/view/2012/1/23/1842.png,0,0.97178638,327,8,825,506,498,498,rarity
1842326.png,https://derpicdn.net/img/view/2018/9/27/1842326.png,0,0.961925268,318,0,732,414,414,414,rarity
1843023.png,https://derpicdn.net/img/view/2018/9/28/1843023.png,0,0.932789445,1241,0,2707,1387,1466,1387,rarity
1846431.png,https://derpicdn.net/img/view/2018/10/2/1846431.png,0,0.985056937,278,0,852,570,574,570,rarity
1847181.png,https://derpicdn.net/img/view/2018/10/3/1847181.png,0,0.968402743,21,36,471,486,450,450,rarity
1848291.png,https://derpicdn.net/img/view/2018/10/5/1848291.png,0,0.957225204,370,41,998,669,628,628,rarity
1848934.png,https://derpicdn.net/img/view/2018/10/5/1848934.png,0,0.994778693,54,0,862,777,808,777,rarity
1849822.png,https://derpicdn.net/img/view/2018/10/6/1849822.png,0,0.947008669,410,0,1650,1330,1240,1330,rarity
1850207.png,https://derpicdn.net/img/view/2018/10/7/1850207.png,0,0.998349428,823,353,1251,781,428,428,rarity
1852389.png,https://derpicdn.net/img/view/2018/10/9/1852389.png,0,0.981565177,214,0,1000,816,786,816,rarity
1855791.png,https://derpicdn.net/img/view/2018/10/13/1855791.png,0,0.937255204,674,188,1290,804,616,616,rarity
1855943.png,https://derpicdn.net/img/view/2018/10/14/1855943.png,0,0.992060363,0,0,1481,1523,1481,1523,rarity
1857454.png,https://derpicdn.net/img/view/2018/10/15/1857454.png,0,0.926303864,200,15,1020,835,820,820,rarity
1858053.png,https://derpicdn.net/img/view/2018/10/16/1858053.png,0,0.963794112,124,0,1220,927,1096,927,rarity
1858607.png,https://derpicdn.net/img/view/2018/10/17/1858607.png,0,0.949151218,215,92,897,774,682,682,rarity
1862463.png,https://derpicdn.net/img/view/2018/10/21/1862463.png,0,0.97909826,177,33,1585,1441,1408,1408,rarity
1865569.png,https://derpicdn.net/img/view/2018/10/25/1865569.png,0,0.955246508,523,97,2329,1903,1806,1806,rarity
1865569.png,https://derpicdn.net/img/view/2018/10/25/1865569.png,0,0.955246508,523,97,2329,1903,1806,1806,rarity
1868067.png,https://derpicdn.net/img/view/2018/10/28/1868067.png,0,0.926649988,464,261,1074,871,610,610,rarity
1868561.png,https://derpicdn.net/img/view/2018/10/28/1868561.png,0,0.972159743,380,269,932,821,552,552,rarity
1870978.png,https://derpicdn.net/img/view/2018/10/31/1870978.png,0,0.926166415,1835,0,4500,2579,2665,2579,rarity
1871408.png,https://derpicdn.net/img/view/2018/10/31/1871408.png,0,0.955078244,0,0,1762,1440,1762,1440,rarity
1873545.png,https://derpicdn.net/img/view/2018/11/2/1873545.png,0,0.987442732,1077,359,1651,933,574,574,rarity
1875076.png,https://derpicdn.net/img/view/2018/11/4/1875076.png,0,0.957169831,95,16,355,276,260,260,rarity
1877852.png,https://derpicdn.net/img/view/2018/11/8/1877852.png,0,0.988346338,369,0,1275,823,906,823,rarity
1883080.png,https://derpicdn.net/img/view/2018/11/15/1883080.png,0,0.949475408,101,30,1251,1180,1150,1150,rarity
1884013.png,https://derpicdn.net/img/view/2018/11/17/1884013.png,0,0.998308122,329,98,799,568,470,470,rarity
1888919.png,https://derpicdn.net/img/view/2018/11/23/1888919.png,0,0.997859657,509,178,2847,2516,2338,2338,rarity
1889523.png,https://derpicdn.net/img/view/2018/11/24/1889523.png,0,0.930660665,243,0,3871,3505,3628,3505,rarity
1890366.png,https://derpicdn.net/img/view/2018/11/25/1890366.png,0,0.989123881,237,311,845,919,608,608,rarity
1893196.png,https://derpicdn.net/img/view/2018/11/28/1893196.png,0,0.975412071,69,128,461,520,392,392,rarity
1897528.png,https://derpicdn.net/img/view/2018/12/4/1897528.png,0,0.998841286,358,0,690,324,332,324,rarity
1900076.png,https://derpicdn.net/img/view/2018/12/6/1900076.png,0,0.995442033,534,30,3294,2790,2760,2760,rarity
1900197.png,https://derpicdn.net/img/view/2018/12/6/1900197.png,0,0.998842418,130,141,764,775,634,634,rarity
1901054.png,https://derpicdn.net/img/view/2018/12/7/1901054.png,0,0.950252295,112,44,1024,956,912,912,rarity
1902959.png,https://derpicdn.net/img/view/2018/12/8/1902959.png,0,0.970342577,408,0,1026,613,618,613,rarity
1906796.png,https://derpicdn.net/img/view/2018/12/13/1906796.png,0,0.9850986,789,42,1339,592,550,550,rarity
1910467.png,https://derpicdn.net/img/view/2018/12/16/1910467.png,0,0.940389991,379,0,2715,2322,2336,2322,rarity
1911218.png,https://derpicdn.net/img/view/2018/12/17/1911218.png,0,0.907856941,735,59,1759,1083,1024,1024,rarity
1917826.png,https://derpicdn.net/img/view/2018/12/24/1917826.png,0,0.996122897,938,0,2970,2005,2032,2005,rarity
1921766.png,https://derpicdn.net/img/view/2018/12/29/1921766.png,0,0.926241159,260,21,880,641,620,620,rarity
1925446.png,https://derpicdn.net/img/view/2019/1/3/1925446.png,0,0.994711876,0,0,1387,1374,1387,1374,rarity
1926082.png,https://derpicdn.net/img/view/2019/1/4/1926082.png,0,0.982660592,0,0,826,873,826,873,rarity
1928345.png,https://derpicdn.net/img/view/2019/1/6/1928345.png,0,0.998291612,369,116,1981,1728,1612,1612,rarity
1928430.png,https://derpicdn.net/img/view/2019/1/6/1928430.png,0,0.978550911,383,105,1271,993,888,888,rarity
193064.png,https://derpicdn.net/img/view/2012/12/25/193064.png,0,0.989305437,117,102,703,688,586,586,rarity
1931755.png,https://derpicdn.net/img/view/2019/1/10/1931755.png,0,0.922242522,1946,0,4146,2099,2200,2099,rarity
1931755.png,https://derpicdn.net/img/view/2019/1/10/1931755.png,0,0.922242522,1946,0,4146,2099,2200,2099,rarity
1933334.png,https://derpicdn.net/img/view/2019/1/12/1933334.png,0,0.997980475,306,48,720,462,414,414,rarity
1939406.png,https://derpicdn.net/img/view/2019/1/19/1939406.png,0,0.99747467,514,0,1866,1348,1352,1348,rarity
1946757.png,https://derpicdn.net/img/view/2019/1/28/1946757.png,0,0.978540957,746,36,1216,506,470,470,rarity
1950178.png,https://derpicdn.net/img/view/2019/2/1/1950178.png,0,0.931616008,577,0,4309,3673,3732,3673,rarity
1951770.png,https://derpicdn.net/img/view/2019/2/3/1951770.png,0,0.995572925,187,13,521,347,334,334,rarity
1952183.png,https://derpicdn.net/img/view/2019/2/3/1952183.png,0,0.98766315,595,358,1467,1230,872,872,rarity
1956045.png,https://derpicdn.net/img/view/2019/2/7/1956045.png,0,0.993120015,350,0,1446,1060,1096,1060,rarity
1960398.png,https://derpicdn.net/img/view/2019/2/12/1960398.png,0,0.987557948,281,0,763,411,482,411,rarity
1961998.png,https://derpicdn.net/img/view/2019/2/14/1961998.png,0,0.986620426,187,99,993,905,806,806,rarity
1963091.png,https://derpicdn.net/img/view/2019/2/15/1963091.png,0,0.955362022,14,0,458,442,444,442,rarity
1963091.png,https://derpicdn.net/img/view/2019/2/15/1963091.png,0,0.955362022,14,0,458,442,444,442,rarity
1963245.png,https://derpicdn.net/img/view/2019/2/16/1963245.png,0,0.993558109,44,0,518,453,474,453,rarity
1963329.png,https://derpicdn.net/img/view/2019/2/16/1963329.png,0,0.998254716,448,18,1086,656,638,638,rarity
1967047.png,https://derpicdn.net/img/view/2019/2/20/1967047.png,0,0.998154998,607,0,1339,696,732,696,rarity
1972917.png,https://derpicdn.net/img/view/2019/2/27/1972917.png,0,0.984026551,639,0,2000,1170,1361,1170,rarity
1973016.png,https://derpicdn.net/img/view/2019/2/27/1973016.png,0,0.997005761,170,6,492,328,322,322,rarity
1973016.png,https://derpicdn.net/img/view/2019/2/27/1973016.png,0,0.997005761,170,6,492,328,322,322,rarity
1979154.png,https://derpicdn.net/img/view/2019/3/7/1979154.png,0,0.949924946,466,0,1252,713,786,713,rarity
1989050.png,https://derpicdn.net/img/view/2019/3/18/1989050.png,0,0.998253167,1891,853,4277,3239,2386,2386,rarity
1989117.png,https://derpicdn.net/img/view/2019/3/18/1989117.png,0,0.995499611,0,44,576,680,576,636,rarity
1992210.png,https://derpicdn.net/img/view/2019/3/22/1992210.png,0,0.990897,59,0,2869,2920,2810,2920,rarity
1993911.png,https://derpicdn.net/img/view/2019/3/24/1993911.png,0,0.967875838,139,215,1889,2035,1750,1820,rarity
1999020.png,https://derpicdn.net/img/view/2019/3/31/1999020.png,0,0.990579307,93,0,615,506,522,506,rarity
2002452.png,https://derpicdn.net/img/view/2019/4/4/2002452.png,0,0.964950204,894,23,1224,353,330,330,rarity
2002452.png,https://derpicdn.net/img/view/2019/4/4/2002452.png,0,0.964950204,894,23,1224,353,330,330,rarity
2005147.png,https://derpicdn.net/img/view/2019/4/7/2005147.png,0,0.946846426,0,34,4258,4384,4258,4350,rarity
2009035.png,https://derpicdn.net/img/view/2019/4/11/2009035.png,0,0.960273325,587,0,2343,1659,1756,1659,rarity
2018319.png,https://derpicdn.net/img/view/2019/4/20/2018319.png,0,0.99468267,877,702,3937,3762,3060,3060,rarity
2031811.png,https://derpicdn.net/img/view/2019/5/5/2031811.png,0,0.994983077,493,28,1679,1214,1186,1186,rarity
2032589.png,https://derpicdn.net/img/view/2019/5/6/2032589.png,0,0.958141148,139,25,1403,1200,1264,1175,rarity
2032589.png,https://derpicdn.net/img/view/2019/5/6/2032589.png,0,0.958141148,139,25,1403,1200,1264,1175,rarity
2032847.png,https://derpicdn.net/img/view/2019/5/6/2032847.png,0,0.953888476,1067,272,1369,574,302,302,rarity
2033245.png,https://derpicdn.net/img/view/2019/5/7/2033245.png,0,0.998359025,614,31,1222,639,608,608,rarity
2033645.png,https://derpicdn.net/img/view/2019/5/8/2033645.png,0,0.983119488,415,173,1965,1723,1550,1550,rarity
2035052.png,https://derpicdn.net/img/view/2019/5/9/2035052.png,0,0.993176877,0,0,1410,1352,1410,1352,rarity
2035185.png,https://derpicdn.net/img/view/2019/5/10/2035185.png,0,0.950390816,5198,40,5700,542,502,502,rarity
2035185.png,https://derpicdn.net/img/view/2019/5/10/2035185.png,1,0.937053144,1923,0,3011,841,1088,841,rarity
2038754.png,https://derpicdn.net/img/view/2019/5/14/2038754.png,0,0.941944063,182,184,1283,1444,1101,1260,rarity
2039724.png,https://derpicdn.net/img/view/2019/5/15/2039724.png,0,0.984200716,261,148,857,744,596,596,rarity
2044900.png,https://derpicdn.net/img/view/2019/5/21/2044900.png,0,0.952538729,163,228,2887,2952,2724,2724,rarity
2046469.png,https://derpicdn.net/img/view/2019/5/23/2046469.png,0,0.992149115,604,37,2330,1763,1726,1726,rarity
2052394.png,https://derpicdn.net/img/view/2019/5/29/2052394.png,0,0.978911996,0,0,289,288,289,288,rarity
2055674.png,https://derpicdn.net/img/view/2019/6/2/2055674.png,0,0.917022288,414,25,1188,799,774,774,rarity
2060983.png,https://derpicdn.net/img/view/2019/6/8/2060983.png,0,0.984323919,195,0,987,725,792,725,rarity
206481.jpg,https://derpicdn.net/img/view/2013/1/8/206481.jpg,0,0.976308644,102,0,440,301,338,301,rarity
207439.jpg,https://derpicdn.net/img/view/2013/1/9/207439.jpg,0,0.98608464,80,0,460,357,380,357,rarity
2075190.png,https://derpicdn.net/img/view/2019/6/25/2075190.png,0,0.987132847,0,115,900,1217,900,1102,rarity
2076392.png,https://derpicdn.net/img/view/2019/6/27/2076392.png,0,0.998849094,193,0,881,635,688,635,rarity
2082415.png,https://derpicdn.net/img/view/2019/7/4/2082415.png,0,0.998934567,507,222,1257,972,750,750,rarity
2101122.png,https://derpicdn.net/img/view/2019/7/25/2101122.png,0,0.993683815,103,0,1371,1181,1268,1181,rarity
2109610.png,https://derpicdn.net/img/view/2019/8/5/2109610.png,0,0.926548719,148,0,1002,805,854,805,rarity
2117918.png,https://derpicdn.net/img/view/2019/8/14/2117918.png,0,0.996395171,172,0,2024,1738,1852,1738,rarity
2119426.png,https://derpicdn.net/img/view/2019/8/16/2119426.png,0,0.917889178,245,147,555,457,310,310,rarity
2124976.png,https://derpicdn.net/img/view/2019/8/22/2124976.png,0,0.909182191,559,23,1149,613,590,590,rarity
21256.png,https://derpicdn.net/img/view/2012/6/26/21256.png,0,0.996011674,336,0,988,640,652,640,rarity
2132154.png,https://derpicdn.net/img/view/2019/8/31/2132154.png,0,0.925388634,1224,361,1652,789,428,428,rarity
2132154.png,https://derpicdn.net/img/view/2019/8/31/2132154.png,1,0.90905112,798,256,1178,636,380,380,rarity
2132556.png,https://derpicdn.net/img/view/2019/8/31/2132556.png,0,0.970655143,49,0,691,633,642,633,rarity
2134490.png,https://derpicdn.net/img/view/2019/9/2/2134490.png,0,0.996117413,1850,153,3770,2073,1920,1920,rarity
2137151.png,https://derpicdn.net/img/view/2019/9/5/2137151.png,0,0.99179703,193,251,2101,2159,1908,1908,rarity
2139463.png,https://derpicdn.net/img/view/2019/9/8/2139463.png,0,0.99473989,1622,0,2778,1053,1156,1053,rarity
2144587.png,https://derpicdn.net/img/view/2019/9/15/2144587.png,0,0.995595992,128,8,352,232,224,224,rarity
2147667.png,https://derpicdn.net/img/view/2019/9/19/2147667.png,0,0.9583112,11,11,585,585,574,574,rarity
2149023.png,https://derpicdn.net/img/view/2019/9/21/2149023.png,0,0.978209615,154,28,770,644,616,616,rarity
2150714.png,https://derpicdn.net/img/view/2019/9/22/2150714.png,0,0.900065839,25,0,623,525,598,525,rarity
2156812.png,https://derpicdn.net/img/view/2019/9/30/2156812.png,0,0.911947131,679,49,1301,671,622,622,rarity
2159254.png,https://derpicdn.net/img/view/2019/10/3/2159254.png,0,0.973998308,0,105,699,827,699,722,rarity
2159254.png,https://derpicdn.net/img/view/2019/10/3/2159254.png,0,0.973998308,0,105,699,827,699,722,rarity
2165739.png,https://derpicdn.net/img/view/2019/10/11/2165739.png,0,0.993824542,1786,0,3800,2072,2014,2072,rarity
2165739.png,https://derpicdn.net/img/view/2019/10/11/2165739.png,1,0.992361963,3172,3353,3770,3951,598,598,rarity
2165741.png,https://derpicdn.net/img/view/2019/10/11/2165741.png,0,0.995202363,2944,96,4514,1666,1570,1570,rarity
2166158.png,https://derpicdn.net/img/view/2019/10/12/2166158.png,0,0.999245763,1022,67,2062,1107,1040,1040,rarity
2166596.png,https://derpicdn.net/img/view/2019/10/12/2166596.png,0,0.99308002,548,10,1096,558,548,548,rarity
2173942.png,https://derpicdn.net/img/view/2019/10/19/2173942.png,0,0.900147617,515,238,1033,756,518,518,rarity
2181059.png,https://derpicdn.net/img/view/2019/10/28/2181059.png,0,0.979892135,417,4,1475,1062,1058,1058,rarity
2184031.png,https://derpicdn.net/img/view/2019/10/31/2184031.png,0,0.99604553,57,0,603,542,546,542,rarity
2189453.png,https://derpicdn.net/img/view/2019/11/7/2189453.png,0,0.996509016,201,87,645,531,444,444,rarity
2194379.png,https://derpicdn.net/img/view/2019/11/13/2194379.png,0,0.995222092,510,0,1378,852,868,852,rarity
2197548.png,https://derpicdn.net/img/view/2019/11/16/2197548.png,0,0.965225697,117,0,487,363,370,363,rarity
2199416.png,https://derpicdn.net/img/view/2019/11/18/2199416.png,0,0.977168739,1017,8,2289,1280,1272,1272,rarity
2203595.png,https://derpicdn.net/img/view/2019/11/23/2203595.png,0,0.957976997,727,58,1147,478,420,420,rarity
2209458.png,https://derpicdn.net/img/view/2019/11/30/2209458.png,0,0.962582171,0,0,663,664,663,664,rarity
2209657.png,https://derpicdn.net/img/view/2019/12/1/2209657.png,0,0.914880097,813,0,1897,1065,1084,1065,rarity
2229550.png,https://derpicdn.net/img/view/2019/12/25/2229550.png,0,0.998280942,412,11,1206,805,794,794,rarity
2229673.png,https://derpicdn.net/img/view/2019/12/25/2229673.png,0,0.9854846,800,218,1298,716,498,498,rarity
2231488.png,https://derpicdn.net/img/view/2019/12/27/2231488.png,0,0.951638699,133,0,943,743,810,743,rarity
2232160.jpg,https://derpicdn.net/img/view/2019/12/28/2232160.jpg,0,0.973721027,140,0,952,743,812,743,rarity
2233763.jpg,https://derpicdn.net/img/view/2019/12/30/2233763.jpg,0,0.983054996,0,0,1225,1199,1225,1199,rarity
2241418.jpg,https://derpicdn.net/img/view/2020/1/7/2241418.jpg,0,0.998370528,1668,62,2372,766,704,704,rarity
2241418.jpg,https://derpicdn.net/img/view/2020/1/7/2241418.jpg,1,0.993246496,624,28,1384,788,760,760,rarity
2242472.jpg,https://derpicdn.net/img/view/2020/1/9/2242472.jpg,0,0.976919711,538,0,1052,476,514,476,rarity
2244401.jpg,https://derpicdn.net/img/view/2020/1/11/2244401.jpg,0,0.982976973,71,0,669,587,598,587,rarity
2244652.png,https://derpicdn.net/img/view/2020/1/11/2244652.png,0,0.9975788,456,67,1110,721,654,654,rarity
2247132.jpg,https://derpicdn.net/img/view/2020/1/14/2247132.jpg,0,0.936338484,0,0,1564,1736,1564,1736,rarity
2247132.jpg,https://derpicdn.net/img/view/2020/1/14/2247132.jpg,1,0.905164361,427,0,1811,1506,1384,1506,rarity
2247969.png,https://derpicdn.net/img/view/2020/1/15/2247969.png,0,0.956396043,434,0,3388,2548,2954,2548,rarity
2250332.jpg,https://derpicdn.net/img/view/2020/1/18/2250332.jpg,0,0.992814243,693,0,1817,1097,1124,1097,rarity
2253742.jpg,https://derpicdn.net/img/view/2020/1/22/2253742.jpg,0,0.995148599,178,177,442,441,264,264,rarity
2253742.jpg,https://derpicdn.net/img/view/2020/1/22/2253742.jpg,1,0.993251324,659,438,959,738,300,300,rarity
2254148.jpg,https://derpicdn.net/img/view/2020/1/22/2254148.jpg,0,0.970072508,187,0,1411,1105,1224,1105,rarity
2255622.jpg,https://derpicdn.net/img/view/2020/1/24/2255622.jpg,0,0.974771619,0,13,853,901,853,888,rarity
2256328.png,https://derpicdn.net/img/view/2020/1/25/2256328.png,0,0.980397701,120,0,469,310,349,310,rarity
2256488.jpg,https://derpicdn.net/img/view/2020/1/25/2256488.jpg,0,0.982026994,423,0,1207,777,784,777,rarity
2261182.png,https://derpicdn.net/img/view/2020/1/30/2261182.png,0,0.983651221,141,0,796,717,655,717,rarity
2261182.png,https://derpicdn.net/img/view/2020/1/30/2261182.png,0,0.983651221,141,0,796,717,655,717,rarity
2261727.png,https://derpicdn.net/img/view/2020/1/31/2261727.png,0,0.990210712,6,0,482,452,476,452,rarity
2262592.jpg,https://derpicdn.net/img/view/2020/2/1/2262592.jpg,0,0.985122561,275,135,2339,2199,2064,2064,rarity
2265724.png,https://derpicdn.net/img/view/2020/2/4/2265724.png,0,0.952552259,0,109,2000,2559,2000,2450,rarity
2265788.jpg,https://derpicdn.net/img/view/2020/2/4/2265788.jpg,0,0.985395789,81,0,885,777,804,777,rarity
2267261.jpg,https://derpicdn.net/img/view/2020/2/6/2267261.jpg,0,0.997354567,604,932,1322,1650,718,718,rarity
2267261.jpg,https://derpicdn.net/img/view/2020/2/6/2267261.jpg,0,0.997354567,604,932,1322,1650,718,718,rarity
2268088.png,https://derpicdn.net/img/view/2020/2/7/2268088.png,0,0.991716743,662,154,1826,1318,1164,1164,rarity
2269125.jpg,https://derpicdn.net/img/view/2020/2/8/2269125.jpg,0,0.987389803,0,0,1524,1579,1524,1579,rarity
2270897.png,https://derpicdn.net/img/view/2020/2/10/2270897.png,0,0.915015638,283,0,2743,2250,2460,2250,rarity
2272349.png,https://derpicdn.net/img/view/2020/2/12/2272349.png,0,0.997021079,530,52,736,258,206,206,rarity
2273692.jpg,https://derpicdn.net/img/view/2020/2/14/2273692.jpg,0,0.994287074,70,0,650,513,580,513,rarity
2280047.jpg,https://derpicdn.net/img/view/2020/2/21/2280047.jpg,0,0.984613121,148,0,1050,950,902,950,rarity
2280047.jpg,https://derpicdn.net/img/view/2020/2/21/2280047.jpg,1,0.911761582,0,0,890,990,890,990,rarity
2281023.png,https://derpicdn.net/img/view/2020/2/22/2281023.png,0,0.985216141,436,64,1576,1204,1140,1140,rarity
228346.png,https://derpicdn.net/img/view/2013/1/30/228346.png,0,0.979130805,17,0,777,722,760,722,rarity
2286551.png,https://derpicdn.net/img/view/2020/2/29/2286551.png,0,0.999707758,44,8,836,800,792,792,rarity
2286560.jpg,https://derpicdn.net/img/view/2020/2/29/2286560.jpg,0,0.971725881,702,0,1821,1118,1119,1118,rarity
2286909.png,https://derpicdn.net/img/view/2020/3/1/2286909.png,0,0.990811884,145,0,813,658,668,658,rarity
2286909.png,https://derpicdn.net/img/view/2020/3/1/2286909.png,0,0.990811884,145,0,813,658,668,658,rarity
2291337.jpg,https://derpicdn.net/img/view/2020/3/6/2291337.jpg,0,0.93696028,93,25,345,277,252,252,rarity
2291557.png,https://derpicdn.net/img/view/2020/3/6/2291557.png,0,0.997670174,402,14,1040,652,638,638,rarity
2292712.jpg,https://derpicdn.net/img/view/2020/3/8/2292712.jpg,0,0.988247871,95,0,863,672,768,672,rarity
2295155.jpg,https://derpicdn.net/img/view/2020/3/11/2295155.jpg,0,0.993738353,731,787,1629,1685,898,898,rarity
2296237.jpg,https://derpicdn.net/img/view/2020/3/13/2296237.jpg,0,0.999267757,17,12,309,304,292,292,rarity
2300320.jpg,https://derpicdn.net/img/view/2020/3/18/2300320.jpg,0,0.999268353,2,0,246,210,244,210,rarity
2300320.jpg,https://derpicdn.net/img/view/2020/3/18/2300320.jpg,1,0.968688488,394,0,1232,809,838,809,rarity
2300959.png,https://derpicdn.net/img/view/2020/3/19/2300959.png,0,0.951614976,296,181,1126,1011,830,830,rarity
2302828.png,https://derpicdn.net/img/view/2020/3/21/2302828.png,0,0.966855049,1041,0,1553,482,512,482,rarity
2303881.png,https://derpicdn.net/img/view/2020/3/23/2303881.png,0,0.981336355,199,0,3657,3163,3458,3163,rarity
2305777.png,https://derpicdn.net/img/view/2020/3/25/2305777.png,0,0.969345212,283,6,555,278,272,272,rarity
2306739.jpg,https://derpicdn.net/img/view/2020/3/26/2306739.jpg,0,0.971387804,937,3,1937,1003,1000,1000,rarity
2308929.jpg,https://derpicdn.net/img/view/2020/3/29/2308929.jpg,0,0.998611867,39,47,487,495,448,448,rarity
231043.png,https://derpicdn.net/img/view/2013/2/2/231043.png,0,0.951758206,13,0,555,526,542,526,rarity
2311340.png,https://derpicdn.net/img/view/2020/4/1/2311340.png,0,0.977205276,337,0,1069,725,732,725,rarity
2311340.png,https://derpicdn.net/img/view/2020/4/1/2311340.png,0,0.977205276,337,0,1069,725,732,725,rarity
2312374.png,https://derpicdn.net/img/view/2020/4/2/2312374.png,0,0.998190165,177,55,559,437,382,382,rarity
2316019.png,https://derpicdn.net/img/view/2020/4/7/2316019.png,0,0.991640151,573,252,1655,1334,1082,1082,rarity
2316078.png,https://derpicdn.net/img/view/2020/4/7/2316078.png,0,0.998118997,260,135,1998,1873,1738,1738,rarity
2316684.jpg,https://derpicdn.net/img/view/2020/4/7/2316684.jpg,0,0.948847294,0,1,689,795,689,794,rarity
2318564.png,https://derpicdn.net/img/view/2020/4/10/2318564.png,0,0.96368444,582,61,1308,787,726,726,rarity
2319373.jpg,https://derpicdn.net/img/view/2020/4/11/2319373.jpg,0,0.949516833,5,29,701,725,696,696,rarity
2320196.jpg,https://derpicdn.net/img/view/2020/4/12/2320196.jpg,0,0.978663385,0,12,683,818,683,806,rarity
2324126.jpg,https://derpicdn.net/img/view/2020/4/16/2324126.jpg,0,0.945315361,85,28,767,710,682,682,rarity
2326787.jpg,https://derpicdn.net/img/view/2020/4/20/2326787.jpg,0,0.998383939,0,0,1049,1014,1049,1014,rarity
2331794.png,https://derpicdn.net/img/view/2020/4/26/2331794.png,0,0.973771214,67,0,849,775,782,775,rarity
2333409.jpg,https://derpicdn.net/img/view/2020/4/27/2333409.jpg,0,0.993552208,592,90,1194,692,602,602,rarity
2335700.png,https://derpicdn.net/img/view/2020/4/30/2335700.png,0,0.974401951,252,0,714,435,462,435,rarity
2335700.png,https://derpicdn.net/img/view/2020/4/30/2335700.png,0,0.974401951,252,0,714,435,462,435,rarity
2338007.png,https://derpicdn.net/img/view/2020/5/3/2338007.png,0,0.980495632,0,77,396,482,396,405,rarity
2340295.jpg,https://derpicdn.net/img/view/2020/5/5/2340295.jpg,0,0.967399895,432,204,1032,804,600,600,rarity
2341035.png,https://derpicdn.net/img/view/2020/5/6/2341035.png,0,0.947137654,147,227,1975,2055,1828,1828,rarity
2341319.png,https://derpicdn.net/img/view/2020/5/6/2341319.png,0,0.99701941,502,0,1736,1219,1234,1219,rarity
2341510.jpg,https://derpicdn.net/img/view/2020/5/7/2341510.jpg,0,0.987743735,0,0,1401,1385,1401,1385,rarity
2341803.jpg,https://derpicdn.net/img/view/2020/5/7/2341803.jpg,0,0.995604038,483,0,1751,1234,1268,1234,rarity
2345778.png,https://derpicdn.net/img/view/2020/5/11/2345778.png,1,0.960864723,214,468,452,706,238,238,rarity
2346682.jpg,https://derpicdn.net/img/view/2020/5/12/2346682.jpg,0,0.962596536,227,81,1867,1721,1640,1640,rarity
2348647.jpg,https://derpicdn.net/img/view/2020/5/14/2348647.jpg,0,0.997144461,1422,213,2468,1259,1046,1046,rarity
237857.png,https://derpicdn.net/img/view/2013/2/9/237857.png,0,0.95628643,114,0,852,671,738,671,rarity
237858.png,https://derpicdn.net/img/view/2013/2/9/237858.png,0,0.982750475,99,0,547,448,448,448,rarity
237858.png,https://derpicdn.net/img/view/2013/2/9/237858.png,0,0.982750475,99,0,547,448,448,448,rarity
237908.png,https://derpicdn.net/img/view/2013/2/9/237908.png,0,0.981566906,35,0,467,413,432,413,rarity
239091.png,https://derpicdn.net/img/view/2013/2/10/239091.png,0,0.97538805,494,105,836,447,342,342,rarity
25504.jpg,https://derpicdn.net/img/view/2012/6/29/25504.jpg,0,0.995529413,16,1,130,115,114,114,rarity
25504.jpg,https://derpicdn.net/img/view/2012/6/29/25504.jpg,1,0.994825304,393,0,555,138,162,138,rarity
25504.jpg,https://derpicdn.net/img/view/2012/6/29/25504.jpg,2,0.985498667,193,0,355,137,162,137,rarity
269056.png,https://derpicdn.net/img/view/2013/3/12/269056.png,0,0.920302451,581,7,1775,1201,1194,1194,rarity
274395.png,https://derpicdn.net/img/view/2013/3/19/274395.png,0,0.998635709,239,35,603,399,364,364,rarity
278497.png,https://derpicdn.net/img/view/2013/3/24/278497.png,0,0.949616551,447,29,711,293,264,264,rarity
278497.png,https://derpicdn.net/img/view/2013/3/24/278497.png,0,0.949616551,447,29,711,293,264,264,rarity
279993.png,https://derpicdn.net/img/view/2013/3/26/279993.png,0,0.995778263,149,0,589,428,440,428,rarity
279993.png,https://derpicdn.net/img/view/2013/3/26/279993.png,0,0.995778263,149,0,589,428,440,428,rarity
285852.png,https://derpicdn.net/img/view/2013/4/2/285852.png,0,0.907632768,74,0,496,375,422,375,rarity
286323.png,https://derpicdn.net/img/view/2013/4/2/286323.png,0,0.997159362,335,12,739,416,404,404,rarity
300056.png,https://derpicdn.net/img/view/2013/4/16/300056.png,0,0.999679983,2193,74,4195,2076,2002,2002,rarity
300057.png,https://derpicdn.net/img/view/2013/4/16/300057.png,0,0.999414742,2169,76,4219,2126,2050,2050,rarity
311345.png,https://derpicdn.net/img/view/2013/4/29/311345.png,0,0.992055297,228,14,636,422,408,408,rarity
325939.jpg,https://derpicdn.net/img/view/2013/5/15/325939.jpg,0,0.99266696,62,0,394,284,332,284,rarity
341908.jpg,https://derpicdn.net/img/view/2013/6/6/341908.jpg,0,0.978538513,192,7,550,365,358,358,rarity
345312.jpg,https://derpicdn.net/img/view/2013/6/10/345312.jpg,0,0.975997388,93,11,295,213,202,202,rarity
345953.png,https://derpicdn.net/img/view/2013/6/11/345953.png,0,0.999706328,569,4,1023,458,454,454,rarity
347.png,https://derpicdn.net/img/view/2012/1/15/347.png,0,0.974624813,447,0,1401,894,954,894,rarity
351836.png,https://derpicdn.net/img/view/2013/6/18/351836.png,0,0.948308229,229,13,497,281,268,268,rarity
351837.png,https://derpicdn.net/img/view/2013/6/18/351837.png,0,0.998732567,318,7,622,311,304,304,rarity
355916.jpg,https://derpicdn.net/img/view/2013/6/24/355916.jpg,0,0.99688369,492,135,698,341,206,206,rarity
355916.jpg,https://derpicdn.net/img/view/2013/6/24/355916.jpg,1,0.974900544,201,409,393,601,192,192,rarity
359852.png,https://derpicdn.net/img/view/2013/6/29/359852.png,0,0.956258059,458,0,1164,678,706,678,rarity
360382.png,https://derpicdn.net/img/view/2013/6/30/360382.png,0,0.998926342,620,66,1022,468,402,402,rarity
360382.png,https://derpicdn.net/img/view/2013/6/30/360382.png,1,0.974534929,52,0,598,496,546,496,rarity
361464.png,https://derpicdn.net/img/view/2013/7/1/361464.png,0,0.996965647,1512,124,2358,970,846,846,rarity
370611.png,https://derpicdn.net/img/view/2013/7/11/370611.png,0,0.982630432,250,3,690,443,440,440,rarity
371053.png,https://derpicdn.net/img/view/2013/7/12/371053.png,0,0.991374552,359,0,889,523,530,523,rarity
381273.png,https://derpicdn.net/img/view/2013/7/22/381273.png,0,0.913839757,249,221,652,645,403,424,rarity
381744.png,https://derpicdn.net/img/view/2013/7/23/381744.png,0,0.995434403,224,0,930,687,706,687,rarity
388803.png,https://derpicdn.net/img/view/2013/8/2/388803.png,0,0.979698122,70,0,696,616,626,616,rarity
393655.png,https://derpicdn.net/img/view/2013/8/7/393655.png,0,0.996025681,110,0,624,496,514,496,rarity
393755.png,https://derpicdn.net/img/view/2013/8/7/393755.png,0,0.999782264,449,0,791,337,342,337,rarity
39570.png,https://derpicdn.net/img/view/2012/7/10/39570.png,0,0.957541704,0,47,463,535,463,488,rarity
405.jpg,https://derpicdn.net/img/view/2012/1/16/405.jpg,0,0.993881941,220,32,1580,1392,1360,1360,rarity
418601.png,https://derpicdn.net/img/view/2013/9/4/418601.png,0,0.922404647,166,0,1058,821,892,821,rarity
422593.png,https://derpicdn.net/img/view/2013/9/8/422593.png,0,0.990636528,755,0,1543,723,788,723,rarity
423588.jpg,https://derpicdn.net/img/view/2013/9/9/423588.jpg,0,0.977383137,160,3,410,253,250,250,rarity
424574.png,https://derpicdn.net/img/view/2013/9/10/424574.png,0,0.973308146,62,0,598,518,536,518,rarity
427365.jpg,https://derpicdn.net/img/view/2013/9/14/427365.jpg,0,0.930084944,807,1453,2229,2875,1422,1422,rarity
429928.png,https://derpicdn.net/img/view/2013/9/17/429928.png,0,0.933723807,1189,584,2691,2086,1502,1502,rarity
429928.png,https://derpicdn.net/img/view/2013/9/17/429928.png,1,0.912257791,2523,28,3435,940,912,912,rarity
441711.png,https://derpicdn.net/img/view/2013/10/4/441711.png,0,0.980260074,0,0,765,719,765,719,rarity
455079.png,https://derpicdn.net/img/view/2013/10/23/455079.png,0,0.998752713,524,2,1096,574,572,572,rarity
4618.png,https://derpicdn.net/img/view/2012/6/17/4618.png,0,0.998878777,238,57,1108,927,870,870,rarity
464893.png,https://derpicdn.net/img/view/2013/11/5/464893.png,0,0.981581688,1019,0,2207,1154,1188,1154,rarity
469983.png,https://derpicdn.net/img/view/2013/11/11/469983.png,0,0.974734724,0,0,458,396,458,396,rarity
472217.jpg,https://derpicdn.net/img/view/2013/11/14/472217.jpg,1,0.999171197,86,56,264,234,178,178,rarity
473398.png,https://derpicdn.net/img/view/2013/11/16/473398.png,0,0.99288553,375,98,803,526,428,428,rarity
479010.png,https://derpicdn.net/img/view/2013/11/23/479010.png,0,0.998969615,7,0,429,410,422,410,rarity
488516.jpg,https://derpicdn.net/img/view/2013/12/3/488516.jpg,0,0.997918725,276,0,628,346,352,346,rarity
489532.jpg,https://derpicdn.net/img/view/2013/12/4/489532.jpg,0,0.996873379,472,0,1158,678,686,678,rarity
493777.png,https://derpicdn.net/img/view/2013/12/10/493777.png,0,0.935073316,788,350,1750,1312,962,962,rarity
498387.jpg,https://derpicdn.net/img/view/2013/12/16/498387.jpg,0,0.991859376,107,560,887,1340,780,780,rarity
498387.jpg,https://derpicdn.net/img/view/2013/12/16/498387.jpg,1,0.906320512,1004,200,1862,1058,858,858,rarity
514176.png,https://derpicdn.net/img/view/2014/1/3/514176.png,0,0.996017218,934,0,2678,1675,1744,1675,rarity
514520.png,https://derpicdn.net/img/view/2014/1/4/514520.png,0,0.938416421,623,92,1153,622,530,530,rarity
514879.png,https://derpicdn.net/img/view/2014/1/4/514879.png,0,0.989310563,0,0,1830,1080,1830,1080,rarity
515125.png,https://derpicdn.net/img/view/2014/1/4/515125.png,0,0.992705047,18,62,426,453,408,391,rarity
515584.png,https://derpicdn.net/img/view/2014/1/5/515584.png,0,0.994009316,0,79,1342,1429,1342,1350,rarity
526441.png,https://derpicdn.net/img/view/2014/1/17/526441.png,0,0.962288558,331,3,845,517,514,514,rarity
535552.png,https://derpicdn.net/img/view/2014/1/27/535552.png,0,0.998343349,116,35,606,525,490,490,rarity
536900.png,https://derpicdn.net/img/view/2014/1/28/536900.png,0,0.967481077,638,32,1192,586,554,554,rarity
542423.png,https://derpicdn.net/img/view/2014/2/3/542423.png,0,0.981018484,680,0,2716,1959,2036,1959,rarity
547806.png,https://derpicdn.net/img/view/2014/2/9/547806.png,0,0.988113642,32,18,340,326,308,308,rarity
549436.jpg,https://derpicdn.net/img/view/2014/2/11/549436.jpg,0,0.983402908,167,0,811,598,644,598,rarity
551162.png,https://derpicdn.net/img/view/2014/2/13/551162.png,0,0.995335996,151,83,429,361,278,278,rarity
562328.png,https://derpicdn.net/img/view/2014/2/26/562328.png,0,0.980756938,0,151,687,911,687,760,rarity
577774.jpg,https://derpicdn.net/img/view/2014/3/17/577774.jpg,0,0.976872265,84,184,482,582,398,398,rarity
578020.png,https://derpicdn.net/img/view/2014/3/17/578020.png,0,0.991070986,708,150,2822,2264,2114,2114,rarity
579727.png,https://derpicdn.net/img/view/2014/3/19/579727.png,0,0.987702608,0,86,447,500,447,414,rarity
579728.png,https://derpicdn.net/img/view/2014/3/19/579728.png,0,0.980150998,24,39,460,475,436,436,rarity
579730.png,https://derpicdn.net/img/view/2014/3/19/579730.png,0,0.980896831,16,54,496,500,480,446,rarity
580851.png,https://derpicdn.net/img/view/2014/3/21/580851.png,0,0.99731046,125,0,549,405,424,405,rarity
58157.png,https://derpicdn.net/img/view/2012/7/27/58157.png,0,0.992978871,0,0,1672,1488,1672,1488,rarity
591757.png,https://derpicdn.net/img/view/2014/4/3/591757.png,0,0.968373239,0,82,574,658,574,576,rarity
591806.png,https://derpicdn.net/img/view/2014/4/3/591806.png,0,0.991199911,0,112,852,900,852,788,rarity
593541.png,https://derpicdn.net/img/view/2014/4/5/593541.png,0,0.914513588,382,0,1786,1080,1404,1080,rarity
597425.png,https://derpicdn.net/img/view/2014/4/10/597425.png,0,0.996431291,115,28,529,442,414,414,rarity
602347.png,https://derpicdn.net/img/view/2014/4/17/602347.png,0,0.941827774,322,142,978,798,656,656,rarity
604604.png,https://derpicdn.net/img/view/2014/4/19/604604.png,0,0.969228268,435,25,897,487,462,462,rarity
608049.png,https://derpicdn.net/img/view/2014/4/23/608049.png,0,0.907843173,136,0,428,289,292,289,rarity
611149.png,https://derpicdn.net/img/view/2014/4/27/611149.png,0,0.970930636,680,55,2000,1375,1320,1320,rarity
618203.png,https://derpicdn.net/img/view/2014/5/5/618203.png,0,0.995021045,514,18,3054,2558,2540,2540,rarity
618209.png,https://derpicdn.net/img/view/2014/5/5/618209.png,0,0.998763084,321,515,3241,3435,2920,2920,rarity
618209.png,https://derpicdn.net/img/view/2014/5/5/618209.png,1,0.998757362,3492,0,6552,2883,3060,2883,rarity
623810.png,https://derpicdn.net/img/view/2014/5/11/623810.png,0,0.975287676,450,0,1024,579,574,579,rarity
6256.png,https://derpicdn.net/img/view/2012/6/18/6256.png,0,0.923820436,1435,46,2803,1414,1368,1368,rarity
631865.jpg,https://derpicdn.net/img/view/2014/5/20/631865.jpg,0,0.998060644,779,453,1181,929,402,476,rarity
631865.jpg,https://derpicdn.net/img/view/2014/5/20/631865.jpg,1,0.949043274,72,104,686,718,614,614,rarity
633587.png,https://derpicdn.net/img/view/2014/5/22/633587.png,0,0.998369038,219,48,609,438,390,390,rarity
633985.png,https://derpicdn.net/img/view/2014/5/22/633985.png,0,0.967578471,189,120,539,470,350,350,rarity
635816.png,https://derpicdn.net/img/view/2014/5/25/635816.png,0,0.997367442,285,0,897,595,612,595,rarity
6431.jpg,https://derpicdn.net/img/view/2012/6/18/6431.jpg,0,0.971810639,319,6,755,442,436,436,rarity
648303.png,https://derpicdn.net/img/view/2014/6/8/648303.png,0,0.992918611,0,0,2204,1898,2204,1898,rarity
652138.png,https://derpicdn.net/img/view/2014/6/13/652138.png,0,0.99819684,896,241,1354,699,458,458,rarity
652138.png,https://derpicdn.net/img/view/2014/6/13/652138.png,0,0.99819684,896,241,1354,699,458,458,rarity
655495.jpg,https://derpicdn.net/img/view/2014/6/17/655495.jpg,0,0.912414372,196,186,388,378,192,192,rarity
657111.png,https://derpicdn.net/img/view/2014/6/19/657111.png,0,0.995983183,257,1,681,425,424,424,rarity
665203.png,https://derpicdn.net/img/view/2014/7/1/665203.png,0,0.973602295,250,0,3000,2697,2750,2697,rarity
66527.png,https://derpicdn.net/img/view/2012/8/4/66527.png,0,0.967661083,255,0,675,413,420,413,rarity
669626.png,https://derpicdn.net/img/view/2014/7/7/669626.png,0,0.999627709,370,0,1202,776,832,776,rarity
671957.png,https://derpicdn.net/img/view/2014/7/10/671957.png,0,0.950816453,157,83,511,437,354,354,rarity
674117.png,https://derpicdn.net/img/view/2014/7/13/674117.png,0,0.999131501,225,0,779,521,554,521,rarity
677863.png,https://derpicdn.net/img/view/2014/7/18/677863.png,0,0.95604974,11,0,761,721,750,721,rarity
679274.png,https://derpicdn.net/img/view/2014/7/20/679274.png,0,0.989122868,189,151,587,549,398,398,rarity
679274.png,https://derpicdn.net/img/view/2014/7/20/679274.png,1,0.956485927,588,175,970,557,382,382,rarity
684629.png,https://derpicdn.net/img/view/2014/7/27/684629.png,0,0.998209178,161,0,465,297,304,297,rarity
685122.jpg,https://derpicdn.net/img/view/2014/7/28/685122.jpg,0,0.961354196,0,43,747,807,747,764,rarity
686085.png,https://derpicdn.net/img/view/2014/7/29/686085.png,0,0.980134666,2,212,358,568,356,356,rarity
688170.png,https://derpicdn.net/img/view/2014/8/1/688170.png,0,0.969677866,319,131,675,487,356,356,rarity
692146.png,https://derpicdn.net/img/view/2014/8/5/692146.png,0,0.989823639,64,11,262,209,198,198,rarity
698053.png,https://derpicdn.net/img/view/2014/8/12/698053.png,0,0.99768579,232,0,684,441,452,441,rarity
710945.png,https://derpicdn.net/img/view/2014/8/30/710945.png,0,0.934510827,306,19,968,681,662,662,rarity
712523.png,https://derpicdn.net/img/view/2014/9/1/712523.png,0,0.93506223,307,20,969,682,662,662,rarity
728968.png,https://derpicdn.net/img/view/2014/9/25/728968.png,0,0.960013688,99,14,489,404,390,390,rarity
729224.png,https://derpicdn.net/img/view/2014/9/25/729224.png,0,0.968592286,21,26,475,480,454,454,rarity
731071.png,https://derpicdn.net/img/view/2014/9/28/731071.png,0,0.9595716,1549,109,2239,799,690,690,rarity
735436.png,https://derpicdn.net/img/view/2014/10/4/735436.png,0,0.999368966,654,87,1490,923,836,836,rarity
736192.png,https://derpicdn.net/img/view/2014/10/5/736192.png,0,0.993713975,1343,0,4584,3596,3241,3596,rarity
740832.png,https://derpicdn.net/img/view/2014/10/11/740832.png,0,0.999679387,53,0,443,375,390,375,rarity
741975.png,https://derpicdn.net/img/view/2014/10/13/741975.png,0,0.993691087,624,185,922,483,298,298,rarity
749571.png,https://derpicdn.net/img/view/2014/10/24/749571.png,0,0.984182656,0,46,677,738,677,692,rarity
758895.png,https://derpicdn.net/img/view/2014/11/6/758895.png,0,0.982309282,277,101,507,331,230,230,rarity
762044.jpg,https://derpicdn.net/img/view/2014/11/10/762044.jpg,0,0.966609716,481,0,773,281,292,281,rarity
766910.png,https://derpicdn.net/img/view/2014/11/18/766910.png,0,0.95375967,0,25,557,601,557,576,rarity
775242.png,https://derpicdn.net/img/view/2014/11/30/775242.png,0,0.998589814,12,132,394,514,382,382,rarity
787669.png,https://derpicdn.net/img/view/2014/12/18/787669.png,0,0.996407211,1405,1178,2475,2248,1070,1070,rarity
787691.png,https://derpicdn.net/img/view/2014/12/18/787691.png,0,0.995702803,1538,1756,3000,3226,1462,1470,rarity
78778.png,https://derpicdn.net/img/view/2012/8/20/78778.png,0,0.973080277,165,0,579,413,414,413,rarity
78778.png,https://derpicdn.net/img/view/2012/8/20/78778.png,0,0.973080277,165,0,579,413,414,413,rarity
790030.png,https://derpicdn.net/img/view/2014/12/22/790030.png,0,0.991820037,137,0,385,239,248,239,rarity
792408.jpg,https://derpicdn.net/img/view/2014/12/25/792408.jpg,0,0.970540643,73,0,785,642,712,642,rarity
802944.png,https://derpicdn.net/img/view/2015/1/10/802944.png,0,0.988729894,310,16,934,640,624,624,rarity
805172.png,https://derpicdn.net/img/view/2015/1/13/805172.png,0,0.994415581,656,705,1940,1989,1284,1284,rarity
808382.png,https://derpicdn.net/img/view/2015/1/17/808382.png,0,0.998834729,93,0,613,509,520,509,rarity
822168.png,https://derpicdn.net/img/view/2015/2/5/822168.png,0,0.999082804,137,8,437,308,300,300,rarity
822168.png,https://derpicdn.net/img/view/2015/2/5/822168.png,1,0.996688008,589,0,855,243,266,243,rarity
825117.png,https://derpicdn.net/img/view/2015/2/9/825117.png,0,0.916529953,500,0,2198,1595,1698,1595,rarity
825117.png,https://derpicdn.net/img/view/2015/2/9/825117.png,0,0.916529953,500,0,2198,1595,1698,1595,rarity
837684.png,https://derpicdn.net/img/view/2015/2/26/837684.png,0,0.946148455,312,0,850,521,538,521,rarity
839055.jpg,https://derpicdn.net/img/view/2015/2/28/839055.jpg,0,0.998130322,111,0,881,729,770,729,rarity
840004.jpg,https://derpicdn.net/img/view/2015/3/1/840004.jpg,0,0.928172469,57,0,509,448,452,448,rarity
840772.jpg,https://derpicdn.net/img/view/2015/3/2/840772.jpg,0,0.987065852,299,14,647,362,348,348,rarity
842989.png,https://derpicdn.net/img/view/2015/3/5/842989.png,0,0.976724446,1977,44,4645,2712,2668,2668,rarity
843059.png,https://derpicdn.net/img/view/2015/3/5/843059.png,0,0.997459292,282,32,576,326,294,294,rarity
846299.png,https://derpicdn.net/img/view/2015/3/9/846299.png,0,0.999846458,882,22,1786,926,904,904,rarity
846960.jpg,https://derpicdn.net/img/view/2015/3/11/846960.jpg,0,0.950354517,223,39,581,397,358,358,rarity
857554.png,https://derpicdn.net/img/view/2015/3/26/857554.png,0,0.984870434,94,0,524,415,430,415,rarity
858707.png,https://derpicdn.net/img/view/2015/3/28/858707.png,0,0.999165952,144,16,418,290,274,274,rarity
859012.png,https://derpicdn.net/img/view/2015/3/28/859012.png,0,0.937759519,116,17,524,425,408,408,rarity
859451.png,https://derpicdn.net/img/view/2015/3/29/859451.png,0,0.967811525,64,0,416,320,352,320,rarity
882222.png,https://derpicdn.net/img/view/2015/4/25/882222.png,0,0.910105824,463,54,853,444,390,390,rarity
886894.png,https://derpicdn.net/img/view/2015/5/1/886894.png,0,0.94026351,671,105,1375,809,704,704,rarity
888336.png,https://derpicdn.net/img/view/2015/5/3/888336.png,0,0.977963924,0,311,430,747,430,436,rarity
888979.png,https://derpicdn.net/img/view/2015/5/4/888979.png,0,0.978861392,1382,0,2498,1006,1116,1006,rarity
889954.png,https://derpicdn.net/img/view/2015/5/5/889954.png,0,0.921998382,305,0,1511,1075,1206,1075,rarity
898172.png,https://derpicdn.net/img/view/2015/5/17/898172.png,0,0.989098668,68,280,240,452,172,172,rarity
900097.png,https://derpicdn.net/img/view/2015/5/19/900097.png,0,0.909500837,509,0,1537,939,1028,939,rarity
902082.png,https://derpicdn.net/img/view/2015/5/23/902082.png,0,0.997101724,2577,0,5423,2356,2846,2356,rarity
904539.png,https://derpicdn.net/img/view/2015/5/26/904539.png,0,0.993868709,304,0,736,426,432,426,rarity
914894.jpg,https://derpicdn.net/img/view/2015/6/11/914894.jpg,0,0.998015285,122,0,668,477,546,477,rarity
920218.png,https://derpicdn.net/img/view/2015/6/20/920218.png,0,0.999166727,474,0,1222,748,748,748,rarity
938268.png,https://derpicdn.net/img/view/2015/7/16/938268.png,0,0.99492234,115,22,613,520,498,498,rarity
9428.png,https://derpicdn.net/img/view/2012/6/19/9428.png,0,0.922940075,798,0,1980,1034,1182,1034,rarity
947187.jpg,https://derpicdn.net/img/view/2015/7/30/947187.jpg,0,0.967290759,158,7,656,505,498,498,rarity
954041.jpg,https://derpicdn.net/img/view/2015/8/9/954041.jpg,0,0.998663425,13,0,481,461,468,461,rarity
954902.png,https://derpicdn.net/img/view/2015/8/10/954902.png,0,0.982489824,709,261,1117,669,408,408,rarity
962214.png,https://derpicdn.net/img/view/2015/8/21/962214.png,0,0.988311529,700,331,1330,961,630,630,rarity
966243.png,https://derpicdn.net/img/view/2015/8/26/966243.png,0,0.90160954,153,22,463,332,310,310,rarity
967779.png,https://derpicdn.net/img/view/2015/8/29/967779.png,0,0.991879404,117,0,627,475,510,475,rarity
973742.jpg,https://derpicdn.net/img/view/2015/9/6/973742.jpg,0,0.977058351,291,2027,837,2573,546,546,rarity
977548.png,https://derpicdn.net/img/view/2015/9/11/977548.png,0,0.985931635,715,958,1023,1266,308,308,rarity
979782.png,https://derpicdn.net/img/view/2015/9/14/979782.png,0,0.992552638,403,3,729,329,326,326,rarity
979782.png,https://derpicdn.net/img/view/2015/9/14/979782.png,1,0.957666576,219,129,501,411,282,282,rarity
981986.png,https://derpicdn.net/img/view/2015/9/18/981986.png,0,0.994533062,730,79,1110,459,380,380,rarity
982638.png,https://derpicdn.net/img/view/2015/9/19/982638.png,0,0.99946475,130,0,766,610,636,610,rarity
983649.png,https://derpicdn.net/img/view/2015/9/20/983649.png,0,0.968188286,48,0,1656,1080,1608,1080,rarity
98423.jpg,https://derpicdn.net/img/view/2012/9/15/98423.jpg,0,0.97849828,341,52,909,620,568,568,rarity
987986.png,https://derpicdn.net/img/view/2015/9/26/987986.png,0,0.965572178,0,0,1500,1538,1500,1538,rarity
987986.png,https://derpicdn.net/img/view/2015/9/26/987986.png,0,0.965572178,0,0,1500,1538,1500,1538,rarity
995275.png,https://derpicdn.net/img/view/2015/10/5/995275.png,0,0.985372782,561,61,1027,527,466,466,rarity
999482.jpg,https://derpicdn.net/img/view/2015/10/11/999482.jpg,0,0.936858118,191,578,1409,1796,1218,1218,rarity
1001036.jpg,https://derpicdn.net/img/view/2015/10/13/1001036.jpg,0,0.994380653,282,424,572,714,290,290,rarity
100180.png,https://derpicdn.net/img/view/2012/9/17/100180.png,0,0.999297023,33,2,359,328,326,326,rarity
1005036.png,https://derpicdn.net/img/view/2015/10/18/1005036.png,0,0.978657961,155,0,903,744,748,744,rarity
1008567.png,https://derpicdn.net/img/view/2015/10/24/1008567.png,0,0.998020351,148,29,586,467,438,438,rarity
1013428.png,https://derpicdn.net/img/view/2015/10/31/1013428.png,0,0.933113754,159,79,671,591,512,512,rarity
10153.jpg,https://derpicdn.net/img/view/2012/6/19/10153.jpg,0,0.986938655,42,0,632,555,590,555,rarity
1015942.png,https://derpicdn.net/img/view/2015/11/4/1015942.png,0,0.996035516,133,0,1123,982,990,982,rarity
1024273.jpg,https://derpicdn.net/img/view/2015/11/16/1024273.jpg,0,0.980707765,0,0,480,558,480,558,rarity
1030525.png,https://derpicdn.net/img/view/2015/11/26/1030525.png,0,0.976206303,43,337,199,493,156,156,rarity
1030525.png,https://derpicdn.net/img/view/2015/11/26/1030525.png,1,0.967053413,340,274,506,440,166,166,rarity
10333.png,https://derpicdn.net/img/view/2012/6/19/10333.png,0,0.990057886,196,0,624,411,428,411,rarity
1043442.png,https://derpicdn.net/img/view/2015/12/13/1043442.png,0,0.997870564,721,584,1551,1414,830,830,rarity
1055463.png,https://derpicdn.net/img/view/2015/12/30/1055463.png,0,0.991697669,201,1,561,361,360,360,rarity
1064841.png,https://derpicdn.net/img/view/2016/1/12/1064841.png,0,0.999645948,130,172,400,442,270,270,rarity
1064841.png,https://derpicdn.net/img/view/2016/1/12/1064841.png,1,0.978610396,434,50,790,406,356,356,rarity
1067093.png,https://derpicdn.net/img/view/2016/1/15/1067093.png,0,0.998278379,319,1,621,303,302,302,rarity
108358.png,https://derpicdn.net/img/view/2012/9/28/108358.png,0,0.995262146,318,0,710,377,392,377,rarity
1083850.jpg,https://derpicdn.net/img/view/2016/2/9/1083850.jpg,0,0.97143203,464,72,1350,958,886,886,rarity
1099907.jpg,https://derpicdn.net/img/view/2016/3/1/1099907.jpg,0,0.968093336,399,161,1115,877,716,716,rarity
1108885.jpg,https://derpicdn.net/img/view/2016/3/14/1108885.jpg,0,0.995284736,881,231,1783,1133,902,902,rarity
1110326.png,https://derpicdn.net/img/view/2016/3/16/1110326.png,0,0.918722928,187,0,739,543,552,543,rarity
1115964.jpg,https://derpicdn.net/img/view/2016/3/24/1115964.jpg,0,0.985917151,466,54,884,472,418,418,rarity
1135747.png,https://derpicdn.net/img/view/2016/4/19/1135747.png,0,0.979221582,114,0,512,398,398,398,rarity
1161781.png,https://derpicdn.net/img/view/2016/5/24/1161781.png,0,0.981677413,350,0,714,364,364,364,rarity
1163592.png,https://derpicdn.net/img/view/2016/5/26/1163592.png,0,0.962433815,302,9,718,425,416,416,rarity
1169170.png,https://derpicdn.net/img/view/2016/6/3/1169170.png,0,0.994505525,905,316,2271,1682,1366,1366,rarity
1170234.png,https://derpicdn.net/img/view/2016/6/4/1170234.png,0,0.985417783,56,60,446,452,390,392,rarity
1179244.png,https://derpicdn.net/img/view/2016/6/15/1179244.png,0,0.972680748,198,0,1230,1025,1032,1025,rarity
1181905.jpg,https://derpicdn.net/img/view/2016/6/19/1181905.jpg,0,0.991651893,362,0,690,327,328,327,rarity
1193529.png,https://derpicdn.net/img/view/2016/7/4/1193529.png,0,0.977336764,1690,230,3530,2070,1840,1840,rarity
1203765.png,https://derpicdn.net/img/view/2016/7/18/1203765.png,0,0.997389495,198,0,640,429,442,429,rarity
1206308.png,https://derpicdn.net/img/view/2016/7/21/1206308.png,0,0.956529975,429,10,909,490,480,480,rarity
1222347.png,https://derpicdn.net/img/view/2016/8/11/1222347.png,0,0.997128725,142,0,516,361,374,361,rarity
122520.png,https://derpicdn.net/img/view/2012/10/14/122520.png,0,0.995409429,2350,0,3918,1510,1568,1510,rarity
1235380.png,https://derpicdn.net/img/view/2016/8/28/1235380.png,0,0.968859434,118,0,1588,1600,1470,1600,rarity
1244029.png,https://derpicdn.net/img/view/2016/9/7/1244029.png,0,0.993593454,281,0,838,581,557,581,rarity
1256792.png,https://derpicdn.net/img/view/2016/9/24/1256792.png,0,0.946553349,161,0,905,697,744,697,rarity
126472.png,https://derpicdn.net/img/view/2012/10/19/126472.png,0,0.996326208,799,110,1593,904,794,794,rarity
1284466.png,https://derpicdn.net/img/view/2016/10/30/1284466.png,0,0.988733768,43,0,1243,1116,1200,1116,rarity
1293963.png,https://derpicdn.net/img/view/2016/11/12/1293963.png,0,0.915196538,473,120,1155,802,682,682,rarity
1300083.png,https://derpicdn.net/img/view/2016/11/21/1300083.png,0,0.995015621,0,0,1454,1331,1454,1331,rarity
130524.png,https://derpicdn.net/img/view/2012/10/24/130524.png,0,0.992487848,419,19,663,263,244,244,rarity
130524.png,https://derpicdn.net/img/view/2012/10/24/130524.png,1,0.986396968,218,517,420,719,202,202,rarity
131999.jpg,https://derpicdn.net/img/view/2012/10/25/131999.jpg,0,0.957615376,173,0,451,278,278,278,rarity
1321588.png,https://derpicdn.net/img/view/2016/12/20/1321588.png,0,0.998296738,788,116,1526,854,738,738,rarity
1322715.png,https://derpicdn.net/img/view/2016/12/22/1322715.png,0,0.973267078,0,361,4148,4811,4148,4450,rarity
1333.png,https://derpicdn.net/img/view/2012/1/22/1333.png,0,0.915390253,0,18,524,624,524,606,rarity
1354116.png,https://derpicdn.net/img/view/2017/2/3/1354116.png,0,0.988783956,147,1,699,553,552,552,rarity
1354486.png,https://derpicdn.net/img/view/2017/2/3/1354486.png,0,0.987564087,0,0,552,533,552,533,rarity
1354539.png,https://derpicdn.net/img/view/2017/2/3/1354539.png,0,0.963540554,71,0,585,504,514,504,rarity
1356285.png,https://derpicdn.net/img/view/2017/2/6/1356285.png,0,0.966082692,1175,0,3500,2536,2325,2536,rarity
1357766.png,https://derpicdn.net/img/view/2017/2/8/1357766.png,0,0.998700738,957,0,1361,344,404,344,rarity
1357766.png,https://derpicdn.net/img/view/2017/2/8/1357766.png,1,0.986789167,32,0,392,331,360,331,rarity
1357766.png,https://derpicdn.net/img/view/2017/2/8/1357766.png,2,0.972286999,446,0,842,341,396,341,rarity
1360382.png,https://derpicdn.net/img/view/2017/2/11/1360382.png,0,0.924925923,123,426,1943,2246,1820,1820,rarity
1377897.png,https://derpicdn.net/img/view/2017/3/3/1377897.png,0,0.974720418,113,26,393,306,280,280,rarity
1378940.png,https://derpicdn.net/img/view/2017/3/4/1378940.png,0,0.987771571,152,0,1080,865,928,865,rarity
1380955.png,https://derpicdn.net/img/view/2017/3/6/1380955.png,0,0.950177908,340,154,656,470,316,316,rarity
1380955.png,https://derpicdn.net/img/view/2017/3/6/1380955.png,1,0.949263215,537,162,903,528,366,366,rarity
1382073.png,https://derpicdn.net/img/view/2017/3/8/1382073.png,0,0.98298645,1092,173,3206,2287,2114,2114,rarity
1394207.png,https://derpicdn.net/img/view/2017/3/23/1394207.png,0,0.990531921,1169,0,2765,1422,1596,1422,rarity
1397505.png,https://derpicdn.net/img/view/2017/3/27/1397505.png,0,0.998585641,39,45,597,603,558,558,rarity
1400495.png,https://derpicdn.net/img/view/2017/3/31/1400495.png,0,0.985921741,198,0,3258,2556,3060,2556,rarity
1400495.png,https://derpicdn.net/img/view/2017/3/31/1400495.png,1,0.924338281,2706,97,4578,1969,1872,1872,rarity
1404245.png,https://derpicdn.net/img/view/2017/4/4/1404245.png,0,0.992921472,23,10,791,778,768,768,rarity
1404706.png,https://derpicdn.net/img/view/2017/4/5/1404706.png,0,0.996763289,1307,101,2049,843,742,742,rarity
1406122.png,https://derpicdn.net/img/view/2017/4/7/1406122.png,0,0.909615338,4412,0,6730,2169,2318,2169,rarity
1408442.png,https://derpicdn.net/img/view/2017/4/10/1408442.png,0,0.996416688,3886,1582,6066,3762,2180,2180,rarity
1408442.png,https://derpicdn.net/img/view/2017/4/10/1408442.png,1,0.959426463,1206,0,3238,1951,2032,1951,rarity
1412625.png,https://derpicdn.net/img/view/2017/4/16/1412625.png,0,0.971484959,493,259,2913,2679,2420,2420,rarity
1420347.png,https://derpicdn.net/img/view/2017/4/24/1420347.png,0,0.992252886,264,164,1604,1504,1340,1340,rarity
1422355.png,https://derpicdn.net/img/view/2017/4/26/1422355.png,0,0.995348752,185,70,551,436,366,366,rarity
1423909.png,https://derpicdn.net/img/view/2017/4/28/1423909.png,0,0.99089855,123,0,555,423,432,423,rarity
1424039.png,https://derpicdn.net/img/view/2017/4/29/1424039.png,0,0.968555868,38,22,440,424,402,402,rarity
1433124.png,https://derpicdn.net/img/view/2017/5/10/1433124.png,0,0.947576761,125,10,1079,964,954,954,rarity
1435041.png,https://derpicdn.net/img/view/2017/5/13/1435041.png,0,0.993331015,2955,65,4459,1569,1504,1504,rarity
1436379.png,https://derpicdn.net/img/view/2017/5/14/1436379.png,0,0.990267992,120,0,608,454,488,454,rarity
1438981.png,https://derpicdn.net/img/view/2017/5/17/1438981.png,0,0.987981796,319,353,963,997,644,644,rarity
1441866.png,https://derpicdn.net/img/view/2017/5/21/1441866.png,0,0.998648643,216,11,802,597,586,586,rarity
1442288.png,https://derpicdn.net/img/view/2017/5/21/1442288.png,0,0.979583979,1613,733,3201,2321,1588,1588,rarity
1448695.png,https://derpicdn.net/img/view/2017/5/29/1448695.png,0,0.99314642,287,14,861,588,574,574,rarity
1450670.png,https://derpicdn.net/img/view/2017/5/31/1450670.png,0,0.929956257,1927,0,4500,2371,2573,2371,rarity
1456598.png,https://derpicdn.net/img/view/2017/6/8/1456598.png,1,0.996862352,558,369,834,645,276,276,rarity
1458926.png,https://derpicdn.net/img/view/2017/6/11/1458926.png,0,0.967440784,113,0,365,242,252,242,rarity
1468084.png,https://derpicdn.net/img/view/2017/6/21/1468084.png,0,0.980520606,331,0,2069,1626,1738,1626,rarity
1468673.png,https://derpicdn.net/img/view/2017/6/22/1468673.png,0,0.972227931,158,163,742,747,584,584,rarity
1469445.png,https://derpicdn.net/img/view/2017/6/23/1469445.png,0,0.981891751,0,0,538,530,538,530,rarity
1472754.png,https://derpicdn.net/img/view/2017/6/27/1472754.png,0,0.995907426,97,9,521,433,424,424,rarity
1475182.png,https://derpicdn.net/img/view/2017/6/30/1475182.png,0,0.985092103,488,0,1140,652,652,652,rarity
1475523.png,https://derpicdn.net/img/view/2017/6/30/1475523.png,0,0.923122466,151,0,1791,1497,1640,1497,rarity
1480396.png,https://derpicdn.net/img/view/2017/7/6/1480396.png,1,0.984561801,1091,268,1415,592,324,324,rarity
148917.png,https://derpicdn.net/img/view/2012/11/11/148917.png,0,0.969061792,379,51,709,381,330,330,rarity
1496211.png,https://derpicdn.net/img/view/2017/7/27/1496211.png,0,0.995494545,559,0,1785,1166,1226,1166,rarity
1500280.png,https://derpicdn.net/img/view/2017/8/1/1500280.png,0,0.975904286,59,11,505,454,446,443,rarity
1501675.png,https://derpicdn.net/img/view/2017/8/3/1501675.png,0,0.979408801,0,0,216,217,216,217,rarity
1504773.png,https://derpicdn.net/img/view/2017/8/7/1504773.png,0,0.969551146,603,412,1133,942,530,530,rarity
1507704.png,https://derpicdn.net/img/view/2017/8/11/1507704.png,0,0.990852118,375,0,1913,1476,1538,1476,rarity
1508189.png,https://derpicdn.net/img/view/2017/8/11/1508189.png,0,0.999031305,233,217,1349,1333,1116,1116,rarity
1511781.png,https://derpicdn.net/img/view/2017/8/16/1511781.png,0,0.964698613,111,4,511,404,400,400,rarity
1525381.png,https://derpicdn.net/img/view/2017/9/1/1525381.png,0,0.940487206,0,18,476,498,476,480,rarity
1533449.png,https://derpicdn.net/img/view/2017/9/12/1533449.png,0,0.906820953,0,0,376,444,376,444,rarity
1534413.png,https://derpicdn.net/img/view/2017/9/13/1534413.png,0,0.961352408,8,0,792,776,784,776,rarity
1535757.png,https://derpicdn.net/img/view/2017/9/15/1535757.png,0,0.984227061,5007,242,8993,4228,3986,3986,rarity
1537253.png,https://derpicdn.net/img/view/2017/9/17/1537253.png,0,0.980749726,0,0,524,546,524,546,rarity
1537303.png,https://derpicdn.net/img/view/2017/9/17/1537303.png,0,0.992743194,164,0,752,562,588,562,rarity
1537491.png,https://derpicdn.net/img/view/2017/9/17/1537491.png,0,0.944248915,0,13,352,407,352,394,rarity
1538206.png,https://derpicdn.net/img/view/2017/9/17/1538206.png,0,0.986319542,340,0,886,506,546,506,rarity
1539508.png,https://derpicdn.net/img/view/2017/9/19/1539508.png,0,0.997649491,189,0,841,601,652,601,rarity
1539582.png,https://derpicdn.net/img/view/2017/9/19/1539582.png,0,0.976126909,0,0,1208,1219,1208,1219,rarity
1541850.png,https://derpicdn.net/img/view/2017/9/22/1541850.png,0,0.992525518,238,14,620,396,382,382,rarity
1545109.png,https://derpicdn.net/img/view/2017/9/26/1545109.png,0,0.99271518,98,0,882,762,784,762,rarity
1548222.png,https://derpicdn.net/img/view/2017/9/30/1548222.png,0,0.99495101,27,874,277,1124,250,250,rarity
1550033.png,https://derpicdn.net/img/view/2017/10/2/1550033.png,0,0.917182028,0,11,643,787,643,776,rarity
1565424.png,https://derpicdn.net/img/view/2017/10/19/1565424.png,0,0.993659675,63,11,595,543,532,532,rarity
1565903.png,https://derpicdn.net/img/view/2017/10/20/1565903.png,0,0.98424238,1085,550,3737,3202,2652,2652,rarity
1570753.png,https://derpicdn.net/img/view/2017/10/26/1570753.png,0,0.970372319,324,27,1280,983,956,956,rarity
1580037.png,https://derpicdn.net/img/view/2017/11/6/1580037.png,0,0.996767759,476,96,1046,666,570,570,rarity
1580311.png,https://derpicdn.net/img/view/2017/11/7/1580311.png,0,0.999258041,0,0,758,751,758,751,rarity
1580311.png,https://derpicdn.net/img/view/2017/11/7/1580311.png,1,0.965817451,761,21,1512,785,751,764,rarity
1581234.png,https://derpicdn.net/img/view/2017/11/8/1581234.png,0,0.996814013,86,0,876,767,790,767,rarity
1584448.png,https://derpicdn.net/img/view/2017/11/12/1584448.png,0,0.970332563,0,0,3406,3000,3406,3000,rarity
1586259.png,https://derpicdn.net/img/view/2017/11/14/1586259.png,0,0.998443484,65,0,1677,1528,1612,1528,rarity
1593683.png,https://derpicdn.net/img/view/2017/11/25/1593683.png,0,0.920167148,695,0,1455,696,760,696,rarity
1595243.png,https://derpicdn.net/img/view/2017/11/27/1595243.png,0,0.971557975,293,45,821,573,528,528,rarity
1596351.png,https://derpicdn.net/img/view/2017/11/28/1596351.png,0,0.991338909,246,344,792,890,546,546,rarity
1598497.png,https://derpicdn.net/img/view/2017/12/1/1598497.png,0,0.901569664,436,0,1020,540,584,540,rarity
1601946.png,https://derpicdn.net/img/view/2017/12/6/1601946.png,0,0.997342467,899,190,1487,778,588,588,rarity
1604943.png,https://derpicdn.net/img/view/2017/12/11/1604943.png,0,0.999523699,23,66,493,536,470,470,rarity
1604943.png,https://derpicdn.net/img/view/2017/12/11/1604943.png,1,0.998858511,1311,1046,1763,1498,452,452,rarity
1604943.png,https://derpicdn.net/img/view/2017/12/11/1604943.png,3,0.989267886,49,2045,459,2455,410,410,rarity
1604943.png,https://derpicdn.net/img/view/2017/12/11/1604943.png,4,0.988966048,1319,1988,1755,2424,436,436,rarity
1604943.png,https://derpicdn.net/img/view/2017/12/11/1604943.png,5,0.98858428,1956,1033,2388,1465,432,432,rarity
1604943.png,https://derpicdn.net/img/view/2017/12/11/1604943.png,6,0.976995945,1954,1984,2402,2432,448,448,rarity
1604943.png,https://derpicdn.net/img/view/2017/12/11/1604943.png,7,0.937112212,665,1999,1083,2417,418,418,rarity
1605712.png,https://derpicdn.net/img/view/2017/12/12/1605712.png,0,0.924885511,0,0,739,756,739,756,rarity
1611008.png,https://derpicdn.net/img/view/2017/12/19/1611008.png,0,0.969485641,2179,0,4207,1941,2028,1941,rarity
1615061.png,https://derpicdn.net/img/view/2017/12/24/1615061.png,0,0.978051007,196,110,834,748,638,638,rarity
1617062.png,https://derpicdn.net/img/view/2017/12/27/1617062.png,0,0.997453749,460,82,1146,768,686,686,rarity
1622934.png,https://derpicdn.net/img/view/2018/1/3/1622934.png,0,0.991151989,163,0,1251,1039,1088,1039,rarity
1629574.png,https://derpicdn.net/img/view/2018/1/11/1629574.png,0,0.958489954,135,741,359,965,224,224,rarity
1629805.png,https://derpicdn.net/img/view/2018/1/11/1629805.png,0,0.997995436,162,6,650,494,488,488,rarity
1630181.png,https://derpicdn.net/img/view/2018/1/12/1630181.png,0,0.918866456,1904,0,4408,2326,2504,2326,rarity
16340.jpg,https://derpicdn.net/img/view/2012/6/23/16340.jpg,0,0.992371559,45,0,951,820,906,820,rarity
1639469.png,https://derpicdn.net/img/view/2018/1/24/1639469.png,0,0.999728382,22,0,932,887,910,887,rarity
1648646.png,https://derpicdn.net/img/view/2018/2/5/1648646.png,0,0.938079357,101,12,773,684,672,672,rarity
1651387.png,https://derpicdn.net/img/view/2018/2/8/1651387.png,0,0.953852415,0,0,596,576,596,576,rarity
1653319.png,https://derpicdn.net/img/view/2018/2/11/1653319.png,0,0.993814528,72,0,1162,720,1090,720,rarity
1669115.png,https://derpicdn.net/img/view/2018/3/1/1669115.png,0,0.925985694,324,14,756,446,432,432,rarity
1679771.png,https://derpicdn.net/img/view/2018/3/14/1679771.png,0,0.995208263,417,0,777,336,360,336,rarity
1683129.png,https://derpicdn.net/img/view/2018/3/17/1683129.png,0,0.987948835,848,221,2852,2225,2004,2004,rarity
1683772.png,https://derpicdn.net/img/view/2018/3/18/1683772.png,0,0.996811688,302,0,670,337,368,337,rarity
1683898.png,https://derpicdn.net/img/view/2018/3/18/1683898.png,0,0.994766474,741,9,1721,989,980,980,rarity
1690629.png,https://derpicdn.net/img/view/2018/3/25/1690629.png,0,0.978338957,124,33,608,517,484,484,rarity
1693941.png,https://derpicdn.net/img/view/2018/3/29/1693941.png,0,0.978606403,554,2015,976,2437,422,422,rarity
1704482.png,https://derpicdn.net/img/view/2018/4/10/1704482.png,0,0.957947969,0,14,315,462,315,448,rarity
1706470.png,https://derpicdn.net/img/view/2018/4/13/1706470.png,2,0.914734602,2275,0,4231,1802,1956,1802,rarity
1711168.png,https://derpicdn.net/img/view/2018/4/18/1711168.png,0,0.997343898,129,0,567,427,438,427,rarity
1711539.png,https://derpicdn.net/img/view/2018/4/19/1711539.png,0,0.964817226,9,0,645,615,636,615,rarity
1713543.png,https://derpicdn.net/img/view/2018/4/21/1713543.png,0,0.996579111,20,210,836,1026,816,816,rarity
1719330.png,https://derpicdn.net/img/view/2018/4/28/1719330.png,0,0.941048026,270,59,1108,897,838,838,rarity
174268.png,https://derpicdn.net/img/view/2012/12/6/174268.png,0,0.997654617,277,554,1187,1464,910,910,rarity
1743044.png,https://derpicdn.net/img/view/2018/5/27/1743044.png,0,0.998034716,1246,0,2208,958,962,958,rarity
1745054.png,https://derpicdn.net/img/view/2018/5/30/1745054.png,0,0.981555223,361,88,953,680,592,592,rarity
1751541.png,https://derpicdn.net/img/view/2018/6/6/1751541.png,0,0.974949539,74,42,558,526,484,484,rarity
1752944.png,https://derpicdn.net/img/view/2018/6/8/1752944.png,0,0.985409915,220,56,938,774,718,718,rarity
1753781.png,https://derpicdn.net/img/view/2018/6/9/1753781.png,0,0.999669433,0,0,349,364,349,364,rarity
1754292.png,https://derpicdn.net/img/view/2018/6/10/1754292.png,0,0.978068352,0,0,3437,3429,3437,3429,rarity
1755.jpg,https://derpicdn.net/img/view/2012/1/23/1755.jpg,0,0.985704243,0,96,339,560,339,464,rarity
1755191.png,https://derpicdn.net/img/view/2018/6/11/1755191.png,0,0.975992382,54,51,552,549,498,498,rarity
1760299.png,https://derpicdn.net/img/view/2018/6/18/1760299.png,0,0.996061623,165,44,659,538,494,494,rarity
1762720.png,https://derpicdn.net/img/view/2018/6/21/1762720.png,0,0.966453254,61,0,273,203,212,203,rarity
1766788.png,https://derpicdn.net/img/view/2018/6/26/1766788.png,0,0.994739652,433,0,1037,602,604,602,rarity
1769080.png,https://derpicdn.net/img/view/2018/6/29/1769080.png,0,0.998929918,131,5,1003,877,872,872,rarity
1771934.png,https://derpicdn.net/img/view/2018/7/3/1771934.png,0,0.991804421,991,99,1651,759,660,660,rarity
1776316.png,https://derpicdn.net/img/view/2018/7/8/1776316.png,0,0.988289177,573,60,1527,1014,954,954,rarity
1777113.png,https://derpicdn.net/img/view/2018/7/9/1777113.png,0,0.977591097,632,0,914,256,282,256,rarity
1781019.png,https://derpicdn.net/img/view/2018/7/14/1781019.png,0,0.913455904,753,1018,1647,1912,894,894,rarity
1788233.png,https://derpicdn.net/img/view/2018/7/24/1788233.png,0,0.937202692,206,19,630,443,424,424,rarity
1793107.png,https://derpicdn.net/img/view/2018/7/30/1793107.png,0,0.984292805,0,178,4066,4430,4066,4252,rarity
1795550.png,https://derpicdn.net/img/view/2018/8/2/1795550.png,0,0.992010295,473,81,795,403,322,322,rarity
1798263.png,https://derpicdn.net/img/view/2018/8/5/1798263.png,0,0.986665249,279,136,1211,1068,932,932,rarity
1799250.png,https://derpicdn.net/img/view/2018/8/6/1799250.png,0,0.934607983,767,0,3186,2553,2419,2553,rarity
1806929.png,https://derpicdn.net/img/view/2018/8/15/1806929.png,0,0.997695386,615,158,2547,2090,1932,1932,rarity
1808559.png,https://derpicdn.net/img/view/2018/8/16/1808559.png,0,0.982021272,11,13,181,185,170,172,rarity
1808559.png,https://derpicdn.net/img/view/2018/8/16/1808559.png,1,0.934887767,0,0,142,148,142,148,rarity
1808574.png,https://derpicdn.net/img/view/2018/8/16/1808574.png,0,0.976032972,0,0,202,227,202,227,rarity
1814948.png,https://derpicdn.net/img/view/2018/8/24/1814948.png,0,0.978099823,86,0,796,777,710,777,rarity
1818777.png,https://derpicdn.net/img/view/2018/8/28/1818777.png,0,0.985513508,102,4,1918,1820,1816,1816,rarity
1820817.png,https://derpicdn.net/img/view/2018/8/31/1820817.png,0,0.981806636,591,114,1551,1074,960,960,rarity
1824192.png,https://derpicdn.net/img/view/2018/9/3/1824192.png,0,0.998688579,1717,0,3613,1794,1896,1794,rarity
1827897.png,https://derpicdn.net/img/view/2018/9/8/1827897.png,0,0.995736241,275,104,1611,1440,1336,1336,rarity
1828615.png,https://derpicdn.net/img/view/2018/9/9/1828615.png,0,0.993063331,18,0,690,654,672,654,rarity
1829333.png,https://derpicdn.net/img/view/2018/9/10/1829333.png,0,0.989565253,656,326,2813,2566,2157,2240,rarity
1830595.png,https://derpicdn.net/img/view/2018/9/11/1830595.png,0,0.975818694,225,9,803,587,578,578,rarity
1831546.png,https://derpicdn.net/img/view/2018/9/13/1831546.png,0,0.992808342,297,0,1141,842,844,842,rarity
1846725.png,https://derpicdn.net/img/view/2018/10/3/1846725.png,0,0.952587664,298,20,1098,820,800,800,rarity
1848335.png,https://derpicdn.net/img/view/2018/10/5/1848335.png,0,0.950608134,766,570,1114,918,348,348,rarity
1851009.png,https://derpicdn.net/img/view/2018/10/8/1851009.png,0,0.969949126,86,0,1144,891,1058,891,rarity
1856744.png,https://derpicdn.net/img/view/2018/10/15/1856744.png,0,0.989108324,109,69,993,953,884,884,rarity
1859810.png,https://derpicdn.net/img/view/2018/10/18/1859810.png,0,0.997800291,438,0,1384,885,946,885,rarity
1860799.png,https://derpicdn.net/img/view/2018/10/19/1860799.png,0,0.99941963,0,0,3252,3273,3252,3273,rarity
1864576.png,https://derpicdn.net/img/view/2018/10/24/1864576.png,0,0.990127385,212,0,986,699,774,699,rarity
1877300.png,https://derpicdn.net/img/view/2018/11/7/1877300.png,0,0.993586838,268,215,1198,1145,930,930,rarity
1877709.png,https://derpicdn.net/img/view/2018/11/8/1877709.png,0,0.998226881,29,7,403,381,374,374,rarity
1884414.png,https://derpicdn.net/img/view/2018/11/17/1884414.png,0,0.981722653,0,43,477,527,477,484,rarity
1891613.png,https://derpicdn.net/img/view/2018/11/26/1891613.png,0,0.953348458,159,0,961,727,802,727,rarity
1892212.png,https://derpicdn.net/img/view/2018/11/27/1892212.png,0,0.994675517,30,49,712,731,682,682,rarity
1903698.png,https://derpicdn.net/img/view/2018/12/9/1903698.png,0,0.980977058,163,42,911,790,748,748,rarity
1906995.png,https://derpicdn.net/img/view/2018/12/13/1906995.png,0,0.993557632,2400,365,3604,1569,1204,1204,rarity
1908683.png,https://derpicdn.net/img/view/2018/12/15/1908683.png,0,0.996502757,68,27,274,233,206,206,rarity
1913914.png,https://derpicdn.net/img/view/2018/12/20/1913914.png,0,0.992449343,69,0,543,388,474,388,rarity
1917870.png,https://derpicdn.net/img/view/2018/12/24/1917870.png,0,0.996478021,717,765,1853,1901,1136,1136,rarity
1922641.png,https://derpicdn.net/img/view/2018/12/31/1922641.png,0,0.971952677,162,27,588,453,426,426,rarity
1923853.png,https://derpicdn.net/img/view/2019/1/1/1923853.png,0,0.99736464,556,25,1058,527,502,502,rarity
1924801.png,https://derpicdn.net/img/view/2019/1/2/1924801.png,0,0.982082725,607,126,1515,1034,908,908,rarity
1926002.png,https://derpicdn.net/img/view/2019/1/3/1926002.png,0,0.967826605,358,0,926,552,568,552,rarity
192800.png,https://derpicdn.net/img/view/2012/12/25/192800.png,0,0.990433276,0,3,343,363,343,360,rarity
1939773.png,https://derpicdn.net/img/view/2019/1/20/1939773.png,0,0.941987813,599,158,1021,580,422,422,rarity
1939840.png,https://derpicdn.net/img/view/2019/1/20/1939840.png,0,0.992836535,419,42,805,428,386,386,rarity
1942304.png,https://derpicdn.net/img/view/2019/1/23/1942304.png,0,0.996598601,476,173,2624,2321,2148,2148,rarity
1944452.png,https://derpicdn.net/img/view/2019/1/25/1944452.png,0,0.998764515,18,0,538,500,520,500,rarity
1953742.png,https://derpicdn.net/img/view/2019/2/4/1953742.png,0,0.987815559,0,79,650,745,650,666,rarity
1958872.png,https://derpicdn.net/img/view/2019/2/11/1958872.png,0,0.962949872,417,104,2401,2088,1984,1984,rarity
1960621.png,https://derpicdn.net/img/view/2019/2/13/1960621.png,0,0.968333781,267,32,1157,930,890,898,rarity
1960902.png,https://derpicdn.net/img/view/2019/2/13/1960902.png,0,0.99387008,119,0,365,246,246,246,rarity
1965480.png,https://derpicdn.net/img/view/2019/2/18/1965480.png,0,0.982716858,0,0,1502,1317,1502,1317,rarity
1975144.png,https://derpicdn.net/img/view/2019/3/2/1975144.png,0,0.961709201,108,0,880,742,772,742,rarity
1976398.png,https://derpicdn.net/img/view/2019/3/3/1976398.png,0,0.986142516,0,0,1176,1127,1176,1127,rarity
1977607.png,https://derpicdn.net/img/view/2019/3/4/1977607.png,0,0.99819994,46,0,980,871,934,871,rarity
1980517.png,https://derpicdn.net/img/view/2019/3/8/1980517.png,0,0.960956275,638,210,1052,624,414,414,rarity
1981388.png,https://derpicdn.net/img/view/2019/3/9/1981388.png,0,0.985521257,288,182,3156,3050,2868,2868,rarity
1986362.png,https://derpicdn.net/img/view/2019/3/15/1986362.png,0,0.938048542,0,97,521,621,521,524,rarity
1990188.png,https://derpicdn.net/img/view/2019/3/19/1990188.png,0,0.907470942,206,56,694,544,488,488,rarity
1992850.png,https://derpicdn.net/img/view/2019/3/23/1992850.png,0,0.914403975,68,136,768,836,700,700,rarity
2003075.png,https://derpicdn.net/img/view/2019/4/4/2003075.png,0,0.985230207,0,0,368,405,368,405,rarity
2003379.png,https://derpicdn.net/img/view/2019/4/5/2003379.png,0,0.997460008,74,392,764,1082,690,690,rarity
2013614.png,https://derpicdn.net/img/view/2019/4/15/2013614.png,0,0.997886658,1306,0,2618,1247,1312,1247,rarity
2015170.png,https://derpicdn.net/img/view/2019/4/17/2015170.png,0,0.99080199,348,77,1418,1147,1070,1070,rarity
2017852.png,https://derpicdn.net/img/view/2019/4/20/2017852.png,0,0.970940113,63,0,753,578,690,578,rarity
2020181.png,https://derpicdn.net/img/view/2019/4/22/2020181.png,0,0.99741286,844,129,2422,1707,1578,1578,rarity
2021161.png,https://derpicdn.net/img/view/2019/4/23/2021161.png,0,0.994025528,834,0,2618,1378,1784,1378,rarity
2029016.png,https://derpicdn.net/img/view/2019/5/2/2029016.png,0,0.999188602,629,78,1553,1002,924,924,rarity
2030231.png,https://derpicdn.net/img/view/2019/5/4/2030231.png,0,0.982869685,20,0,408,376,388,376,rarity
2031445.png,https://derpicdn.net/img/view/2019/5/5/2031445.png,0,0.983288825,127,0,1579,1080,1452,1080,rarity
2047089.png,https://derpicdn.net/img/view/2019/5/23/2047089.png,0,0.979519188,164,0,664,486,500,486,rarity
2056554.png,https://derpicdn.net/img/view/2019/6/3/2056554.png,0,0.932151854,0,19,1280,1479,1280,1460,rarity
2057222.png,https://derpicdn.net/img/view/2019/6/3/2057222.png,0,0.98846966,0,0,223,271,223,271,rarity
2061027.png,https://derpicdn.net/img/view/2019/6/8/2061027.png,0,0.965083599,101,310,981,1190,880,880,rarity
2061074.png,https://derpicdn.net/img/view/2019/6/9/2061074.png,0,0.998741329,65,39,719,693,654,654,rarity
2061645.png,https://derpicdn.net/img/view/2019/6/9/2061645.png,0,0.987032115,0,0,627,613,627,613,rarity
2075094.png,https://derpicdn.net/img/view/2019/6/25/2075094.png,0,0.999884486,694,0,1566,773,872,773,rarity
2077100.png,https://derpicdn.net/img/view/2019/6/28/2077100.png,0,0.995931089,145,0,1279,1065,1134,1065,rarity
2081706.png,https://derpicdn.net/img/view/2019/7/3/2081706.png,0,0.999482632,587,261,1403,1077,816,816,rarity
2084706.png,https://derpicdn.net/img/view/2019/7/6/2084706.png,0,0.989868045,0,0,563,540,563,540,rarity
2089718.png,https://derpicdn.net/img/view/2019/7/12/2089718.png,0,0.990487814,0,0,2101,2503,2101,2503,rarity
2092872.png,https://derpicdn.net/img/view/2019/7/16/2092872.png,0,0.981023431,26,0,412,369,386,369,rarity
2096764.png,https://derpicdn.net/img/view/2019/7/20/2096764.png,0,0.918612003,166,69,436,339,270,270,rarity
2099793.png,https://derpicdn.net/img/view/2019/7/24/2099793.png,0,0.994106412,310,0,2424,1991,2114,1991,rarity
2102922.png,https://derpicdn.net/img/view/2019/7/28/2102922.png,0,0.94233191,1191,883,1973,1665,782,782,rarity
2103969.png,https://derpicdn.net/img/view/2019/7/29/2103969.png,0,0.937436342,1613,172,2505,1064,892,892,rarity
2108877.png,https://derpicdn.net/img/view/2019/8/4/2108877.png,0,0.907370329,186,120,1454,1388,1268,1268,rarity
2113671.png,https://derpicdn.net/img/view/2019/8/10/2113671.png,0,0.97397846,388,50,2434,2096,2046,2046,rarity
2132453.png,https://derpicdn.net/img/view/2019/8/31/2132453.png,0,0.987763941,910,30,1736,856,826,826,rarity
2138250.png,https://derpicdn.net/img/view/2019/9/7/2138250.png,0,0.98491466,439,224,769,554,330,330,rarity
2140594.png,https://derpicdn.net/img/view/2019/9/10/2140594.png,0,0.982601821,187,742,1547,2102,1360,1360,rarity
2141297.png,https://derpicdn.net/img/view/2019/9/11/2141297.png,0,0.954120457,0,0,314,356,314,356,rarity
2141297.png,https://derpicdn.net/img/view/2019/9/11/2141297.png,1,0.953573823,45,0,359,340,314,340,rarity
2145853.png,https://derpicdn.net/img/view/2019/9/16/2145853.png,0,0.998880148,200,4,922,726,722,722,rarity
2147266.png,https://derpicdn.net/img/view/2019/9/18/2147266.png,0,0.936353922,421,45,1569,1193,1148,1148,rarity
2147794.png,https://derpicdn.net/img/view/2019/9/19/2147794.png,0,0.991239071,139,0,1019,873,880,873,rarity
2150867.png,https://derpicdn.net/img/view/2019/9/23/2150867.png,0,0.921879232,293,65,639,411,346,346,rarity
2154611.png,https://derpicdn.net/img/view/2019/9/28/2154611.png,0,0.999375224,2081,413,3617,1949,1536,1536,rarity
2154636.png,https://derpicdn.net/img/view/2019/9/28/2154636.png,0,0.993871391,276,57,596,377,320,320,rarity
2172752.png,https://derpicdn.net/img/view/2019/10/18/2172752.png,0,0.983521163,639,45,2473,1879,1834,1834,rarity
2174792.png,https://derpicdn.net/img/view/2019/10/20/2174792.png,0,0.980830729,220,32,440,252,220,220,rarity
2176479.png,https://derpicdn.net/img/view/2019/10/22/2176479.png,0,0.987581909,270,6,648,384,378,378,rarity
2180290.png,https://derpicdn.net/img/view/2019/10/27/2180290.png,0,0.97909826,242,155,1348,1261,1106,1106,rarity
2188446.png,https://derpicdn.net/img/view/2019/11/5/2188446.png,0,0.903623879,638,74,2470,1906,1832,1832,rarity
2192657.png,https://derpicdn.net/img/view/2019/11/10/2192657.png,0,0.983317256,43,0,1403,1045,1360,1045,rarity
2196293.png,https://derpicdn.net/img/view/2019/11/15/2196293.png,0,0.979043782,26,0,1042,977,1016,977,rarity
2198954.png,https://derpicdn.net/img/view/2019/11/17/2198954.png,0,0.956920743,482,181,2118,1817,1636,1636,rarity
2204405.png,https://derpicdn.net/img/view/2019/11/24/2204405.png,0,0.994995892,62,0,836,748,774,748,rarity
2212414.png,https://derpicdn.net/img/view/2019/12/4/2212414.png,0,0.922792315,1594,0,3158,1562,1564,1562,rarity
2216096.png,https://derpicdn.net/img/view/2019/12/8/2216096.png,0,0.950903356,132,0,778,620,646,620,rarity
2216535.png,https://derpicdn.net/img/view/2019/12/9/2216535.png,0,0.992271602,786,0,1636,845,850,845,rarity
2224101.png,https://derpicdn.net/img/view/2019/12/19/2224101.png,0,0.979901731,207,111,906,855,699,744,rarity
22294.jpg,https://derpicdn.net/img/view/2012/6/27/22294.jpg,0,0.960802794,0,55,719,849,719,794,rarity
2231515.png,https://derpicdn.net/img/view/2019/12/27/2231515.png,0,0.992297709,513,0,1237,705,724,705,rarity
2232217.png,https://derpicdn.net/img/view/2019/12/28/2232217.png,0,0.993745863,401,70,2687,2356,2286,2286,rarity
2240767.png,https://derpicdn.net/img/view/2020/1/7/2240767.png,0,0.904472888,723,0,1197,442,474,442,rarity
2244258.png,https://derpicdn.net/img/view/2020/1/11/2244258.png,0,0.99773097,586,182,816,412,230,230,rarity
2247684.jpg,https://derpicdn.net/img/view/2020/1/15/2247684.jpg,0,0.994453073,333,0,1003,667,670,667,rarity
2253117.jpg,https://derpicdn.net/img/view/2020/1/21/2253117.jpg,0,0.973337471,0,0,378,382,378,382,rarity
2254466.png,https://derpicdn.net/img/view/2020/1/23/2254466.png,0,0.910296321,3563,282,7097,3816,3534,3534,rarity
2263859.png,https://derpicdn.net/img/view/2020/2/2/2263859.png,0,0.996245265,866,2701,1922,3757,1056,1056,rarity
2263859.png,https://derpicdn.net/img/view/2020/2/2/2263859.png,1,0.951149046,894,0,2060,1126,1166,1126,rarity
22660.png,https://derpicdn.net/img/view/2012/6/27/22660.png,0,0.979772389,204,26,624,446,420,420,rarity
2266827.jpg,https://derpicdn.net/img/view/2020/2/6/2266827.jpg,0,0.996348023,551,420,1191,1060,640,640,rarity
2267320.png,https://derpicdn.net/img/view/2020/2/6/2267320.png,0,0.961652577,3465,3410,4045,3990,580,580,rarity
2268022.png,https://derpicdn.net/img/view/2020/2/7/2268022.png,0,0.998848677,949,0,2295,1288,1346,1288,rarity
2269042.png,https://derpicdn.net/img/view/2020/2/8/2269042.png,0,0.994784236,548,119,2541,2275,1993,2156,rarity
2273450.png,https://derpicdn.net/img/view/2020/2/13/2273450.png,0,0.943924069,215,5,547,337,332,332,rarity
2278336.png,https://derpicdn.net/img/view/2020/2/19/2278336.png,0,0.998920977,356,32,1016,692,660,660,rarity
2281879.png,https://derpicdn.net/img/view/2020/2/23/2281879.png,0,0.933258712,198,1070,1080,1920,882,850,rarity
2287974.png,https://derpicdn.net/img/view/2020/3/2/2287974.png,0,0.999006033,413,0,1143,702,730,702,rarity
2290539.png,https://derpicdn.net/img/view/2020/3/5/2290539.png,0,0.97779566,414,226,3000,3399,2586,3173,rarity
2290539.png,https://derpicdn.net/img/view/2020/3/5/2290539.png,1,0.96872735,0,495,2722,3271,2722,2776,rarity
2294181.jpg,https://derpicdn.net/img/view/2020/3/10/2294181.jpg,0,0.993840456,182,0,1078,779,896,779,rarity
2298874.png,https://derpicdn.net/img/view/2020/3/16/2298874.png,0,0.982351661,0,19,454,613,454,594,rarity
2301120.jpg,https://derpicdn.net/img/view/2020/3/19/2301120.jpg,0,0.997968316,1547,71,3015,1539,1468,1468,rarity
2301390.png,https://derpicdn.net/img/view/2020/3/19/2301390.png,0,0.998428285,36,3,576,543,540,540,rarity
2302498.png,https://derpicdn.net/img/view/2020/3/21/2302498.png,0,0.998060286,1528,0,2832,1364,1304,1364,rarity
2302498.png,https://derpicdn.net/img/view/2020/3/21/2302498.png,1,0.997762144,172,1772,1660,3260,1488,1488,rarity
2308707.png,https://derpicdn.net/img/view/2020/3/29/2308707.png,0,0.933698595,1575,480,3203,2108,1628,1628,rarity
2309410.jpg,https://derpicdn.net/img/view/2020/3/30/2309410.jpg,0,0.98545754,29,0,789,686,760,686,rarity
2311945.png,https://derpicdn.net/img/view/2020/4/2/2311945.png,0,0.995450616,90,56,402,368,312,312,rarity
2313597.png,https://derpicdn.net/img/view/2020/4/4/2313597.png,0,0.969893992,0,0,735,785,735,785,rarity
23153.png,https://derpicdn.net/img/view/2012/6/27/23153.png,0,0.990633547,72,0,700,608,628,608,rarity
2317191.png,https://derpicdn.net/img/view/2020/4/8/2317191.png,0,0.999645829,212,344,880,1012,668,668,rarity
2317514.jpg,https://derpicdn.net/img/view/2020/4/8/2317514.jpg,0,0.949578226,0,0,203,254,203,254,rarity
2318082.png,https://derpicdn.net/img/view/2020/4/9/2318082.png,0,0.963736832,226,64,736,574,510,510,rarity
2325687.png,https://derpicdn.net/img/view/2020/4/18/2325687.png,0,0.995931983,1480,0,2880,1089,1400,1089,rarity
2331580.jpg,https://derpicdn.net/img/view/2020/4/25/2331580.jpg,0,0.992368221,120,0,1624,1436,1504,1436,rarity
2336126.png,https://derpicdn.net/img/view/2020/5/1/2336126.png,0,0.968680501,0,0,685,711,685,711,rarity
2336162.png,https://derpicdn.net/img/view/2020/5/1/2336162.png,0,0.994215429,364,0,716,350,352,350,rarity
2338854.jpg,https://derpicdn.net/img/view/2020/5/4/2338854.jpg,0,0.999121964,592,169,1140,717,548,548,rarity
2340247.png,https://derpicdn.net/img/view/2020/5/5/2340247.png,0,0.998660088,61,18,273,230,212,212,rarity
2340417.jpg,https://derpicdn.net/img/view/2020/5/5/2340417.jpg,0,0.945733011,380,830,1332,1782,952,952,rarity
2346619.png,https://derpicdn.net/img/view/2020/5/12/2346619.png,0,0.978685796,74,0,434,359,360,359,rarity
2347454.jpg,https://derpicdn.net/img/view/2020/5/13/2347454.jpg,0,0.969575107,5,80,780,932,775,852,rarity
2348717.png,https://derpicdn.net/img/view/2020/5/14/2348717.png,0,0.944641948,0,43,730,807,730,764,rarity
2349898.png,https://derpicdn.net/img/view/2020/5/16/2349898.png,0,0.963792086,112,28,600,516,488,488,rarity
2351170.png,https://derpicdn.net/img/view/2020/5/17/2351170.png,0,0.998220921,2857,0,5431,2216,2574,2216,rarity
2354660.jpg,https://derpicdn.net/img/view/2020/5/21/2354660.jpg,0,0.994996369,0,0,805,725,805,725,rarity
237882.png,https://derpicdn.net/img/view/2013/2/9/237882.png,0,0.979824364,483,65,779,361,296,296,rarity
239484.png,https://derpicdn.net/img/view/2013/2/10/239484.png,0,0.96867615,641,23,1057,439,416,416,rarity
260725.png,https://derpicdn.net/img/view/2013/3/3/260725.png,0,0.986052632,177,0,559,342,382,342,rarity
2671.jpg,https://derpicdn.net/img/view/2012/1/29/2671.jpg,0,0.916730046,17,0,633,591,616,591,rarity
268372.png,https://derpicdn.net/img/view/2013/3/11/268372.png,0,0.998862982,0,35,329,373,329,338,rarity
268372.png,https://derpicdn.net/img/view/2013/3/11/268372.png,1,0.995593607,622,43,945,377,323,334,rarity
280401.png,https://derpicdn.net/img/view/2013/3/27/280401.png,0,0.98897028,189,51,451,313,262,262,rarity
28306.jpg,https://derpicdn.net/img/view/2012/7/2/28306.jpg,0,0.98180002,0,0,596,566,596,566,rarity
295023.jpg,https://derpicdn.net/img/view/2013/4/11/295023.jpg,0,0.948470712,426,28,840,442,414,414,rarity
297857.png,https://derpicdn.net/img/view/2013/4/14/297857.png,0,0.935855746,255,257,555,557,300,300,rarity
300992.jpg,https://derpicdn.net/img/view/2013/4/17/300992.jpg,0,0.99839747,9,0,299,275,290,275,rarity
305766.png,https://derpicdn.net/img/view/2013/4/22/305766.png,0,0.97950834,16,25,204,213,188,188,rarity
306326.png,https://derpicdn.net/img/view/2013/4/23/306326.png,0,0.998156548,119,3,367,251,248,248,rarity
309653.png,https://derpicdn.net/img/view/2013/4/27/309653.png,0,0.95698595,34,35,474,475,440,440,rarity
32027.png,https://derpicdn.net/img/view/2012/7/5/32027.png,0,0.98149091,98,0,596,453,498,453,rarity
329151.png,https://derpicdn.net/img/view/2013/5/20/329151.png,0,0.978551149,39,30,422,367,383,337,rarity
329649.png,https://derpicdn.net/img/view/2013/5/20/329649.png,0,0.997547805,62,0,404,342,342,342,rarity
34005.png,https://derpicdn.net/img/view/2012/7/6/34005.png,0,0.973829091,1303,126,2761,1584,1458,1458,rarity
346128.png,https://derpicdn.net/img/view/2013/6/11/346128.png,0,0.937016308,332,0,908,574,576,574,rarity
350067.jpg,https://derpicdn.net/img/view/2013/6/16/350067.jpg,0,0.999634624,573,0,1057,476,484,476,rarity
350834.png,https://derpicdn.net/img/view/2013/6/17/350834.png,0,0.992368162,328,0,800,419,472,419,rarity
357363.jpg,https://derpicdn.net/img/view/2013/6/26/357363.jpg,0,0.919257462,479,11,853,385,374,374,rarity
372018.png,https://derpicdn.net/img/view/2013/7/12/372018.png,0,0.946995914,835,6,1537,708,702,702,rarity
379568.png,https://derpicdn.net/img/view/2013/7/20/379568.png,0,0.998302639,249,63,499,313,250,250,rarity
383584.png,https://derpicdn.net/img/view/2013/7/25/383584.png,0,0.994141459,749,1417,1025,1767,276,350,rarity
389365.png,https://derpicdn.net/img/view/2013/8/2/389365.png,0,0.981975555,160,182,916,938,756,756,rarity
389676.png,https://derpicdn.net/img/view/2013/8/2/389676.png,0,0.964045048,811,1077,1615,1881,804,804,rarity
408951.png,https://derpicdn.net/img/view/2013/8/24/408951.png,0,0.950397015,0,27,706,897,706,870,rarity
419571.png,https://derpicdn.net/img/view/2013/9/5/419571.png,0,0.977164268,327,10,649,332,322,322,rarity
42565.png,https://derpicdn.net/img/view/2012/7/13/42565.png,0,0.94002074,119,0,575,420,456,420,rarity
430803.jpg,https://derpicdn.net/img/view/2013/9/19/430803.jpg,0,0.921203434,284,101,772,589,488,488,rarity
431892.png,https://derpicdn.net/img/view/2013/9/21/431892.png,0,0.982010424,436,177,920,661,484,484,rarity
441937.png,https://derpicdn.net/img/view/2013/10/5/441937.png,0,0.978301585,0,0,564,583,564,583,rarity
447615.png,https://derpicdn.net/img/view/2013/10/13/447615.png,0,0.975632489,580,0,4170,3511,3590,3511,rarity
449804.png,https://derpicdn.net/img/view/2013/10/16/449804.png,0,0.939382434,178,0,516,326,338,326,rarity
450377.jpg,https://derpicdn.net/img/view/2013/10/17/450377.jpg,0,0.939192653,0,0,450,396,450,396,rarity
456802.png,https://derpicdn.net/img/view/2013/10/26/456802.png,0,0.994887888,440,51,784,395,344,344,rarity
468728.png,https://derpicdn.net/img/view/2013/11/10/468728.png,0,0.984417439,17,15,1387,1374,1370,1359,rarity
481494.png,https://derpicdn.net/img/view/2013/11/25/481494.png,0,0.990346611,155,0,523,358,368,358,rarity
482493.png,https://derpicdn.net/img/view/2013/11/26/482493.png,0,0.997544944,699,0,1193,464,494,464,rarity
485668.png,https://derpicdn.net/img/view/2013/11/30/485668.png,0,0.996414244,302,0,852,497,550,497,rarity
487580.png,https://derpicdn.net/img/view/2013/12/2/487580.png,0,0.984987676,211,4,557,350,346,346,rarity
496147.jpg,https://derpicdn.net/img/view/2013/12/13/496147.jpg,0,0.998133838,816,0,1124,296,308,296,rarity
515155.png,https://derpicdn.net/img/view/2014/1/4/515155.png,0,0.995277226,4,0,1286,768,1282,768,rarity
520605.jpg,https://derpicdn.net/img/view/2014/1/11/520605.jpg,0,0.991296053,615,0,1387,736,772,736,rarity
52065.jpg,https://derpicdn.net/img/view/2012/7/21/52065.jpg,0,0.995352983,177,0,653,470,476,470,rarity
525285.png,https://derpicdn.net/img/view/2014/1/15/525285.png,0,0.984915316,157,32,557,432,400,400,rarity
525652.jpg,https://derpicdn.net/img/view/2014/1/16/525652.jpg,0,0.996936083,192,0,754,535,562,535,rarity
525889.jpg,https://derpicdn.net/img/view/2014/1/16/525889.jpg,0,0.987963021,111,15,555,459,444,444,rarity
530072.jpg,https://derpicdn.net/img/view/2014/1/20/530072.jpg,0,0.904421389,328,347,1572,1591,1244,1244,rarity
530425.png,https://derpicdn.net/img/view/2014/1/21/530425.png,0,0.986476123,82,0,1284,1124,1202,1124,rarity
538092.png,https://derpicdn.net/img/view/2014/1/30/538092.png,0,0.995226324,448,132,826,510,378,378,rarity
538092.png,https://derpicdn.net/img/view/2014/1/30/538092.png,1,0.986876428,118,182,516,580,398,398,rarity
539651.png,https://derpicdn.net/img/view/2014/1/31/539651.png,0,0.927150428,131,0,505,355,374,355,rarity
540387.png,https://derpicdn.net/img/view/2014/2/1/540387.png,0,0.984351397,448,398,674,624,226,226,rarity
540387.png,https://derpicdn.net/img/view/2014/2/1/540387.png,1,0.92516309,204,302,512,610,308,308,rarity
541635.png,https://derpicdn.net/img/view/2014/2/2/541635.png,0,0.912533581,271,0,773,496,502,496,rarity
543002.png,https://derpicdn.net/img/view/2014/2/4/543002.png,0,0.955842793,2186,175,3086,1075,900,900,rarity
550452.png,https://derpicdn.net/img/view/2014/2/13/550452.png,0,0.997062027,318,0,744,420,426,420,rarity
567284.jpg,https://derpicdn.net/img/view/2014/3/5/567284.jpg,0,0.953952372,229,0,719,485,490,485,rarity
574442.png,https://derpicdn.net/img/view/2014/3/14/574442.png,0,0.926410258,692,92,3378,2778,2686,2686,rarity
576795.png,https://derpicdn.net/img/view/2014/3/16/576795.png,0,0.994821072,346,78,692,424,346,346,rarity
577766.png,https://derpicdn.net/img/view/2014/3/17/577766.png,0,0.991993606,374,123,742,491,368,368,rarity
57925.png,https://derpicdn.net/img/view/2012/7/26/57925.png,0,0.94731003,45,0,553,508,508,508,rarity
584025.png,https://derpicdn.net/img/view/2014/3/24/584025.png,0,0.998363853,348,0,2890,2453,2542,2453,rarity
587671.png,https://derpicdn.net/img/view/2014/3/29/587671.png,0,0.988031924,220,51,472,303,252,252,rarity
587716.png,https://derpicdn.net/img/view/2014/3/29/587716.png,0,0.947639644,265,29,559,323,294,294,rarity
596069.png,https://derpicdn.net/img/view/2014/4/8/596069.png,0,0.994311631,137,34,529,426,392,392,rarity
597249.jpg,https://derpicdn.net/img/view/2014/4/10/597249.jpg,0,0.995876968,138,0,494,304,356,304,rarity
598621.png,https://derpicdn.net/img/view/2014/4/12/598621.png,0,0.985497117,98,0,618,514,520,514,rarity
608316.png,https://derpicdn.net/img/view/2014/4/24/608316.png,0,0.977024913,23,0,505,482,482,482,rarity
608478.png,https://derpicdn.net/img/view/2014/4/24/608478.png,0,0.96077013,291,0,571,277,280,277,rarity
610988.png,https://derpicdn.net/img/view/2014/4/27/610988.png,0,0.980081499,475,293,1083,901,608,608,rarity
612942.png,https://derpicdn.net/img/view/2014/4/29/612942.png,0,0.996073902,53,0,3011,2888,2958,2888,rarity
62331.png,https://derpicdn.net/img/view/2012/7/30/62331.png,0,0.991376996,310,0,636,291,326,291,rarity
6259.png,https://derpicdn.net/img/view/2012/6/18/6259.png,0,0.993465781,742,545,1050,853,308,308,rarity
642021.jpg,https://derpicdn.net/img/view/2014/6/1/642021.jpg,0,0.908630073,46,0,394,320,348,320,rarity
648346.png,https://derpicdn.net/img/view/2014/6/8/648346.png,0,0.966018736,232,0,916,668,684,668,rarity
652728.png,https://derpicdn.net/img/view/2014/6/14/652728.png,0,0.974389434,654,0,1298,578,644,578,rarity
654523.png,https://derpicdn.net/img/view/2014/6/16/654523.png,0,0.998222351,0,0,1059,968,1059,968,rarity
659199.png,https://derpicdn.net/img/view/2014/6/22/659199.png,0,0.9641729,180,0,848,642,668,642,rarity
660452.png,https://derpicdn.net/img/view/2014/6/24/660452.png,0,0.99405998,442,0,882,415,440,415,rarity
662461.png,https://derpicdn.net/img/view/2014/6/27/662461.png,0,0.980757177,244,0,894,622,650,622,rarity
671922.png,https://derpicdn.net/img/view/2014/7/10/671922.png,0,0.994107962,262,17,556,311,294,294,rarity
675582.png,https://derpicdn.net/img/view/2014/7/15/675582.png,0,0.970539033,13,0,529,512,516,512,rarity
676145.png,https://derpicdn.net/img/view/2014/7/16/676145.png,0,0.990501225,43,0,395,336,352,336,rarity
676875.png,https://derpicdn.net/img/view/2014/7/17/676875.png,0,0.980042219,115,68,600,596,485,528,rarity
677713.png,https://derpicdn.net/img/view/2014/7/18/677713.png,0,0.975962043,0,0,272,224,272,224,rarity
692664.png,https://derpicdn.net/img/view/2014/8/6/692664.png,0,0.996522188,170,18,1280,1128,1110,1110,rarity
692737.png,https://derpicdn.net/img/view/2014/8/6/692737.png,0,0.983397663,830,155,1868,1193,1038,1038,rarity
699808.png,https://derpicdn.net/img/view/2014/8/14/699808.png,0,0.994088948,83,0,575,409,492,409,rarity
70053.jpg,https://derpicdn.net/img/view/2012/8/8/70053.jpg,0,0.963813305,141,0,729,568,588,568,rarity
702355.jpg,https://derpicdn.net/img/view/2014/8/18/702355.jpg,0,0.975307882,112,0,828,592,716,592,rarity
704362.png,https://derpicdn.net/img/view/2014/8/20/704362.png,0,0.972753465,159,136,481,458,322,322,rarity
705400.png,https://derpicdn.net/img/view/2014/8/22/705400.png,0,0.969422221,284,373,3084,3173,2800,2800,rarity
709574.png,https://derpicdn.net/img/view/2014/8/28/709574.png,0,0.974458575,73,0,1217,1116,1144,1116,rarity
726387.jpg,https://derpicdn.net/img/view/2014/9/21/726387.jpg,0,0.967082739,0,71,1000,1117,1000,1046,rarity
7387.jpg,https://derpicdn.net/img/view/2012/6/18/7387.jpg,0,0.935171008,26,0,636,524,610,524,rarity
748440.png,https://derpicdn.net/img/view/2014/10/22/748440.png,0,0.995239019,307,0,817,489,510,489,rarity
748440.png,https://derpicdn.net/img/view/2014/10/22/748440.png,1,0.979945123,819,0,1317,495,498,495,rarity
760142.png,https://derpicdn.net/img/view/2014/11/7/760142.png,0,0.989257693,33,0,671,606,638,606,rarity
76383.png,https://derpicdn.net/img/view/2012/8/17/76383.png,0,0.986056566,1407,51,2517,1161,1110,1110,rarity
767886.png,https://derpicdn.net/img/view/2014/11/19/767886.png,0,0.9845801,1141,8,2447,1314,1306,1306,rarity
772589.png,https://derpicdn.net/img/view/2014/11/27/772589.png,0,0.994282007,255,0,589,325,334,325,rarity
7813.jpg,https://derpicdn.net/img/view/2012/6/18/7813.jpg,1,0.96961689,333,485,659,811,326,326,rarity
787168.png,https://derpicdn.net/img/view/2014/12/18/787168.png,0,0.994444728,774,691,1600,1517,826,826,rarity
797473.png,https://derpicdn.net/img/view/2015/1/1/797473.png,0,0.943017483,72,0,480,404,408,404,rarity
808979.png,https://derpicdn.net/img/view/2015/1/18/808979.png,0,0.940706789,73,51,213,191,140,140,rarity
819478.png,https://derpicdn.net/img/view/2015/2/1/819478.png,0,0.989299059,124,87,532,495,408,408,rarity
827528.png,https://derpicdn.net/img/view/2015/2/13/827528.png,0,0.996931851,152,0,924,754,772,754,rarity
830603.png,https://derpicdn.net/img/view/2015/2/17/830603.png,0,0.98339361,256,0,610,317,354,317,rarity
832716.png,https://derpicdn.net/img/view/2015/2/19/832716.png,0,0.99920249,514,0,1482,967,968,967,rarity
841698.png,https://derpicdn.net/img/view/2015/3/3/841698.png,0,0.992229342,177,94,1013,930,836,836,rarity
841766.jpg,https://derpicdn.net/img/view/2015/3/4/841766.jpg,1,0.993476331,1182,1269,1748,1835,566,566,rarity
843051.png,https://derpicdn.net/img/view/2015/3/5/843051.png,0,0.96414274,0,0,1433,1239,1433,1239,rarity
844844.png,https://derpicdn.net/img/view/2015/3/7/844844.png,0,0.983961582,162,1,658,497,496,496,rarity
851224.png,https://derpicdn.net/img/view/2015/3/17/851224.png,0,0.978259623,442,0,820,359,378,359,rarity
854948.png,https://derpicdn.net/img/view/2015/3/22/854948.png,0,0.982265532,274,43,748,517,474,474,rarity
862713.png,https://derpicdn.net/img/view/2015/4/2/862713.png,0,0.998698473,381,10,777,406,396,396,rarity
863556.png,https://derpicdn.net/img/view/2015/4/3/863556.png,0,0.99988842,118,0,512,351,394,351,rarity
872100.png,https://derpicdn.net/img/view/2015/4/12/872100.png,0,0.971308351,0,0,1143,1269,1143,1269,rarity
877919.png,https://derpicdn.net/img/view/2015/4/19/877919.png,0,0.967790604,280,0,1192,810,912,810,rarity
885360.png,https://derpicdn.net/img/view/2015/4/29/885360.png,0,0.957253933,84,0,418,329,334,329,rarity
888304.png,https://derpicdn.net/img/view/2015/5/3/888304.png,0,0.947772324,316,0,1586,1024,1270,1024,rarity
890361.png,https://derpicdn.net/img/view/2015/5/6/890361.png,0,0.991740227,52,9,386,343,334,334,rarity
898414.png,https://derpicdn.net/img/view/2015/5/17/898414.png,0,0.960748196,130,0,440,287,310,287,rarity
906177.png,https://derpicdn.net/img/view/2015/5/29/906177.png,0,0.988554776,220,92,480,352,260,260,rarity
91364.jpg,https://derpicdn.net/img/view/2012/9/6/91364.jpg,0,0.995786548,224,132,638,546,414,414,rarity
915780.png,https://derpicdn.net/img/view/2015/6/13/915780.png,0,0.997892141,668,321,944,597,276,276,rarity
920570.png,https://derpicdn.net/img/view/2015/6/20/920570.png,0,0.970987976,4,3,238,237,234,234,rarity
925289.png,https://derpicdn.net/img/view/2015/6/28/925289.png,0,0.994211972,1623,0,2997,1303,1374,1303,rarity
934775.png,https://derpicdn.net/img/view/2015/7/11/934775.png,0,0.982365191,3,10,499,506,496,496,rarity
936610.png,https://derpicdn.net/img/view/2015/7/13/936610.png,0,0.98710978,54,0,2718,2639,2664,2639,rarity
946533.png,https://derpicdn.net/img/view/2015/7/29/946533.png,0,0.978467286,208,0,546,334,338,334,rarity
946756.png,https://derpicdn.net/img/view/2015/7/29/946756.png,0,0.978545845,530,24,1290,784,760,760,rarity
957868.png,https://derpicdn.net/img/view/2015/8/14/957868.png,0,0.963352799,234,0,932,627,698,627,rarity
960526.png,https://derpicdn.net/img/view/2015/8/18/960526.png,0,0.990012825,1580,84,2938,1612,1358,1528,rarity
961207.png,https://derpicdn.net/img/view/2015/8/19/961207.png,0,0.970800877,387,200,745,558,358,358,rarity
964755.jpg,https://derpicdn.net/img/view/2015/8/24/964755.jpg,0,0.990171969,448,7,1010,569,562,562,rarity
1009672.png,https://derpicdn.net/img/view/2015/10/25/1009672.png,0,0.971912384,963,1921,2163,3121,1200,1200,rarity
101296.png,https://derpicdn.net/img/view/2012/9/18/101296.png,0,0.996709049,53,125,401,473,348,348,rarity
1013315.jpg,https://derpicdn.net/img/view/2015/10/31/1013315.jpg,0,0.964246392,0,53,614,673,614,620,rarity
1021015.png,https://derpicdn.net/img/view/2015/11/11/1021015.png,0,0.996135354,260,16,976,732,716,716,rarity
1033629.png,https://derpicdn.net/img/view/2015/11/30/1033629.png,0,0.94422543,283,0,1366,768,1083,768,rarity
1037719.jpg,https://derpicdn.net/img/view/2015/12/5/1037719.jpg,0,0.981333733,200,99,2702,2601,2502,2502,rarity
1045344.png,https://derpicdn.net/img/view/2015/12/16/1045344.png,0,0.975921333,322,0,688,362,366,362,rarity
1045924.png,https://derpicdn.net/img/view/2015/12/16/1045924.png,0,0.999194324,1,0,499,487,498,487,rarity
1058030.png,https://derpicdn.net/img/view/2016/1/2/1058030.png,0,0.989176452,131,499,665,1033,534,534,rarity
1060721.png,https://derpicdn.net/img/view/2016/1/6/1060721.png,0,0.989571691,0,0,2681,2933,2681,2933,rarity
1076818.png,https://derpicdn.net/img/view/2016/1/30/1076818.png,0,0.99131459,918,0,1226,296,308,296,rarity
1076818.png,https://derpicdn.net/img/view/2016/1/30/1076818.png,1,0.974176764,347,0,589,190,242,190,rarity
1081029.png,https://derpicdn.net/img/view/2016/2/5/1081029.png,0,0.953366935,61,15,349,303,288,288,rarity
1081702.png,https://derpicdn.net/img/view/2016/2/6/1081702.png,0,0.998236299,614,137,1268,791,654,654,rarity
1086786.png,https://derpicdn.net/img/view/2016/2/13/1086786.png,0,0.964470208,575,426,3573,3424,2998,2998,rarity
1098843.png,https://derpicdn.net/img/view/2016/2/28/1098843.png,0,0.984461486,352,0,1202,816,850,816,rarity
1101009.png,https://derpicdn.net/img/view/2016/3/3/1101009.png,0,0.916938841,228,228,1330,1330,1102,1102,rarity
1105107.png,https://derpicdn.net/img/view/2016/3/9/1105107.png,0,0.962256372,24,10,600,672,576,662,rarity
1113725.png,https://derpicdn.net/img/view/2016/3/21/1113725.png,0,0.995506167,149,0,557,395,408,395,rarity
1114726.jpg,https://derpicdn.net/img/view/2016/3/22/1114726.jpg,0,0.983111024,67,0,381,307,314,307,rarity
1120286.png,https://derpicdn.net/img/view/2016/3/30/1120286.png,0,0.943734646,2303,326,3451,1474,1148,1148,rarity
1124230.png,https://derpicdn.net/img/view/2016/4/4/1124230.png,0,0.962067604,92,153,732,793,640,640,rarity
112732.png,https://derpicdn.net/img/view/2012/10/3/112732.png,0,0.986467361,469,119,967,617,498,498,rarity
1140340.png,https://derpicdn.net/img/view/2016/4/26/1140340.png,0,0.995556712,1497,649,2437,1589,940,940,rarity
1177526.png,https://derpicdn.net/img/view/2016/6/13/1177526.png,0,0.993268907,305,0,1407,1065,1102,1065,rarity
1181557.png,https://derpicdn.net/img/view/2016/6/19/1181557.png,0,0.989907205,81,79,1239,1237,1158,1158,rarity
1198484.png,https://derpicdn.net/img/view/2016/7/11/1198484.png,0,0.996646166,665,8,1259,602,594,594,rarity
1218517.png,https://derpicdn.net/img/view/2016/8/6/1218517.png,0,0.995722115,0,0,1239,713,1239,713,rarity
1223608.png,https://derpicdn.net/img/view/2016/8/12/1223608.png,0,0.922181666,517,18,878,432,361,414,rarity
1228835.png,https://derpicdn.net/img/view/2016/8/19/1228835.png,0,0.977351189,46,32,1244,1230,1198,1198,rarity
12331.png,https://derpicdn.net/img/view/2012/6/20/12331.png,0,0.995363116,386,763,950,1327,564,564,rarity
1238280.png,https://derpicdn.net/img/view/2016/8/31/1238280.png,0,0.972721696,71,16,397,342,326,326,rarity
1251679.png,https://derpicdn.net/img/view/2016/9/17/1251679.png,0,0.921465039,172,9,562,399,390,390,rarity
1252318.png,https://derpicdn.net/img/view/2016/9/18/1252318.png,0,0.951185346,218,0,2762,2515,2544,2515,rarity
1265635.png,https://derpicdn.net/img/view/2016/10/5/1265635.png,0,0.982897639,82,10,298,226,216,216,rarity
1271682.png,https://derpicdn.net/img/view/2016/10/13/1271682.png,0,0.969242156,0,0,1388,1277,1388,1277,rarity
1286687.png,https://derpicdn.net/img/view/2016/11/1/1286687.png,0,0.960093558,252,74,1838,1720,1586,1646,rarity
1291501.png,https://derpicdn.net/img/view/2016/11/8/1291501.png,0,0.999195755,790,0,3576,2660,2786,2660,rarity
129774.png,https://derpicdn.net/img/view/2012/10/22/129774.png,0,0.990628242,393,0,806,393,413,393,rarity
1328636.png,https://derpicdn.net/img/view/2016/12/30/1328636.png,0,0.999136567,674,75,1166,567,492,492,rarity
1328636.png,https://derpicdn.net/img/view/2016/12/30/1328636.png,1,0.974869847,91,98,565,572,474,474,rarity
1335082.png,https://derpicdn.net/img/view/2017/1/8/1335082.png,0,0.910829067,684,383,1214,913,530,530,rarity
1348461.png,https://derpicdn.net/img/view/2017/1/26/1348461.png,0,0.996606052,3734,0,8448,4222,4714,4222,rarity
1348550.png,https://derpicdn.net/img/view/2017/1/26/1348550.png,0,0.990699649,347,0,1600,1263,1253,1263,rarity
1351671.png,https://derpicdn.net/img/view/2017/1/31/1351671.png,0,0.978352666,200,18,1448,1266,1248,1248,rarity
1365092.png,https://derpicdn.net/img/view/2017/2/17/1365092.png,0,0.992806077,21,2,605,586,584,584,rarity
1374361.png,https://derpicdn.net/img/view/2017/2/27/1374361.png,0,0.923209846,259,251,2467,2459,2208,2208,rarity
1375783.png,https://derpicdn.net/img/view/2017/2/28/1375783.png,0,0.969060242,2800,0,6732,3669,3932,3669,rarity
1376698.png,https://derpicdn.net/img/view/2017/3/1/1376698.png,0,0.987335801,370,0,1720,1277,1350,1277,rarity
1381537.png,https://derpicdn.net/img/view/2017/3/7/1381537.png,0,0.9949072,99,152,1281,1334,1182,1182,rarity
1384821.png,https://derpicdn.net/img/view/2017/3/11/1384821.png,0,0.931705832,161,0,423,252,262,252,rarity
1385653.png,https://derpicdn.net/img/view/2017/3/12/1385653.png,0,0.923564255,982,24,2398,1440,1416,1416,rarity
1390300.png,https://derpicdn.net/img/view/2017/3/18/1390300.png,0,0.989893794,2153,281,3551,1679,1398,1398,rarity
1391179.png,https://derpicdn.net/img/view/2017/3/19/1391179.png,0,0.924329937,93,31,989,927,896,896,rarity
1400514.png,https://derpicdn.net/img/view/2017/3/31/1400514.png,0,0.980939209,186,1082,4290,5000,4104,3918,rarity
1411185.png,https://derpicdn.net/img/view/2017/4/14/1411185.png,0,0.998824656,777,54,1093,370,316,316,rarity
1418323.png,https://derpicdn.net/img/view/2017/4/22/1418323.png,0,0.993454993,31,0,455,371,424,371,rarity
1419284.png,https://derpicdn.net/img/view/2017/4/23/1419284.png,0,0.999019444,251,0,697,440,446,440,rarity
1420703.png,https://derpicdn.net/img/view/2017/4/24/1420703.png,0,0.998978853,155,59,1097,1001,942,942,rarity
1426785.png,https://derpicdn.net/img/view/2017/5/2/1426785.png,0,0.988574862,0,110,579,726,579,616,rarity
1427873.png,https://derpicdn.net/img/view/2017/5/3/1427873.png,0,0.937139452,303,0,947,613,644,613,rarity
1430171.png,https://derpicdn.net/img/view/2017/5/6/1430171.png,0,0.995862842,198,0,1068,838,870,838,rarity
1432780.png,https://derpicdn.net/img/view/2017/5/9/1432780.png,0,0.992581367,261,81,2715,2392,2454,2311,rarity
1433963.png,https://derpicdn.net/img/view/2017/5/11/1433963.png,0,0.962241471,171,80,1663,1590,1492,1510,rarity
1435265.png,https://derpicdn.net/img/view/2017/5/13/1435265.png,0,0.972638249,159,0,900,737,741,737,rarity
1440537.png,https://derpicdn.net/img/view/2017/5/19/1440537.png,0,0.974754512,546,32,950,436,404,404,rarity
1448421.png,https://derpicdn.net/img/view/2017/5/28/1448421.png,0,0.985265672,99,29,381,311,282,282,rarity
1463114.png,https://derpicdn.net/img/view/2017/6/16/1463114.png,0,0.951611519,165,0,2009,1415,1844,1415,rarity
1463720.png,https://derpicdn.net/img/view/2017/6/17/1463720.png,0,0.985882819,19,0,461,427,442,427,rarity
1464415.png,https://derpicdn.net/img/view/2017/6/18/1464415.png,0,0.933262467,968,109,3217,2491,2249,2382,rarity
1472328.png,https://derpicdn.net/img/view/2017/6/26/1472328.png,0,0.980443835,270,0,1504,1184,1234,1184,rarity
1478248.png,https://derpicdn.net/img/view/2017/7/4/1478248.png,0,0.929882765,590,233,1544,1187,954,954,rarity
148490.png,https://derpicdn.net/img/view/2012/11/11/148490.png,0,0.937968135,59,0,417,356,358,356,rarity
148645.jpg,https://derpicdn.net/img/view/2012/11/11/148645.jpg,0,0.931984961,40,24,826,810,786,786,rarity
1487402.png,https://derpicdn.net/img/view/2017/7/16/1487402.png,0,0.97614491,0,0,1105,1083,1105,1083,rarity
1488988.png,https://derpicdn.net/img/view/2017/7/18/1488988.png,0,0.992147207,2064,0,4114,1920,2050,1920,rarity
1491173.png,https://derpicdn.net/img/view/2017/7/21/1491173.png,1,0.975859463,247,576,1353,1682,1106,1106,rarity
1499698.png,https://derpicdn.net/img/view/2017/7/31/1499698.png,0,0.999127269,1165,410,1927,1172,762,762,rarity
1506786.png,https://derpicdn.net/img/view/2017/8/9/1506786.png,0,0.997835994,145,0,1129,955,984,955,rarity
1508917.png,https://derpicdn.net/img/view/2017/8/12/1508917.png,0,0.980822206,20,0,764,718,744,718,rarity
1509786.png,https://derpicdn.net/img/view/2017/8/13/1509786.png,0,0.935864806,0,402,709,1146,709,744,rarity
1512815.png,https://derpicdn.net/img/view/2017/8/17/1512815.png,0,0.928804457,0,0,2263,2244,2263,2244,rarity
1517546.png,https://derpicdn.net/img/view/2017/8/22/1517546.png,0,0.998790503,1517,146,2499,1128,982,982,rarity
1518969.png,https://derpicdn.net/img/view/2017/8/24/1518969.png,0,0.962261796,610,0,2472,1804,1862,1804,rarity
1520676.png,https://derpicdn.net/img/view/2017/8/27/1520676.png,0,0.960511684,257,44,701,488,444,444,rarity
15242.png,https://derpicdn.net/img/view/2012/6/22/15242.png,0,0.997672439,1654,0,3234,1209,1580,1209,rarity
1525538.png,https://derpicdn.net/img/view/2017/9/2/1525538.png,0,0.988317847,225,52,529,356,304,304,rarity
1532690.png,https://derpicdn.net/img/view/2017/9/11/1532690.png,0,0.954615712,1420,73,2244,897,824,824,rarity
1535696.png,https://derpicdn.net/img/view/2017/9/15/1535696.png,0,0.99783808,119,180,483,544,364,364,rarity
1536859.png,https://derpicdn.net/img/view/2017/9/16/1536859.png,0,0.931726217,32,0,764,707,732,707,rarity
1536923.png,https://derpicdn.net/img/view/2017/9/16/1536923.png,0,0.974310994,77,2,409,334,332,332,rarity
1537713.png,https://derpicdn.net/img/view/2017/9/17/1537713.png,0,0.979988098,373,22,1090,675,717,653,rarity
1538472.png,https://derpicdn.net/img/view/2017/9/18/1538472.png,0,0.937027037,2,180,3428,3606,3426,3426,rarity
1539429.png,https://derpicdn.net/img/view/2017/9/19/1539429.png,0,0.969317973,343,102,1559,1380,1216,1278,rarity
1539440.png,https://derpicdn.net/img/view/2017/9/19/1539440.png,0,0.975931704,374,129,1559,1355,1185,1226,rarity
1540748.png,https://derpicdn.net/img/view/2017/9/21/1540748.png,0,0.994225919,102,0,2418,2244,2316,2244,rarity
1542778.png,https://derpicdn.net/img/view/2017/9/23/1542778.png,0,0.997565806,525,245,993,713,468,468,rarity
1544594.png,https://derpicdn.net/img/view/2017/9/25/1544594.png,0,0.980355859,39,0,927,879,888,879,rarity
1547126.png,https://derpicdn.net/img/view/2017/9/28/1547126.png,0,0.996606588,395,88,1047,740,652,652,rarity
1552920.png,https://derpicdn.net/img/view/2017/10/5/1552920.png,0,0.986538649,788,0,4270,3455,3482,3455,rarity
1553651.png,https://derpicdn.net/img/view/2017/10/6/1553651.png,0,0.98216784,76,0,782,675,706,675,rarity
1559840.png,https://derpicdn.net/img/view/2017/10/13/1559840.png,0,0.977674305,119,0,925,763,806,763,rarity
1562237.png,https://derpicdn.net/img/view/2017/10/15/1562237.png,0,0.927897096,41,38,751,748,710,710,rarity
1566579.png,https://derpicdn.net/img/view/2017/10/21/1566579.png,0,0.990080893,2459,225,3840,1667,1381,1442,rarity
1572903.png,https://derpicdn.net/img/view/2017/10/29/1572903.png,0,0.957218289,168,146,4260,4238,4092,4092,rarity
1575489.png,https://derpicdn.net/img/view/2017/11/1/1575489.png,0,0.995311379,1676,62,4020,2406,2344,2344,rarity
1578626.png,https://derpicdn.net/img/view/2017/11/5/1578626.png,0,0.977995872,298,47,1532,1281,1234,1234,rarity
1581982.png,https://derpicdn.net/img/view/2017/11/9/1581982.png,0,0.959058225,1101,23,1565,487,464,464,rarity
1584833.png,https://derpicdn.net/img/view/2017/11/12/1584833.png,0,0.970243156,1428,12,2444,1028,1016,1016,rarity
1588075.png,https://derpicdn.net/img/view/2017/11/17/1588075.png,0,0.973892927,1,0,764,744,763,744,rarity
1588109.png,https://derpicdn.net/img/view/2017/11/17/1588109.png,0,0.909630418,70,66,657,690,587,624,rarity
1588306.png,https://derpicdn.net/img/view/2017/11/17/1588306.png,0,0.954693139,1024,193,2040,1209,1016,1016,rarity
15905.jpg,https://derpicdn.net/img/view/2012/6/22/15905.jpg,0,0.994675934,338,0,618,253,280,253,rarity
1594450.png,https://derpicdn.net/img/view/2017/11/26/1594450.png,0,0.994109094,131,12,669,550,538,538,rarity
1594865.png,https://derpicdn.net/img/view/2017/11/26/1594865.png,0,0.964472592,967,0,2571,1532,1604,1532,rarity
1610969.png,https://derpicdn.net/img/view/2017/12/19/1610969.png,0,0.977436006,997,0,2229,1208,1232,1208,rarity
1611047.png,https://derpicdn.net/img/view/2017/12/19/1611047.png,0,0.955630064,134,2,456,324,322,322,rarity
1613331.png,https://derpicdn.net/img/view/2017/12/22/1613331.png,0,0.960713983,324,118,882,676,558,558,rarity
1623279.png,https://derpicdn.net/img/view/2018/1/3/1623279.png,0,0.993947029,515,126,2609,2220,2094,2094,rarity
1629664.png,https://derpicdn.net/img/view/2018/1/11/1629664.png,0,0.965842009,85,23,329,267,244,244,rarity
1632008.png,https://derpicdn.net/img/view/2018/1/14/1632008.png,0,0.950452089,0,75,4851,5653,4851,5578,rarity
1633324.png,https://derpicdn.net/img/view/2018/1/16/1633324.png,0,0.974695027,257,47,633,423,376,376,rarity
1639529.png,https://derpicdn.net/img/view/2018/1/24/1639529.png,0,0.990058243,140,0,905,760,765,760,rarity
1641053.png,https://derpicdn.net/img/view/2018/1/26/1641053.png,0,0.993321598,1081,0,3025,1942,1944,1942,rarity
1645834.png,https://derpicdn.net/img/view/2018/2/1/1645834.png,0,0.994800389,141,26,857,742,716,716,rarity
1649216.png,https://derpicdn.net/img/view/2018/2/5/1649216.png,1,0.990082383,476,26,800,408,324,382,rarity
1654825.png,https://derpicdn.net/img/view/2018/2/13/1654825.png,0,0.992876649,827,84,2153,1410,1326,1326,rarity
1655147.png,https://derpicdn.net/img/view/2018/2/13/1655147.png,0,0.996708155,427,0,1451,965,1024,965,rarity
1656080.png,https://derpicdn.net/img/view/2018/2/14/1656080.png,0,0.99898541,1120,0,2150,969,1030,969,rarity
1656383.png,https://derpicdn.net/img/view/2018/2/15/1656383.png,0,0.973862946,436,29,804,397,368,368,rarity
1670290.png,https://derpicdn.net/img/view/2018/3/3/1670290.png,0,0.997791588,1213,22,2605,1414,1392,1392,rarity
1683786.png,https://derpicdn.net/img/view/2018/3/18/1683786.png,0,0.995298147,187,0,639,435,452,435,rarity
1687658.png,https://derpicdn.net/img/view/2018/3/22/1687658.png,0,0.977590919,391,0,845,382,454,382,rarity
1688020.png,https://derpicdn.net/img/view/2018/3/23/1688020.png,0,0.987110257,0,0,314,329,314,329,rarity
1695444.png,https://derpicdn.net/img/view/2018/3/31/1695444.png,0,0.956021607,445,28,1021,604,576,576,rarity
170163.png,https://derpicdn.net/img/view/2012/12/2/170163.png,0,0.992126882,895,0,1969,1029,1074,1029,rarity
1703782.png,https://derpicdn.net/img/view/2018/4/9/1703782.png,0,0.99027884,1098,0,1916,769,818,769,rarity
1703904.png,https://derpicdn.net/img/view/2018/4/10/1703904.png,0,0.942441523,472,0,874,376,402,376,rarity
1705142.png,https://derpicdn.net/img/view/2018/4/11/1705142.png,0,0.999426186,248,7,536,295,288,288,rarity
1705241.png,https://derpicdn.net/img/view/2018/4/11/1705241.png,0,0.942061841,497,79,1161,743,664,664,rarity
1709514.png,https://derpicdn.net/img/view/2018/4/16/1709514.png,0,0.992758632,491,9,1431,949,940,940,rarity
1711547.png,https://derpicdn.net/img/view/2018/4/19/1711547.png,0,0.99505204,961,17,1469,525,508,508,rarity
1715405.png,https://derpicdn.net/img/view/2018/4/23/1715405.png,0,0.990658641,80,0,864,749,784,749,rarity
1717558.png,https://derpicdn.net/img/view/2018/4/26/1717558.png,0,0.967327654,2087,31,3355,1299,1268,1268,rarity
1721870.png,https://derpicdn.net/img/view/2018/5/1/1721870.png,0,0.999204814,60,427,668,1035,608,608,rarity
1725278.png,https://derpicdn.net/img/view/2018/5/5/1725278.png,0,0.995899618,316,95,926,705,610,610,rarity
1727340.png,https://derpicdn.net/img/view/2018/5/8/1727340.png,0,0.995039642,202,7,474,279,272,272,rarity
1732380.png,https://derpicdn.net/img/view/2018/5/14/1732380.png,0,0.975825846,0,0,250,343,250,343,rarity
1739441.png,https://derpicdn.net/img/view/2018/5/23/1739441.png,0,0.908627689,211,1,541,331,330,330,rarity
1746261.png,https://derpicdn.net/img/view/2018/5/31/1746261.png,0,0.998945057,64,0,660,569,596,569,rarity
1746953.png,https://derpicdn.net/img/view/2018/6/1/1746953.png,0,0.977178574,548,35,956,443,408,408,rarity
1752866.png,https://derpicdn.net/img/view/2018/6/8/1752866.png,0,0.983826041,59,0,563,471,504,471,rarity
1754083.png,https://derpicdn.net/img/view/2018/6/10/1754083.png,0,0.981111705,334,39,986,691,652,652,rarity
1756215.png,https://derpicdn.net/img/view/2018/6/12/1756215.png,0,0.998192132,306,0,1462,1150,1156,1150,rarity
1758684.png,https://derpicdn.net/img/view/2018/6/16/1758684.png,0,0.989476919,310,0,742,421,432,421,rarity
1761405.png,https://derpicdn.net/img/view/2018/6/19/1761405.png,0,0.999224603,22,0,454,407,432,407,rarity
1767914.png,https://derpicdn.net/img/view/2018/6/28/1767914.png,0,0.978043139,25,154,839,968,814,814,rarity
1768230.png,https://derpicdn.net/img/view/2018/6/28/1768230.png,0,0.977476239,910,778,1412,1280,502,502,rarity
1769507.png,https://derpicdn.net/img/view/2018/6/30/1769507.png,0,0.935096562,301,201,665,565,364,364,rarity
1776748.png,https://derpicdn.net/img/view/2018/7/9/1776748.png,0,0.991893113,213,0,577,363,364,363,rarity
1777393.png,https://derpicdn.net/img/view/2018/7/10/1777393.png,0,0.937935233,1945,862,8151,7068,6206,6206,rarity
1784903.png,https://derpicdn.net/img/view/2018/7/19/1784903.png,0,0.994606256,1909,952,3805,2848,1896,1896,rarity
1789961.png,https://derpicdn.net/img/view/2018/7/26/1789961.png,0,0.988011599,132,0,712,538,580,538,rarity
1794334.png,https://derpicdn.net/img/view/2018/7/31/1794334.png,0,0.942383587,0,342,1010,1402,1010,1060,rarity
1796164.png,https://derpicdn.net/img/view/2018/8/2/1796164.png,0,0.985392332,695,334,2853,2492,2158,2158,rarity
1797448.png,https://derpicdn.net/img/view/2018/8/4/1797448.png,0,0.940845728,657,50,991,384,334,334,rarity
1799722.png,https://derpicdn.net/img/view/2018/8/6/1799722.png,0,0.999617338,352,143,1478,1269,1126,1126,rarity
1800121.png,https://derpicdn.net/img/view/2018/8/6/1800121.png,0,0.988655925,297,79,757,539,460,460,rarity
1802428.png,https://derpicdn.net/img/view/2018/8/9/1802428.png,0,0.985369146,95,0,1153,929,1058,929,rarity
1811576.png,https://derpicdn.net/img/view/2018/8/20/1811576.png,0,0.996403098,115,0,897,774,782,774,rarity
1811897.png,https://derpicdn.net/img/view/2018/8/20/1811897.png,0,0.997001827,2182,800,3394,2012,1212,1212,rarity
1818986.png,https://derpicdn.net/img/view/2018/8/29/1818986.png,0,0.998602748,1145,3,1833,691,688,688,rarity
1829506.png,https://derpicdn.net/img/view/2018/9/10/1829506.png,0,0.996341765,263,3,785,525,522,522,rarity
1835818.png,https://derpicdn.net/img/view/2018/9/18/1835818.png,0,0.995977521,196,19,1154,977,958,958,rarity
184112.png,https://derpicdn.net/img/view/2012/12/16/184112.png,0,0.945542395,145,65,435,355,290,290,rarity
1842876.png,https://derpicdn.net/img/view/2018/9/28/1842876.png,0,0.997738838,520,0,1524,833,1004,833,rarity
1844678.png,https://derpicdn.net/img/view/2018/9/30/1844678.png,0,0.977363586,0,30,720,768,720,738,rarity
1847758.png,https://derpicdn.net/img/view/2018/10/4/1847758.png,0,0.994479716,394,1163,1008,1777,614,614,rarity
1852688.png,https://derpicdn.net/img/view/2018/10/10/1852688.png,0,0.973055243,0,0,1861,1600,1861,1600,rarity
1859461.png,https://derpicdn.net/img/view/2018/10/18/1859461.png,0,0.985157013,0,0,1144,1143,1144,1143,rarity
1867437.png,https://derpicdn.net/img/view/2018/10/27/1867437.png,0,0.910173833,171,59,601,489,430,430,rarity
1867897.png,https://derpicdn.net/img/view/2018/10/27/1867897.png,0,0.927060127,201,0,877,540,676,540,rarity
1868742.png,https://derpicdn.net/img/view/2018/10/28/1868742.png,0,0.981037259,144,0,2280,2113,2136,2113,rarity
1868979.png,https://derpicdn.net/img/view/2018/10/28/1868979.png,0,0.957506061,638,50,2224,1636,1586,1586,rarity
1868996.png,https://derpicdn.net/img/view/2018/10/28/1868996.png,0,0.983332753,11,49,1131,1169,1120,1120,rarity
1882930.png,https://derpicdn.net/img/view/2018/11/15/1882930.png,0,0.997827888,372,100,938,666,566,566,rarity
1885628.png,https://derpicdn.net/img/view/2018/11/19/1885628.png,0,0.98036629,238,0,1000,876,762,876,rarity
1889295.png,https://derpicdn.net/img/view/2018/11/23/1889295.png,0,0.998859286,147,24,1005,882,858,858,rarity
1889524.png,https://derpicdn.net/img/view/2018/11/24/1889524.png,0,0.964909196,207,52,2099,1944,1892,1892,rarity
1890556.png,https://derpicdn.net/img/view/2018/11/25/1890556.png,0,0.999604702,59,37,333,311,274,274,rarity
1890735.png,https://derpicdn.net/img/view/2018/11/25/1890735.png,0,0.999673367,221,1201,713,1693,492,492,rarity
1890735.png,https://derpicdn.net/img/view/2018/11/25/1890735.png,1,0.980684102,1090,1302,1618,1830,528,528,rarity
1890735.png,https://derpicdn.net/img/view/2018/11/25/1890735.png,2,0.965230048,71,54,759,742,688,688,rarity
1900203.png,https://derpicdn.net/img/view/2018/12/6/1900203.png,0,0.987685382,20,0,208,184,188,184,rarity
1901968.png,https://derpicdn.net/img/view/2018/12/8/1901968.png,0,0.981617272,52,31,246,225,194,194,rarity
1903164.png,https://derpicdn.net/img/view/2018/12/9/1903164.png,0,0.969292462,39,0,579,528,540,528,rarity
1903475.png,https://derpicdn.net/img/view/2018/12/9/1903475.png,0,0.949469984,0,0,798,806,798,806,rarity
1903808.png,https://derpicdn.net/img/view/2018/12/9/1903808.png,0,0.94722873,30,13,422,405,392,392,rarity
1907128.png,https://derpicdn.net/img/view/2018/12/13/1907128.png,0,0.998710692,104,0,784,582,680,582,rarity
191482.png,https://derpicdn.net/img/view/2012/12/23/191482.png,0,0.997643948,222,0,600,340,378,340,rarity
1916590.png,https://derpicdn.net/img/view/2018/12/23/1916590.png,0,0.990530491,568,9,1190,631,622,622,rarity
1917336.png,https://derpicdn.net/img/view/2018/12/24/1917336.png,0,0.970745623,370,0,1606,1059,1236,1059,rarity
1921962.png,https://derpicdn.net/img/view/2018/12/30/1921962.png,0,0.996905982,96,5,556,465,460,460,rarity
1924604.png,https://derpicdn.net/img/view/2019/1/2/1924604.png,0,0.998724461,152,0,472,298,320,298,rarity
1927545.png,https://derpicdn.net/img/view/2019/1/5/1927545.png,0,0.998042285,0,0,380,358,380,358,rarity
1930232.png,https://derpicdn.net/img/view/2019/1/9/1930232.png,0,0.965861678,90,0,1018,891,928,891,rarity
1930755.png,https://derpicdn.net/img/view/2019/1/9/1930755.png,0,0.982593834,296,87,1424,1215,1128,1128,rarity
1930756.png,https://derpicdn.net/img/view/2019/1/9/1930756.png,0,0.977890313,296,89,1424,1217,1128,1128,rarity
1936352.png,https://derpicdn.net/img/view/2019/1/15/1936352.png,0,0.965217888,1738,0,5000,2880,3262,2880,rarity
1938648.png,https://derpicdn.net/img/view/2019/1/18/1938648.png,0,0.920336068,523,0,1277,709,754,709,rarity
1948122.png,https://derpicdn.net/img/view/2019/1/29/1948122.png,0,0.975548089,293,21,1991,1719,1698,1698,rarity
1953080.png,https://derpicdn.net/img/view/2019/2/4/1953080.png,0,0.979380071,0,5,186,195,186,190,rarity
1954445.png,https://derpicdn.net/img/view/2019/2/5/1954445.png,0,0.986260533,337,0,2473,1998,2136,1998,rarity
1955246.png,https://derpicdn.net/img/view/2019/2/6/1955246.png,0,0.992687106,101,0,955,808,854,808,rarity
1957957.png,https://derpicdn.net/img/view/2019/2/10/1957957.png,0,0.982336462,39,0,687,629,648,629,rarity
1963938.png,https://derpicdn.net/img/view/2019/2/16/1963938.png,0,0.972679794,422,730,1250,1558,828,828,rarity
1968341.png,https://derpicdn.net/img/view/2019/2/22/1968341.png,0,0.948785722,48,1,386,339,338,338,rarity
1971992.png,https://derpicdn.net/img/view/2019/2/26/1971992.png,0,0.986419559,315,0,815,471,500,471,rarity
1975687.png,https://derpicdn.net/img/view/2019/3/2/1975687.png,2,0.988208652,1120,115,1350,345,230,230,rarity
1979071.png,https://derpicdn.net/img/view/2019/3/6/1979071.png,0,0.990253806,294,0,658,357,364,357,rarity
1979835.png,https://derpicdn.net/img/view/2019/3/7/1979835.png,0,0.989176393,931,0,2013,1066,1082,1066,rarity
1983745.png,https://derpicdn.net/img/view/2019/3/12/1983745.png,0,0.988217115,392,0,1136,779,744,779,rarity
1986251.png,https://derpicdn.net/img/view/2019/3/15/1986251.png,0,0.986832261,99,33,429,363,330,330,rarity
1988587.png,https://derpicdn.net/img/view/2019/3/17/1988587.png,0,0.925937235,18,0,1280,1318,1262,1318,rarity
2005277.png,https://derpicdn.net/img/view/2019/4/7/2005277.png,0,0.992360473,0,0,652,679,652,679,rarity
2009095.png,https://derpicdn.net/img/view/2019/4/11/2009095.png,0,0.978845835,741,37,2039,1335,1298,1298,rarity
2020143.png,https://derpicdn.net/img/view/2019/4/22/2020143.png,0,0.961511016,571,366,4017,3812,3446,3446,rarity
2035770.png,https://derpicdn.net/img/view/2019/5/10/2035770.png,0,0.968093514,110,0,406,296,296,296,rarity
2036690.png,https://derpicdn.net/img/view/2019/5/11/2036690.png,0,0.957025111,889,0,1575,581,686,581,rarity
2040695.png,https://derpicdn.net/img/view/2019/5/16/2040695.png,0,0.975703895,1133,75,2083,1025,950,950,rarity
2042220.png,https://derpicdn.net/img/view/2019/5/18/2042220.png,0,0.991691649,0,0,2298,2253,2298,2253,rarity
2045944.png,https://derpicdn.net/img/view/2019/5/22/2045944.png,0,0.994696617,0,0,692,616,692,616,rarity
2050333.png,https://derpicdn.net/img/view/2019/5/27/2050333.png,0,0.964838564,113,0,909,730,796,730,rarity
2054702.png,https://derpicdn.net/img/view/2019/5/31/2054702.png,0,0.938699305,137,18,887,768,750,750,rarity
2059191.png,https://derpicdn.net/img/view/2019/6/6/2059191.png,0,0.989507437,494,14,750,322,256,308,rarity
2060903.png,https://derpicdn.net/img/view/2019/6/8/2060903.png,0,0.926985145,181,0,1331,1082,1150,1082,rarity
2074739.png,https://derpicdn.net/img/view/2019/6/25/2074739.png,0,0.994062066,487,27,1263,803,776,776,rarity
2074956.png,https://derpicdn.net/img/view/2019/6/25/2074956.png,0,0.998542905,192,107,878,793,686,686,rarity
2076211.png,https://derpicdn.net/img/view/2019/6/27/2076211.png,0,0.979891062,257,92,1099,934,842,842,rarity
2077278.png,https://derpicdn.net/img/view/2019/6/28/2077278.png,0,0.99782455,663,697,2175,2209,1512,1512,rarity
2078110.png,https://derpicdn.net/img/view/2019/6/29/2078110.png,0,0.996103585,283,266,1063,1046,780,780,rarity
2080756.png,https://derpicdn.net/img/view/2019/7/1/2080756.png,0,0.988677323,532,0,998,458,466,458,rarity
2083299.png,https://derpicdn.net/img/view/2019/7/5/2083299.png,0,0.996362567,562,121,1834,1393,1272,1272,rarity
2083704.png,https://derpicdn.net/img/view/2019/7/5/2083704.png,0,0.999702036,27,0,1095,980,1068,980,rarity
2083704.png,https://derpicdn.net/img/view/2019/7/5/2083704.png,1,0.994594991,611,1076,1263,1728,652,652,rarity
2083704.png,https://derpicdn.net/img/view/2019/7/5/2083704.png,2,0.950576067,1532,392,2600,1494,1068,1102,rarity
2083925.png,https://derpicdn.net/img/view/2019/7/5/2083925.png,0,0.996888876,85,487,1305,1707,1220,1220,rarity
208895.png,https://derpicdn.net/img/view/2013/1/10/208895.png,0,0.920227349,63,0,1287,1078,1224,1078,rarity
2094545.png,https://derpicdn.net/img/view/2019/7/18/2094545.png,0,0.997700572,202,45,670,513,468,468,rarity
209874.png,https://derpicdn.net/img/view/2013/1/12/209874.png,0,0.974559784,664,326,1000,662,336,336,rarity
2108763.png,https://derpicdn.net/img/view/2019/8/4/2108763.png,0,0.915872812,8,0,532,507,524,507,rarity
2112851.png,https://derpicdn.net/img/view/2019/8/9/2112851.png,0,0.970573127,184,55,704,575,520,520,rarity
2117290.png,https://derpicdn.net/img/view/2019/8/13/2117290.png,0,0.939262211,257,225,689,657,432,432,rarity
2132897.png,https://derpicdn.net/img/view/2019/8/31/2132897.png,0,0.976927102,419,50,3201,2832,2782,2782,rarity
2138379.png,https://derpicdn.net/img/view/2019/9/7/2138379.png,0,0.998199046,365,0,1055,689,690,689,rarity
2139967.png,https://derpicdn.net/img/view/2019/9/9/2139967.png,0,0.986999989,204,0,1540,1226,1336,1226,rarity
2142068.png,https://derpicdn.net/img/view/2019/9/12/2142068.png,0,0.998863935,0,38,2152,2292,2152,2254,rarity
2142846.png,https://derpicdn.net/img/view/2019/9/13/2142846.png,0,0.947332978,678,67,1158,547,480,480,rarity
2150826.png,https://derpicdn.net/img/view/2019/9/23/2150826.png,0,0.93949753,138,0,436,291,298,291,rarity
2154534.png,https://derpicdn.net/img/view/2019/9/27/2154534.png,0,0.983932614,15,0,1113,1052,1098,1052,rarity
2155842.png,https://derpicdn.net/img/view/2019/9/29/2155842.png,0,0.984004021,28,0,842,803,814,803,rarity
2158402.png,https://derpicdn.net/img/view/2019/10/2/2158402.png,0,0.984287322,1353,0,2749,1210,1396,1210,rarity
2161399.png,https://derpicdn.net/img/view/2019/10/6/2161399.png,0,0.951330304,55,124,443,512,388,388,rarity
2162201.png,https://derpicdn.net/img/view/2019/10/7/2162201.png,0,0.998580694,127,11,1241,1125,1114,1114,rarity
2166822.png,https://derpicdn.net/img/view/2019/10/13/2166822.png,1,0.978270531,783,0,1743,953,960,953,rarity
2180045.png,https://derpicdn.net/img/view/2019/10/27/2180045.png,0,0.993288338,0,0,574,576,574,576,rarity
2182587.png,https://derpicdn.net/img/view/2019/10/30/2182587.png,0,0.994270325,148,0,678,520,530,520,rarity
2188003.png,https://derpicdn.net/img/view/2019/11/5/2188003.png,0,0.983510256,105,174,383,452,278,278,rarity
2188003.png,https://derpicdn.net/img/view/2019/11/5/2188003.png,1,0.936528802,0,0,960,1216,960,1216,rarity
2192475.png,https://derpicdn.net/img/view/2019/11/10/2192475.png,0,0.999279976,204,0,580,364,376,364,rarity
2195470.png,https://derpicdn.net/img/view/2019/11/14/2195470.png,0,0.976743758,859,10,1531,682,672,672,rarity
2198081.png,https://derpicdn.net/img/view/2019/11/17/2198081.png,0,0.913067102,141,32,729,620,588,588,rarity
2204681.png,https://derpicdn.net/img/view/2019/11/24/2204681.png,0,0.981831312,485,0,1823,1278,1338,1278,rarity
2204681.png,https://derpicdn.net/img/view/2019/11/24/2204681.png,1,0.944838226,1765,945,2165,1345,400,400,rarity
2208981.png,https://derpicdn.net/img/view/2019/11/30/2208981.png,0,0.986223161,0,0,495,449,495,449,rarity
2209116.png,https://derpicdn.net/img/view/2019/11/30/2209116.png,0,0.982205689,129,0,1191,1014,1062,1014,rarity
2216464.png,https://derpicdn.net/img/view/2019/12/9/2216464.png,0,0.958953679,3320,425,5506,2611,2186,2186,rarity
2220620.png,https://derpicdn.net/img/view/2019/12/14/2220620.png,0,0.992145061,261,69,555,363,294,294,rarity
2226640.png,https://derpicdn.net/img/view/2019/12/22/2226640.png,1,0.995958209,173,689,925,1441,752,752,rarity
2226640.png,https://derpicdn.net/img/view/2019/12/22/2226640.png,2,0.956842244,640,5,1167,567,527,562,rarity
2228971.jpg,https://derpicdn.net/img/view/2019/12/24/2228971.jpg,0,0.995314479,262,16,832,586,570,570,rarity
2230132.png,https://derpicdn.net/img/view/2019/12/26/2230132.png,0,0.997573078,563,7,901,345,338,338,rarity
2239251.png,https://derpicdn.net/img/view/2020/1/5/2239251.png,0,0.927032292,144,0,1004,851,860,851,rarity
2239397.png,https://derpicdn.net/img/view/2020/1/5/2239397.png,0,0.938889802,0,116,1437,1592,1437,1476,rarity
2244130.png,https://derpicdn.net/img/view/2020/1/11/2244130.png,0,0.962237239,227,0,633,398,406,398,rarity
2252097.jpg,https://derpicdn.net/img/view/2020/1/20/2252097.jpg,0,0.978682756,299,0,1726,1135,1427,1135,rarity
2252098.jpg,https://derpicdn.net/img/view/2020/1/20/2252098.jpg,0,0.96977967,247,0,1301,848,1054,848,rarity
2252418.png,https://derpicdn.net/img/view/2020/1/20/2252418.png,0,0.982916415,38,0,900,826,862,826,rarity
2260839.jpg,https://derpicdn.net/img/view/2020/1/30/2260839.jpg,0,0.999104321,287,145,743,601,456,456,rarity
2265699.png,https://derpicdn.net/img/view/2020/2/4/2265699.png,0,0.996905684,105,0,473,352,368,352,rarity
2268822.jpg,https://derpicdn.net/img/view/2020/2/8/2268822.jpg,0,0.97289753,240,267,844,871,604,604,rarity
2269764.jpg,https://derpicdn.net/img/view/2020/2/9/2269764.jpg,0,0.932530403,93,23,855,835,762,812,rarity
2271012.png,https://derpicdn.net/img/view/2020/2/11/2271012.png,0,0.967317402,71,0,390,340,319,340,rarity
2272049.png,https://derpicdn.net/img/view/2020/2/12/2272049.png,0,0.980624259,1652,0,2912,1086,1260,1086,rarity
2275682.png,https://derpicdn.net/img/view/2020/2/16/2275682.png,0,0.991007805,52,0,598,543,546,543,rarity
2278271.jpg,https://derpicdn.net/img/view/2020/2/19/2278271.jpg,0,0.987763822,1231,0,2377,1024,1146,1024,rarity
2279696.jpg,https://derpicdn.net/img/view/2020/2/21/2279696.jpg,0,0.989344895,0,0,299,314,299,314,rarity
2285164.jpg,https://derpicdn.net/img/view/2020/2/28/2285164.jpg,0,0.994983494,129,16,543,430,414,414,rarity
2286392.png,https://derpicdn.net/img/view/2020/2/29/2286392.png,0,0.999132037,244,10,928,694,684,684,rarity
2286603.png,https://derpicdn.net/img/view/2020/2/29/2286603.png,0,0.994502604,1691,0,5623,3682,3932,3682,rarity
2290516.jpg,https://derpicdn.net/img/view/2020/3/5/2290516.jpg,0,0.979865134,78,132,1002,943,924,811,rarity
2292738.png,https://derpicdn.net/img/view/2020/3/8/2292738.png,0,0.997456908,65,33,843,811,778,778,rarity
2298292.png,https://derpicdn.net/img/view/2020/3/15/2298292.png,0,0.998508573,820,0,2170,1210,1350,1210,rarity
2299928.png,https://derpicdn.net/img/view/2020/3/17/2299928.png,0,0.996823549,69,0,491,392,422,392,rarity
2299948.png,https://derpicdn.net/img/view/2020/3/17/2299948.png,0,0.984665394,289,51,1023,785,734,734,rarity
2301755.jpg,https://derpicdn.net/img/view/2020/3/20/2301755.jpg,0,0.985978961,292,321,596,625,304,304,rarity
2302110.png,https://derpicdn.net/img/view/2020/3/20/2302110.png,0,0.980700791,75,0,1241,1119,1166,1119,rarity
2305116.png,https://derpicdn.net/img/view/2020/3/24/2305116.png,0,0.939065814,197,0,843,629,646,629,rarity
2309398.jpg,https://derpicdn.net/img/view/2020/3/30/2309398.jpg,0,0.997460246,372,19,674,321,302,302,rarity
2318089.jpg,https://derpicdn.net/img/view/2020/4/9/2318089.jpg,0,0.996180713,1207,2085,1799,2677,592,592,rarity
2319838.png,https://derpicdn.net/img/view/2020/4/11/2319838.png,0,0.999111414,197,39,623,465,426,426,rarity
2319838.png,https://derpicdn.net/img/view/2020/4/11/2319838.png,1,0.997285724,151,695,451,995,300,300,rarity
2319838.png,https://derpicdn.net/img/view/2020/4/11/2319838.png,2,0.995459974,874,46,1170,342,296,296,rarity
2322439.png,https://derpicdn.net/img/view/2020/4/14/2322439.png,0,0.999533236,1503,1541,2321,2359,818,818,rarity
2322439.png,https://derpicdn.net/img/view/2020/4/14/2322439.png,1,0.999260545,708,1468,1620,2380,912,912,rarity
2322439.png,https://derpicdn.net/img/view/2020/4/14/2322439.png,2,0.996544361,4,1552,814,2362,810,810,rarity
2322439.png,https://derpicdn.net/img/view/2020/4/14/2322439.png,3,0.993750334,1412,265,2318,1171,906,906,rarity
2324329.png,https://derpicdn.net/img/view/2020/4/17/2324329.png,0,0.98071897,490,0,3000,2543,2510,2543,rarity
2329823.jpg,https://derpicdn.net/img/view/2020/4/23/2329823.jpg,0,0.981832862,727,139,1399,811,672,672,rarity
2337483.png,https://derpicdn.net/img/view/2020/5/2/2337483.png,0,0.944606006,7,0,813,797,806,797,rarity
2338379.jpg,https://derpicdn.net/img/view/2020/5/3/2338379.jpg,0,0.996972501,70,0,950,814,880,814,rarity
2338655.jpg,https://derpicdn.net/img/view/2020/5/3/2338655.jpg,0,0.997466743,454,494,1082,1122,628,628,rarity
2339497.png,https://derpicdn.net/img/view/2020/5/4/2339497.png,0,0.988191426,78,2,636,560,558,558,rarity
2340857.jpg,https://derpicdn.net/img/view/2020/5/6/2340857.jpg,0,0.988991499,298,9,902,613,604,604,rarity
2345540.png,https://derpicdn.net/img/view/2020/5/11/2345540.png,0,0.968829811,167,0,4583,4164,4416,4164,rarity
2351032.jpg,https://derpicdn.net/img/view/2020/5/17/2351032.jpg,1,0.939935565,359,755,651,1047,292,292,rarity
2354685.jpg,https://derpicdn.net/img/view/2020/5/21/2354685.jpg,0,0.994328439,693,30,1905,1242,1212,1212,rarity
2355688.png,https://derpicdn.net/img/view/2020/5/23/2355688.png,0,0.980140507,142,0,900,703,758,703,rarity
244219.png,https://derpicdn.net/img/view/2013/2/15/244219.png,0,0.993931293,631,34,1161,564,530,530,rarity
244405.png,https://derpicdn.net/img/view/2013/2/15/244405.png,0,0.979767501,228,0,506,257,278,257,rarity
278318.jpg,https://derpicdn.net/img/view/2013/3/24/278318.jpg,0,0.998772204,226,0,644,393,418,393,rarity
307097.png,https://derpicdn.net/img/view/2013/4/24/307097.png,0,0.98170048,144,0,381,219,237,219,rarity
338721.png,https://derpicdn.net/img/view/2013/6/1/338721.png,0,0.991490662,172,51,706,585,534,534,rarity
3397.png,https://derpicdn.net/img/view/2012/2/23/3397.png,0,0.98737967,560,97,1024,561,464,464,rarity
351869.png,https://derpicdn.net/img/view/2013/6/18/351869.png,0,0.998068571,330,309,1940,1919,1610,1610,rarity
361532.jpg,https://derpicdn.net/img/view/2013/7/1/361532.jpg,0,0.986694574,1203,282,1837,916,634,634,rarity
363112.png,https://derpicdn.net/img/view/2013/7/3/363112.png,0,0.94691968,99,459,1213,1573,1114,1114,rarity
367675.png,https://derpicdn.net/img/view/2013/7/8/367675.png,0,0.996832371,54,0,1560,1335,1506,1335,rarity
377300.png,https://derpicdn.net/img/view/2013/7/18/377300.png,0,0.951563656,373,0,2255,1858,1882,1858,rarity
383135.jpg,https://derpicdn.net/img/view/2013/7/24/383135.jpg,0,0.996822417,339,0,1691,1344,1352,1344,rarity
3995.png,https://derpicdn.net/img/view/2012/4/24/3995.png,0,0.997051656,70,0,390,309,320,309,rarity
40415.png,https://derpicdn.net/img/view/2012/7/11/40415.png,0,0.95709753,174,921,414,1161,240,240,rarity
411954.png,https://derpicdn.net/img/view/2013/8/27/411954.png,0,0.99906683,1399,60,2657,1318,1258,1258,rarity
411954.png,https://derpicdn.net/img/view/2013/8/27/411954.png,1,0.982855678,0,89,1189,1315,1189,1226,rarity
415415.png,https://derpicdn.net/img/view/2013/8/31/415415.png,0,0.999650002,407,0,777,362,370,362,rarity
429535.png,https://derpicdn.net/img/view/2013/9/17/429535.png,0,0.988519907,893,115,1503,725,610,610,rarity
430524.png,https://derpicdn.net/img/view/2013/9/19/430524.png,0,0.993103147,31,0,417,324,386,324,rarity
43073.jpg,https://derpicdn.net/img/view/2012/7/13/43073.jpg,0,0.945729434,72,40,364,332,292,292,rarity
434518.png,https://derpicdn.net/img/view/2013/9/25/434518.png,0,0.985088468,316,73,738,495,422,422,rarity
447517.png,https://derpicdn.net/img/view/2013/10/13/447517.png,0,0.984143853,499,0,949,428,450,428,rarity
448037.png,https://derpicdn.net/img/view/2013/10/13/448037.png,0,0.997637212,608,66,950,408,342,342,rarity
455084.png,https://derpicdn.net/img/view/2013/10/23/455084.png,0,0.973391652,45,7,247,209,202,202,rarity
455468.jpg,https://derpicdn.net/img/view/2013/10/24/455468.jpg,0,0.998032451,564,54,1048,538,484,484,rarity
468932.png,https://derpicdn.net/img/view/2013/11/10/468932.png,0,0.99982053,510,0,1108,576,598,576,rarity
481732.png,https://derpicdn.net/img/view/2013/11/25/481732.png,0,0.998668969,144,85,464,405,320,320,rarity
490392.png,https://derpicdn.net/img/view/2013/12/5/490392.png,0,0.997024655,251,99,633,481,382,382,rarity
503628.png,https://derpicdn.net/img/view/2013/12/22/503628.png,0,0.993053794,148,0,1090,806,942,806,rarity
504059.jpg,https://derpicdn.net/img/view/2013/12/22/504059.jpg,0,0.998732269,578,0,1728,1101,1150,1101,rarity
505902.png,https://derpicdn.net/img/view/2013/12/25/505902.png,0,0.969155014,90,16,634,560,544,544,rarity
511079.jpg,https://derpicdn.net/img/view/2013/12/31/511079.jpg,0,0.996442258,148,0,774,611,626,611,rarity
514944.png,https://derpicdn.net/img/view/2014/1/4/514944.png,0,0.977375388,0,17,788,845,788,828,rarity
523988.png,https://derpicdn.net/img/view/2014/1/14/523988.png,0,0.998659253,400,0,746,341,346,341,rarity
529530.png,https://derpicdn.net/img/view/2014/1/20/529530.png,0,0.932288766,79,0,317,226,238,226,rarity
544473.jpg,https://derpicdn.net/img/view/2014/2/6/544473.jpg,0,0.933195472,1405,0,1797,363,392,363,rarity
563190.png,https://derpicdn.net/img/view/2014/2/28/563190.png,0,0.970255494,4,49,560,605,556,556,rarity
576374.png,https://derpicdn.net/img/view/2014/3/16/576374.png,0,0.996306896,34,0,616,566,582,566,rarity
576374.png,https://derpicdn.net/img/view/2014/3/16/576374.png,1,0.983074307,618,9,1218,609,600,600,rarity
591663.png,https://derpicdn.net/img/view/2014/4/3/591663.png,0,0.997020066,473,139,1709,1375,1236,1236,rarity
591663.png,https://derpicdn.net/img/view/2014/4/3/591663.png,1,0.990075111,2062,693,3614,2245,1552,1552,rarity
594274.png,https://derpicdn.net/img/view/2014/4/6/594274.png,0,0.995783329,260,107,604,451,344,344,rarity
594592.png,https://derpicdn.net/img/view/2014/4/6/594592.png,0,0.99292624,586,643,1250,1307,664,664,rarity
59693.png,https://derpicdn.net/img/view/2012/7/28/59693.png,0,0.995573819,224,9,486,271,262,262,rarity
61101.jpg,https://derpicdn.net/img/view/2012/7/29/61101.jpg,0,0.997078001,690,0,1762,1068,1072,1068,rarity
611529.png,https://derpicdn.net/img/view/2014/4/27/611529.png,0,0.993393302,567,98,2551,2082,1984,1984,rarity
612172.png,https://derpicdn.net/img/view/2014/4/28/612172.png,0,0.935112894,68,0,317,278,249,278,rarity
622852.png,https://derpicdn.net/img/view/2014/5/10/622852.png,0,0.992581844,464,75,1260,871,796,796,rarity
628698.png,https://derpicdn.net/img/view/2014/5/17/628698.png,0,0.988135755,1301,34,2345,1078,1044,1044,rarity
629364.png,https://derpicdn.net/img/view/2014/5/17/629364.png,0,0.98937583,7,0,1219,1094,1212,1094,rarity
636327.png,https://derpicdn.net/img/view/2014/5/25/636327.png,0,0.9805516,0,0,213,203,213,203,rarity
638447.png,https://derpicdn.net/img/view/2014/5/27/638447.png,0,0.997639179,830,0,1332,469,502,469,rarity
638447.png,https://derpicdn.net/img/view/2014/5/27/638447.png,1,0.989857256,125,0,639,477,514,477,rarity
660838.jpg,https://derpicdn.net/img/view/2014/6/24/660838.jpg,0,0.975482166,58,0,706,633,648,633,rarity
665274.png,https://derpicdn.net/img/view/2014/7/1/665274.png,0,0.98864454,217,0,823,446,606,446,rarity
670784.png,https://derpicdn.net/img/view/2014/7/9/670784.png,0,0.994694889,59,0,319,276,260,276,rarity
672.png,https://derpicdn.net/img/view/2012/1/17/672.png,0,0.997665107,0,0,838,813,838,813,rarity
674692.png,https://derpicdn.net/img/view/2014/7/14/674692.png,0,0.993249953,735,0,2119,1338,1384,1338,rarity
678853.png,https://derpicdn.net/img/view/2014/7/20/678853.png,0,0.979243934,899,1036,1345,1482,446,446,rarity
681476.png,https://derpicdn.net/img/view/2014/7/23/681476.png,0,0.929322004,390,0,1077,709,687,709,rarity
681596.png,https://derpicdn.net/img/view/2014/7/23/681596.png,0,0.99935168,241,0,527,263,286,263,rarity
682958.png,https://derpicdn.net/img/view/2014/7/25/682958.png,0,0.976504385,103,0,1271,1041,1168,1041,rarity
701121.png,https://derpicdn.net/img/view/2014/8/16/701121.png,0,0.994746149,146,23,518,395,372,372,rarity
707822.jpg,https://derpicdn.net/img/view/2014/8/25/707822.jpg,0,0.999462426,621,7,1535,921,914,914,rarity
712279.png,https://derpicdn.net/img/view/2014/8/31/712279.png,0,0.997536123,235,0,647,405,412,405,rarity
715071.jpg,https://derpicdn.net/img/view/2014/9/4/715071.jpg,0,0.996041894,315,93,661,439,346,346,rarity
719960.png,https://derpicdn.net/img/view/2014/9/11/719960.png,0,0.990579367,60,2,412,354,352,352,rarity
721641.jpg,https://derpicdn.net/img/view/2014/9/14/721641.jpg,0,0.991824269,852,209,2750,2107,1898,1898,rarity
726849.jpg,https://derpicdn.net/img/view/2014/9/21/726849.jpg,0,0.98530519,222,0,908,655,686,655,rarity
752063.jpg,https://derpicdn.net/img/view/2014/10/27/752063.jpg,0,0.998342156,662,0,1616,901,954,901,rarity
759975.jpg,https://derpicdn.net/img/view/2014/11/7/759975.jpg,0,0.937918365,161,0,645,432,484,432,rarity
762153.png,https://derpicdn.net/img/view/2014/11/10/762153.png,0,0.999168217,97,46,397,346,300,300,rarity
762168.png,https://derpicdn.net/img/view/2014/11/11/762168.png,0,0.969079196,435,30,1109,704,674,674,rarity
766912.png,https://derpicdn.net/img/view/2014/11/18/766912.png,0,0.984509408,41,18,591,568,550,550,rarity
76728.png,https://derpicdn.net/img/view/2012/8/17/76728.png,0,0.918670774,124,6,524,406,400,400,rarity
768362.png,https://derpicdn.net/img/view/2014/11/20/768362.png,0,0.951549649,32,45,348,361,316,316,rarity
768363.png,https://derpicdn.net/img/view/2014/11/20/768363.png,0,0.947538674,32,3,385,391,353,388,rarity
795401.png,https://derpicdn.net/img/view/2014/12/29/795401.png,0,0.912359595,28,0,542,507,514,507,rarity
798017.png,https://derpicdn.net/img/view/2015/1/2/798017.png,0,0.998950601,215,14,557,356,342,342,rarity
808404.png,https://derpicdn.net/img/view/2015/1/17/808404.png,0,0.969002485,0,0,259,273,259,273,rarity
814667.png,https://derpicdn.net/img/view/2015/1/25/814667.png,0,0.99564606,208,0,564,340,356,340,rarity
816030.png,https://derpicdn.net/img/view/2015/1/27/816030.png,0,0.919849038,295,0,1289,992,994,992,rarity
843090.png,https://derpicdn.net/img/view/2015/3/5/843090.png,0,0.993385911,0,0,465,497,465,497,rarity
84585.png,https://derpicdn.net/img/view/2012/8/28/84585.png,0,0.949516594,634,0,1060,365,426,365,rarity
846911.png,https://derpicdn.net/img/view/2015/3/10/846911.png,0,0.976108491,500,204,864,568,364,364,rarity
849164.jpg,https://derpicdn.net/img/view/2015/3/14/849164.jpg,0,0.997455299,283,358,631,706,348,348,rarity
859014.png,https://derpicdn.net/img/view/2015/3/28/859014.png,0,0.998937905,312,61,594,343,282,282,rarity
867372.png,https://derpicdn.net/img/view/2015/4/7/867372.png,0,0.980327487,216,0,966,667,750,667,rarity
871960.png,https://derpicdn.net/img/view/2015/4/12/871960.png,1,0.978283644,421,143,721,443,300,300,rarity
872869.png,https://derpicdn.net/img/view/2015/4/13/872869.png,0,0.997824371,317,6,631,320,314,314,rarity
875170.png,https://derpicdn.net/img/view/2015/4/16/875170.png,0,0.939973474,89,24,367,302,278,278,rarity
883990.png,https://derpicdn.net/img/view/2015/4/27/883990.png,0,0.961658359,122,0,1000,904,878,904,rarity
890410.png,https://derpicdn.net/img/view/2015/5/6/890410.png,0,0.931316793,0,0,206,205,206,205,rarity
897287.png,https://derpicdn.net/img/view/2015/5/16/897287.png,0,0.99902916,211,20,627,436,416,416,rarity
902219.png,https://derpicdn.net/img/view/2015/5/23/902219.png,0,0.999178588,215,51,519,355,304,304,rarity
903437.png,https://derpicdn.net/img/view/2015/5/24/903437.png,0,0.971099079,37,34,1105,1102,1068,1068,rarity
909016.png,https://derpicdn.net/img/view/2015/6/2/909016.png,0,0.920836091,61,41,363,343,302,302,rarity
913863.png,https://derpicdn.net/img/view/2015/6/10/913863.png,0,0.958936572,851,0,1975,1029,1124,1029,rarity
914898.jpg,https://derpicdn.net/img/view/2015/6/11/914898.jpg,0,0.994061768,138,90,452,404,314,314,rarity
929812.png,https://derpicdn.net/img/view/2015/7/4/929812.png,0,0.975128233,12,0,272,238,260,238,rarity
930959.png,https://derpicdn.net/img/view/2015/7/6/930959.png,0,0.999816597,619,0,1001,378,382,378,rarity
940841.png,https://derpicdn.net/img/view/2015/7/21/940841.png,0,0.902981579,140,6,316,182,176,176,rarity
981988.png,https://derpicdn.net/img/view/2015/9/18/981988.png,0,0.988976955,77,242,509,674,432,432,rarity
983937.png,https://derpicdn.net/img/view/2015/9/20/983937.png,0,0.986358583,56,0,322,258,266,258,rarity
985180.png,https://derpicdn.net/img/view/2015/9/22/985180.png,0,0.962293684,300,0,1578,1082,1278,1082,rarity
987394.png,https://derpicdn.net/img/view/2015/9/25/987394.png,0,0.940079272,276,0,700,414,424,414,rarity
993629.png,https://derpicdn.net/img/view/2015/10/3/993629.png,0,0.975660384,421,280,672,584,251,304,rarity
1013978.png,https://derpicdn.net/img/view/2015/11/1/1013978.png,0,0.923816621,293,44,1045,796,752,752,rarity
101968.png,https://derpicdn.net/img/view/2012/9/19/101968.png,0,0.998406053,311,16,609,314,298,298,rarity
1027244.png,https://derpicdn.net/img/view/2015/11/21/1027244.png,0,0.910209417,0,0,281,277,281,277,rarity
1029706.png,https://derpicdn.net/img/view/2015/11/25/1029706.png,0,0.993715048,303,1032,559,1280,256,248,rarity
1029706.png,https://derpicdn.net/img/view/2015/11/25/1029706.png,1,0.979119241,181,0,525,290,344,290,rarity
1030533.jpg,https://derpicdn.net/img/view/2015/11/26/1030533.jpg,0,0.981173754,0,0,366,322,366,322,rarity
1030595.png,https://derpicdn.net/img/view/2015/11/26/1030595.png,0,0.959692895,164,197,866,899,702,702,rarity
1048485.png,https://derpicdn.net/img/view/2015/12/20/1048485.png,0,0.960542977,454,102,872,520,418,418,rarity
1050276.png,https://derpicdn.net/img/view/2015/12/22/1050276.png,0,0.954363942,37,0,379,327,342,327,rarity
1060854.jpg,https://derpicdn.net/img/view/2016/1/6/1060854.jpg,0,0.973630548,0,0,618,593,618,593,rarity
1069756.png,https://derpicdn.net/img/view/2016/1/19/1069756.png,0,0.946506917,150,27,420,297,270,270,rarity
1092477.png,https://derpicdn.net/img/view/2016/2/20/1092477.png,0,0.992217541,128,0,526,382,398,382,rarity
1094826.jpg,https://derpicdn.net/img/view/2016/2/23/1094826.jpg,0,0.947909296,171,105,437,371,266,266,rarity
1096623.png,https://derpicdn.net/img/view/2016/2/25/1096623.png,0,0.957498252,400,133,2558,2291,2158,2158,rarity
1099695.png,https://derpicdn.net/img/view/2016/3/1/1099695.png,0,0.919516742,880,0,3626,2650,2746,2650,rarity
110341.png,https://derpicdn.net/img/view/2012/9/30/110341.png,0,0.962915599,240,34,658,452,418,418,rarity
1109058.png,https://derpicdn.net/img/view/2016/3/14/1109058.png,0,0.995769918,181,0,1911,1659,1730,1659,rarity
1132744.png,https://derpicdn.net/img/view/2016/4/15/1132744.png,0,0.988770485,222,0,2336,2071,2114,2071,rarity
1141359.png,https://derpicdn.net/img/view/2016/4/27/1141359.png,0,0.944104433,321,37,3161,2877,2840,2840,rarity
1146.jpg,https://derpicdn.net/img/view/2012/1/22/1146.jpg,0,0.972188532,423,270,1137,984,714,714,rarity
115005.png,https://derpicdn.net/img/view/2012/10/6/115005.png,0,0.997078001,133,0,395,259,262,259,rarity
1152432.png,https://derpicdn.net/img/view/2016/5/12/1152432.png,0,0.995550096,0,0,397,421,397,421,rarity
1174150.png,https://derpicdn.net/img/view/2016/6/9/1174150.png,0,0.984404087,73,6,528,496,455,490,rarity
1174150.png,https://derpicdn.net/img/view/2016/6/9/1174150.png,1,0.979171574,0,97,403,528,403,431,rarity
1175735.png,https://derpicdn.net/img/view/2016/6/11/1175735.png,0,0.962162137,8,0,269,301,261,301,rarity
1178181.png,https://derpicdn.net/img/view/2016/6/14/1178181.png,0,0.997997522,377,9,1047,679,670,670,rarity
1178891.png,https://derpicdn.net/img/view/2016/6/15/1178891.png,0,0.997998297,2779,113,6223,3557,3444,3444,rarity
1180726.jpg,https://derpicdn.net/img/view/2016/6/18/1180726.jpg,0,0.980152726,207,6,543,342,336,336,rarity
1184761.png,https://derpicdn.net/img/view/2016/6/23/1184761.png,0,0.977483511,42,174,670,802,628,628,rarity
1188348.jpg,https://derpicdn.net/img/view/2016/6/27/1188348.jpg,1,0.984838665,266,63,588,385,322,322,rarity
1202087.png,https://derpicdn.net/img/view/2016/7/16/1202087.png,0,0.992624402,221,86,961,826,740,740,rarity
1209594.png,https://derpicdn.net/img/view/2016/7/26/1209594.png,0,0.95421356,149,77,603,531,454,454,rarity
1217632.png,https://derpicdn.net/img/view/2016/8/5/1217632.png,0,0.929312944,203,127,475,399,272,272,rarity
1218762.png,https://derpicdn.net/img/view/2016/8/6/1218762.png,0,0.988166511,36,45,458,476,422,431,rarity
12271.jpg,https://derpicdn.net/img/view/2012/6/20/12271.jpg,0,0.908189178,541,237,777,473,236,236,rarity
1228347.png,https://derpicdn.net/img/view/2016/8/18/1228347.png,0,0.990512848,147,0,1023,860,876,860,rarity
1243413.png,https://derpicdn.net/img/view/2016/9/6/1243413.png,0,0.994894624,824,406,1182,764,358,358,rarity
1243413.png,https://derpicdn.net/img/view/2016/9/6/1243413.png,1,0.989043891,560,398,896,734,336,336,rarity
1262540.png,https://derpicdn.net/img/view/2016/10/1/1262540.png,0,0.959320128,150,0,633,467,483,467,rarity
1294315.png,https://derpicdn.net/img/view/2016/11/12/1294315.png,0,0.953902423,258,0,1946,1636,1688,1636,rarity
1294936.png,https://derpicdn.net/img/view/2016/11/13/1294936.png,0,0.973625481,89,1,435,347,346,346,rarity
1296775.png,https://derpicdn.net/img/view/2016/11/16/1296775.png,0,0.917962015,97,0,501,382,404,382,rarity
1298565.png,https://derpicdn.net/img/view/2016/11/18/1298565.png,0,0.915248096,884,35,1124,275,240,240,rarity
1304043.png,https://derpicdn.net/img/view/2016/11/26/1304043.png,0,0.995465279,736,139,1248,651,512,512,rarity
1304043.png,https://derpicdn.net/img/view/2016/11/26/1304043.png,1,0.972567081,366,379,836,849,470,470,rarity
131473.jpg,https://derpicdn.net/img/view/2012/10/25/131473.jpg,0,0.981210053,640,59,1102,521,462,462,rarity
1317797.png,https://derpicdn.net/img/view/2016/12/15/1317797.png,0,0.996594071,96,68,646,618,550,550,rarity
1331857.png,https://derpicdn.net/img/view/2017/1/4/1331857.png,0,0.998414159,74,0,576,499,502,499,rarity
133412.jpg,https://derpicdn.net/img/view/2012/10/26/133412.jpg,0,0.980993927,448,37,1182,728,734,691,rarity
1346214.png,https://derpicdn.net/img/view/2017/1/23/1346214.png,0,0.977976978,949,36,1791,878,842,842,rarity
1347195.png,https://derpicdn.net/img/view/2017/1/24/1347195.png,0,0.986280084,124,6,720,618,596,612,rarity
1351802.png,https://derpicdn.net/img/view/2017/1/31/1351802.png,0,0.994231641,256,261,680,685,424,424,rarity
1354965.png,https://derpicdn.net/img/view/2017/2/4/1354965.png,0,0.980691552,0,22,999,1026,999,1004,rarity
1356059.png,https://derpicdn.net/img/view/2017/2/5/1356059.png,0,0.940097094,345,0,855,404,510,404,rarity
136411.png,https://derpicdn.net/img/view/2012/10/30/136411.png,0,0.993827403,405,24,651,270,246,246,rarity
1365441.png,https://derpicdn.net/img/view/2017/2/17/1365441.png,0,0.99964416,689,0,1467,764,778,764,rarity
13808.jpg,https://derpicdn.net/img/view/2012/6/21/13808.jpg,0,0.996329486,52,348,342,638,290,290,rarity
1380870.png,https://derpicdn.net/img/view/2017/3/6/1380870.png,0,0.991288483,872,38,1456,622,584,584,rarity
1382149.png,https://derpicdn.net/img/view/2017/3/8/1382149.png,0,0.974750698,364,64,1256,956,892,892,rarity
1384249.png,https://derpicdn.net/img/view/2017/3/11/1384249.png,0,0.978730679,141,3,899,761,758,758,rarity
1395752.png,https://derpicdn.net/img/view/2017/3/25/1395752.png,0,0.995308638,4426,0,9294,4738,4868,4738,rarity
1399864.png,https://derpicdn.net/img/view/2017/3/30/1399864.png,0,0.90193367,2038,0,3986,1864,1948,1864,rarity
1406961.png,https://derpicdn.net/img/view/2017/4/8/1406961.png,0,0.96728617,0,2,409,488,409,486,rarity
1412687.png,https://derpicdn.net/img/view/2017/4/16/1412687.png,0,0.977633774,10,16,408,414,398,398,rarity
1422199.png,https://derpicdn.net/img/view/2017/4/26/1422199.png,0,0.986871302,539,53,915,429,376,376,rarity
1422387.png,https://derpicdn.net/img/view/2017/4/26/1422387.png,0,0.996629119,16,77,960,1021,944,944,rarity
1431110.png,https://derpicdn.net/img/view/2017/5/7/1431110.png,0,0.965797007,3071,0,6413,3106,3342,3106,rarity
1433863.png,https://derpicdn.net/img/view/2017/5/11/1433863.png,0,0.978800058,117,454,3013,3350,2896,2896,rarity
1443157.png,https://derpicdn.net/img/view/2017/5/22/1443157.png,0,0.989991486,272,476,770,974,498,498,rarity
1446429.png,https://derpicdn.net/img/view/2017/5/26/1446429.png,0,0.967982173,200,137,1108,1045,908,908,rarity
1448965.png,https://derpicdn.net/img/view/2017/5/29/1448965.png,0,0.90573287,1084,0,2958,1826,1874,1826,rarity
1452753.png,https://derpicdn.net/img/view/2017/6/3/1452753.png,0,0.959061682,333,30,1425,1122,1092,1092,rarity
1465316.png,https://derpicdn.net/img/view/2017/6/18/1465316.png,0,0.999216318,0,0,1067,1161,1067,1161,rarity
1465436.png,https://derpicdn.net/img/view/2017/6/19/1465436.png,0,0.999217391,543,125,1779,1361,1236,1236,rarity
1472390.png,https://derpicdn.net/img/view/2017/6/26/1472390.png,0,0.985766709,27,0,445,406,418,406,rarity
1473986.png,https://derpicdn.net/img/view/2017/6/29/1473986.png,0,0.903025091,136,104,266,234,130,130,rarity
1478923.png,https://derpicdn.net/img/view/2017/7/5/1478923.png,0,0.992705822,50,210,364,524,314,314,rarity
1478923.png,https://derpicdn.net/img/view/2017/7/5/1478923.png,1,0.980092168,314,280,582,548,268,268,rarity
1483563.png,https://derpicdn.net/img/view/2017/7/11/1483563.png,0,0.924518228,474,84,744,354,270,270,rarity
1491644.png,https://derpicdn.net/img/view/2017/7/21/1491644.png,0,0.991685629,73,0,1109,989,1036,989,rarity
149404.png,https://derpicdn.net/img/view/2012/11/12/149404.png,0,0.953827739,1327,76,2197,946,870,870,rarity
1496213.png,https://derpicdn.net/img/view/2017/7/27/1496213.png,0,0.983198524,299,0,571,250,272,250,rarity
1500944.png,https://derpicdn.net/img/view/2017/8/2/1500944.png,0,0.996086955,236,12,916,692,680,680,rarity
1506.jpg,https://derpicdn.net/img/view/2012/1/22/1506.jpg,0,0.964927316,893,31,1645,783,752,752,rarity
1510643.png,https://derpicdn.net/img/view/2017/8/14/1510643.png,0,0.998666048,6,0,968,932,962,932,rarity
1512599.png,https://derpicdn.net/img/view/2017/8/17/1512599.png,0,0.965271831,389,0,1053,644,664,644,rarity
1522474.png,https://derpicdn.net/img/view/2017/8/29/1522474.png,0,0.979296267,0,0,384,430,384,430,rarity
1524917.png,https://derpicdn.net/img/view/2017/9/1/1524917.png,0,0.914433122,908,632,6162,5886,5254,5254,rarity
1525437.png,https://derpicdn.net/img/view/2017/9/1/1525437.png,0,0.919930875,0,4434,3986,8602,3986,4168,rarity
1527840.png,https://derpicdn.net/img/view/2017/9/4/1527840.png,0,0.908348978,200,723,642,1165,442,442,rarity
1530020.png,https://derpicdn.net/img/view/2017/9/7/1530020.png,0,0.992419839,396,185,900,689,504,504,rarity
1536626.png,https://derpicdn.net/img/view/2017/9/16/1536626.png,0,0.951660752,0,0,1165,900,1165,900,rarity
1536763.png,https://derpicdn.net/img/view/2017/9/16/1536763.png,0,0.994582415,134,0,524,352,390,352,rarity
1536903.png,https://derpicdn.net/img/view/2017/9/16/1536903.png,0,0.90754199,89,0,539,368,450,368,rarity
1539644.png,https://derpicdn.net/img/view/2017/9/19/1539644.png,0,0.991816103,26,0,402,352,376,352,rarity
1540802.png,https://derpicdn.net/img/view/2017/9/21/1540802.png,0,0.983811557,347,0,843,474,496,474,rarity
154347.png,https://derpicdn.net/img/view/2012/11/17/154347.png,0,0.940652549,511,82,1413,984,902,902,rarity
1546371.png,https://derpicdn.net/img/view/2017/9/27/1546371.png,0,0.95887363,187,39,481,333,294,294,rarity
1550131.png,https://derpicdn.net/img/view/2017/10/2/1550131.png,0,0.980912328,521,0,1024,562,503,562,rarity
1550601.png,https://derpicdn.net/img/view/2017/10/2/1550601.png,0,0.905454934,44,366,662,984,618,618,rarity
1550691.png,https://derpicdn.net/img/view/2017/10/2/1550691.png,0,0.993100047,57,0,1125,1010,1068,1010,rarity
1561261.png,https://derpicdn.net/img/view/2017/10/14/1561261.png,0,0.933056056,95,25,557,487,462,462,rarity
1569086.png,https://derpicdn.net/img/view/2017/10/24/1569086.png,0,0.99125886,111,0,2349,2156,2238,2156,rarity
1569087.png,https://derpicdn.net/img/view/2017/10/24/1569087.png,0,0.940042734,0,0,2400,2460,2400,2460,rarity
157168.png,https://derpicdn.net/img/view/2012/11/19/157168.png,0,0.98742348,96,0,980,833,884,833,rarity
1578691.png,https://derpicdn.net/img/view/2017/11/5/1578691.png,0,0.992483437,0,0,334,323,334,323,rarity
1599050.png,https://derpicdn.net/img/view/2017/12/2/1599050.png,0,0.988551021,26,135,1492,1575,1466,1440,rarity
1600278.png,https://derpicdn.net/img/view/2017/12/4/1600278.png,0,0.974993587,627,254,2339,1966,1712,1712,rarity
160595.png,https://derpicdn.net/img/view/2012/11/23/160595.png,0,0.989594996,0,44,1101,1172,1101,1128,rarity
1606494.png,https://derpicdn.net/img/view/2017/12/13/1606494.png,0,0.987269282,2273,649,4751,3127,2478,2478,rarity
1606934.png,https://derpicdn.net/img/view/2017/12/13/1606934.png,0,0.942617834,59,0,327,243,268,243,rarity
1608122.png,https://derpicdn.net/img/view/2017/12/15/1608122.png,0,0.990416408,0,0,601,628,601,628,rarity
1614993.png,https://derpicdn.net/img/view/2017/12/24/1614993.png,0,0.9975335,0,31,880,937,880,906,rarity
1616605.png,https://derpicdn.net/img/view/2017/12/26/1616605.png,0,0.967707038,75,57,475,469,400,412,rarity
1617031.png,https://derpicdn.net/img/view/2017/12/27/1617031.png,0,0.973133266,517,370,1185,1038,668,668,rarity
1622219.png,https://derpicdn.net/img/view/2018/1/2/1622219.png,0,0.998333931,119,7,601,489,482,482,rarity
1623271.png,https://derpicdn.net/img/view/2018/1/3/1623271.png,0,0.991080761,164,0,573,401,409,401,rarity
1626800.png,https://derpicdn.net/img/view/2018/1/7/1626800.png,0,0.986481667,0,11,794,877,794,866,rarity
1639542.png,https://derpicdn.net/img/view/2018/1/24/1639542.png,0,0.977497995,668,66,1270,668,602,602,rarity
1641931.png,https://derpicdn.net/img/view/2018/1/27/1641931.png,0,0.988733113,0,0,319,334,319,334,rarity
1652653.png,https://derpicdn.net/img/view/2018/2/10/1652653.png,0,0.99066174,687,0,1215,508,528,508,rarity
1657908.png,https://derpicdn.net/img/view/2018/2/17/1657908.png,0,0.962315083,0,130,862,1010,862,880,rarity
1659290.png,https://derpicdn.net/img/view/2018/2/18/1659290.png,0,0.989881098,18,0,820,756,802,756,rarity
1662225.png,https://derpicdn.net/img/view/2018/2/21/1662225.png,0,0.998862207,904,0,1730,808,826,808,rarity
166392.jpg,https://derpicdn.net/img/view/2012/11/28/166392.jpg,0,0.99400574,13,6,357,350,344,344,rarity
1665532.png,https://derpicdn.net/img/view/2018/2/25/1665532.png,0,0.92577666,678,75,1250,647,572,572,rarity
1671261.png,https://derpicdn.net/img/view/2018/3/4/1671261.png,0,0.999754488,412,107,888,583,476,476,rarity
1671429.png,https://derpicdn.net/img/view/2018/3/4/1671429.png,0,0.982491732,286,2,588,304,302,302,rarity
1678275.png,https://derpicdn.net/img/view/2018/3/12/1678275.png,0,0.992419362,58,0,588,513,530,513,rarity
1681347.png,https://derpicdn.net/img/view/2018/3/15/1681347.png,0,0.99611789,2266,271,6180,4185,3914,3914,rarity
1687950.png,https://derpicdn.net/img/view/2018/3/23/1687950.png,0,0.922412336,0,0,1175,1356,1175,1356,rarity
1701116.png,https://derpicdn.net/img/view/2018/4/6/1701116.png,0,0.971485794,473,40,1071,638,598,598,rarity
1702447.png,https://derpicdn.net/img/view/2018/4/8/1702447.png,0,0.995287597,233,0,470,238,237,238,rarity
1704723.png,https://derpicdn.net/img/view/2018/4/11/1704723.png,0,0.99928683,1123,169,2703,1749,1580,1580,rarity
1709064.png,https://derpicdn.net/img/view/2018/4/16/1709064.png,0,0.988808632,80,0,460,363,380,363,rarity
1712400.png,https://derpicdn.net/img/view/2018/4/20/1712400.png,0,0.991357803,0,0,725,711,725,711,rarity
1715373.png,https://derpicdn.net/img/view/2018/4/23/1715373.png,0,0.997419178,661,0,2139,1472,1478,1472,rarity
1725785.png,https://derpicdn.net/img/view/2018/5/6/1725785.png,0,0.965672731,970,166,2226,1422,1256,1256,rarity
1726557.png,https://derpicdn.net/img/view/2018/5/7/1726557.png,0,0.957118809,387,71,1213,897,826,826,rarity
1736211.png,https://derpicdn.net/img/view/2018/5/19/1736211.png,0,0.93815583,1490,316,6000,5434,4510,5118,rarity
1736768.png,https://derpicdn.net/img/view/2018/5/19/1736768.png,0,0.988693953,242,0,1424,1160,1182,1160,rarity
1741980.png,https://derpicdn.net/img/view/2018/5/26/1741980.png,0,0.967662752,443,23,1377,999,934,976,rarity
1759375.png,https://derpicdn.net/img/view/2018/6/16/1759375.png,0,0.978521526,71,12,721,662,650,650,rarity
1767911.png,https://derpicdn.net/img/view/2018/6/28/1767911.png,0,0.995369971,133,47,2135,2049,2002,2002,rarity
1767912.png,https://derpicdn.net/img/view/2018/6/28/1767912.png,0,0.99535346,133,48,2135,2050,2002,2002,rarity
1770511.png,https://derpicdn.net/img/view/2018/7/1/1770511.png,0,0.993304312,129,20,431,322,302,302,rarity
1770511.png,https://derpicdn.net/img/view/2018/7/1/1770511.png,1,0.987909973,516,33,808,325,292,292,rarity
1771155.png,https://derpicdn.net/img/view/2018/7/2/1771155.png,0,0.999034405,1363,0,2755,1378,1392,1378,rarity
1776774.png,https://derpicdn.net/img/view/2018/7/9/1776774.png,0,0.989843726,88,0,1440,1392,1352,1392,rarity
1783473.png,https://derpicdn.net/img/view/2018/7/17/1783473.png,0,0.993308544,49,9,445,405,396,396,rarity
1788037.png,https://derpicdn.net/img/view/2018/7/23/1788037.png,0,0.971068263,3014,0,4698,1608,1684,1608,rarity
1795079.png,https://derpicdn.net/img/view/2018/8/1/1795079.png,0,0.996363699,636,130,1384,878,748,748,rarity
1796066.png,https://derpicdn.net/img/view/2018/8/2/1796066.png,0,0.997647822,2728,0,5464,2305,2736,2305,rarity
1798698.png,https://derpicdn.net/img/view/2018/8/5/1798698.png,0,0.988898098,47,22,356,371,309,349,rarity
1798698.png,https://derpicdn.net/img/view/2018/8/5/1798698.png,1,0.93981564,0,100,271,371,271,271,rarity
1806610.png,https://derpicdn.net/img/view/2018/8/14/1806610.png,0,0.993247986,39,0,721,659,682,659,rarity
1809428.png,https://derpicdn.net/img/view/2018/8/17/1809428.png,0,0.998148084,606,0,1172,561,566,561,rarity
1811491.png,https://derpicdn.net/img/view/2018/8/20/1811491.png,0,0.995235741,882,0,1084,182,202,182,rarity
1811491.png,https://derpicdn.net/img/view/2018/8/20/1811491.png,1,0.989345968,67,0,719,642,652,642,rarity
1814004.png,https://derpicdn.net/img/view/2018/8/23/1814004.png,0,0.987407982,3749,0,8017,4221,4268,4221,rarity
1814390.png,https://derpicdn.net/img/view/2018/8/23/1814390.png,0,0.99202317,93,0,1081,931,988,931,rarity
1820974.png,https://derpicdn.net/img/view/2018/8/31/1820974.png,0,0.998143554,963,153,1773,963,810,810,rarity
1820975.png,https://derpicdn.net/img/view/2018/8/31/1820975.png,0,0.99293685,627,43,1431,847,804,804,rarity
1821227.png,https://derpicdn.net/img/view/2018/8/31/1821227.png,0,0.991811275,0,4,397,426,397,422,rarity
1833247.png,https://derpicdn.net/img/view/2018/9/15/1833247.png,0,0.998524308,34,0,466,423,432,423,rarity
1834462.png,https://derpicdn.net/img/view/2018/9/16/1834462.png,0,0.905770421,1056,0,2146,821,1090,821,rarity
1838775.png,https://derpicdn.net/img/view/2018/9/22/1838775.png,0,0.98975265,113,0,421,295,308,295,rarity
1840925.png,https://derpicdn.net/img/view/2018/9/25/1840925.png,0,0.940749407,0,194,2227,2664,2227,2470,rarity
1846432.png,https://derpicdn.net/img/view/2018/10/2/1846432.png,0,0.965486109,492,0,968,399,476,399,rarity
1849911.png,https://derpicdn.net/img/view/2018/10/6/1849911.png,0,0.992309749,554,397,852,695,298,298,rarity
1849912.png,https://derpicdn.net/img/view/2018/10/6/1849912.png,0,0.992103994,556,399,850,693,294,294,rarity
1852521.png,https://derpicdn.net/img/view/2018/10/9/1852521.png,0,0.976944447,0,295,812,1111,812,816,rarity
1867893.png,https://derpicdn.net/img/view/2018/10/27/1867893.png,0,0.92970866,15,0,771,540,756,540,rarity
1873992.png,https://derpicdn.net/img/view/2018/11/3/1873992.png,0,0.99768585,387,113,977,703,590,590,rarity
1887168.png,https://derpicdn.net/img/view/2018/11/20/1887168.png,0,0.977912664,347,0,1440,807,1093,807,rarity
1890213.png,https://derpicdn.net/img/view/2018/11/25/1890213.png,0,0.981169701,0,0,521,537,521,537,rarity
1893360.png,https://derpicdn.net/img/view/2018/11/29/1893360.png,0,0.995689392,474,176,1256,958,782,782,rarity
191212.png,https://derpicdn.net/img/view/2012/12/23/191212.png,0,0.968444705,368,366,812,810,444,444,rarity
1920090.png,https://derpicdn.net/img/view/2018/12/27/1920090.png,0,0.96075809,0,0,444,415,444,415,rarity
1925407.png,https://derpicdn.net/img/view/2019/1/3/1925407.png,0,0.997544944,427,61,973,607,546,546,rarity
1927536.png,https://derpicdn.net/img/view/2019/1/5/1927536.png,0,0.944840252,107,82,1221,1196,1114,1114,rarity
1934155.png,https://derpicdn.net/img/view/2019/1/13/1934155.png,0,0.967184424,77,0,395,269,318,269,rarity
1938426.png,https://derpicdn.net/img/view/2019/1/18/1938426.png,0,0.997042477,127,0,463,332,336,332,rarity
1940230.png,https://derpicdn.net/img/view/2019/1/20/1940230.png,0,0.92056793,182,0,1032,761,850,761,rarity
1950296.png,https://derpicdn.net/img/view/2019/2/1/1950296.png,0,0.998516917,482,11,2364,1893,1882,1882,rarity
1952298.png,https://derpicdn.net/img/view/2019/2/3/1952298.png,0,0.983538687,1406,0,5372,3937,3966,3937,rarity
1953079.png,https://derpicdn.net/img/view/2019/2/4/1953079.png,0,0.96772629,108,0,446,327,338,327,rarity
1962974.png,https://derpicdn.net/img/view/2019/2/15/1962974.png,0,0.973824024,235,109,1651,1525,1416,1416,rarity
1967326.png,https://derpicdn.net/img/view/2019/2/20/1967326.png,0,0.930159628,0,0,1377,938,1377,938,rarity
1967327.png,https://derpicdn.net/img/view/2019/2/20/1967327.png,0,0.972762942,105,73,421,389,316,316,rarity
1969243.png,https://derpicdn.net/img/view/2019/2/22/1969243.png,0,0.992737949,451,0,1079,537,628,537,rarity
1970030.png,https://derpicdn.net/img/view/2019/2/23/1970030.png,0,0.980507553,31,0,523,452,492,452,rarity
1974061.png,https://derpicdn.net/img/view/2019/2/28/1974061.png,0,0.994105279,473,69,2555,2151,2082,2082,rarity
1979300.png,https://derpicdn.net/img/view/2019/3/7/1979300.png,0,0.988137305,0,66,684,786,684,720,rarity
1982920.png,https://derpicdn.net/img/view/2019/3/11/1982920.png,0,0.925784945,422,20,1178,776,756,756,rarity
1988851.png,https://derpicdn.net/img/view/2019/3/18/1988851.png,0,0.994982302,458,25,1158,725,700,700,rarity
1994678.png,https://derpicdn.net/img/view/2019/3/25/1994678.png,0,0.985159338,15,0,1421,941,1406,941,rarity
1997787.png,https://derpicdn.net/img/view/2019/3/29/1997787.png,0,0.988382578,4,5,543,651,539,646,rarity
2002094.png,https://derpicdn.net/img/view/2019/4/3/2002094.png,0,0.97932905,501,0,1371,861,870,861,rarity
201035.png,https://derpicdn.net/img/view/2013/1/3/201035.png,0,0.978816211,28,0,440,376,412,376,rarity
2011669.png,https://derpicdn.net/img/view/2019/4/14/2011669.png,0,0.988197505,569,0,3181,2609,2612,2609,rarity
2016214.png,https://derpicdn.net/img/view/2019/4/18/2016214.png,0,0.942251921,82,0,648,548,566,548,rarity
2019335.png,https://derpicdn.net/img/view/2019/4/21/2019335.png,0,0.973564744,0,221,2434,3111,2434,2890,rarity
2020455.png,https://derpicdn.net/img/view/2019/4/23/2020455.png,0,0.98622328,60,18,890,848,830,830,rarity
2021563.png,https://derpicdn.net/img/view/2019/4/24/2021563.png,0,0.990156829,0,0,207,207,207,207,rarity
2023061.png,https://derpicdn.net/img/view/2019/4/26/2023061.png,0,0.914400756,260,0,3656,2931,3396,2931,rarity
2024663.png,https://derpicdn.net/img/view/2019/4/27/2024663.png,0,0.998924673,582,54,1618,1090,1036,1036,rarity
2030235.png,https://derpicdn.net/img/view/2019/5/4/2030235.png,0,0.960504711,81,0,325,234,244,234,rarity
2030552.png,https://derpicdn.net/img/view/2019/5/4/2030552.png,0,0.997786403,188,102,448,362,260,260,rarity
2032197.png,https://derpicdn.net/img/view/2019/5/6/2032197.png,0,0.98237741,79,0,1371,1107,1292,1107,rarity
2034560.png,https://derpicdn.net/img/view/2019/5/9/2034560.png,0,0.989361227,16,52,554,590,538,538,rarity
2038855.png,https://derpicdn.net/img/view/2019/5/14/2038855.png,0,0.997711837,367,0,767,396,400,396,rarity
2047164.png,https://derpicdn.net/img/view/2019/5/23/2047164.png,0,0.978569984,658,0,2100,1438,1442,1438,rarity
204781.png,https://derpicdn.net/img/view/2013/1/7/204781.png,0,0.99030447,61,0,419,342,358,342,rarity
2049452.png,https://derpicdn.net/img/view/2019/5/26/2049452.png,0,0.950130343,69,9,679,619,610,610,rarity
2068570.png,https://derpicdn.net/img/view/2019/6/18/2068570.png,0,0.952236593,0,40,775,950,775,910,rarity
2072848.png,https://derpicdn.net/img/view/2019/6/23/2072848.png,0,0.994823396,117,0,635,507,518,507,rarity
2077788.png,https://derpicdn.net/img/view/2019/6/28/2077788.png,0,0.926405668,752,150,1244,642,492,492,rarity
2078489.png,https://derpicdn.net/img/view/2019/6/29/2078489.png,0,0.946576476,765,43,1381,659,616,616,rarity
2078939.png,https://derpicdn.net/img/view/2019/6/30/2078939.png,0,0.997903824,253,379,557,683,304,304,rarity
2089181.png,https://derpicdn.net/img/view/2019/7/11/2089181.png,0,0.990265906,944,43,2516,1615,1572,1572,rarity
2108484.png,https://derpicdn.net/img/view/2019/8/4/2108484.png,1,0.987686574,672,140,1104,572,432,432,rarity
2108558.png,https://derpicdn.net/img/view/2019/8/4/2108558.png,0,0.993377924,0,0,579,559,579,559,rarity
2111672.png,https://derpicdn.net/img/view/2019/8/7/2111672.png,0,0.993067324,302,0,850,446,548,446,rarity
2111672.png,https://derpicdn.net/img/view/2019/8/7/2111672.png,1,0.989393651,878,221,1380,723,502,502,rarity
2111673.png,https://derpicdn.net/img/view/2019/8/7/2111673.png,1,0.952331901,7,230,415,638,408,408,rarity
2117195.png,https://derpicdn.net/img/view/2019/8/13/2117195.png,0,0.962902248,841,0,2131,1255,1290,1255,rarity
2117854.png,https://derpicdn.net/img/view/2019/8/14/2117854.png,0,0.997999251,204,188,878,862,674,674,rarity
2130258.png,https://derpicdn.net/img/view/2019/8/29/2130258.png,0,0.952998996,215,85,1067,937,852,852,rarity
2130298.png,https://derpicdn.net/img/view/2019/8/29/2130298.png,0,0.983939528,512,24,1202,714,690,690,rarity
2137547.png,https://derpicdn.net/img/view/2019/9/6/2137547.png,0,0.993574798,353,0,1493,1092,1140,1092,rarity
2138642.png,https://derpicdn.net/img/view/2019/9/7/2138642.png,0,0.988735497,112,0,832,688,720,688,rarity
2138748.png,https://derpicdn.net/img/view/2019/9/7/2138748.png,0,0.959968567,928,1596,2254,2922,1326,1326,rarity
2138816.png,https://derpicdn.net/img/view/2019/9/7/2138816.png,0,0.9492172,21,0,935,885,914,885,rarity
2140332.png,https://derpicdn.net/img/view/2019/9/9/2140332.png,0,0.985702693,190,7,1136,953,946,946,rarity
2142961.png,https://derpicdn.net/img/view/2019/9/13/2142961.png,0,0.982323408,182,71,1158,1047,976,976,rarity
2145235.png,https://derpicdn.net/img/view/2019/9/15/2145235.png,0,0.984383345,59,75,683,759,624,684,rarity
2150782.png,https://derpicdn.net/img/view/2019/9/23/2150782.png,0,0.98199445,278,29,800,551,522,522,rarity
2151576.png,https://derpicdn.net/img/view/2019/9/24/2151576.png,0,0.991186976,670,0,1848,1126,1178,1126,rarity
2153058.png,https://derpicdn.net/img/view/2019/9/25/2153058.png,0,0.981903613,1484,487,6504,5507,5020,5020,rarity
2156131.png,https://derpicdn.net/img/view/2019/9/29/2156131.png,0,0.967009306,383,48,1567,1232,1184,1184,rarity
2177946.png,https://derpicdn.net/img/view/2019/10/24/2177946.png,0,0.998746634,434,2,848,416,414,414,rarity
2179175.png,https://derpicdn.net/img/view/2019/10/26/2179175.png,0,0.995124459,21,0,499,474,478,474,rarity
2180869.png,https://derpicdn.net/img/view/2019/10/28/2180869.png,0,0.959179759,0,0,3274,3378,3274,3378,rarity
21848.png,https://derpicdn.net/img/view/2012/6/26/21848.png,0,0.973888218,152,0,466,265,314,265,rarity
2187975.png,https://derpicdn.net/img/view/2019/11/5/2187975.png,0,0.968701661,164,252,432,520,268,268,rarity
2187975.png,https://derpicdn.net/img/view/2019/11/5/2187975.png,1,0.908210218,670,0,1398,718,728,718,rarity
2205858.png,https://derpicdn.net/img/view/2019/11/26/2205858.png,0,0.983403862,68,13,218,163,150,150,rarity
2210127.png,https://derpicdn.net/img/view/2019/12/1/2210127.png,0,0.970320225,368,15,884,531,516,516,rarity
2211699.png,https://derpicdn.net/img/view/2019/12/3/2211699.png,0,0.900015235,1102,0,5100,3637,3998,3637,rarity
2218785.png,https://derpicdn.net/img/view/2019/12/12/2218785.png,0,0.987571955,509,0,1131,595,622,595,rarity
2220936.png,https://derpicdn.net/img/view/2019/12/15/2220936.png,0,0.992319465,530,17,1606,1093,1076,1076,rarity
2222395.png,https://derpicdn.net/img/view/2019/12/16/2222395.png,0,0.965073645,553,388,2215,2050,1662,1662,rarity
2228392.png,https://derpicdn.net/img/view/2019/12/24/2228392.png,0,0.994262815,252,0,1516,1235,1264,1235,rarity
2233415.png,https://derpicdn.net/img/view/2019/12/29/2233415.png,0,0.986990988,0,0,274,287,274,287,rarity
2238493.jpg,https://derpicdn.net/img/view/2020/1/4/2238493.jpg,0,0.971406281,151,2,455,306,304,304,rarity
2240442.png,https://derpicdn.net/img/view/2020/1/6/2240442.png,0,0.927621663,1026,689,2292,1955,1266,1266,rarity
2252223.jpg,https://derpicdn.net/img/view/2020/1/20/2252223.jpg,0,0.985900283,0,0,1706,1980,1706,1980,rarity
2256507.png,https://derpicdn.net/img/view/2020/1/25/2256507.png,0,0.9384588,103,0,847,717,744,717,rarity
2256774.png,https://derpicdn.net/img/view/2020/1/25/2256774.png,0,0.995000124,237,0,1245,967,1008,967,rarity
2258534.jpg,https://derpicdn.net/img/view/2020/1/27/2258534.jpg,0,0.998584807,258,0,1044,759,786,759,rarity
2260056.png,https://derpicdn.net/img/view/2020/1/29/2260056.png,0,0.97231698,443,0,913,470,470,470,rarity
2260056.png,https://derpicdn.net/img/view/2020/1/29/2260056.png,1,0.943768859,981,118,1253,390,272,272,rarity
2261587.png,https://derpicdn.net/img/view/2020/1/31/2261587.png,0,0.982376456,0,0,1383,1300,1383,1300,rarity
2262919.png,https://derpicdn.net/img/view/2020/2/1/2262919.png,0,0.943358123,0,20,401,484,401,464,rarity
2263157.png,https://derpicdn.net/img/view/2020/2/1/2263157.png,0,0.96244067,453,116,2479,2142,2026,2026,rarity
2270566.png,https://derpicdn.net/img/view/2020/2/10/2270566.png,0,0.906933367,1047,0,2771,1526,1724,1526,rarity
2272791.png,https://derpicdn.net/img/view/2020/2/13/2272791.png,0,0.977886736,168,26,608,466,440,440,rarity
2277842.jpg,https://derpicdn.net/img/view/2020/2/18/2277842.jpg,0,0.984572113,411,0,897,458,486,458,rarity
227840.png,https://derpicdn.net/img/view/2013/1/30/227840.png,0,0.998311698,273,0,1221,923,948,923,rarity
2291915.jpg,https://derpicdn.net/img/view/2020/3/7/2291915.jpg,0,0.994975924,475,0,1467,978,992,978,rarity
2293279.png,https://derpicdn.net/img/view/2020/3/9/2293279.png,0,0.983897507,222,0,1192,892,970,892,rarity
2295674.jpg,https://derpicdn.net/img/view/2020/3/12/2295674.jpg,0,0.989427269,51,0,857,773,806,773,rarity
2297023.png,https://derpicdn.net/img/view/2020/3/14/2297023.png,0,0.998237193,230,0,1328,965,1098,965,rarity
2299807.png,https://derpicdn.net/img/view/2020/3/17/2299807.png,0,0.981047869,1614,988,2026,1400,412,412,rarity
2301451.png,https://derpicdn.net/img/view/2020/3/19/2301451.png,0,0.991595805,349,0,1363,904,1014,904,rarity
2302500.png,https://derpicdn.net/img/view/2020/3/21/2302500.png,0,0.998101652,1526,0,2832,1364,1306,1364,rarity
2302500.png,https://derpicdn.net/img/view/2020/3/21/2302500.png,1,0.99645257,183,1787,1647,3251,1464,1464,rarity
2303420.png,https://derpicdn.net/img/view/2020/3/22/2303420.png,0,0.931576729,2406,105,3938,1819,1532,1714,rarity
2303564.png,https://derpicdn.net/img/view/2020/3/22/2303564.png,0,0.907353461,145,5,409,269,264,264,rarity
2307777.jpg,https://derpicdn.net/img/view/2020/3/28/2307777.jpg,0,0.974450529,210,190,810,790,600,600,rarity
2310671.jpg,https://derpicdn.net/img/view/2020/3/31/2310671.jpg,0,0.99377799,208,94,892,778,684,684,rarity
2312289.png,https://derpicdn.net/img/view/2020/4/2/2312289.png,0,0.959191203,3177,3371,3819,4013,642,642,rarity
2314014.jpg,https://derpicdn.net/img/view/2020/4/4/2314014.jpg,0,0.971790791,70,0,394,320,324,320,rarity
2321006.jpg,https://derpicdn.net/img/view/2020/4/13/2321006.jpg,0,0.9957636,125,348,525,748,400,400,rarity
2324056.jpg,https://derpicdn.net/img/view/2020/4/16/2324056.jpg,0,0.980910182,28,0,780,719,752,719,rarity
2328377.jpg,https://derpicdn.net/img/view/2020/4/22/2328377.jpg,0,0.921468973,281,54,435,208,154,154,rarity
2328773.jpg,https://derpicdn.net/img/view/2020/4/22/2328773.jpg,0,0.968804061,688,11,1894,1217,1206,1206,rarity
2330267.jpg,https://derpicdn.net/img/view/2020/4/24/2330267.jpg,0,0.997928143,559,364,1113,918,554,554,rarity
2330915.jpg,https://derpicdn.net/img/view/2020/4/24/2330915.jpg,0,0.983255923,18,0,748,697,730,697,rarity
2331962.png,https://derpicdn.net/img/view/2020/4/26/2331962.png,0,0.998705328,4169,0,7677,3348,3508,3348,rarity
2331962.png,https://derpicdn.net/img/view/2020/4/26/2331962.png,1,0.92437464,241,0,3555,3282,3314,3282,rarity
2333734.png,https://derpicdn.net/img/view/2020/4/28/2333734.png,0,0.986427069,0,64,690,794,690,730,rarity
2335437.png,https://derpicdn.net/img/view/2020/4/30/2335437.png,0,0.990968764,10,23,442,455,432,432,rarity
2338687.jpg,https://derpicdn.net/img/view/2020/5/3/2338687.jpg,0,0.964238942,84,270,474,660,390,390,rarity
2345836.png,https://derpicdn.net/img/view/2020/5/11/2345836.png,0,0.990961254,8,0,484,420,476,420,rarity
2347590.png,https://derpicdn.net/img/view/2020/5/13/2347590.png,0,0.997675896,620,7,1682,1069,1062,1062,rarity
2348024.png,https://derpicdn.net/img/view/2020/5/14/2348024.png,0,0.991746724,28,0,406,359,378,359,rarity
23533.png,https://derpicdn.net/img/view/2012/6/28/23533.png,0,0.93274647,513,336,735,558,222,222,rarity
235340.png,https://derpicdn.net/img/view/2013/2/6/235340.png,0,0.999068022,173,31,479,337,306,306,rarity
235341.png,https://derpicdn.net/img/view/2013/2/6/235341.png,0,0.978573859,183,22,471,310,288,288,rarity
2353496.jpg,https://derpicdn.net/img/view/2020/5/20/2353496.jpg,0,0.958107412,313,205,911,803,598,598,rarity
2354643.jpg,https://derpicdn.net/img/view/2020/5/21/2354643.jpg,0,0.966214776,540,370,818,648,278,278,rarity
2354643.jpg,https://derpicdn.net/img/view/2020/5/21/2354643.jpg,1,0.938194573,19,12,583,576,564,564,rarity
245671.png,https://derpicdn.net/img/view/2013/2/16/245671.png,0,0.987771094,0,37,636,725,636,688,rarity
272619.png,https://derpicdn.net/img/view/2013/3/17/272619.png,0,0.994050086,79,3,331,255,252,252,rarity
274264.png,https://derpicdn.net/img/view/2013/3/19/274264.png,0,0.998899817,415,0,905,481,490,481,rarity
274716.png,https://derpicdn.net/img/view/2013/3/20/274716.png,0,0.996179283,202,50,554,402,352,352,rarity
281681.png,https://derpicdn.net/img/view/2013/3/28/281681.png,0,0.90702343,361,405,639,683,278,278,rarity
286874.png,https://derpicdn.net/img/view/2013/4/3/286874.png,0,0.982242823,333,0,875,462,542,462,rarity
297436.jpg,https://derpicdn.net/img/view/2013/4/14/297436.jpg,0,0.974498451,59,722,301,964,242,242,rarity
301185.png,https://derpicdn.net/img/view/2013/4/18/301185.png,0,0.951791227,2,0,236,216,234,216,rarity
30325.jpg,https://derpicdn.net/img/view/2012/7/3/30325.jpg,0,0.976178527,93,0,589,467,496,467,rarity
313333.png,https://derpicdn.net/img/view/2013/5/1/313333.png,0,0.977587581,621,0,1217,493,596,493,rarity
313333.png,https://derpicdn.net/img/view/2013/5/1/313333.png,1,0.910755694,167,0,601,374,434,374,rarity
314012.png,https://derpicdn.net/img/view/2013/5/2/314012.png,0,0.997124076,760,0,1442,665,682,665,rarity
316849.jpg,https://derpicdn.net/img/view/2013/5/5/316849.jpg,0,0.998788595,270,0,828,554,558,554,rarity
32126.jpg,https://derpicdn.net/img/view/2012/7/5/32126.jpg,0,0.957263529,355,0,1493,1115,1138,1115,rarity
333091.png,https://derpicdn.net/img/view/2013/5/25/333091.png,0,0.946920633,2330,158,3956,1784,1626,1626,rarity
334323.png,https://derpicdn.net/img/view/2013/5/26/334323.png,0,0.994339824,675,107,1185,617,510,510,rarity
339526.png,https://derpicdn.net/img/view/2013/6/3/339526.png,0,0.90200305,274,0,1024,629,750,629,rarity
347236.png,https://derpicdn.net/img/view/2013/6/13/347236.png,0,0.995814741,865,79,1713,927,848,848,rarity
347661.png,https://derpicdn.net/img/view/2013/6/13/347661.png,0,0.978271961,174,0,362,188,188,188,rarity
366825.png,https://derpicdn.net/img/view/2013/7/7/366825.png,0,0.985165596,203,0,1701,1429,1498,1429,rarity
372541.png,https://derpicdn.net/img/view/2013/7/13/372541.png,0,0.994098246,437,47,991,601,554,554,rarity
380214.jpg,https://derpicdn.net/img/view/2013/7/21/380214.jpg,0,0.996271491,171,0,571,384,400,384,rarity
410877.png,https://derpicdn.net/img/view/2013/8/26/410877.png,0,0.997318447,149,0,473,313,324,313,rarity
412539.png,https://derpicdn.net/img/view/2013/8/27/412539.png,0,0.975068092,0,43,754,805,754,762,rarity
412885.png,https://derpicdn.net/img/view/2013/8/28/412885.png,0,0.982717454,354,61,594,301,240,240,rarity
426668.png,https://derpicdn.net/img/view/2013/9/13/426668.png,0,0.998702765,319,0,673,334,354,334,rarity
437890.png,https://derpicdn.net/img/view/2013/9/29/437890.png,0,0.951038063,139,0,1407,1239,1268,1239,rarity
459755.png,https://derpicdn.net/img/view/2013/10/29/459755.png,0,0.979955137,2815,0,4347,1330,1532,1330,rarity
472161.jpg,https://derpicdn.net/img/view/2013/11/14/472161.jpg,0,0.99890846,32,116,202,286,170,170,rarity
478706.png,https://derpicdn.net/img/view/2013/11/23/478706.png,0,0.942576706,1297,586,2673,1962,1376,1376,rarity
485038.png,https://derpicdn.net/img/view/2013/11/29/485038.png,0,0.987632513,1857,0,4367,2493,2510,2493,rarity
486098.png,https://derpicdn.net/img/view/2013/11/30/486098.png,0,0.973963857,104,14,702,612,598,598,rarity
497162.png,https://derpicdn.net/img/view/2013/12/14/497162.png,0,0.969591618,157,0,1023,716,866,716,rarity
518553.jpg,https://derpicdn.net/img/view/2014/1/8/518553.jpg,0,0.979908705,1122,2810,2738,4426,1616,1616,rarity
532233.png,https://derpicdn.net/img/view/2014/1/23/532233.png,0,0.957042456,0,0,426,453,426,453,rarity
548131.jpg,https://derpicdn.net/img/view/2014/2/10/548131.jpg,0,0.931894302,12,0,678,475,666,475,rarity
549654.png,https://derpicdn.net/img/view/2014/2/12/549654.png,0,0.978062153,108,13,870,775,762,762,rarity
554849.png,https://derpicdn.net/img/view/2014/2/17/554849.png,0,0.996854722,106,0,290,183,184,183,rarity
562642.jpg,https://derpicdn.net/img/view/2014/2/27/562642.jpg,0,0.997551262,87,0,303,216,216,216,rarity
585535.png,https://derpicdn.net/img/view/2014/3/26/585535.png,0,0.993840754,264,28,500,264,236,236,rarity
599710.jpg,https://derpicdn.net/img/view/2014/4/13/599710.jpg,0,0.922921956,0,90,369,478,369,388,rarity
607984.png,https://derpicdn.net/img/view/2014/4/23/607984.png,0,0.997035384,699,165,1183,649,484,484,rarity
607984.png,https://derpicdn.net/img/view/2014/4/23/607984.png,1,0.960721672,1335,2064,1615,2344,280,280,rarity
607984.png,https://derpicdn.net/img/view/2014/4/23/607984.png,2,0.905973554,1989,2059,2317,2387,328,328,rarity
611154.png,https://derpicdn.net/img/view/2014/4/27/611154.png,0,0.914602101,244,38,772,566,528,528,rarity
612442.png,https://derpicdn.net/img/view/2014/4/28/612442.png,0,0.984226108,350,26,736,412,386,386,rarity
612444.png,https://derpicdn.net/img/view/2014/4/28/612444.png,0,0.915198863,358,32,732,406,374,374,rarity
618204.png,https://derpicdn.net/img/view/2014/5/5/618204.png,0,0.994871914,0,0,2877,2987,2877,2987,rarity
625071.png,https://derpicdn.net/img/view/2014/5/12/625071.png,0,0.976985574,759,270,997,508,238,238,rarity
631150.png,https://derpicdn.net/img/view/2014/5/19/631150.png,0,0.983652532,124,0,1758,1504,1634,1504,rarity
634065.png,https://derpicdn.net/img/view/2014/5/23/634065.png,0,0.985952973,1318,0,2468,1071,1150,1071,rarity
650038.png,https://derpicdn.net/img/view/2014/6/10/650038.png,0,0.998214364,128,173,430,475,302,302,rarity
653414.png,https://derpicdn.net/img/view/2014/6/15/653414.png,0,0.998416007,587,61,1341,815,754,754,rarity
65376.png,https://derpicdn.net/img/view/2012/8/2/65376.png,0,0.986770332,227,383,499,655,272,272,rarity
6554.png,https://derpicdn.net/img/view/2012/6/18/6554.png,0,0.92798239,629,136,1263,770,634,634,rarity
657877.png,https://derpicdn.net/img/view/2014/6/20/657877.png,0,0.981030643,368,72,794,498,426,426,rarity
657877.png,https://derpicdn.net/img/view/2014/6/20/657877.png,1,0.971859694,34,50,302,318,268,268,rarity
665403.png,https://derpicdn.net/img/view/2014/7/1/665403.png,0,0.983223796,106,0,410,294,304,294,rarity
671702.png,https://derpicdn.net/img/view/2014/7/10/671702.png,0,0.972957313,652,315,1490,1153,838,838,rarity
681756.png,https://derpicdn.net/img/view/2014/7/23/681756.png,0,0.998650432,425,9,865,449,440,440,rarity
687405.png,https://derpicdn.net/img/view/2014/7/31/687405.png,0,0.966562271,68,13,554,499,486,486,rarity
687813.png,https://derpicdn.net/img/view/2014/7/31/687813.png,0,0.995936573,225,0,741,478,516,478,rarity
690008.png,https://derpicdn.net/img/view/2014/8/3/690008.png,0,0.995782912,217,0,825,598,608,598,rarity
690613.png,https://derpicdn.net/img/view/2014/8/3/690613.png,0,0.937007189,7162,4045,10494,7377,3332,3332,rarity
698860.png,https://derpicdn.net/img/view/2014/8/13/698860.png,0,0.993150115,379,204,1157,982,778,778,rarity
703866.png,https://derpicdn.net/img/view/2014/8/20/703866.png,0,0.99320519,107,0,1325,1163,1218,1163,rarity
708964.png,https://derpicdn.net/img/view/2014/8/27/708964.png,0,0.999273002,2568,207,4258,1897,1690,1690,rarity
720769.png,https://derpicdn.net/img/view/2014/9/12/720769.png,0,0.984799206,232,84,994,846,762,762,rarity
720939.png,https://derpicdn.net/img/view/2014/9/13/720939.png,0,0.950086057,447,91,867,511,420,420,rarity
728118.png,https://derpicdn.net/img/view/2014/9/23/728118.png,0,0.952156305,0,9,885,949,885,940,rarity
747852.png,https://derpicdn.net/img/view/2014/10/22/747852.png,0,0.942116857,256,175,1170,1089,914,914,rarity
749660.png,https://derpicdn.net/img/view/2014/10/24/749660.png,0,0.932147563,105,91,337,323,232,232,rarity
752286.jpg,https://derpicdn.net/img/view/2014/10/28/752286.jpg,0,0.99834621,386,0,776,378,390,378,rarity
758021.png,https://derpicdn.net/img/view/2014/11/4/758021.png,0,0.994480073,225,28,591,394,366,366,rarity
768372.png,https://derpicdn.net/img/view/2014/11/20/768372.png,0,0.903473437,3,25,691,713,688,688,rarity
770038.jpg,https://derpicdn.net/img/view/2014/11/23/770038.jpg,0,0.991232514,1632,419,2272,1059,640,640,rarity
770038.jpg,https://derpicdn.net/img/view/2014/11/23/770038.jpg,1,0.991174579,1015,182,1819,986,804,804,rarity
7747.png,https://derpicdn.net/img/view/2012/6/18/7747.png,0,0.972935319,0,0,773,739,773,739,rarity
782153.png,https://derpicdn.net/img/view/2014/12/10/782153.png,0,0.998824835,128,38,526,436,398,398,rarity
785663.jpg,https://derpicdn.net/img/view/2014/12/15/785663.jpg,0,0.998081326,288,65,1188,965,900,900,rarity
788476.png,https://derpicdn.net/img/view/2014/12/20/788476.png,0,0.98473525,303,21,659,377,356,356,rarity
78876.png,https://derpicdn.net/img/view/2012/8/20/78876.png,0,0.980498075,453,0,900,493,447,493,rarity
790288.png,https://derpicdn.net/img/view/2014/12/22/790288.png,0,0.931621313,660,48,1486,874,826,826,rarity
79150.png,https://derpicdn.net/img/view/2012/8/21/79150.png,0,0.969253659,543,226,691,374,148,148,rarity
796407.png,https://derpicdn.net/img/view/2014/12/31/796407.png,0,0.986560285,284,0,696,400,412,400,rarity
797517.png,https://derpicdn.net/img/view/2015/1/1/797517.png,0,0.989640594,585,16,3409,2840,2824,2824,rarity
801399.jpg,https://derpicdn.net/img/view/2015/1/7/801399.jpg,0,0.936694205,65,154,365,454,300,300,rarity
820453.png,https://derpicdn.net/img/view/2015/2/3/820453.png,0,0.990527153,1725,0,3049,1205,1324,1205,rarity
823930.png,https://derpicdn.net/img/view/2015/2/8/823930.png,0,0.988854945,626,195,1562,1131,936,936,rarity
83457.png,https://derpicdn.net/img/view/2012/8/26/83457.png,0,0.997438669,446,174,750,478,304,304,rarity
835079.png,https://derpicdn.net/img/view/2015/2/22/835079.png,0,0.987327635,294,21,670,397,376,376,rarity
840056.png,https://derpicdn.net/img/view/2015/3/1/840056.png,0,0.989185631,152,0,1780,1470,1628,1470,rarity
844696.png,https://derpicdn.net/img/view/2015/3/7/844696.png,0,0.994262338,250,4,770,524,520,520,rarity
872416.png,https://derpicdn.net/img/view/2015/4/12/872416.png,0,0.996611238,137,67,431,361,294,294,rarity
872550.png,https://derpicdn.net/img/view/2015/4/12/872550.png,0,0.998779356,476,22,714,260,238,238,rarity
881502.jpg,https://derpicdn.net/img/view/2015/4/24/881502.jpg,0,0.953019142,475,44,855,424,380,380,rarity
883331.png,https://derpicdn.net/img/view/2015/4/26/883331.png,0,0.999307036,358,223,634,499,276,276,rarity
889549.png,https://derpicdn.net/img/view/2015/5/5/889549.png,0,0.998980284,64,0,478,414,414,414,rarity
893799.png,https://derpicdn.net/img/view/2015/5/11/893799.png,0,0.900436461,175,18,619,462,444,444,rarity
90260.jpg,https://derpicdn.net/img/view/2012/9/5/90260.jpg,0,0.999197662,145,0,443,290,298,290,rarity
904831.png,https://derpicdn.net/img/view/2015/5/27/904831.png,0,0.987785161,171,0,578,449,407,449,rarity
909117.png,https://derpicdn.net/img/view/2015/6/3/909117.png,0,0.995956957,694,0,1418,676,724,676,rarity
919388.png,https://derpicdn.net/img/view/2015/6/18/919388.png,0,0.911619842,767,579,1353,1165,586,586,rarity
927763.jpg,https://derpicdn.net/img/view/2015/7/1/927763.jpg,0,0.96571964,51,0,513,448,462,448,rarity
937804.png,https://derpicdn.net/img/view/2015/7/16/937804.png,0,0.989254057,11,0,659,596,648,596,rarity
942336.png,https://derpicdn.net/img/view/2015/7/23/942336.png,0,0.988269269,243,99,789,645,546,546,rarity
971752.png,https://derpicdn.net/img/view/2015/9/3/971752.png,0,0.995013773,298,15,762,479,464,464,rarity
97229.jpg,https://derpicdn.net/img/view/2012/9/13/97229.jpg,0,0.995545864,198,487,464,753,266,266,rarity
974681.png,https://derpicdn.net/img/view/2015/9/7/974681.png,0,0.994330645,19,0,385,359,366,359,rarity
975690.png,https://derpicdn.net/img/view/2015/9/8/975690.png,0,0.928471208,0,0,851,873,851,873,rarity
978415.jpg,https://derpicdn.net/img/view/2015/9/12/978415.jpg,0,0.994719982,91,603,353,865,262,262,rarity
978415.jpg,https://derpicdn.net/img/view/2015/9/12/978415.jpg,2,0.991437197,14,0,242,225,228,225,rarity
978415.jpg,https://derpicdn.net/img/view/2015/9/12/978415.jpg,4,0.973943174,99,1703,355,1959,256,256,rarity
978415.jpg,https://derpicdn.net/img/view/2015/9/12/978415.jpg,5,0.967505634,0,899,382,1287,382,388,rarity
981879.png,https://derpicdn.net/img/view/2015/9/17/981879.png,0,0.976111233,183,0,1415,1045,1232,1045,rarity
996615.png,https://derpicdn.net/img/view/2015/10/7/996615.png,0,0.978776395,37,143,621,727,584,584,rarity
1003994.jpeg,https://derpicdn.net/img/view/2015/10/17/1003994.jpeg,0,0.991769135,396,0,860,457,464,457,rarity
1004558.jpeg,https://derpicdn.net/img/view/2015/10/17/1004558.jpeg,0,0.984523416,138,2,542,406,404,404,rarity
1005252.jpeg,https://derpicdn.net/img/view/2015/10/18/1005252.jpeg,0,0.968987823,482,156,842,516,360,360,rarity
1005252.jpeg,https://derpicdn.net/img/view/2015/10/18/1005252.jpeg,1,0.947215319,0,1216,255,1508,255,292,rarity
1006390.jpeg,https://derpicdn.net/img/view/2015/10/20/1006390.jpeg,0,0.981805146,1035,0,3359,2152,2324,2152,rarity
1008417.jpeg,https://derpicdn.net/img/view/2015/10/24/1008417.jpeg,0,0.994507492,366,0,850,470,484,470,rarity
1009420.jpeg,https://derpicdn.net/img/view/2015/10/25/1009420.jpeg,0,0.991020918,290,0,654,364,364,364,rarity
1020649.jpeg,https://derpicdn.net/img/view/2015/11/11/1020649.jpeg,0,0.944368362,283,0,661,363,378,363,rarity
1024134.jpeg,https://derpicdn.net/img/view/2015/11/16/1024134.jpeg,0,0.994485497,51,0,529,476,478,476,rarity
1025251.jpeg,https://derpicdn.net/img/view/2015/11/18/1025251.jpeg,0,0.987602413,879,0,1861,946,982,946,rarity
1025356.jpeg,https://derpicdn.net/img/view/2015/11/18/1025356.jpeg,0,0.904119492,332,145,916,729,584,584,rarity
1029222.jpeg,https://derpicdn.net/img/view/2015/11/24/1029222.jpeg,0,0.959525347,66,0,348,276,282,276,rarity
1036698.jpeg,https://derpicdn.net/img/view/2015/12/4/1036698.jpeg,0,0.901349425,316,0,994,608,678,608,rarity
1041245.jpeg,https://derpicdn.net/img/view/2015/12/10/1041245.jpeg,0,0.993464112,116,778,424,1086,308,308,rarity
1049943.jpeg,https://derpicdn.net/img/view/2015/12/21/1049943.jpeg,0,0.95021975,1,0,597,556,596,556,rarity
1068977.jpeg,https://derpicdn.net/img/view/2016/1/18/1068977.jpeg,0,0.998173714,183,0,587,390,404,390,rarity
1073753.jpeg,https://derpicdn.net/img/view/2016/1/25/1073753.jpeg,0,0.961643517,31,0,817,768,786,768,rarity
1074303.jpeg,https://derpicdn.net/img/view/2016/1/26/1074303.jpeg,0,0.996618688,358,0,1278,799,920,799,rarity
1077111.jpeg,https://derpicdn.net/img/view/2016/1/31/1077111.jpeg,0,0.981611371,149,24,413,288,264,264,rarity
1082723.jpeg,https://derpicdn.net/img/view/2016/2/7/1082723.jpeg,0,0.995040357,575,444,1623,1492,1048,1048,rarity
1086762.jpeg,https://derpicdn.net/img/view/2016/2/13/1086762.jpeg,0,0.968895972,137,0,757,490,620,490,rarity
1101919.jpeg,https://derpicdn.net/img/view/2016/3/4/1101919.jpeg,0,0.94683516,492,0,1920,1080,1428,1080,rarity
1105325.jpeg,https://derpicdn.net/img/view/2016/3/9/1105325.jpeg,0,0.999699295,196,1,468,273,272,272,rarity
1106640.jpeg,https://derpicdn.net/img/view/2016/3/11/1106640.jpeg,0,0.98876965,0,0,459,458,459,458,rarity
1107115.jpeg,https://derpicdn.net/img/view/2016/3/12/1107115.jpeg,0,0.963384628,37,0,725,414,688,414,rarity
1109353.jpeg,https://derpicdn.net/img/view/2016/3/15/1109353.jpeg,0,0.994278431,276,18,628,370,352,352,rarity
1111072.jpeg,https://derpicdn.net/img/view/2016/3/17/1111072.jpeg,0,0.979961932,57,0,853,788,796,788,rarity
1114358.jpeg,https://derpicdn.net/img/view/2016/3/22/1114358.jpeg,0,0.939808011,0,425,1080,1920,1080,1495,rarity
1124320.jpeg,https://derpicdn.net/img/view/2016/4/4/1124320.jpeg,0,0.990305603,486,223,2420,2157,1934,1934,rarity
1133558.jpeg,https://derpicdn.net/img/view/2016/4/16/1133558.jpeg,0,0.991595566,302,71,910,679,608,608,rarity
1140130.jpeg,https://derpicdn.net/img/view/2016/4/26/1140130.jpeg,0,0.998446822,332,44,898,610,566,566,rarity
1144022.jpeg,https://derpicdn.net/img/view/2016/5/1/1144022.jpeg,0,0.996551752,179,267,555,643,376,376,rarity
1150795.jpeg,https://derpicdn.net/img/view/2016/5/10/1150795.jpeg,0,0.987356663,532,0,1110,509,578,509,rarity
1151816.jpeg,https://derpicdn.net/img/view/2016/5/11/1151816.jpeg,0,0.996183991,922,142,1682,902,760,760,rarity
1156334.jpeg,https://derpicdn.net/img/view/2016/5/17/1156334.jpeg,0,0.993723094,964,152,1668,856,704,704,rarity
1163485.jpeg,https://derpicdn.net/img/view/2016/5/26/1163485.jpeg,0,0.996900141,0,343,1492,1869,1492,1526,rarity
1165823.jpeg,https://derpicdn.net/img/view/2016/5/29/1165823.jpeg,0,0.946090758,2554,153,3507,1123,953,970,rarity
1189906.jpeg,https://derpicdn.net/img/view/2016/6/30/1189906.jpeg,0,0.938501716,541,0,1547,967,1006,967,rarity
1195396.jpeg,https://derpicdn.net/img/view/2016/7/7/1195396.jpeg,0,0.97670877,294,0,1032,634,738,634,rarity
1195610.jpeg,https://derpicdn.net/img/view/2016/7/7/1195610.jpeg,0,0.989880979,266,0,838,487,572,487,rarity
1195611.jpeg,https://derpicdn.net/img/view/2016/7/7/1195611.jpeg,0,0.930078387,287,0,787,456,500,456,rarity
1196238.jpeg,https://derpicdn.net/img/view/2016/7/8/1196238.jpeg,0,0.975869417,760,0,1692,894,932,894,rarity
1196252.jpeg,https://derpicdn.net/img/view/2016/7/8/1196252.jpeg,0,0.989417434,577,38,1067,528,490,490,rarity
1204483.jpeg,https://derpicdn.net/img/view/2016/7/19/1204483.jpeg,0,0.936636746,35,0,835,789,800,789,rarity
1206087.jpeg,https://derpicdn.net/img/view/2016/7/21/1206087.jpeg,0,0.996471584,786,323,1654,1191,868,868,rarity
1206792.jpeg,https://derpicdn.net/img/view/2016/7/22/1206792.jpeg,0,0.999182284,1494,1592,2664,2762,1170,1170,rarity
1206792.jpeg,https://derpicdn.net/img/view/2016/7/22/1206792.jpeg,1,0.919778764,798,2064,1548,2814,750,750,rarity
1217681.jpeg,https://derpicdn.net/img/view/2016/8/5/1217681.jpeg,0,0.97811538,812,1068,1204,1460,392,392,rarity
1217681.jpeg,https://derpicdn.net/img/view/2016/8/5/1217681.jpeg,1,0.948219419,97,33,703,639,606,606,rarity
1222143.jpeg,https://derpicdn.net/img/view/2016/8/10/1222143.jpeg,0,0.984803617,131,0,927,788,796,788,rarity
1223642.jpeg,https://derpicdn.net/img/view/2016/8/12/1223642.jpeg,0,0.995872259,120,114,824,818,704,704,rarity
1231150.jpeg,https://derpicdn.net/img/view/2016/8/22/1231150.jpeg,0,0.933311522,0,0,522,525,522,525,rarity
1233316.jpeg,https://derpicdn.net/img/view/2016/8/25/1233316.jpeg,0,0.993061423,2,63,250,311,248,248,rarity
1234742.jpeg,https://derpicdn.net/img/view/2016/8/27/1234742.jpeg,0,0.985627532,85,0,343,251,258,251,rarity
1235979.jpeg,https://derpicdn.net/img/view/2016/8/28/1235979.jpeg,0,0.983999431,248,180,2046,1978,1798,1798,rarity
1241657.jpeg,https://derpicdn.net/img/view/2016/9/4/1241657.jpeg,0,0.98865819,236,25,946,735,710,710,rarity
1241659.jpeg,https://derpicdn.net/img/view/2016/9/4/1241659.jpeg,0,0.987508535,234,23,950,739,716,716,rarity
1245334.jpeg,https://derpicdn.net/img/view/2016/9/9/1245334.jpeg,0,0.989288568,1594,1574,2828,2808,1234,1234,rarity
1248640.jpeg,https://derpicdn.net/img/view/2016/9/13/1248640.jpeg,0,0.99235791,192,0,748,539,556,539,rarity
1250486.jpeg,https://derpicdn.net/img/view/2016/9/16/1250486.jpeg,0,0.916987658,52,8,276,232,224,224,rarity
1255757.jpeg,https://derpicdn.net/img/view/2016/9/22/1255757.jpeg,0,0.9887622,291,0,657,366,366,366,rarity
1255775.jpeg,https://derpicdn.net/img/view/2016/9/22/1255775.jpeg,0,0.990660489,290,0,654,364,364,364,rarity
1261184.jpeg,https://derpicdn.net/img/view/2016/9/29/1261184.jpeg,0,0.990155399,2446,326,3507,1432,1061,1106,rarity
1261184.jpeg,https://derpicdn.net/img/view/2016/9/29/1261184.jpeg,1,0.919510245,0,917,932,1857,932,940,rarity
1263542.jpeg,https://derpicdn.net/img/view/2016/10/2/1263542.jpeg,0,0.994380832,70,46,292,268,222,222,rarity
1263871.jpeg,https://derpicdn.net/img/view/2016/10/3/1263871.jpeg,0,0.916168034,371,29,715,373,344,344,rarity
1264118.jpeg,https://derpicdn.net/img/view/2016/10/3/1264118.jpeg,0,0.996546328,465,36,975,546,510,510,rarity
1265630.jpeg,https://derpicdn.net/img/view/2016/10/5/1265630.jpeg,0,0.998909414,234,42,648,456,414,414,rarity
1267657.jpeg,https://derpicdn.net/img/view/2016/10/8/1267657.jpeg,0,0.987066388,175,68,521,414,346,346,rarity
1277617.jpeg,https://derpicdn.net/img/view/2016/10/20/1277617.jpeg,0,0.976462603,364,145,2484,2265,2120,2120,rarity
1281435.jpeg,https://derpicdn.net/img/view/2016/10/25/1281435.jpeg,0,0.995979607,317,231,589,503,272,272,rarity
1284247.jpeg,https://derpicdn.net/img/view/2016/10/29/1284247.jpeg,0,0.958158314,0,0,279,272,279,272,rarity
1284462.jpeg,https://derpicdn.net/img/view/2016/10/30/1284462.jpeg,0,0.987909079,191,44,415,268,224,224,rarity
1286963.jpeg,https://derpicdn.net/img/view/2016/11/2/1286963.jpeg,0,0.990653336,57,158,757,858,700,700,rarity
1289380.jpeg,https://derpicdn.net/img/view/2016/11/5/1289380.jpeg,0,0.903598547,501,91,841,431,340,340,rarity
1290403.jpeg,https://derpicdn.net/img/view/2016/11/7/1290403.jpeg,0,0.951540887,160,8,536,384,376,376,rarity
1291412.jpeg,https://derpicdn.net/img/view/2016/11/8/1291412.jpeg,0,0.993311465,184,0,1124,873,940,873,rarity
1300220.jpeg,https://derpicdn.net/img/view/2016/11/21/1300220.jpeg,0,0.968722284,361,0,1459,1049,1098,1049,rarity
1303382.jpeg,https://derpicdn.net/img/view/2016/11/25/1303382.jpeg,0,0.986065209,233,0,579,331,346,331,rarity
1308450.jpeg,https://derpicdn.net/img/view/2016/12/2/1308450.jpeg,0,0.999025583,415,0,729,277,314,277,rarity
1322969.jpeg,https://derpicdn.net/img/view/2016/12/22/1322969.jpeg,0,0.977103472,101,0,479,372,378,372,rarity
1322969.jpeg,https://derpicdn.net/img/view/2016/12/22/1322969.jpeg,1,0.958531499,808,0,1186,353,378,353,rarity
1323595.jpeg,https://derpicdn.net/img/view/2016/12/23/1323595.jpeg,0,0.993535459,298,87,928,717,630,630,rarity
1325679.jpeg,https://derpicdn.net/img/view/2016/12/26/1325679.jpeg,0,0.966225922,220,191,1358,1329,1138,1138,rarity
1327941.jpeg,https://derpicdn.net/img/view/2016/12/29/1327941.jpeg,0,0.991291344,133,0,871,725,738,725,rarity
1329416.jpeg,https://derpicdn.net/img/view/2017/1/1/1329416.jpeg,0,0.998931885,93,7,741,655,648,648,rarity
1336651.jpeg,https://derpicdn.net/img/view/2017/1/10/1336651.jpeg,0,0.982988656,316,0,1200,853,884,853,rarity
1343150.jpeg,https://derpicdn.net/img/view/2017/1/19/1343150.jpeg,0,0.956891179,1299,6,1613,320,314,314,rarity
1349569.jpeg,https://derpicdn.net/img/view/2017/1/28/1349569.jpeg,0,0.965894103,373,47,750,435,377,388,rarity
1349569.jpeg,https://derpicdn.net/img/view/2017/1/28/1349569.jpeg,1,0.931750655,0,2,413,442,413,440,rarity
1349651.jpeg,https://derpicdn.net/img/view/2017/1/28/1349651.jpeg,0,0.948261678,1939,550,2851,1462,912,912,rarity
1354651.jpeg,https://derpicdn.net/img/view/2017/2/4/1354651.jpeg,0,0.988035023,239,74,375,210,136,136,rarity
1354882.jpeg,https://derpicdn.net/img/view/2017/2/4/1354882.jpeg,0,0.996884167,114,0,818,659,704,659,rarity
1355392.jpeg,https://derpicdn.net/img/view/2017/2/5/1355392.jpeg,1,0.995480955,176,114,436,374,260,260,rarity
1356389.jpeg,https://derpicdn.net/img/view/2017/2/6/1356389.jpeg,0,0.958627462,496,0,1714,1152,1218,1152,rarity
1356727.jpeg,https://derpicdn.net/img/view/2017/2/6/1356727.jpeg,1,0.966791153,569,50,1033,514,464,464,rarity
1356813.jpeg,https://derpicdn.net/img/view/2017/2/6/1356813.jpeg,1,0.948682606,666,0,1176,494,510,494,rarity
1361782.jpeg,https://derpicdn.net/img/view/2017/2/13/1361782.jpeg,0,0.939819396,293,210,1533,1450,1240,1240,rarity
1375594.jpeg,https://derpicdn.net/img/view/2017/2/28/1375594.jpeg,0,0.975635052,94,0,732,606,638,606,rarity
1376064.jpeg,https://derpicdn.net/img/view/2017/2/28/1376064.jpeg,0,0.992514253,61,0,917,855,856,855,rarity
1376321.jpeg,https://derpicdn.net/img/view/2017/3/1/1376321.jpeg,0,0.966561913,936,249,1622,935,686,686,rarity
1376937.jpeg,https://derpicdn.net/img/view/2017/3/1/1376937.jpeg,0,0.996157646,834,70,1454,690,620,620,rarity
1376937.jpeg,https://derpicdn.net/img/view/2017/3/1/1376937.jpeg,1,0.988408446,111,142,717,748,606,606,rarity
1379433.jpeg,https://derpicdn.net/img/view/2017/3/4/1379433.jpeg,0,0.999605238,653,171,945,463,292,292,rarity
1385364.jpeg,https://derpicdn.net/img/view/2017/3/12/1385364.jpeg,0,0.998276412,158,5,924,771,766,766,rarity
1386881.jpeg,https://derpicdn.net/img/view/2017/3/14/1386881.jpeg,0,0.985062003,183,0,2184,1726,2001,1726,rarity
1396257.jpeg,https://derpicdn.net/img/view/2017/3/25/1396257.jpeg,0,0.998047769,503,0,1669,1133,1166,1133,rarity
1399591.jpeg,https://derpicdn.net/img/view/2017/3/30/1399591.jpeg,0,0.96894294,273,35,719,481,446,446,rarity
1405750.jpeg,https://derpicdn.net/img/view/2017/4/6/1405750.jpeg,0,0.975450993,0,36,900,976,900,940,rarity
1406767.jpeg,https://derpicdn.net/img/view/2017/4/8/1406767.jpeg,0,0.998465419,171,0,1073,859,902,859,rarity
1410027.jpeg,https://derpicdn.net/img/view/2017/4/12/1410027.jpeg,0,0.953103602,1,0,587,521,586,521,rarity
1411622.jpeg,https://derpicdn.net/img/view/2017/4/15/1411622.jpeg,0,0.973577261,133,89,675,631,542,542,rarity
1413237.jpeg,https://derpicdn.net/img/view/2017/4/16/1413237.jpeg,0,0.995550692,56,0,1014,919,958,919,rarity
1414191.jpeg,https://derpicdn.net/img/view/2017/4/17/1414191.jpeg,0,0.945608377,126,220,426,520,300,300,rarity
1416938.jpeg,https://derpicdn.net/img/view/2017/4/20/1416938.jpeg,0,0.99861908,537,286,899,648,362,362,rarity
1418254.jpeg,https://derpicdn.net/img/view/2017/4/22/1418254.jpeg,0,0.951647282,117,0,899,678,782,678,rarity
1419161.jpeg,https://derpicdn.net/img/view/2017/4/23/1419161.jpeg,0,0.986793935,209,37,727,555,518,518,rarity
1422654.jpeg,https://derpicdn.net/img/view/2017/4/27/1422654.jpeg,0,0.982353508,69,0,1201,792,1132,792,rarity
1425518.jpeg,https://derpicdn.net/img/view/2017/4/30/1425518.jpeg,0,0.984225631,178,56,618,496,440,440,rarity
1426389.jpeg,https://derpicdn.net/img/view/2017/5/1/1426389.jpeg,0,0.992357671,6,96,430,520,424,424,rarity
1426389.jpeg,https://derpicdn.net/img/view/2017/5/1/1426389.jpeg,1,0.973928571,536,110,930,504,394,394,rarity
1428244.jpeg,https://derpicdn.net/img/view/2017/5/4/1428244.jpeg,0,0.998960197,0,8,489,520,489,512,rarity
1430608.jpeg,https://derpicdn.net/img/view/2017/5/7/1430608.jpeg,0,0.974592149,79,17,768,711,689,694,rarity
1431409.jpeg,https://derpicdn.net/img/view/2017/5/8/1431409.jpeg,0,0.988855541,94,0,806,685,712,685,rarity
1431411.jpeg,https://derpicdn.net/img/view/2017/5/8/1431411.jpeg,0,0.97609973,64,0,828,710,764,710,rarity
1431421.jpeg,https://derpicdn.net/img/view/2017/5/8/1431421.jpeg,0,0.961533189,891,248,3911,3268,3020,3020,rarity
1431424.jpeg,https://derpicdn.net/img/view/2017/5/8/1431424.jpeg,0,0.987158358,85,0,813,694,728,694,rarity
1433188.jpeg,https://derpicdn.net/img/view/2017/5/10/1433188.jpeg,0,0.966942787,244,0,1902,1080,1658,1080,rarity
1434336.jpeg,https://derpicdn.net/img/view/2017/5/11/1434336.jpeg,0,0.998902082,86,23,738,675,652,652,rarity
1436724.jpeg,https://derpicdn.net/img/view/2017/5/14/1436724.jpeg,0,0.9547472,408,114,1030,736,622,622,rarity
1444900.jpeg,https://derpicdn.net/img/view/2017/5/24/1444900.jpeg,0,0.99238205,648,500,940,792,292,292,rarity
1444900.jpeg,https://derpicdn.net/img/view/2017/5/24/1444900.jpeg,1,0.982334137,818,50,1176,408,358,358,rarity
1449616.jpeg,https://derpicdn.net/img/view/2017/5/30/1449616.jpeg,0,0.99911356,483,174,905,596,422,422,rarity
1450017.jpeg,https://derpicdn.net/img/view/2017/5/30/1450017.jpeg,0,0.953495622,283,3,607,327,324,324,rarity
1451594.jpeg,https://derpicdn.net/img/view/2017/6/1/1451594.jpeg,0,0.9997316,249,168,1057,976,808,808,rarity
1452371.jpeg,https://derpicdn.net/img/view/2017/6/2/1452371.jpeg,0,0.941820323,0,6,1520,1704,1520,1698,rarity
1454124.jpeg,https://derpicdn.net/img/view/2017/6/4/1454124.jpeg,0,0.963796377,0,22,373,428,373,406,rarity
1457117.jpeg,https://derpicdn.net/img/view/2017/6/8/1457117.jpeg,0,0.989588618,203,59,533,389,330,330,rarity
1460582.jpeg,https://derpicdn.net/img/view/2017/6/13/1460582.jpeg,0,0.92694062,328,0,1139,894,811,894,rarity
1461962.jpeg,https://derpicdn.net/img/view/2017/6/14/1461962.jpeg,0,0.996443152,387,164,937,714,550,550,rarity
1464191.jpeg,https://derpicdn.net/img/view/2017/6/17/1464191.jpeg,0,0.986741424,157,0,1891,1500,1734,1500,rarity
1465303.jpeg,https://derpicdn.net/img/view/2017/6/18/1465303.jpeg,0,0.947041571,261,85,2839,2663,2578,2578,rarity
1473408.jpeg,https://derpicdn.net/img/view/2017/6/28/1473408.jpeg,0,0.912660182,57,26,1181,1080,1124,1054,rarity
1481342.jpeg,https://derpicdn.net/img/view/2017/7/8/1481342.jpeg,0,0.953243434,1078,348,2732,2002,1654,1654,rarity
1484007.jpeg,https://derpicdn.net/img/view/2017/7/11/1484007.jpeg,0,0.992028415,235,1,689,455,454,454,rarity
1484526.jpeg,https://derpicdn.net/img/view/2017/7/12/1484526.jpeg,0,0.930800915,0,26,750,874,750,848,rarity
1486136.jpeg,https://derpicdn.net/img/view/2017/7/14/1486136.jpeg,0,0.966654181,434,0,1594,878,1160,878,rarity
1487949.jpeg,https://derpicdn.net/img/view/2017/7/16/1487949.jpeg,1,0.970487714,2024,274,2886,1136,862,862,rarity
1489119.jpeg,https://derpicdn.net/img/view/2017/7/18/1489119.jpeg,0,0.99508816,959,180,1607,828,648,648,rarity
1490275.jpeg,https://derpicdn.net/img/view/2017/7/20/1490275.jpeg,0,0.998184383,114,34,490,410,376,376,rarity
1493957.jpeg,https://derpicdn.net/img/view/2017/7/24/1493957.jpeg,0,0.97018379,135,119,831,815,696,696,rarity
1499390.jpeg,https://derpicdn.net/img/view/2017/7/31/1499390.jpeg,0,0.989312649,131,0,1417,1080,1286,1080,rarity
1499493.jpeg,https://derpicdn.net/img/view/2017/7/31/1499493.jpeg,0,0.995041192,60,0,604,486,544,486,rarity
1499493.jpeg,https://derpicdn.net/img/view/2017/7/31/1499493.jpeg,1,0.991899371,915,12,1323,420,408,408,rarity
1505909.jpeg,https://derpicdn.net/img/view/2017/8/8/1505909.jpeg,0,0.961271584,1074,168,1450,544,376,376,rarity
1513335.jpeg,https://derpicdn.net/img/view/2017/8/18/1513335.jpeg,0,0.956077874,72,232,1568,1728,1496,1496,rarity
1520693.jpeg,https://derpicdn.net/img/view/2017/8/27/1520693.jpeg,0,0.987505555,0,0,607,700,607,700,rarity
1524360.jpeg,https://derpicdn.net/img/view/2017/8/31/1524360.jpeg,0,0.971436977,190,168,1670,1648,1480,1480,rarity
1525752.jpeg,https://derpicdn.net/img/view/2017/9/2/1525752.jpeg,0,0.966956317,16,13,756,753,740,740,rarity
1527506.jpeg,https://derpicdn.net/img/view/2017/9/4/1527506.jpeg,0,0.984984219,777,9,2061,1293,1284,1284,rarity
1530110.jpeg,https://derpicdn.net/img/view/2017/9/7/1530110.jpeg,0,0.997268438,393,306,773,686,380,380,rarity
1533202.jpeg,https://derpicdn.net/img/view/2017/9/11/1533202.jpeg,0,0.963004708,573,118,1091,636,518,518,rarity
1533413.jpeg,https://derpicdn.net/img/view/2017/9/12/1533413.jpeg,0,0.997746646,131,0,595,449,464,449,rarity
1534830.jpeg,https://derpicdn.net/img/view/2017/9/13/1534830.jpeg,0,0.978414834,131,120,749,738,618,618,rarity
1536687.jpeg,https://derpicdn.net/img/view/2017/9/16/1536687.jpeg,0,0.990640938,161,89,955,901,794,812,rarity
1536731.jpeg,https://derpicdn.net/img/view/2017/9/16/1536731.jpeg,0,0.986238897,549,746,1239,1436,690,690,rarity
1536850.jpeg,https://derpicdn.net/img/view/2017/9/16/1536850.jpeg,0,0.986266911,67,0,960,885,893,885,rarity
1538048.jpeg,https://derpicdn.net/img/view/2017/9/17/1538048.jpeg,0,0.996252537,9,0,1767,1927,1758,1927,rarity
1538512.jpeg,https://derpicdn.net/img/view/2017/9/18/1538512.jpeg,0,0.995864272,66,22,854,810,788,788,rarity
1539042.jpeg,https://derpicdn.net/img/view/2017/9/18/1539042.jpeg,0,0.99672991,210,0,706,444,496,444,rarity
1539226.jpeg,https://derpicdn.net/img/view/2017/9/19/1539226.jpeg,0,0.941126585,329,25,667,363,338,338,rarity
1540002.jpeg,https://derpicdn.net/img/view/2017/9/20/1540002.jpeg,0,0.966417313,83,8,717,642,634,634,rarity
1540028.jpeg,https://derpicdn.net/img/view/2017/9/20/1540028.jpeg,0,0.984226465,1930,929,3906,2905,1976,1976,rarity
1540582.jpeg,https://derpicdn.net/img/view/2017/9/21/1540582.jpeg,0,0.947481871,782,616,1652,1486,870,870,rarity
1541504.jpeg,https://derpicdn.net/img/view/2017/9/22/1541504.jpeg,0,0.987570465,405,314,829,738,424,424,rarity
1542054.jpeg,https://derpicdn.net/img/view/2017/9/22/1542054.jpeg,0,0.928057075,91,0,1063,948,972,948,rarity
1543397.jpeg,https://derpicdn.net/img/view/2017/9/24/1543397.jpeg,0,0.99885875,447,0,913,377,466,377,rarity
1546510.jpeg,https://derpicdn.net/img/view/2017/9/28/1546510.jpeg,0,0.997778356,766,33,2020,1287,1254,1254,rarity
1547946.jpeg,https://derpicdn.net/img/view/2017/9/29/1547946.jpeg,0,0.956506371,92,15,1482,1405,1390,1390,rarity
1548226.jpeg,https://derpicdn.net/img/view/2017/9/30/1548226.jpeg,0,0.997968614,176,45,524,393,348,348,rarity
1548709.jpeg,https://derpicdn.net/img/view/2017/9/30/1548709.jpeg,0,0.911690056,18,0,784,757,766,757,rarity
1550978.jpeg,https://derpicdn.net/img/view/2017/10/3/1550978.jpeg,0,0.983599663,561,67,1127,633,566,566,rarity
1553095.jpeg,https://derpicdn.net/img/view/2017/10/6/1553095.jpeg,0,0.917720377,385,14,1537,1250,1152,1236,rarity
1553285.jpeg,https://derpicdn.net/img/view/2017/10/6/1553285.jpeg,0,0.999613523,258,0,808,523,550,523,rarity
1554705.jpeg,https://derpicdn.net/img/view/2017/10/7/1554705.jpeg,0,0.991394997,0,0,1129,1000,1129,1000,rarity
1555514.jpeg,https://derpicdn.net/img/view/2017/10/8/1555514.jpeg,0,0.998498857,62,54,620,612,558,558,rarity
1555514.jpeg,https://derpicdn.net/img/view/2017/10/8/1555514.jpeg,1,0.995675147,456,0,950,434,494,434,rarity
1555779.jpeg,https://derpicdn.net/img/view/2017/10/8/1555779.jpeg,0,0.993854403,151,0,449,297,298,297,rarity
1567922.jpeg,https://derpicdn.net/img/view/2017/10/22/1567922.jpeg,0,0.908316374,423,1853,717,2147,294,294,rarity
1569182.jpeg,https://derpicdn.net/img/view/2017/10/24/1569182.jpeg,0,0.960452259,656,0,864,200,208,200,rarity
1569741.jpeg,https://derpicdn.net/img/view/2017/10/25/1569741.jpeg,0,0.986123383,423,44,887,508,464,464,rarity
1570962.jpeg,https://derpicdn.net/img/view/2017/10/27/1570962.jpeg,0,0.974463701,0,0,2752,2743,2752,2743,rarity
1572727.jpeg,https://derpicdn.net/img/view/2017/10/29/1572727.jpeg,0,0.99452132,153,20,325,192,172,172,rarity
1572727.jpeg,https://derpicdn.net/img/view/2017/10/29/1572727.jpeg,1,0.988610089,390,246,584,440,194,194,rarity
1573649.jpeg,https://derpicdn.net/img/view/2017/10/30/1573649.jpeg,0,0.998503327,801,187,1065,451,264,264,rarity
1573649.jpeg,https://derpicdn.net/img/view/2017/10/30/1573649.jpeg,1,0.994137406,1185,111,1447,373,262,262,rarity
1574333.jpeg,https://derpicdn.net/img/view/2017/10/31/1574333.jpeg,0,0.965396523,11,0,2203,2093,2192,2093,rarity
1577530.jpeg,https://derpicdn.net/img/view/2017/11/4/1577530.jpeg,0,0.928351045,549,0,959,343,410,343,rarity
1578399.jpeg,https://derpicdn.net/img/view/2017/11/5/1578399.jpeg,0,0.97661674,124,22,482,380,358,358,rarity
1578401.jpeg,https://derpicdn.net/img/view/2017/11/5/1578401.jpeg,0,0.992135465,279,43,625,389,346,346,rarity
1580838.jpeg,https://derpicdn.net/img/view/2017/11/7/1580838.jpeg,0,0.98196578,905,689,3161,2945,2256,2256,rarity
1584799.jpeg,https://derpicdn.net/img/view/2017/11/12/1584799.jpeg,0,0.993571877,549,0,1093,421,544,421,rarity
1585254.jpeg,https://derpicdn.net/img/view/2017/11/13/1585254.jpeg,0,0.996570885,379,26,925,572,546,546,rarity
1585914.jpeg,https://derpicdn.net/img/view/2017/11/14/1585914.jpeg,0,0.983486891,43,0,408,331,365,331,rarity
1585914.jpeg,https://derpicdn.net/img/view/2017/11/14/1585914.jpeg,1,0.971879125,61,91,389,408,328,317,rarity
1589161.jpeg,https://derpicdn.net/img/view/2017/11/18/1589161.jpeg,0,0.988448858,50,0,2842,2618,2792,2618,rarity
1589970.jpeg,https://derpicdn.net/img/view/2017/11/19/1589970.jpeg,0,0.975646317,92,11,654,573,562,562,rarity
1590054.jpeg,https://derpicdn.net/img/view/2017/11/19/1590054.jpeg,0,0.99544996,433,292,2927,2786,2494,2494,rarity
1590695.jpeg,https://derpicdn.net/img/view/2017/11/20/1590695.jpeg,0,0.935035169,120,4183,1300,5363,1180,1180,rarity
1593263.jpeg,https://derpicdn.net/img/view/2017/11/24/1593263.jpeg,0,0.94062978,136,0,506,359,370,359,rarity
1597675.jpeg,https://derpicdn.net/img/view/2017/11/30/1597675.jpeg,0,0.972139716,152,37,446,331,294,294,rarity
1600891.jpeg,https://derpicdn.net/img/view/2017/12/5/1600891.jpeg,0,0.997784615,482,0,1178,689,696,689,rarity
1603252.jpeg,https://derpicdn.net/img/view/2017/12/8/1603252.jpeg,0,0.920183182,0,217,778,1000,778,783,rarity
1603436.jpeg,https://derpicdn.net/img/view/2017/12/9/1603436.jpeg,0,0.967107594,642,0,2000,1298,1358,1298,rarity
1603891.jpeg,https://derpicdn.net/img/view/2017/12/9/1603891.jpeg,0,0.983368397,612,0,1022,347,410,347,rarity
1605117.jpeg,https://derpicdn.net/img/view/2017/12/11/1605117.jpeg,0,0.986980021,470,18,812,360,342,342,rarity
1607864.jpeg,https://derpicdn.net/img/view/2017/12/14/1607864.jpeg,0,0.995287657,305,26,643,364,338,338,rarity
1608945.jpeg,https://derpicdn.net/img/view/2017/12/16/1608945.jpeg,0,0.943362892,234,17,708,491,474,474,rarity
1609407.jpeg,https://derpicdn.net/img/view/2017/12/17/1609407.jpeg,0,0.999031365,671,33,1961,1323,1290,1290,rarity
1610854.jpeg,https://derpicdn.net/img/view/2017/12/18/1610854.jpeg,0,0.996551275,169,12,695,538,526,526,rarity
1610855.jpeg,https://derpicdn.net/img/view/2017/12/18/1610855.jpeg,0,0.994833648,176,21,690,535,514,514,rarity
1611699.jpeg,https://derpicdn.net/img/view/2017/12/20/1611699.jpeg,0,0.980914652,376,53,930,607,554,554,rarity
1612124.jpeg,https://derpicdn.net/img/view/2017/12/20/1612124.jpeg,0,0.990458608,161,31,559,429,398,398,rarity
1618654.jpeg,https://derpicdn.net/img/view/2017/12/29/1618654.jpeg,0,0.908201098,225,145,811,731,586,586,rarity
1622220.jpeg,https://derpicdn.net/img/view/2018/1/2/1622220.jpeg,0,0.981205821,340,395,1996,2051,1656,1656,rarity
1623199.jpeg,https://derpicdn.net/img/view/2018/1/3/1623199.jpeg,0,0.975250959,0,0,1269,1378,1269,1378,rarity
1624916.jpeg,https://derpicdn.net/img/view/2018/1/5/1624916.jpeg,0,0.954355121,212,32,700,520,488,488,rarity
1626417.jpeg,https://derpicdn.net/img/view/2018/1/7/1626417.jpeg,0,0.987779498,130,0,1688,1584,1558,1584,rarity
1627116.jpeg,https://derpicdn.net/img/view/2018/1/8/1627116.jpeg,0,0.959326625,344,0,546,188,202,188,rarity
1639177.jpeg,https://derpicdn.net/img/view/2018/1/23/1639177.jpeg,0,0.935640693,73,0,679,638,606,638,rarity
1641129.jpeg,https://derpicdn.net/img/view/2018/1/26/1641129.jpeg,0,0.967879415,259,45,733,519,474,474,rarity
1643316.jpeg,https://derpicdn.net/img/view/2018/1/29/1643316.jpeg,0,0.976819992,301,10,647,356,346,346,rarity
1645412.jpeg,https://derpicdn.net/img/view/2018/1/31/1645412.jpeg,0,0.979566693,462,0,2692,2040,2230,2040,rarity
1647115.jpeg,https://derpicdn.net/img/view/2018/2/3/1647115.jpeg,0,0.999036074,560,517,2266,2223,1706,1706,rarity
1647226.jpeg,https://derpicdn.net/img/view/2018/2/3/1647226.jpeg,0,0.997742057,861,222,2353,1714,1492,1492,rarity
1649036.jpeg,https://derpicdn.net/img/view/2018/2/5/1649036.jpeg,0,0.988965869,437,0,1555,1031,1118,1031,rarity
1653756.jpeg,https://derpicdn.net/img/view/2018/2/11/1653756.jpeg,0,0.992449522,387,358,1743,1714,1356,1356,rarity
1654506.jpeg,https://derpicdn.net/img/view/2018/2/12/1654506.jpeg,0,0.994885504,937,0,1843,904,906,904,rarity
1656404.jpeg,https://derpicdn.net/img/view/2018/2/15/1656404.jpeg,0,0.988475621,20,0,754,723,734,723,rarity
1659282.jpeg,https://derpicdn.net/img/view/2018/2/18/1659282.jpeg,0,0.998528004,745,423,1293,971,548,548,rarity
1659285.jpeg,https://derpicdn.net/img/view/2018/2/18/1659285.jpeg,0,0.960462689,37,299,711,973,674,674,rarity
1659316.jpeg,https://derpicdn.net/img/view/2018/2/18/1659316.jpeg,0,0.999222159,464,56,830,422,366,366,rarity
1659317.jpeg,https://derpicdn.net/img/view/2018/2/18/1659317.jpeg,0,0.999538064,477,58,835,416,358,358,rarity
1660192.jpeg,https://derpicdn.net/img/view/2018/2/19/1660192.jpeg,0,0.930921733,120,121,656,657,536,536,rarity
1661648.jpeg,https://derpicdn.net/img/view/2018/2/20/1661648.jpeg,0,0.991443336,26,0,648,595,622,595,rarity
1662497.jpeg,https://derpicdn.net/img/view/2018/2/22/1662497.jpeg,0,0.971581042,321,0,1809,1473,1488,1473,rarity
1664307.jpeg,https://derpicdn.net/img/view/2018/2/24/1664307.jpeg,0,0.938292742,196,20,644,468,448,448,rarity
1664317.jpeg,https://derpicdn.net/img/view/2018/2/24/1664317.jpeg,0,0.978962958,272,3,634,365,362,362,rarity
1664323.jpeg,https://derpicdn.net/img/view/2018/2/24/1664323.jpeg,0,0.988659501,113,19,447,353,334,334,rarity
1665281.jpeg,https://derpicdn.net/img/view/2018/2/25/1665281.jpeg,0,0.917674661,78,1,983,931,905,930,rarity
1665900.jpeg,https://derpicdn.net/img/view/2018/2/25/1665900.jpeg,0,0.989162564,0,0,601,560,601,560,rarity
1667812.jpeg,https://derpicdn.net/img/view/2018/2/28/1667812.jpeg,0,0.946147263,68,0,1072,935,1004,935,rarity
1667960.jpeg,https://derpicdn.net/img/view/2018/2/28/1667960.jpeg,0,0.992506564,423,0,975,530,552,530,rarity
1668367.jpeg,https://derpicdn.net/img/view/2018/2/28/1668367.jpeg,0,0.957811058,75,44,573,542,498,498,rarity
1672933.jpeg,https://derpicdn.net/img/view/2018/3/6/1672933.jpeg,0,0.948214948,291,0,1239,871,948,871,rarity
1675925.jpeg,https://derpicdn.net/img/view/2018/3/10/1675925.jpeg,0,0.946458936,0,158,825,1138,825,980,rarity
1677920.jpeg,https://derpicdn.net/img/view/2018/3/12/1677920.jpeg,0,0.999042392,180,0,1084,818,904,818,rarity
1678676.jpeg,https://derpicdn.net/img/view/2018/3/13/1678676.jpeg,0,0.980738699,62,0,470,406,408,406,rarity
1679786.jpeg,https://derpicdn.net/img/view/2018/3/14/1679786.jpeg,0,0.901526511,0,0,1006,952,1006,952,rarity
1681830.jpeg,https://derpicdn.net/img/view/2018/3/16/1681830.jpeg,0,0.997077525,527,451,1245,1169,718,718,rarity
1683627.jpeg,https://derpicdn.net/img/view/2018/3/18/1683627.jpeg,0,0.998685598,232,8,1114,890,882,882,rarity
1687577.jpeg,https://derpicdn.net/img/view/2018/3/22/1687577.jpeg,0,0.961265802,234,1,790,557,556,556,rarity
1690847.jpeg,https://derpicdn.net/img/view/2018/3/26/1690847.jpeg,0,0.994498014,157,17,643,503,486,486,rarity
1693465.jpeg,https://derpicdn.net/img/view/2018/3/29/1693465.jpeg,0,0.947560132,357,108,1187,938,830,830,rarity
1695883.jpeg,https://derpicdn.net/img/view/2018/4/1/1695883.jpeg,0,0.925607443,416,0,1154,591,738,591,rarity
1697581.jpeg,https://derpicdn.net/img/view/2018/4/2/1697581.jpeg,0,0.965935171,65,0,315,236,250,236,rarity
1698250.jpeg,https://derpicdn.net/img/view/2018/4/3/1698250.jpeg,0,0.976573229,487,0,2665,1793,2178,1793,rarity
1700081.jpeg,https://derpicdn.net/img/view/2018/4/5/1700081.jpeg,0,0.997476518,4,0,870,858,866,858,rarity
1701959.jpeg,https://derpicdn.net/img/view/2018/4/7/1701959.jpeg,0,0.921092331,386,150,750,514,364,364,rarity
1703057.jpeg,https://derpicdn.net/img/view/2018/4/9/1703057.jpeg,0,0.987141848,0,0,797,886,797,886,rarity
1703263.jpeg,https://derpicdn.net/img/view/2018/4/9/1703263.jpeg,0,0.947502494,6,0,456,339,450,339,rarity
1703797.jpeg,https://derpicdn.net/img/view/2018/4/9/1703797.jpeg,0,0.984988749,1095,0,2169,1008,1074,1008,rarity
1711207.jpeg,https://derpicdn.net/img/view/2018/4/18/1711207.jpeg,0,0.93976289,212,41,634,463,422,422,rarity
1720691.jpeg,https://derpicdn.net/img/view/2018/4/30/1720691.jpeg,0,0.992568493,43,32,605,594,562,562,rarity
1724198.jpeg,https://derpicdn.net/img/view/2018/5/4/1724198.jpeg,0,0.998622715,43,0,627,584,584,584,rarity
1733473.jpeg,https://derpicdn.net/img/view/2018/5/15/1733473.jpeg,0,0.976380527,518,118,1416,1016,898,898,rarity
1733972.jpeg,https://derpicdn.net/img/view/2018/5/16/1733972.jpeg,0,0.93072176,19,0,659,621,640,621,rarity
1737267.jpeg,https://derpicdn.net/img/view/2018/5/20/1737267.jpeg,0,0.942410827,435,0,1223,703,788,703,rarity
1738935.jpeg,https://derpicdn.net/img/view/2018/5/22/1738935.jpeg,0,0.982789278,474,104,886,516,412,412,rarity
1744726.jpeg,https://derpicdn.net/img/view/2018/5/29/1744726.jpeg,0,0.989034832,198,306,686,794,488,488,rarity
1745975.jpeg,https://derpicdn.net/img/view/2018/5/31/1745975.jpeg,0,0.998740673,1186,170,2218,1202,1032,1032,rarity
1748322.jpeg,https://derpicdn.net/img/view/2018/6/2/1748322.jpeg,0,0.995464325,168,0,1190,1000,1022,1000,rarity
1752548.jpeg,https://derpicdn.net/img/view/2018/6/8/1752548.jpeg,0,0.929840386,666,0,3396,2702,2730,2702,rarity
1754630.jpeg,https://derpicdn.net/img/view/2018/6/10/1754630.jpeg,0,0.994625688,192,94,598,500,406,406,rarity
1756054.jpeg,https://derpicdn.net/img/view/2018/6/12/1756054.jpeg,0,0.990577936,524,0,2092,1559,1568,1559,rarity
1758271.jpeg,https://derpicdn.net/img/view/2018/6/15/1758271.jpeg,0,0.971863508,27,0,541,498,514,498,rarity
1759326.jpeg,https://derpicdn.net/img/view/2018/6/16/1759326.jpeg,0,0.998360574,265,0,671,402,406,402,rarity
1761306.jpeg,https://derpicdn.net/img/view/2018/6/19/1761306.jpeg,0,0.991923034,164,13,836,685,672,672,rarity
1763111.jpeg,https://derpicdn.net/img/view/2018/6/21/1763111.jpeg,0,0.986258864,4,0,540,423,536,423,rarity
1764339.jpeg,https://derpicdn.net/img/view/2018/6/23/1764339.jpeg,0,0.995709777,248,35,778,565,530,530,rarity
1767993.jpeg,https://derpicdn.net/img/view/2018/6/28/1767993.jpeg,0,0.997016191,37,43,799,805,762,762,rarity
1770411.jpeg,https://derpicdn.net/img/view/2018/7/1/1770411.jpeg,0,0.986301422,180,0,944,716,764,716,rarity
1771476.jpeg,https://derpicdn.net/img/view/2018/7/2/1771476.jpeg,0,0.99658674,558,124,918,484,360,360,rarity
1771634.jpeg,https://derpicdn.net/img/view/2018/7/2/1771634.jpeg,0,0.978914976,207,40,423,256,216,216,rarity
1772633.jpeg,https://derpicdn.net/img/view/2018/7/4/1772633.jpeg,0,0.90526104,367,0,1339,952,972,952,rarity
1776723.jpeg,https://derpicdn.net/img/view/2018/7/9/1776723.jpeg,0,0.989229381,24,0,653,637,629,637,rarity
1778309.jpeg,https://derpicdn.net/img/view/2018/7/11/1778309.jpeg,0,0.970806122,0,47,831,945,831,898,rarity
1778666.jpeg,https://derpicdn.net/img/view/2018/7/11/1778666.jpeg,0,0.934659719,310,79,856,625,546,546,rarity
1778825.jpeg,https://derpicdn.net/img/view/2018/7/11/1778825.jpeg,0,0.997076392,63,0,377,312,314,312,rarity
1780235.jpeg,https://derpicdn.net/img/view/2018/7/13/1780235.jpeg,0,0.943672359,277,29,677,429,400,400,rarity
1780619.jpeg,https://derpicdn.net/img/view/2018/7/14/1780619.jpeg,0,0.938742936,419,0,1771,1261,1352,1261,rarity
1780651.jpeg,https://derpicdn.net/img/view/2018/7/14/1780651.jpeg,0,0.987025023,3875,2695,4923,3743,1048,1048,rarity
1780651.jpeg,https://derpicdn.net/img/view/2018/7/14/1780651.jpeg,1,0.95872879,2327,2718,3317,3708,990,990,rarity
1782285.jpeg,https://derpicdn.net/img/view/2018/7/16/1782285.jpeg,0,0.965929449,613,229,1351,967,738,738,rarity
1784644.jpeg,https://derpicdn.net/img/view/2018/7/19/1784644.jpeg,0,0.998091221,460,0,1604,1057,1144,1057,rarity
1784713.jpeg,https://derpicdn.net/img/view/2018/7/19/1784713.jpeg,1,0.990219831,282,0,912,594,630,594,rarity
1786589.jpeg,https://derpicdn.net/img/view/2018/7/22/1786589.jpeg,0,0.991021514,562,125,976,539,414,414,rarity
1787093.jpeg,https://derpicdn.net/img/view/2018/7/22/1787093.jpeg,0,0.986985683,510,74,1740,1220,1230,1146,rarity
1787272.jpeg,https://derpicdn.net/img/view/2018/7/22/1787272.jpeg,0,0.998755813,509,43,1477,1011,968,968,rarity
1787507.jpeg,https://derpicdn.net/img/view/2018/7/23/1787507.jpeg,0,0.986588001,104,9,908,813,804,804,rarity
1792105.jpeg,https://derpicdn.net/img/view/2018/7/28/1792105.jpeg,0,0.95958811,1199,275,2245,1321,1046,1046,rarity
1792579.jpeg,https://derpicdn.net/img/view/2018/7/29/1792579.jpeg,0,0.951003551,151,6,577,432,426,426,rarity
1794016.jpeg,https://derpicdn.net/img/view/2018/7/31/1794016.jpeg,0,0.998889208,67,0,773,698,706,698,rarity
1797777.jpeg,https://derpicdn.net/img/view/2018/8/4/1797777.jpeg,0,0.979201615,2,0,632,622,630,622,rarity
1801779.jpeg,https://derpicdn.net/img/view/2018/8/8/1801779.jpeg,0,0.961287737,738,128,1328,718,590,590,rarity
1802060.jpeg,https://derpicdn.net/img/view/2018/8/9/1802060.jpeg,0,0.978927374,559,1517,1927,2885,1368,1368,rarity
1803158.jpeg,https://derpicdn.net/img/view/2018/8/10/1803158.jpeg,0,0.944599748,185,123,619,557,434,434,rarity
1803281.jpeg,https://derpicdn.net/img/view/2018/8/10/1803281.jpeg,0,0.991242826,183,65,461,343,278,278,rarity
1805164.jpeg,https://derpicdn.net/img/view/2018/8/12/1805164.jpeg,0,0.979529202,770,194,1288,712,518,518,rarity
1805501.jpeg,https://derpicdn.net/img/view/2018/8/13/1805501.jpeg,0,0.903428733,259,0,688,457,429,457,rarity
1806972.jpeg,https://derpicdn.net/img/view/2018/8/15/1806972.jpeg,0,0.941388905,33,0,881,824,848,824,rarity
1807673.jpeg,https://derpicdn.net/img/view/2018/8/15/1807673.jpeg,0,0.999103904,1228,523,1884,1179,656,656,rarity
1808339.jpeg,https://derpicdn.net/img/view/2018/8/16/1808339.jpeg,0,0.996108353,122,9,934,821,812,812,rarity
1809722.jpeg,https://derpicdn.net/img/view/2018/8/18/1809722.jpeg,0,0.995022237,556,0,2262,1645,1706,1645,rarity
1810836.jpeg,https://derpicdn.net/img/view/2018/8/19/1810836.jpeg,0,0.996579945,183,44,607,468,424,424,rarity
1811467.jpeg,https://derpicdn.net/img/view/2018/8/20/1811467.jpeg,0,0.992861211,300,124,1206,1030,906,906,rarity
1812248.jpeg,https://derpicdn.net/img/view/2018/8/21/1812248.jpeg,0,0.986212909,87,0,1221,1096,1134,1096,rarity
1813747.jpeg,https://derpicdn.net/img/view/2018/8/23/1813747.jpeg,0,0.96157378,381,65,2259,1943,1878,1878,rarity
1814038.jpeg,https://derpicdn.net/img/view/2018/8/23/1814038.jpeg,0,0.978366554,6,160,542,696,536,536,rarity
1814091.jpeg,https://derpicdn.net/img/view/2018/8/23/1814091.jpeg,0,0.993953407,129,0,591,378,462,378,rarity
1822364.jpeg,https://derpicdn.net/img/view/2018/9/1/1822364.jpeg,0,0.995404184,1730,210,3024,1504,1294,1294,rarity
1824975.jpeg,https://derpicdn.net/img/view/2018/9/4/1824975.jpeg,0,0.996454895,179,0,1341,1154,1162,1154,rarity
1825505.jpeg,https://derpicdn.net/img/view/2018/9/5/1825505.jpeg,0,0.995296538,181,102,495,416,314,314,rarity
182730.jpeg,https://derpicdn.net/img/view/2012/12/14/182730.jpeg,0,0.995179296,767,607,1987,1827,1220,1220,rarity
1827354.jpeg,https://derpicdn.net/img/view/2018/9/8/1827354.jpeg,0,0.965902567,117,0,477,360,360,360,rarity
1827540.jpeg,https://derpicdn.net/img/view/2018/9/8/1827540.jpeg,0,0.95719409,227,2251,1333,3357,1106,1106,rarity
1827540.jpeg,https://derpicdn.net/img/view/2018/9/8/1827540.jpeg,1,0.944781423,3040,3070,4026,4056,986,986,rarity
1827540.jpeg,https://derpicdn.net/img/view/2018/9/8/1827540.jpeg,2,0.908116758,718,3483,1650,4415,932,932,rarity
1827664.jpeg,https://derpicdn.net/img/view/2018/9/8/1827664.jpeg,0,0.943703532,16,2,742,728,726,726,rarity
1832490.jpeg,https://derpicdn.net/img/view/2018/9/14/1832490.jpeg,0,0.961022258,511,0,3000,2457,2489,2457,rarity
1835747.jpeg,https://derpicdn.net/img/view/2018/9/18/1835747.jpeg,0,0.984378457,0,0,696,795,696,795,rarity
1836306.jpeg,https://derpicdn.net/img/view/2018/9/19/1836306.jpeg,0,0.970379591,540,498,1144,1102,604,604,rarity
1836751.jpeg,https://derpicdn.net/img/view/2018/9/20/1836751.jpeg,0,0.96727109,97,47,477,427,380,380,rarity
1837601.jpeg,https://derpicdn.net/img/view/2018/9/21/1837601.jpeg,0,0.985081315,184,0,1138,930,954,930,rarity
1837680.jpeg,https://derpicdn.net/img/view/2018/9/21/1837680.jpeg,0,0.967397034,533,36,1029,532,496,496,rarity
1841726.jpeg,https://derpicdn.net/img/view/2018/9/26/1841726.jpeg,0,0.979882479,69,0,2001,1910,1932,1910,rarity
1842138.jpeg,https://derpicdn.net/img/view/2018/9/27/1842138.jpeg,0,0.957835019,706,0,1786,948,1080,948,rarity
1843037.jpeg,https://derpicdn.net/img/view/2018/9/28/1843037.jpeg,0,0.999481916,754,403,1594,1243,840,840,rarity
1846311.jpeg,https://derpicdn.net/img/view/2018/10/2/1846311.jpeg,0,0.975853324,561,244,1089,772,528,528,rarity
1847254.jpeg,https://derpicdn.net/img/view/2018/10/3/1847254.jpeg,0,0.934191287,540,42,706,208,166,166,rarity
1850160.jpeg,https://derpicdn.net/img/view/2018/10/7/1850160.jpeg,0,0.995207369,0,0,1218,1226,1218,1226,rarity
1850837.jpeg,https://derpicdn.net/img/view/2018/10/7/1850837.jpeg,0,0.992945611,327,0,923,546,596,546,rarity
1851849.jpeg,https://derpicdn.net/img/view/2018/10/9/1851849.jpeg,1,0.963933706,38,27,988,977,950,950,rarity
1851849.jpeg,https://derpicdn.net/img/view/2018/10/9/1851849.jpeg,2,0.923814833,817,728,1253,1164,436,436,rarity
1853861.jpeg,https://derpicdn.net/img/view/2018/10/11/1853861.jpeg,0,0.989562929,0,43,941,991,941,948,rarity
1855129.jpeg,https://derpicdn.net/img/view/2018/10/13/1855129.jpeg,0,0.974195182,171,0,1841,1080,1670,1080,rarity
1858153.jpeg,https://derpicdn.net/img/view/2018/10/16/1858153.jpeg,0,0.998735845,586,330,830,574,244,244,rarity
1858153.jpeg,https://derpicdn.net/img/view/2018/10/16/1858153.jpeg,1,0.996600747,373,0,639,257,266,257,rarity
1858153.jpeg,https://derpicdn.net/img/view/2018/10/16/1858153.jpeg,3,0.974284172,179,102,373,296,194,194,rarity
1862029.jpeg,https://derpicdn.net/img/view/2018/10/21/1862029.jpeg,0,0.995540261,487,47,995,555,508,508,rarity
1862403.jpeg,https://derpicdn.net/img/view/2018/10/21/1862403.jpeg,0,0.950966418,0,0,546,583,546,583,rarity
1862469.jpeg,https://derpicdn.net/img/view/2018/10/21/1862469.jpeg,0,0.99931848,625,364,973,712,348,348,rarity
1862663.jpeg,https://derpicdn.net/img/view/2018/10/21/1862663.jpeg,0,0.996770322,134,23,620,509,486,486,rarity
1863911.jpeg,https://derpicdn.net/img/view/2018/10/23/1863911.jpeg,0,0.952537298,7,0,371,344,364,344,rarity
1863912.jpeg,https://derpicdn.net/img/view/2018/10/23/1863912.jpeg,0,0.980361462,0,1,353,421,353,420,rarity
1863912.jpeg,https://derpicdn.net/img/view/2018/10/23/1863912.jpeg,1,0.940419018,6,0,400,465,394,465,rarity
1864296.jpeg,https://derpicdn.net/img/view/2018/10/23/1864296.jpeg,0,0.972251236,100,0,354,222,254,222,rarity
1866162.jpeg,https://derpicdn.net/img/view/2018/10/26/1866162.jpeg,0,0.993178725,327,140,725,538,398,398,rarity
1870336.jpeg,https://derpicdn.net/img/view/2018/10/30/1870336.jpeg,2,0.949786007,194,370,352,528,158,158,rarity
1870838.jpeg,https://derpicdn.net/img/view/2018/10/31/1870838.jpeg,0,0.982740045,83,0,849,680,766,680,rarity
1871513.jpeg,https://derpicdn.net/img/view/2018/10/31/1871513.jpeg,0,0.960903227,1067,272,1607,812,540,540,rarity
1873042.jpeg,https://derpicdn.net/img/view/2018/11/2/1873042.jpeg,0,0.984658599,275,0,883,532,608,532,rarity
1874033.jpeg,https://derpicdn.net/img/view/2018/11/3/1874033.jpeg,0,0.995129168,476,0,2000,1667,1524,1667,rarity
1875213.jpeg,https://derpicdn.net/img/view/2018/11/4/1875213.jpeg,0,0.957330942,0,18,566,590,566,572,rarity
1877318.jpeg,https://derpicdn.net/img/view/2018/11/7/1877318.jpeg,0,0.993542671,0,0,1422,1387,1422,1387,rarity
1877476.jpeg,https://derpicdn.net/img/view/2018/11/8/1877476.jpeg,0,0.995898247,122,14,578,470,456,456,rarity
1877576.jpeg,https://derpicdn.net/img/view/2018/11/8/1877576.jpeg,0,0.998167515,1292,0,2800,1479,1508,1479,rarity
1881950.jpeg,https://derpicdn.net/img/view/2018/11/14/1881950.jpeg,0,0.945029736,585,0,2027,1273,1442,1273,rarity
1884011.jpeg,https://derpicdn.net/img/view/2018/11/17/1884011.jpeg,0,0.935460329,338,105,900,707,562,602,rarity
1885885.jpeg,https://derpicdn.net/img/view/2018/11/19/1885885.jpeg,0,0.907429516,224,3,604,383,380,380,rarity
1885886.jpeg,https://derpicdn.net/img/view/2018/11/19/1885886.jpeg,0,0.919631422,280,11,610,341,330,330,rarity
1886712.jpeg,https://derpicdn.net/img/view/2018/11/20/1886712.jpeg,0,0.988574207,269,105,1173,1009,904,904,rarity
1887476.jpeg,https://derpicdn.net/img/view/2018/11/21/1887476.jpeg,0,0.996091127,37,45,333,341,296,296,rarity
1887477.jpeg,https://derpicdn.net/img/view/2018/11/21/1887477.jpeg,0,0.999416113,92,0,504,381,412,381,rarity
1887486.jpeg,https://derpicdn.net/img/view/2018/11/21/1887486.jpeg,0,0.998996377,446,49,1646,1249,1200,1200,rarity
1887486.jpeg,https://derpicdn.net/img/view/2018/11/21/1887486.jpeg,1,0.997787476,2026,31,3252,1257,1226,1226,rarity
1888146.jpeg,https://derpicdn.net/img/view/2018/11/22/1888146.jpeg,0,0.982018411,488,0,2040,1457,1552,1457,rarity
1888359.jpeg,https://derpicdn.net/img/view/2018/11/22/1888359.jpeg,0,0.958931029,80,0,348,267,268,267,rarity
1891469.jpeg,https://derpicdn.net/img/view/2018/11/26/1891469.jpeg,0,0.98588717,102,0,944,776,842,776,rarity
1891633.jpeg,https://derpicdn.net/img/view/2018/11/26/1891633.jpeg,0,0.989125013,80,8,390,318,310,310,rarity
1893409.jpeg,https://derpicdn.net/img/view/2018/11/29/1893409.jpeg,0,0.996202946,237,53,761,577,524,524,rarity
1895167.jpeg,https://derpicdn.net/img/view/2018/12/1/1895167.jpeg,0,0.96298486,184,0,1362,1350,1178,1350,rarity
1896398.jpeg,https://derpicdn.net/img/view/2018/12/2/1896398.jpeg,0,0.999395013,290,95,474,279,184,184,rarity
1896457.jpeg,https://derpicdn.net/img/view/2018/12/2/1896457.jpeg,0,0.956105411,83,28,1437,1382,1354,1354,rarity
1898364.jpeg,https://derpicdn.net/img/view/2018/12/4/1898364.jpeg,0,0.992074072,40,0,1078,1114,1038,1114,rarity
1901065.jpeg,https://derpicdn.net/img/view/2018/12/7/1901065.jpeg,0,0.99749279,172,191,640,659,468,468,rarity
1906963.jpeg,https://derpicdn.net/img/view/2018/12/13/1906963.jpeg,0,0.974625826,698,288,1476,1066,778,778,rarity
1907133.jpeg,https://derpicdn.net/img/view/2018/12/13/1907133.jpeg,0,0.959272444,25,0,1047,976,1022,976,rarity
1908078.jpeg,https://derpicdn.net/img/view/2018/12/14/1908078.jpeg,0,0.995150745,564,81,956,473,392,392,rarity
1908786.jpeg,https://derpicdn.net/img/view/2018/12/15/1908786.jpeg,0,0.979497552,165,71,597,503,432,432,rarity
1910728.jpeg,https://derpicdn.net/img/view/2018/12/17/1910728.jpeg,0,0.995801926,150,0,790,606,640,606,rarity
1911007.jpeg,https://derpicdn.net/img/view/2018/12/17/1911007.jpeg,0,0.998996317,396,17,1016,637,620,620,rarity
1911601.jpeg,https://derpicdn.net/img/view/2018/12/17/1911601.jpeg,0,0.998002172,475,106,1411,1042,936,936,rarity
1912250.jpeg,https://derpicdn.net/img/view/2018/12/18/1912250.jpeg,0,0.973974526,560,0,1938,1280,1378,1280,rarity
1912277.jpeg,https://derpicdn.net/img/view/2018/12/18/1912277.jpeg,0,0.96030128,70,0,664,553,594,553,rarity
1912393.jpeg,https://derpicdn.net/img/view/2018/12/18/1912393.jpeg,0,0.993804455,56,0,630,522,574,522,rarity
1918821.jpeg,https://derpicdn.net/img/view/2018/12/25/1918821.jpeg,0,0.967257559,587,0,1837,986,1250,986,rarity
1919766.jpeg,https://derpicdn.net/img/view/2018/12/27/1919766.jpeg,0,0.999514639,122,0,854,702,732,702,rarity
1921257.jpeg,https://derpicdn.net/img/view/2018/12/29/1921257.jpeg,0,0.972927988,250,0,594,341,344,341,rarity
1924571.jpeg,https://derpicdn.net/img/view/2019/1/2/1924571.jpeg,0,0.984159648,0,0,1015,943,1015,943,rarity
1924836.jpeg,https://derpicdn.net/img/view/2019/1/2/1924836.jpeg,0,0.986045718,23,0,1059,852,1036,852,rarity
1925487.jpeg,https://derpicdn.net/img/view/2019/1/3/1925487.jpeg,0,0.970989764,252,0,768,454,516,454,rarity
1928737.jpeg,https://derpicdn.net/img/view/2019/1/7/1928737.jpeg,0,0.902190268,2308,99,3644,1435,1336,1336,rarity
1933301.jpeg,https://derpicdn.net/img/view/2019/1/12/1933301.jpeg,0,0.981093407,687,0,1015,261,328,261,rarity
1934508.jpeg,https://derpicdn.net/img/view/2019/1/13/1934508.jpeg,0,0.950719535,68,0,996,909,928,909,rarity
1938849.jpeg,https://derpicdn.net/img/view/2019/1/19/1938849.jpeg,0,0.994475007,1798,291,2534,1027,736,736,rarity
1938849.jpeg,https://derpicdn.net/img/view/2019/1/19/1938849.jpeg,1,0.948350012,1025,158,1875,1008,850,850,rarity
1941271.jpeg,https://derpicdn.net/img/view/2019/1/21/1941271.jpeg,0,0.975862682,77,20,621,564,544,544,rarity
1941583.jpeg,https://derpicdn.net/img/view/2019/1/22/1941583.jpeg,0,0.998427987,0,0,390,389,390,389,rarity
1947584.jpeg,https://derpicdn.net/img/view/2019/1/29/1947584.jpeg,0,0.998550534,129,0,595,455,466,455,rarity
1949176.jpeg,https://derpicdn.net/img/view/2019/1/31/1949176.jpeg,0,0.976166904,0,0,936,793,936,793,rarity
1950242.jpeg,https://derpicdn.net/img/view/2019/2/1/1950242.jpeg,0,0.948913395,0,18,612,648,612,630,rarity
1953378.jpeg,https://derpicdn.net/img/view/2019/2/4/1953378.jpeg,0,0.997749031,727,200,1763,1236,1036,1036,rarity
1953611.jpeg,https://derpicdn.net/img/view/2019/2/4/1953611.jpeg,0,0.930480242,402,345,1286,1229,884,884,rarity
1953627.jpeg,https://derpicdn.net/img/view/2019/2/4/1953627.jpeg,0,0.982841849,12,54,1372,1414,1360,1360,rarity
1953628.jpeg,https://derpicdn.net/img/view/2019/2/4/1953628.jpeg,0,0.985847771,26,117,1356,1447,1330,1330,rarity
1953636.jpeg,https://derpicdn.net/img/view/2019/2/4/1953636.jpeg,0,0.99238795,295,102,1599,1406,1304,1304,rarity
195741.jpeg,https://derpicdn.net/img/view/2012/12/28/195741.jpeg,0,0.932610214,432,41,786,395,354,354,rarity
1958480.jpeg,https://derpicdn.net/img/view/2019/2/10/1958480.jpeg,0,0.998516917,177,140,405,368,228,228,rarity
1958532.jpeg,https://derpicdn.net/img/view/2019/2/10/1958532.jpeg,0,0.976373911,47,9,745,707,698,698,rarity
1958798.jpeg,https://derpicdn.net/img/view/2019/2/10/1958798.jpeg,0,0.992933452,0,0,777,780,777,780,rarity
1960735.jpeg,https://derpicdn.net/img/view/2019/2/13/1960735.jpeg,0,0.995058775,388,49,1100,761,712,712,rarity
1962568.jpeg,https://derpicdn.net/img/view/2019/2/15/1962568.jpeg,0,0.953118443,60,0,1096,945,1036,945,rarity
1963283.jpeg,https://derpicdn.net/img/view/2019/2/16/1963283.jpeg,0,0.997146487,521,0,1083,484,562,484,rarity
1963744.jpeg,https://derpicdn.net/img/view/2019/2/16/1963744.jpeg,0,0.964538097,52,14,668,630,616,616,rarity
1964378.jpeg,https://derpicdn.net/img/view/2019/2/17/1964378.jpeg,0,0.996260643,126,37,522,433,396,396,rarity
1967889.jpeg,https://derpicdn.net/img/view/2019/2/21/1967889.jpeg,0,0.950333416,483,172,1323,1012,840,840,rarity
1970502.jpeg,https://derpicdn.net/img/view/2019/2/24/1970502.jpeg,0,0.933287084,139,618,471,950,332,332,rarity
1973571.jpeg,https://derpicdn.net/img/view/2019/2/28/1973571.jpeg,0,0.964402616,289,112,729,552,440,440,rarity
1974771.jpeg,https://derpicdn.net/img/view/2019/3/1/1974771.jpeg,0,0.981096685,31,0,647,608,616,608,rarity
1974943.jpeg,https://derpicdn.net/img/view/2019/3/1/1974943.jpeg,0,0.980001032,0,0,642,632,642,632,rarity
1975004.jpeg,https://derpicdn.net/img/view/2019/3/2/1975004.jpeg,0,0.989549935,435,479,1613,1657,1178,1178,rarity
1975426.jpeg,https://derpicdn.net/img/view/2019/3/2/1975426.jpeg,0,0.94349736,42,5,766,729,724,724,rarity
1976305.jpeg,https://derpicdn.net/img/view/2019/3/3/1976305.jpeg,0,0.939212143,86,0,781,724,695,724,rarity
1978106.jpeg,https://derpicdn.net/img/view/2019/3/5/1978106.jpeg,0,0.99518919,466,15,880,429,414,414,rarity
1978934.jpeg,https://derpicdn.net/img/view/2019/3/6/1978934.jpeg,0,0.992044389,250,0,1028,742,778,742,rarity
1979220.jpeg,https://derpicdn.net/img/view/2019/3/7/1979220.jpeg,0,0.980891168,5,0,383,367,378,367,rarity
1980305.jpeg,https://derpicdn.net/img/view/2019/3/8/1980305.jpeg,0,0.964655459,86,59,992,965,906,906,rarity
1983541.jpeg,https://derpicdn.net/img/view/2019/3/12/1983541.jpeg,0,0.998399913,455,33,1261,839,806,806,rarity
1986585.jpeg,https://derpicdn.net/img/view/2019/3/16/1986585.jpeg,0,0.9976089,649,461,789,601,140,140,rarity
1986585.jpeg,https://derpicdn.net/img/view/2019/3/16/1986585.jpeg,1,0.994187474,179,9,417,247,238,238,rarity
1989799.jpeg,https://derpicdn.net/img/view/2019/3/19/1989799.jpeg,1,0.942820132,631,0,1241,583,610,583,rarity
199237.jpeg,https://derpicdn.net/img/view/2013/1/1/199237.jpeg,0,0.930842161,236,0,668,425,432,425,rarity
1992474.jpeg,https://derpicdn.net/img/view/2019/3/23/1992474.jpeg,0,0.994787753,1476,176,2010,710,534,534,rarity
1992523.jpeg,https://derpicdn.net/img/view/2019/3/23/1992523.jpeg,0,0.985434115,733,113,1015,395,282,282,rarity
1994980.jpeg,https://derpicdn.net/img/view/2019/3/25/1994980.jpeg,0,0.996778309,582,0,2088,1362,1506,1362,rarity
1997721.jpeg,https://derpicdn.net/img/view/2019/3/29/1997721.jpeg,0,0.909449577,443,0,1731,1206,1288,1206,rarity
1999239.jpeg,https://derpicdn.net/img/view/2019/3/31/1999239.jpeg,0,0.983951032,300,264,596,560,296,296,rarity
2005386.jpeg,https://derpicdn.net/img/view/2019/4/7/2005386.jpeg,0,0.959571064,233,156,907,830,674,674,rarity
2006218.jpeg,https://derpicdn.net/img/view/2019/4/8/2006218.jpeg,0,0.953106642,416,4,966,554,550,550,rarity
2007077.jpeg,https://derpicdn.net/img/view/2019/4/9/2007077.jpeg,0,0.988561988,55,5,517,467,462,462,rarity
2007868.jpeg,https://derpicdn.net/img/view/2019/4/10/2007868.jpeg,0,0.991774142,77,0,563,474,486,474,rarity
2007868.jpeg,https://derpicdn.net/img/view/2019/4/10/2007868.jpeg,1,0.984721601,610,0,1280,589,670,589,rarity
2009984.jpeg,https://derpicdn.net/img/view/2019/4/12/2009984.jpeg,0,0.995990992,681,100,1025,444,344,344,rarity
2012643.jpeg,https://derpicdn.net/img/view/2019/4/14/2012643.jpeg,0,0.97180891,0,44,600,814,600,770,rarity
2012881.jpeg,https://derpicdn.net/img/view/2019/4/15/2012881.jpeg,0,0.993151248,384,127,1052,795,668,668,rarity
2012933.jpeg,https://derpicdn.net/img/view/2019/4/15/2012933.jpeg,0,0.996479034,379,124,1053,798,674,674,rarity
2014276.jpeg,https://derpicdn.net/img/view/2019/4/16/2014276.jpeg,0,0.993658125,171,94,767,690,596,596,rarity
2017094.jpeg,https://derpicdn.net/img/view/2019/4/19/2017094.jpeg,0,0.998813987,0,0,510,449,510,449,rarity
2018200.jpeg,https://derpicdn.net/img/view/2019/4/20/2018200.jpeg,0,0.979652822,142,0,902,717,760,717,rarity
2018559.jpeg,https://derpicdn.net/img/view/2019/4/21/2018559.jpeg,0,0.969289064,163,0,863,687,700,687,rarity
2019470.jpeg,https://derpicdn.net/img/view/2019/4/22/2019470.jpeg,0,0.975806057,1000,190,1716,906,716,716,rarity
2020032.jpeg,https://derpicdn.net/img/view/2019/4/22/2020032.jpeg,0,0.988188386,32,0,598,541,566,541,rarity
202188.jpeg,https://derpicdn.net/img/view/2013/1/4/202188.jpeg,0,0.912271857,468,61,858,451,390,390,rarity
2021910.jpeg,https://derpicdn.net/img/view/2019/4/24/2021910.jpeg,0,0.961529136,16,47,1444,1475,1428,1428,rarity
2022983.jpeg,https://derpicdn.net/img/view/2019/4/26/2022983.jpeg,0,0.998959959,507,0,889,328,382,328,rarity
2023073.jpeg,https://derpicdn.net/img/view/2019/4/26/2023073.jpeg,0,0.994395673,64,0,924,829,860,829,rarity
202436.jpeg,https://derpicdn.net/img/view/2013/1/4/202436.jpeg,0,0.994332194,46,70,372,396,326,326,rarity
2024666.jpeg,https://derpicdn.net/img/view/2019/4/27/2024666.jpeg,0,0.923750937,0,0,610,614,610,614,rarity
2027933.jpeg,https://derpicdn.net/img/view/2019/5/1/2027933.jpeg,0,0.997137308,227,281,663,717,436,436,rarity
2027933.jpeg,https://derpicdn.net/img/view/2019/5/1/2027933.jpeg,1,0.996749997,521,0,1045,495,524,495,rarity
2028825.jpeg,https://derpicdn.net/img/view/2019/5/2/2028825.jpeg,0,0.976193011,80,14,968,831,888,817,rarity
2032066.jpeg,https://derpicdn.net/img/view/2019/5/6/2032066.jpeg,0,0.999128163,910,344,1728,1162,818,818,rarity
203207.jpeg,https://derpicdn.net/img/view/2013/1/5/203207.jpeg,0,0.958159506,488,0,1052,527,564,527,rarity
2034649.jpeg,https://derpicdn.net/img/view/2019/5/9/2034649.jpeg,0,0.940482616,509,2,1001,494,492,492,rarity
2035443.jpeg,https://derpicdn.net/img/view/2019/5/10/2035443.jpeg,0,0.999545276,122,0,854,702,732,702,rarity
2035577.jpeg,https://derpicdn.net/img/view/2019/5/10/2035577.jpeg,0,0.911352038,737,105,1701,1069,964,964,rarity
2035805.jpeg,https://derpicdn.net/img/view/2019/5/10/2035805.jpeg,0,0.939568996,152,0,786,554,634,554,rarity
2038938.jpeg,https://derpicdn.net/img/view/2019/5/14/2038938.jpeg,0,0.995260775,132,16,654,538,522,522,rarity
2040845.jpeg,https://derpicdn.net/img/view/2019/5/16/2040845.jpeg,0,0.93864584,210,77,812,679,602,602,rarity
204239.jpeg,https://derpicdn.net/img/view/2013/1/6/204239.jpeg,0,0.992909372,230,0,594,352,364,352,rarity
2043255.jpeg,https://derpicdn.net/img/view/2019/5/19/2043255.jpeg,0,0.978619814,81,0,985,732,904,732,rarity
2045584.jpeg,https://derpicdn.net/img/view/2019/5/22/2045584.jpeg,0,0.999779761,542,5,1034,497,492,492,rarity
2046547.jpeg,https://derpicdn.net/img/view/2019/5/23/2046547.jpeg,0,0.983327508,120,0,1012,801,892,801,rarity
2049063.jpeg,https://derpicdn.net/img/view/2019/5/26/2049063.jpeg,0,0.997917473,733,0,1713,966,980,966,rarity
2052001.jpeg,https://derpicdn.net/img/view/2019/5/28/2052001.jpeg,0,0.976920485,0,105,2084,2949,2084,2844,rarity
2052323.jpeg,https://derpicdn.net/img/view/2019/5/29/2052323.jpeg,0,0.997045398,421,45,751,375,330,330,rarity
2052664.jpeg,https://derpicdn.net/img/view/2019/5/29/2052664.jpeg,0,0.99924618,599,0,2135,1387,1536,1387,rarity
2054613.jpeg,https://derpicdn.net/img/view/2019/5/31/2054613.jpeg,0,0.992461205,163,6,561,404,398,398,rarity
2054765.jpeg,https://derpicdn.net/img/view/2019/6/1/2054765.jpeg,0,0.999164104,1502,0,2576,1065,1074,1065,rarity
2055156.jpeg,https://derpicdn.net/img/view/2019/6/1/2055156.jpeg,0,0.996688128,78,0,424,343,346,343,rarity
2055156.jpeg,https://derpicdn.net/img/view/2019/6/1/2055156.jpeg,1,0.990973473,647,33,941,327,294,294,rarity
2057082.jpeg,https://derpicdn.net/img/view/2019/6/3/2057082.jpeg,0,0.995322049,216,0,893,662,677,662,rarity
2059015.jpeg,https://derpicdn.net/img/view/2019/6/6/2059015.jpeg,0,0.998770595,444,3,1352,911,908,908,rarity
2061231.jpeg,https://derpicdn.net/img/view/2019/6/9/2061231.jpeg,0,0.971546292,846,8,1492,654,646,646,rarity
2061903.jpeg,https://derpicdn.net/img/view/2019/6/10/2061903.jpeg,0,0.996520221,280,39,2260,2019,1980,1980,rarity
2067293.jpeg,https://derpicdn.net/img/view/2019/6/16/2067293.jpeg,0,0.990895867,255,0,1355,1066,1100,1066,rarity
2071700.jpeg,https://derpicdn.net/img/view/2019/6/22/2071700.jpeg,0,0.995902002,197,0,591,392,394,392,rarity
2071998.jpeg,https://derpicdn.net/img/view/2019/6/22/2071998.jpeg,0,0.980237842,50,34,850,720,800,686,rarity
2071999.jpeg,https://derpicdn.net/img/view/2019/6/22/2071999.jpeg,0,0.982175231,42,0,848,720,806,720,rarity
2072007.jpeg,https://derpicdn.net/img/view/2019/6/22/2072007.jpeg,0,0.961277306,23,31,695,703,672,672,rarity
2073070.jpeg,https://derpicdn.net/img/view/2019/6/23/2073070.jpeg,0,0.997989476,656,6,874,228,218,222,rarity
2073070.jpeg,https://derpicdn.net/img/view/2019/6/23/2073070.jpeg,1,0.996845722,14,318,214,518,200,200,rarity
2073070.jpeg,https://derpicdn.net/img/view/2019/6/23/2073070.jpeg,2,0.992432237,192,0,500,271,308,271,rarity
2073070.jpeg,https://derpicdn.net/img/view/2019/6/23/2073070.jpeg,4,0.983032167,0,9,214,227,214,218,rarity
2073070.jpeg,https://derpicdn.net/img/view/2019/6/23/2073070.jpeg,5,0.947569788,639,313,865,539,226,226,rarity
207468.jpeg,https://derpicdn.net/img/view/2013/1/9/207468.jpeg,0,0.993648291,437,0,815,372,378,372,rarity
2074849.jpeg,https://derpicdn.net/img/view/2019/6/25/2074849.jpeg,0,0.996900499,72,82,316,326,244,244,rarity
2074915.jpeg,https://derpicdn.net/img/view/2019/6/25/2074915.jpeg,0,0.984759331,496,0,1426,906,930,906,rarity
2075151.jpeg,https://derpicdn.net/img/view/2019/6/25/2075151.jpeg,0,0.99845612,99,14,847,762,748,748,rarity
2075363.jpeg,https://derpicdn.net/img/view/2019/6/26/2075363.jpeg,0,0.965958655,279,100,607,428,328,328,rarity
2075691.jpeg,https://derpicdn.net/img/view/2019/6/26/2075691.jpeg,0,0.997967124,222,41,870,689,648,648,rarity
2076276.jpeg,https://derpicdn.net/img/view/2019/6/27/2076276.jpeg,0,0.972496331,0,0,930,1081,930,1081,rarity
2078024.jpeg,https://derpicdn.net/img/view/2019/6/29/2078024.jpeg,0,0.987912178,430,13,1106,689,676,676,rarity
2081625.jpeg,https://derpicdn.net/img/view/2019/7/2/2081625.jpeg,0,0.965041995,148,0,1248,1053,1100,1053,rarity
2093523.jpeg,https://derpicdn.net/img/view/2019/7/16/2093523.jpeg,0,0.979674578,625,485,827,687,202,202,rarity
2093523.jpeg,https://derpicdn.net/img/view/2019/7/16/2093523.jpeg,1,0.969759583,70,0,584,469,514,469,rarity
2093745.jpeg,https://derpicdn.net/img/view/2019/7/16/2093745.jpeg,0,0.924612164,0,0,487,493,487,493,rarity
2094904.jpeg,https://derpicdn.net/img/view/2019/7/18/2094904.jpeg,0,0.992266357,323,706,727,1110,404,404,rarity
2095475.jpeg,https://derpicdn.net/img/view/2019/7/19/2095475.jpeg,0,0.98087728,350,43,730,423,380,380,rarity
2096525.jpeg,https://derpicdn.net/img/view/2019/7/20/2096525.jpeg,0,0.971183002,223,77,2529,2383,2306,2306,rarity
2096871.jpeg,https://derpicdn.net/img/view/2019/7/20/2096871.jpeg,0,0.986824036,140,0,688,531,548,531,rarity
2097502.jpeg,https://derpicdn.net/img/view/2019/7/21/2097502.jpeg,0,0.972351551,251,20,1079,848,828,828,rarity
2098992.jpeg,https://derpicdn.net/img/view/2019/7/23/2098992.jpeg,0,0.997918189,1223,976,1555,1308,332,332,rarity
2098992.jpeg,https://derpicdn.net/img/view/2019/7/23/2098992.jpeg,1,0.980979741,56,0,1376,1147,1320,1147,rarity
2100656.jpeg,https://derpicdn.net/img/view/2019/7/25/2100656.jpeg,0,0.990626395,268,0,886,612,618,612,rarity
2102337.jpeg,https://derpicdn.net/img/view/2019/7/27/2102337.jpeg,0,0.977387667,242,25,1170,953,928,928,rarity
2107490.jpeg,https://derpicdn.net/img/view/2019/8/2/2107490.jpeg,0,0.994623244,73,0,653,546,580,546,rarity
2108424.jpeg,https://derpicdn.net/img/view/2019/8/4/2108424.jpeg,0,0.987956762,530,0,1102,570,572,570,rarity
2111189.jpeg,https://derpicdn.net/img/view/2019/8/7/2111189.jpeg,0,0.998455584,216,70,692,546,476,476,rarity
2114461.jpeg,https://derpicdn.net/img/view/2019/8/10/2114461.jpeg,0,0.996339917,710,0,1636,905,926,905,rarity
2114950.jpeg,https://derpicdn.net/img/view/2019/8/11/2114950.jpeg,0,0.987013102,31,42,437,448,406,406,rarity
2118661.jpeg,https://derpicdn.net/img/view/2019/8/15/2118661.jpeg,0,0.997100413,192,0,1248,944,1056,944,rarity
2120156.jpeg,https://derpicdn.net/img/view/2019/8/17/2120156.jpeg,0,0.985175371,522,389,1370,1237,848,848,rarity
2122242.jpeg,https://derpicdn.net/img/view/2019/8/19/2122242.jpeg,0,0.992791831,779,37,1495,753,716,716,rarity
2125022.jpeg,https://derpicdn.net/img/view/2019/8/22/2125022.jpeg,0,0.986414135,41,179,975,1113,934,934,rarity
2125356.jpeg,https://derpicdn.net/img/view/2019/8/23/2125356.jpeg,0,0.999634862,743,195,1165,617,422,422,rarity
2125356.jpeg,https://derpicdn.net/img/view/2019/8/23/2125356.jpeg,1,0.999265134,385,12,789,416,404,404,rarity
2125356.jpeg,https://derpicdn.net/img/view/2019/8/23/2125356.jpeg,2,0.998331666,1064,139,1484,559,420,420,rarity
2125356.jpeg,https://derpicdn.net/img/view/2019/8/23/2125356.jpeg,3,0.996896446,1020,962,1488,1456,468,494,rarity
2125356.jpeg,https://derpicdn.net/img/view/2019/8/23/2125356.jpeg,4,0.989392698,0,186,407,628,407,442,rarity
2126553.jpeg,https://derpicdn.net/img/view/2019/8/24/2126553.jpeg,0,0.99667114,169,5,787,623,618,618,rarity
2127408.jpeg,https://derpicdn.net/img/view/2019/8/25/2127408.jpeg,0,0.961148798,596,795,928,1127,332,332,rarity
2127481.jpeg,https://derpicdn.net/img/view/2019/8/25/2127481.jpeg,0,0.995139718,1121,65,1849,793,728,728,rarity
2130193.jpeg,https://derpicdn.net/img/view/2019/8/28/2130193.jpeg,0,0.992235482,84,0,960,812,876,812,rarity
2131446.jpeg,https://derpicdn.net/img/view/2019/8/30/2131446.jpeg,0,0.996879935,13,0,855,740,842,740,rarity
2132292.jpeg,https://derpicdn.net/img/view/2019/8/31/2132292.jpeg,0,0.997083127,624,12,1330,718,706,706,rarity
2133361.jpeg,https://derpicdn.net/img/view/2019/9/1/2133361.jpeg,1,0.988468528,1151,172,1475,496,324,324,rarity
2134662.jpeg,https://derpicdn.net/img/view/2019/9/2/2134662.jpeg,0,0.995872796,279,0,697,401,418,401,rarity
2135825.jpeg,https://derpicdn.net/img/view/2019/9/3/2135825.jpeg,1,0.994469166,2,91,428,517,426,426,rarity
2136006.jpeg,https://derpicdn.net/img/view/2019/9/4/2136006.jpeg,0,0.997260451,1221,978,1555,1312,334,334,rarity
2136006.jpeg,https://derpicdn.net/img/view/2019/9/4/2136006.jpeg,1,0.986050129,64,0,1376,1149,1312,1149,rarity
2136440.jpeg,https://derpicdn.net/img/view/2019/9/4/2136440.jpeg,0,0.926328182,903,0,2415,1427,1512,1427,rarity
2136812.jpeg,https://derpicdn.net/img/view/2019/9/5/2136812.jpeg,0,0.965135574,291,0,1003,631,712,631,rarity
2137431.jpeg,https://derpicdn.net/img/view/2019/9/5/2137431.jpeg,0,0.998811066,25,3,541,519,516,516,rarity
2138665.jpeg,https://derpicdn.net/img/view/2019/9/7/2138665.jpeg,0,0.986168742,0,0,2550,3006,2550,3006,rarity
2140119.jpeg,https://derpicdn.net/img/view/2019/9/9/2140119.jpeg,0,0.943266809,34,352,1016,1334,982,982,rarity
2142736.jpeg,https://derpicdn.net/img/view/2019/9/13/2142736.jpeg,0,0.947817564,406,0,1560,1123,1154,1123,rarity
2145975.jpeg,https://derpicdn.net/img/view/2019/9/16/2145975.jpeg,0,0.991423666,176,0,732,510,556,510,rarity
2146244.jpeg,https://derpicdn.net/img/view/2019/9/17/2146244.jpeg,0,0.953582823,48,0,310,260,262,260,rarity
2150837.jpeg,https://derpicdn.net/img/view/2019/9/23/2150837.jpeg,0,0.992013454,327,0,1000,645,673,645,rarity
2151573.jpeg,https://derpicdn.net/img/view/2019/9/24/2151573.jpeg,0,0.960465431,97,0,513,376,416,376,rarity
2155755.jpeg,https://derpicdn.net/img/view/2019/9/29/2155755.jpeg,0,0.992729425,0,0,457,444,457,444,rarity
2156569.jpeg,https://derpicdn.net/img/view/2019/9/30/2156569.jpeg,0,0.996762156,363,147,941,725,578,578,rarity
2156569.jpeg,https://derpicdn.net/img/view/2019/9/30/2156569.jpeg,1,0.981575727,1574,144,2216,786,642,642,rarity
2156705.jpeg,https://derpicdn.net/img/view/2019/9/30/2156705.jpeg,0,0.955379367,78,0,952,813,874,813,rarity
2159184.jpeg,https://derpicdn.net/img/view/2019/10/3/2159184.jpeg,0,0.966664076,131,15,259,143,128,128,rarity
2159242.jpeg,https://derpicdn.net/img/view/2019/10/3/2159242.jpeg,0,0.998920262,292,144,526,378,234,234,rarity
2159339.jpeg,https://derpicdn.net/img/view/2019/10/3/2159339.jpeg,0,0.983615518,565,115,721,271,156,156,rarity
2159459.jpeg,https://derpicdn.net/img/view/2019/10/3/2159459.jpeg,0,0.9172194,446,45,882,481,436,436,rarity
2163841.jpeg,https://derpicdn.net/img/view/2019/10/9/2163841.jpeg,0,0.960560322,179,0,573,370,394,370,rarity
2163884.jpeg,https://derpicdn.net/img/view/2019/10/9/2163884.jpeg,0,0.987953007,546,209,1308,971,762,762,rarity
2164515.jpeg,https://derpicdn.net/img/view/2019/10/10/2164515.jpeg,0,0.996358514,191,65,507,381,316,316,rarity
2164884.jpeg,https://derpicdn.net/img/view/2019/10/10/2164884.jpeg,0,0.96257484,285,0,1013,679,728,679,rarity
2168564.jpeg,https://derpicdn.net/img/view/2019/10/14/2168564.jpeg,0,0.983233571,225,45,805,625,580,580,rarity
2169003.jpeg,https://derpicdn.net/img/view/2019/10/14/2169003.jpeg,0,0.979986131,81,11,655,585,574,574,rarity
2176356.jpeg,https://derpicdn.net/img/view/2019/10/22/2176356.jpeg,0,0.994383872,186,33,826,673,640,640,rarity
2178216.jpeg,https://derpicdn.net/img/view/2019/10/25/2178216.jpeg,0,0.981627584,205,231,677,703,472,472,rarity
2178284.jpeg,https://derpicdn.net/img/view/2019/10/25/2178284.jpeg,0,0.983994782,77,0,1545,1292,1468,1292,rarity
2179228.jpeg,https://derpicdn.net/img/view/2019/10/26/2179228.jpeg,0,0.962208211,17,0,391,366,374,366,rarity
2179678.jpeg,https://derpicdn.net/img/view/2019/10/26/2179678.jpeg,0,0.962052107,836,749,1556,1469,720,720,rarity
2181447.jpeg,https://derpicdn.net/img/view/2019/10/28/2181447.jpeg,0,0.986763299,240,38,1036,834,796,796,rarity
2181588.jpeg,https://derpicdn.net/img/view/2019/10/28/2181588.jpeg,0,0.973212361,0,0,1583,1597,1583,1597,rarity
2181616.jpeg,https://derpicdn.net/img/view/2019/10/29/2181616.jpeg,0,0.940315127,235,3,643,411,408,408,rarity
2182681.jpeg,https://derpicdn.net/img/view/2019/10/30/2182681.jpeg,0,0.980801344,54,0,326,232,272,232,rarity
2183316.jpeg,https://derpicdn.net/img/view/2019/10/31/2183316.jpeg,0,0.990283668,1018,72,2102,1156,1084,1084,rarity
2184014.jpeg,https://derpicdn.net/img/view/2019/10/31/2184014.jpeg,0,0.990246058,0,0,1130,1188,1130,1188,rarity
2184050.jpeg,https://derpicdn.net/img/view/2019/10/31/2184050.jpeg,0,0.974146008,695,126,1597,1028,902,902,rarity
2185821.jpeg,https://derpicdn.net/img/view/2019/11/2/2185821.jpeg,0,0.982314229,214,43,616,445,402,402,rarity
2190301.jpeg,https://derpicdn.net/img/view/2019/11/8/2190301.jpeg,0,0.985061586,103,0,571,415,468,415,rarity
2193393.jpeg,https://derpicdn.net/img/view/2019/11/11/2193393.jpeg,0,0.944461346,319,9,1063,753,744,744,rarity
2193560.jpeg,https://derpicdn.net/img/view/2019/11/11/2193560.jpeg,0,0.990192056,572,92,1406,926,834,834,rarity
2195971.jpeg,https://derpicdn.net/img/view/2019/11/14/2195971.jpeg,0,0.998506308,102,2419,666,2983,564,564,rarity
2195971.jpeg,https://derpicdn.net/img/view/2019/11/14/2195971.jpeg,1,0.988350809,1968,44,2608,684,640,640,rarity
2195971.jpeg,https://derpicdn.net/img/view/2019/11/14/2195971.jpeg,2,0.984300077,212,213,846,847,634,634,rarity
2198698.jpeg,https://derpicdn.net/img/view/2019/11/17/2198698.jpeg,0,0.965347528,178,10,551,386,373,376,rarity
2200971.jpeg,https://derpicdn.net/img/view/2019/11/20/2200971.jpeg,0,0.986467719,998,1896,1920,2820,922,924,rarity
2203620.jpeg,https://derpicdn.net/img/view/2019/11/23/2203620.jpeg,0,0.944655836,1798,185,2954,1341,1156,1156,rarity
2204749.jpeg,https://derpicdn.net/img/view/2019/11/24/2204749.jpeg,0,0.983423471,1258,987,3040,2769,1782,1782,rarity
2205056.jpeg,https://derpicdn.net/img/view/2019/11/25/2205056.jpeg,0,0.996728301,375,254,1219,1098,844,844,rarity
2205875.jpeg,https://derpicdn.net/img/view/2019/11/26/2205875.jpeg,0,0.997420967,71,0,1527,1390,1456,1390,rarity
2208116.jpeg,https://derpicdn.net/img/view/2019/11/29/2208116.jpeg,0,0.997783005,245,46,801,602,556,556,rarity
2209805.jpeg,https://derpicdn.net/img/view/2019/12/1/2209805.jpeg,0,0.941091239,70,0,648,551,578,551,rarity
2211812.jpeg,https://derpicdn.net/img/view/2019/12/3/2211812.jpeg,0,0.969747543,46,16,404,374,358,358,rarity
2212250.jpeg,https://derpicdn.net/img/view/2019/12/4/2212250.jpeg,0,0.997855246,957,0,2479,1437,1522,1437,rarity
2213434.jpeg,https://derpicdn.net/img/view/2019/12/6/2213434.jpeg,0,0.932972252,949,0,3443,2487,2494,2487,rarity
2215623.jpeg,https://derpicdn.net/img/view/2019/12/8/2215623.jpeg,0,0.978386343,670,75,1000,405,330,330,rarity
2218913.jpeg,https://derpicdn.net/img/view/2019/12/12/2218913.jpeg,0,0.991210878,0,0,589,618,589,618,rarity
2218913.jpeg,https://derpicdn.net/img/view/2019/12/12/2218913.jpeg,1,0.969416261,440,22,955,586,515,564,rarity
2219272.jpeg,https://derpicdn.net/img/view/2019/12/13/2219272.jpeg,0,0.989994764,148,24,456,332,308,308,rarity
2221123.jpeg,https://derpicdn.net/img/view/2019/12/15/2221123.jpeg,0,0.999345481,591,0,1017,375,426,375,rarity
2221123.jpeg,https://derpicdn.net/img/view/2019/12/15/2221123.jpeg,1,0.995257854,156,298,544,686,388,388,rarity
2221366.jpeg,https://derpicdn.net/img/view/2019/12/15/2221366.jpeg,0,0.974348783,319,0,1149,683,830,683,rarity
2221826.jpeg,https://derpicdn.net/img/view/2019/12/16/2221826.jpeg,0,0.922542274,52,0,726,659,674,659,rarity
2222885.jpeg,https://derpicdn.net/img/view/2019/12/17/2222885.jpeg,0,0.950252533,183,0,567,374,384,374,rarity
2222903.jpeg,https://derpicdn.net/img/view/2019/12/17/2222903.jpeg,0,0.917123377,361,34,889,562,528,528,rarity
2224744.jpeg,https://derpicdn.net/img/view/2019/12/19/2224744.jpeg,0,0.996602714,21,7,471,457,450,450,rarity
225480.jpeg,https://derpicdn.net/img/view/2013/1/27/225480.jpeg,0,0.994615614,20,0,394,359,374,359,rarity
228647.jpeg,https://derpicdn.net/img/view/2013/1/30/228647.jpeg,0,0.990546465,264,0,560,283,296,283,rarity
232309.jpeg,https://derpicdn.net/img/view/2013/2/3/232309.jpeg,0,0.995438814,198,0,512,312,314,312,rarity
232615.jpeg,https://derpicdn.net/img/view/2013/2/3/232615.jpeg,0,0.99910444,400,0,738,333,338,333,rarity
238214.jpeg,https://derpicdn.net/img/view/2013/2/9/238214.jpeg,0,0.960385621,570,162,788,380,218,218,rarity
275524.jpeg,https://derpicdn.net/img/view/2013/3/20/275524.jpeg,0,0.99865669,76,45,492,461,416,416,rarity
278616.jpeg,https://derpicdn.net/img/view/2013/3/24/278616.jpeg,0,0.928308785,84,32,786,734,702,702,rarity
288512.jpeg,https://derpicdn.net/img/view/2013/4/5/288512.jpeg,0,0.979101717,1401,0,1891,413,490,413,rarity
307883.jpeg,https://derpicdn.net/img/view/2013/4/25/307883.jpeg,0,0.996083021,96,345,398,647,302,302,rarity
307883.jpeg,https://derpicdn.net/img/view/2013/4/25/307883.jpeg,1,0.976172268,659,126,847,314,188,188,rarity
310588.jpeg,https://derpicdn.net/img/view/2013/4/28/310588.jpeg,0,0.989147723,675,169,1083,577,408,408,rarity
317498.jpeg,https://derpicdn.net/img/view/2013/5/5/317498.jpeg,2,0.985122681,846,206,1222,582,376,376,rarity
317498.jpeg,https://derpicdn.net/img/view/2013/5/5/317498.jpeg,4,0.95009464,44,60,350,366,306,306,rarity
325693.jpeg,https://derpicdn.net/img/view/2013/5/15/325693.jpeg,0,0.973433018,484,582,970,1068,486,486,rarity
335523.jpeg,https://derpicdn.net/img/view/2013/5/28/335523.jpeg,0,0.976243556,363,0,891,527,528,527,rarity
352497.jpeg,https://derpicdn.net/img/view/2013/6/19/352497.jpeg,0,0.904752016,54,152,304,402,250,250,rarity
356007.jpeg,https://derpicdn.net/img/view/2013/6/24/356007.jpeg,0,0.97553879,0,0,948,922,948,922,rarity
359431.jpeg,https://derpicdn.net/img/view/2013/6/28/359431.jpeg,0,0.969328225,15,0,383,336,368,336,rarity
375771.jpeg,https://derpicdn.net/img/view/2013/7/16/375771.jpeg,0,0.923524559,1531,241,1963,673,432,432,rarity
384646.jpeg,https://derpicdn.net/img/view/2013/7/29/384646.jpeg,0,0.999316752,122,17,454,349,332,332,rarity
391257.jpeg,https://derpicdn.net/img/view/2013/8/4/391257.jpeg,0,0.919468403,546,302,1428,1184,882,882,rarity
391640.jpeg,https://derpicdn.net/img/view/2013/8/5/391640.jpeg,0,0.984805107,72,24,650,602,578,578,rarity
411508.jpeg,https://derpicdn.net/img/view/2013/8/26/411508.jpeg,0,0.994912148,632,43,1336,747,704,704,rarity
422763.jpeg,https://derpicdn.net/img/view/2013/9/8/422763.jpeg,0,0.931010604,591,93,1645,1147,1054,1054,rarity
431591.jpeg,https://derpicdn.net/img/view/2013/9/20/431591.jpeg,0,0.99751395,205,0,671,457,466,457,rarity
431946.jpeg,https://derpicdn.net/img/view/2013/9/21/431946.jpeg,0,0.97961247,0,0,1188,1456,1188,1456,rarity
436888.jpeg,https://derpicdn.net/img/view/2013/9/28/436888.jpeg,0,0.989511788,390,1741,1744,3095,1354,1354,rarity
446856.jpeg,https://derpicdn.net/img/view/2013/10/12/446856.jpeg,1,0.973897934,238,0,1390,1071,1152,1071,rarity
448787.jpeg,https://derpicdn.net/img/view/2013/10/14/448787.jpeg,0,0.981254041,46,0,218,169,172,169,rarity
454456.jpeg,https://derpicdn.net/img/view/2013/10/22/454456.jpeg,0,0.990740299,235,28,499,292,264,264,rarity
467054.jpeg,https://derpicdn.net/img/view/2013/11/8/467054.jpeg,0,0.995293319,429,282,663,516,234,234,rarity
474078.jpeg,https://derpicdn.net/img/view/2013/11/16/474078.jpeg,0,0.999174416,594,40,1280,750,686,710,rarity
475846.jpeg,https://derpicdn.net/img/view/2013/11/19/475846.jpeg,0,0.960990191,111,0,469,340,358,340,rarity
485289.jpeg,https://derpicdn.net/img/view/2013/11/29/485289.jpeg,0,0.995347619,191,22,527,358,336,336,rarity
490817.jpeg,https://derpicdn.net/img/view/2013/12/6/490817.jpeg,0,0.998286784,1577,63,2877,1363,1300,1300,rarity
493083.jpeg,https://derpicdn.net/img/view/2013/12/8/493083.jpeg,0,0.924576283,193,0,481,284,288,284,rarity
498867.jpeg,https://derpicdn.net/img/view/2013/12/16/498867.jpeg,0,0.98407203,499,29,933,463,434,434,rarity
501075.jpeg,https://derpicdn.net/img/view/2013/12/19/501075.jpeg,0,0.962145984,174,14,356,196,182,182,rarity
511934.jpeg,https://derpicdn.net/img/view/2014/1/1/511934.jpeg,0,0.942784309,681,0,1497,749,816,749,rarity
514612.jpeg,https://derpicdn.net/img/view/2014/1/4/514612.jpeg,0,0.994268119,188,0,600,396,412,396,rarity
524518.jpeg,https://derpicdn.net/img/view/2014/1/14/524518.jpeg,0,0.996038795,20,0,426,340,406,340,rarity
526101.jpeg,https://derpicdn.net/img/view/2014/1/16/526101.jpeg,0,0.994019866,382,0,1522,1101,1140,1101,rarity
527482.jpeg,https://derpicdn.net/img/view/2014/1/18/527482.jpeg,0,0.970107138,233,31,747,545,514,514,rarity
537450.jpeg,https://derpicdn.net/img/view/2014/1/29/537450.jpeg,0,0.989461839,53,0,483,427,430,427,rarity
541488.jpeg,https://derpicdn.net/img/view/2014/2/2/541488.jpeg,0,0.996791124,277,0,1039,717,762,717,rarity
547258.jpeg,https://derpicdn.net/img/view/2014/2/9/547258.jpeg,0,0.986302793,123,0,621,477,498,477,rarity
549407.jpeg,https://derpicdn.net/img/view/2014/2/11/549407.jpeg,0,0.979029894,195,0,815,591,620,591,rarity
556242.jpeg,https://derpicdn.net/img/view/2014/2/19/556242.jpeg,0,0.998230875,496,186,658,348,162,162,rarity
559703.jpeg,https://derpicdn.net/img/view/2014/2/23/559703.jpeg,0,0.985218823,573,101,943,471,370,370,rarity
575477.jpeg,https://derpicdn.net/img/view/2014/3/15/575477.jpeg,0,0.998676717,1165,0,1865,678,700,678,rarity
594118.jpeg,https://derpicdn.net/img/view/2014/4/6/594118.jpeg,0,0.936251283,210,0,778,500,568,500,rarity
596562.jpeg,https://derpicdn.net/img/view/2014/4/9/596562.jpeg,0,0.927889824,399,0,891,462,492,462,rarity
599038.jpeg,https://derpicdn.net/img/view/2014/4/13/599038.jpeg,0,0.977059662,131,3,597,469,466,466,rarity
602387.jpeg,https://derpicdn.net/img/view/2014/4/17/602387.jpeg,0,0.996057093,253,31,521,299,268,268,rarity
606877.jpeg,https://derpicdn.net/img/view/2014/4/22/606877.jpeg,0,0.923017323,281,0,809,496,528,496,rarity
611079.jpeg,https://derpicdn.net/img/view/2014/4/27/611079.jpeg,0,0.997924745,192,65,402,275,210,210,rarity
618952.jpeg,https://derpicdn.net/img/view/2014/5/6/618952.jpeg,0,0.98314327,434,111,728,405,294,294,rarity
624678.jpeg,https://derpicdn.net/img/view/2014/5/12/624678.jpeg,0,0.998628616,402,15,850,463,448,448,rarity
630809.jpeg,https://derpicdn.net/img/view/2014/5/19/630809.jpeg,0,0.980584383,248,158,466,376,218,218,rarity
652243.jpeg,https://derpicdn.net/img/view/2014/6/13/652243.jpeg,0,0.987211823,311,35,905,629,594,594,rarity
653955.jpeg,https://derpicdn.net/img/view/2014/6/15/653955.jpeg,0,0.99155575,64,0,516,457,452,457,rarity
654801.jpeg,https://derpicdn.net/img/view/2014/6/16/654801.jpeg,0,0.980797589,149,0,817,642,668,642,rarity
656759.jpeg,https://derpicdn.net/img/view/2014/6/19/656759.jpeg,0,0.996499121,57,0,521,456,464,456,rarity
661899.jpeg,https://derpicdn.net/img/view/2014/6/26/661899.jpeg,0,0.974569798,1585,715,2153,1283,568,568,rarity
674124.jpeg,https://derpicdn.net/img/view/2014/7/13/674124.jpeg,0,0.975127101,351,0,1024,608,673,608,rarity
684391.jpeg,https://derpicdn.net/img/view/2014/7/27/684391.jpeg,0,0.910717309,628,1019,2218,2609,1590,1590,rarity
685855.jpeg,https://derpicdn.net/img/view/2014/7/29/685855.jpeg,0,0.994509459,205,47,777,619,572,572,rarity
689622.jpeg,https://derpicdn.net/img/view/2014/8/2/689622.jpeg,0,0.998563886,687,0,1273,441,586,441,rarity
689622.jpeg,https://derpicdn.net/img/view/2014/8/2/689622.jpeg,1,0.991048992,82,0,636,540,554,540,rarity
702915.jpeg,https://derpicdn.net/img/view/2014/8/19/702915.jpeg,0,0.985245645,294,0,1208,824,914,824,rarity
708615.jpeg,https://derpicdn.net/img/view/2014/8/26/708615.jpeg,0,0.998100936,328,3,902,577,574,574,rarity
710231.jpeg,https://derpicdn.net/img/view/2014/8/29/710231.jpeg,0,0.948384047,317,80,621,384,304,304,rarity
720711.jpeg,https://derpicdn.net/img/view/2014/9/12/720711.jpeg,0,0.99095583,295,250,665,620,370,370,rarity
725475.jpeg,https://derpicdn.net/img/view/2014/9/19/725475.jpeg,0,0.997186899,2091,320,3011,1240,920,920,rarity
740129.jpeg,https://derpicdn.net/img/view/2014/10/10/740129.jpeg,0,0.973374605,180,49,662,531,482,482,rarity
740322.jpeg,https://derpicdn.net/img/view/2014/10/10/740322.jpeg,0,0.992402375,994,108,2868,1982,1874,1874,rarity
740372.jpeg,https://derpicdn.net/img/view/2014/10/10/740372.jpeg,0,0.998075902,325,72,989,736,664,664,rarity
741828.jpeg,https://derpicdn.net/img/view/2014/10/13/741828.jpeg,0,0.97558558,64,8,498,442,434,434,rarity
742754.jpeg,https://derpicdn.net/img/view/2014/10/14/742754.jpeg,0,0.966974199,166,110,318,262,152,152,rarity
743485.jpeg,https://derpicdn.net/img/view/2014/10/15/743485.jpeg,0,0.955938697,113,0,723,533,610,533,rarity
744180.jpeg,https://derpicdn.net/img/view/2014/10/16/744180.jpeg,0,0.993779302,570,0,1078,494,508,494,rarity
750631.jpeg,https://derpicdn.net/img/view/2014/10/25/750631.jpeg,0,0.921367884,168,24,880,736,712,712,rarity
758025.jpeg,https://derpicdn.net/img/view/2014/11/4/758025.jpeg,0,0.909804285,660,0,1482,638,822,638,rarity
760483.jpeg,https://derpicdn.net/img/view/2014/11/8/760483.jpeg,0,0.989219189,227,66,1469,1348,1242,1282,rarity
761146.jpeg,https://derpicdn.net/img/view/2014/11/9/761146.jpeg,0,0.978242397,238,33,1966,1761,1728,1728,rarity
763455.jpeg,https://derpicdn.net/img/view/2014/11/13/763455.jpeg,0,0.965990663,439,0,1503,1006,1064,1006,rarity
765330.jpeg,https://derpicdn.net/img/view/2014/11/15/765330.jpeg,0,0.999252439,488,45,804,361,316,316,rarity
766382.jpeg,https://derpicdn.net/img/view/2014/11/17/766382.jpeg,0,0.997326612,171,27,1163,1019,992,992,rarity
766625.jpeg,https://derpicdn.net/img/view/2014/11/17/766625.jpeg,0,0.959055781,48,24,386,362,338,338,rarity
772012.jpeg,https://derpicdn.net/img/view/2014/11/26/772012.jpeg,0,0.977166176,0,52,1711,1884,1711,1832,rarity
775050.jpeg,https://derpicdn.net/img/view/2014/11/30/775050.jpeg,0,0.999041021,183,11,337,165,154,154,rarity
775949.jpeg,https://derpicdn.net/img/view/2014/12/1/775949.jpeg,0,0.988667548,92,0,662,569,570,569,rarity
777837.jpeg,https://derpicdn.net/img/view/2014/12/4/777837.jpeg,0,0.968257308,178,0,876,582,698,582,rarity
780336.jpeg,https://derpicdn.net/img/view/2014/12/8/780336.jpeg,0,0.98685056,269,3,453,187,184,184,rarity
783777.jpeg,https://derpicdn.net/img/view/2014/12/13/783777.jpeg,0,0.990427852,319,242,629,552,310,310,rarity
783779.jpeg,https://derpicdn.net/img/view/2014/12/13/783779.jpeg,0,0.945648313,0,103,692,897,692,794,rarity
783797.jpeg,https://derpicdn.net/img/view/2014/12/13/783797.jpeg,0,0.974036992,203,43,589,429,386,386,rarity
786740.jpeg,https://derpicdn.net/img/view/2014/12/17/786740.jpeg,0,0.99031508,313,0,625,300,312,300,rarity
788426.jpeg,https://derpicdn.net/img/view/2014/12/20/788426.jpeg,0,0.991110086,285,0,739,448,454,448,rarity
798055.jpeg,https://derpicdn.net/img/view/2015/1/2/798055.jpeg,0,0.907768846,257,4,745,492,488,488,rarity
803851.jpeg,https://derpicdn.net/img/view/2015/1/11/803851.jpeg,0,0.995636642,140,11,386,257,246,246,rarity
804117.jpeg,https://derpicdn.net/img/view/2015/1/11/804117.jpeg,0,0.927333355,0,32,1094,1136,1094,1104,rarity
806782.jpeg,https://derpicdn.net/img/view/2015/1/15/806782.jpeg,0,0.998109162,1470,316,2158,1004,688,688,rarity
816316.jpeg,https://derpicdn.net/img/view/2015/1/28/816316.jpeg,0,0.996543527,131,12,357,238,226,226,rarity
834913.jpeg,https://derpicdn.net/img/view/2015/2/22/834913.jpeg,0,0.971280217,175,0,1500,1269,1325,1269,rarity
851738.jpeg,https://derpicdn.net/img/view/2015/3/17/851738.jpeg,0,0.995930135,172,47,776,651,604,604,rarity
853791.jpeg,https://derpicdn.net/img/view/2015/3/20/853791.jpeg,1,0.976850986,324,0,608,271,284,271,rarity
860579.jpeg,https://derpicdn.net/img/view/2015/3/30/860579.jpeg,0,0.999525726,222,0,816,541,594,541,rarity
861099.jpeg,https://derpicdn.net/img/view/2015/3/31/861099.jpeg,0,0.945808053,737,0,1503,753,766,753,rarity
868003.jpeg,https://derpicdn.net/img/view/2015/4/7/868003.jpeg,0,0.992494226,995,2568,3889,5462,2894,2894,rarity
899145.jpeg,https://derpicdn.net/img/view/2015/5/18/899145.jpeg,0,0.989988089,191,22,769,600,578,578,rarity
899266.jpeg,https://derpicdn.net/img/view/2015/5/18/899266.jpeg,0,0.998067081,498,0,950,431,452,431,rarity
899515.jpeg,https://derpicdn.net/img/view/2015/5/18/899515.jpeg,0,0.932598114,179,74,1025,920,846,846,rarity
904692.jpeg,https://derpicdn.net/img/view/2015/5/26/904692.jpeg,0,0.999497533,101,464,317,680,216,216,rarity
919794.jpeg,https://derpicdn.net/img/view/2015/6/19/919794.jpeg,0,0.995989084,450,0,1382,890,932,890,rarity
921174.jpeg,https://derpicdn.net/img/view/2015/6/21/921174.jpeg,0,0.96206075,272,0,728,418,456,418,rarity
921175.jpeg,https://derpicdn.net/img/view/2015/6/21/921175.jpeg,0,0.966640174,275,0,679,388,404,388,rarity
925268.jpeg,https://derpicdn.net/img/view/2015/6/28/925268.jpeg,0,0.980066776,233,0,1400,1166,1167,1166,rarity
939058.jpeg,https://derpicdn.net/img/view/2015/7/18/939058.jpeg,0,0.992814004,416,10,894,488,478,478,rarity
942086.jpeg,https://derpicdn.net/img/view/2015/7/23/942086.jpeg,0,0.982341826,301,0,903,554,602,554,rarity
942774.jpeg,https://derpicdn.net/img/view/2015/7/24/942774.jpeg,0,0.983699441,124,0,766,581,642,581,rarity
954107.jpeg,https://derpicdn.net/img/view/2015/8/9/954107.jpeg,0,0.999625087,1402,90,2480,1168,1078,1078,rarity
957553.jpeg,https://derpicdn.net/img/view/2015/8/14/957553.jpeg,0,0.969799817,0,0,370,550,370,550,rarity
958522.jpeg,https://derpicdn.net/img/view/2015/8/15/958522.jpeg,0,0.993132234,168,5,556,393,388,388,rarity
978782.jpeg,https://derpicdn.net/img/view/2015/9/13/978782.jpeg,1,0.935957313,575,0,1087,433,512,433,rarity
982350.jpeg,https://derpicdn.net/img/view/2015/9/18/982350.jpeg,0,0.993820906,368,88,1382,1102,1014,1014,rarity
982377.jpeg,https://derpicdn.net/img/view/2015/9/18/982377.jpeg,0,0.998634517,645,324,955,634,310,310,rarity
982643.jpeg,https://derpicdn.net/img/view/2015/9/19/982643.jpeg,0,0.995699763,735,59,1367,691,632,632,rarity
990308.jpeg,https://derpicdn.net/img/view/2015/9/28/990308.jpeg,0,0.986710489,238,0,460,210,222,210,rarity
993349.jpeg,https://derpicdn.net/img/view/2015/10/3/993349.jpeg,0,0.954156041,3,0,407,366,404,366,rarity
995655.jpeg,https://derpicdn.net/img/view/2015/10/6/995655.jpeg,0,0.99557668,270,29,614,373,344,344,rarity
1002895.png,https://derpicdn.net/img/view/2015/10/15/1002895.png,0,0.996547759,47,7,415,375,368,368,twilight sparkle
1002895.png,https://derpicdn.net/img/view/2015/10/15/1002895.png,0,0.996547759,64,24,398,358,334,334,twilight sparkle
1002895.png,https://derpicdn.net/img/view/2015/10/15/1002895.png,0,0.996547759,64,24,398,358,334,334,twilight sparkle
1005256.png,https://derpicdn.net/img/view/2015/10/18/1005256.png,0,0.99859184,493,223,791,521,298,298,twilight sparkle
1005256.png,https://derpicdn.net/img/view/2015/10/18/1005256.png,0,0.99859184,507,236,777,506,270,270,twilight sparkle
1005256.png,https://derpicdn.net/img/view/2015/10/18/1005256.png,0,0.99859184,507,236,777,506,270,270,twilight sparkle
1006491.png,https://derpicdn.net/img/view/2015/10/20/1006491.png,0,0.955888867,132,0,698,495,566,495,twilight sparkle
1006491.png,https://derpicdn.net/img/view/2015/10/20/1006491.png,0,0.955888867,159,0,681,458,522,458,twilight sparkle
1006491.png,https://derpicdn.net/img/view/2015/10/20/1006491.png,0,0.955888867,159,0,681,458,522,458,twilight sparkle
1006945.png,https://derpicdn.net/img/view/2015/10/21/1006945.png,0,0.939468741,0,50,433,530,433,480,twilight sparkle
1006945.png,https://derpicdn.net/img/view/2015/10/21/1006945.png,0,0.939468741,0,72,411,508,411,436,twilight sparkle
1006945.png,https://derpicdn.net/img/view/2015/10/21/1006945.png,0,0.939468741,0,72,411,508,411,436,twilight sparkle
1007039.png,https://derpicdn.net/img/view/2015/10/21/1007039.png,0,0.967764914,347,0,835,452,488,452,twilight sparkle
1007039.png,https://derpicdn.net/img/view/2015/10/21/1007039.png,0,0.967764914,368,0,812,430,444,430,twilight sparkle
1007039.png,https://derpicdn.net/img/view/2015/10/21/1007039.png,0,0.967764914,368,0,812,430,444,430,twilight sparkle
1009635.png,https://derpicdn.net/img/view/2015/10/25/1009635.png,0,0.994134545,1020,0,2600,1509,1580,1509,twilight sparkle
1009635.png,https://derpicdn.net/img/view/2015/10/25/1009635.png,0,0.994134545,1060,0,2560,1433,1500,1433,twilight sparkle
1009635.png,https://derpicdn.net/img/view/2015/10/25/1009635.png,0,0.994134545,1060,0,2560,1433,1500,1433,twilight sparkle
1010471.png,https://derpicdn.net/img/view/2015/10/28/1010471.png,0,0.932707191,784,296,1738,1250,954,954,twilight sparkle
1010471.png,https://derpicdn.net/img/view/2015/10/28/1010471.png,0,0.932707191,825,336,1697,1208,872,872,twilight sparkle
1010471.png,https://derpicdn.net/img/view/2015/10/28/1010471.png,0,0.932707191,825,336,1697,1208,872,872,twilight sparkle
1010557.png,https://derpicdn.net/img/view/2015/10/28/1010557.png,0,0.998324335,1853,0,2893,1021,1040,1021,twilight sparkle
1010557.png,https://derpicdn.net/img/view/2015/10/28/1010557.png,0,0.998324335,1900,26,2844,970,944,944,twilight sparkle
1010557.png,https://derpicdn.net/img/view/2015/10/28/1010557.png,0,0.998324335,1900,26,2844,970,944,944,twilight sparkle
1013521.png,https://derpicdn.net/img/view/2015/10/31/1013521.png,0,0.998923898,336,0,1130,849,794,849,twilight sparkle
1013521.png,https://derpicdn.net/img/view/2015/10/31/1013521.png,0,0.998923898,380,0,1130,808,750,808,twilight sparkle
1013521.png,https://derpicdn.net/img/view/2015/10/31/1013521.png,0,0.998923898,380,0,1130,808,750,808,twilight sparkle
1014331.png,https://derpicdn.net/img/view/2015/11/1/1014331.png,0,0.924075544,759,0,2491,1661,1732,1661,twilight sparkle
1014331.png,https://derpicdn.net/img/view/2015/11/1/1014331.png,0,0.924075544,840,8,2414,1582,1574,1574,twilight sparkle
1014331.png,https://derpicdn.net/img/view/2015/11/1/1014331.png,0,0.924075544,840,8,2414,1582,1574,1574,twilight sparkle
1018166.png,https://derpicdn.net/img/view/2015/11/7/1018166.png,0,0.962246776,82,28,472,418,390,390,twilight sparkle
1018166.png,https://derpicdn.net/img/view/2015/11/7/1018166.png,0,0.962246776,35,0,504,464,469,464,twilight sparkle
1018166.png,https://derpicdn.net/img/view/2015/11/7/1018166.png,0,0.962246776,35,0,504,464,469,464,twilight sparkle
1018835.png,https://derpicdn.net/img/view/2015/11/8/1018835.png,0,0.984200954,36,3,512,479,476,476,twilight sparkle
1018835.png,https://derpicdn.net/img/view/2015/11/8/1018835.png,0,0.984200954,9,0,528,505,519,505,twilight sparkle
1018835.png,https://derpicdn.net/img/view/2015/11/8/1018835.png,0,0.984200954,9,0,528,505,519,505,twilight sparkle
1019250.jpg,https://derpicdn.net/img/view/2015/11/8/1019250.jpg,0,0.959278882,67,194,1300,1536,1233,1342,twilight sparkle
1019250.jpg,https://derpicdn.net/img/view/2015/11/8/1019250.jpg,0,0.959278882,156,255,1300,1475,1144,1220,twilight sparkle
1019250.jpg,https://derpicdn.net/img/view/2015/11/8/1019250.jpg,0,0.959278882,156,255,1300,1475,1144,1220,twilight sparkle
1019910.png,https://derpicdn.net/img/view/2015/11/9/1019910.png,0,0.998399913,266,1017,510,1261,244,244,twilight sparkle
1019910.png,https://derpicdn.net/img/view/2015/11/9/1019910.png,3,0.989804804,268,731,458,921,190,190,twilight sparkle
1019910.png,https://derpicdn.net/img/view/2015/11/9/1019910.png,5,0.94854039,228,1319,452,1543,224,224,twilight sparkle
1019910.png,https://derpicdn.net/img/view/2015/11/9/1019910.png,6,0.906217933,95,1866,289,2060,194,194,twilight sparkle
1019910.png,https://derpicdn.net/img/view/2015/11/9/1019910.png,0,0.998399913,279,1030,499,1250,220,220,twilight sparkle
1019910.png,https://derpicdn.net/img/view/2015/11/9/1019910.png,3,0.989804804,277,742,449,914,172,172,twilight sparkle
1019910.png,https://derpicdn.net/img/view/2015/11/9/1019910.png,5,0.94854039,238,1331,442,1535,204,204,twilight sparkle
1019910.png,https://derpicdn.net/img/view/2015/11/9/1019910.png,6,0.906217933,103,1875,279,2051,176,176,twilight sparkle
1019910.png,https://derpicdn.net/img/view/2015/11/9/1019910.png,0,0.998399913,279,1030,499,1250,220,220,twilight sparkle
1019910.png,https://derpicdn.net/img/view/2015/11/9/1019910.png,3,0.989804804,277,742,449,914,172,172,twilight sparkle
1019910.png,https://derpicdn.net/img/view/2015/11/9/1019910.png,5,0.94854039,238,1331,442,1535,204,204,twilight sparkle
1019910.png,https://derpicdn.net/img/view/2015/11/9/1019910.png,6,0.906217933,103,1875,279,2051,176,176,twilight sparkle
1020574.png,https://derpicdn.net/img/view/2015/11/10/1020574.png,0,0.9939273,872,290,2066,1484,1194,1194,twilight sparkle
1020574.png,https://derpicdn.net/img/view/2015/11/10/1020574.png,0,0.9939273,926,345,2014,1433,1088,1088,twilight sparkle
1020574.png,https://derpicdn.net/img/view/2015/11/10/1020574.png,0,0.9939273,926,345,2014,1433,1088,1088,twilight sparkle
1020747.png,https://derpicdn.net/img/view/2015/11/11/1020747.png,0,0.94725883,390,17,860,517,470,500,twilight sparkle
1020747.png,https://derpicdn.net/img/view/2015/11/11/1020747.png,0,0.94725883,412,39,860,495,448,456,twilight sparkle
1020747.png,https://derpicdn.net/img/view/2015/11/11/1020747.png,0,0.94725883,412,39,860,495,448,456,twilight sparkle
1021993.png,https://derpicdn.net/img/view/2015/11/13/1021993.png,0,0.993889272,218,139,906,827,688,688,twilight sparkle
1021993.png,https://derpicdn.net/img/view/2015/11/13/1021993.png,0,0.993889272,248,171,874,797,626,626,twilight sparkle
1021993.png,https://derpicdn.net/img/view/2015/11/13/1021993.png,0,0.993889272,248,171,874,797,626,626,twilight sparkle
1022277.png,https://derpicdn.net/img/view/2015/11/13/1022277.png,0,0.990042925,3,1063,2003,3063,2000,2000,twilight sparkle
1022277.png,https://derpicdn.net/img/view/2015/11/13/1022277.png,0,0.990042925,93,1153,1913,2973,1820,1820,twilight sparkle
1022277.png,https://derpicdn.net/img/view/2015/11/13/1022277.png,0,0.990042925,93,1153,1913,2973,1820,1820,twilight sparkle
1023093.png,https://derpicdn.net/img/view/2015/11/15/1023093.png,0,0.999144733,142,36,796,690,654,654,twilight sparkle
1023093.png,https://derpicdn.net/img/view/2015/11/15/1023093.png,0,0.999144733,172,66,766,660,594,594,twilight sparkle
1023093.png,https://derpicdn.net/img/view/2015/11/15/1023093.png,0,0.999144733,172,66,766,660,594,594,twilight sparkle
1023114.png,https://derpicdn.net/img/view/2015/11/15/1023114.png,0,0.982586563,0,807,4295,5813,4295,5006,twilight sparkle
1023114.png,https://derpicdn.net/img/view/2015/11/15/1023114.png,0,0.982586563,0,234,4295,6376,4295,6142,twilight sparkle
1023114.png,https://derpicdn.net/img/view/2015/11/15/1023114.png,0,0.982586563,0,234,4295,6376,4295,6142,twilight sparkle
1023241.png,https://derpicdn.net/img/view/2015/11/15/1023241.png,0,0.955510199,0,0,4884,5112,4884,5112,twilight sparkle
1023241.png,https://derpicdn.net/img/view/2015/11/15/1023241.png,0,0.955510199,0,125,4638,4983,4638,4858,twilight sparkle
1023241.png,https://derpicdn.net/img/view/2015/11/15/1023241.png,0,0.955510199,0,125,4638,4983,4638,4858,twilight sparkle
1023306.png,https://derpicdn.net/img/view/2015/11/15/1023306.png,0,0.991416872,234,54,790,610,556,556,twilight sparkle
1023306.png,https://derpicdn.net/img/view/2015/11/15/1023306.png,0,0.991416872,259,79,765,585,506,506,twilight sparkle
1023306.png,https://derpicdn.net/img/view/2015/11/15/1023306.png,0,0.991416872,259,79,765,585,506,506,twilight sparkle
1024395.png,https://derpicdn.net/img/view/2015/11/17/1024395.png,0,0.98360759,16,0,292,274,276,274,twilight sparkle
1024395.png,https://derpicdn.net/img/view/2015/11/17/1024395.png,0,0.98360759,29,10,279,260,250,250,twilight sparkle
1024395.png,https://derpicdn.net/img/view/2015/11/17/1024395.png,0,0.98360759,29,10,279,260,250,250,twilight sparkle
1024727.png,https://derpicdn.net/img/view/2015/11/17/1024727.png,0,0.999188364,2064,3489,3000,4523,936,1034,twilight sparkle
1024727.png,https://derpicdn.net/img/view/2015/11/17/1024727.png,1,0.998749435,1342,2376,2400,3434,1058,1058,twilight sparkle
1024727.png,https://derpicdn.net/img/view/2015/11/17/1024727.png,4,0.996795595,2022,2374,3000,3464,978,1090,twilight sparkle
1024727.png,https://derpicdn.net/img/view/2015/11/17/1024727.png,10,0.991565645,2052,1259,3000,2369,948,1110,twilight sparkle
1024727.png,https://derpicdn.net/img/view/2015/11/17/1024727.png,11,0.986133397,0,2398,1008,3470,1008,1072,twilight sparkle
1024727.png,https://derpicdn.net/img/view/2015/11/17/1024727.png,12,0.985505044,585,1324,1669,2408,1084,1084,twilight sparkle
1024727.png,https://derpicdn.net/img/view/2015/11/17/1024727.png,13,0.954688787,1323,224,2387,1288,1064,1064,twilight sparkle
1024727.png,https://derpicdn.net/img/view/2015/11/17/1024727.png,0,0.999188364,2113,3540,3000,4472,887,932,twilight sparkle
1024727.png,https://derpicdn.net/img/view/2015/11/17/1024727.png,1,0.998749435,1388,2420,2358,3390,970,970,twilight sparkle
1024727.png,https://derpicdn.net/img/view/2015/11/17/1024727.png,4,0.996795595,2072,2424,3000,3414,928,990,twilight sparkle
1024727.png,https://derpicdn.net/img/view/2015/11/17/1024727.png,10,0.991565645,2103,1310,3000,2318,897,1008,twilight sparkle
1024727.png,https://derpicdn.net/img/view/2015/11/17/1024727.png,11,0.986133397,0,2449,957,3419,957,970,twilight sparkle
1024727.png,https://derpicdn.net/img/view/2015/11/17/1024727.png,12,0.985505044,630,1368,1620,2358,990,990,twilight sparkle
1024727.png,https://derpicdn.net/img/view/2015/11/17/1024727.png,13,0.954688787,1375,274,2339,1238,964,964,twilight sparkle
1024727.png,https://derpicdn.net/img/view/2015/11/17/1024727.png,0,0.999188364,2113,3540,3000,4472,887,932,twilight sparkle
1024727.png,https://derpicdn.net/img/view/2015/11/17/1024727.png,1,0.998749435,1388,2420,2358,3390,970,970,twilight sparkle
1024727.png,https://derpicdn.net/img/view/2015/11/17/1024727.png,4,0.996795595,2072,2424,3000,3414,928,990,twilight sparkle
1024727.png,https://derpicdn.net/img/view/2015/11/17/1024727.png,10,0.991565645,2103,1310,3000,2318,897,1008,twilight sparkle
1024727.png,https://derpicdn.net/img/view/2015/11/17/1024727.png,11,0.986133397,0,2449,957,3419,957,970,twilight sparkle
1024727.png,https://derpicdn.net/img/view/2015/11/17/1024727.png,12,0.985505044,630,1368,1620,2358,990,990,twilight sparkle
1024727.png,https://derpicdn.net/img/view/2015/11/17/1024727.png,13,0.954688787,1375,274,2339,1238,964,964,twilight sparkle
1024874.png,https://derpicdn.net/img/view/2015/11/17/1024874.png,0,0.998733222,338,0,1598,1138,1260,1138,twilight sparkle
1024874.png,https://derpicdn.net/img/view/2015/11/17/1024874.png,0,0.998733222,394,0,1540,1060,1146,1060,twilight sparkle
1024874.png,https://derpicdn.net/img/view/2015/11/17/1024874.png,0,0.998733222,394,0,1540,1060,1146,1060,twilight sparkle
1026111.png,https://derpicdn.net/img/view/2015/11/19/1026111.png,0,0.986966014,135,0,640,531,505,531,twilight sparkle
1026111.png,https://derpicdn.net/img/view/2015/11/19/1026111.png,0,0.986966014,169,0,640,506,471,506,twilight sparkle
1026111.png,https://derpicdn.net/img/view/2015/11/19/1026111.png,0,0.986966014,169,0,640,506,471,506,twilight sparkle
1028775.png,https://derpicdn.net/img/view/2015/11/23/1028775.png,0,0.994636774,0,69,719,935,719,866,twilight sparkle
1028775.png,https://derpicdn.net/img/view/2015/11/23/1028775.png,0,0.994636774,0,108,678,896,678,788,twilight sparkle
1028775.png,https://derpicdn.net/img/view/2015/11/23/1028775.png,0,0.994636774,0,108,678,896,678,788,twilight sparkle
1032994.png,https://derpicdn.net/img/view/2015/11/29/1032994.png,0,0.986247957,426,487,964,1025,538,538,twilight sparkle
1034138.jpg,https://derpicdn.net/img/view/2015/11/30/1034138.jpg,0,0.957231343,60,0,1252,1112,1192,1112,twilight sparkle
1035654.png,https://derpicdn.net/img/view/2015/12/3/1035654.png,0,0.988385737,46,0,542,485,496,485,twilight sparkle
1038072.png,https://derpicdn.net/img/view/2015/12/6/1038072.png,0,0.998555481,4,25,378,399,374,374,twilight sparkle
1040481.jpg,https://derpicdn.net/img/view/2015/12/9/1040481.jpg,0,0.981872439,7,31,659,683,652,652,twilight sparkle
1041899.png,https://derpicdn.net/img/view/2015/12/11/1041899.png,0,0.99831599,389,523,765,899,376,376,twilight sparkle
1041958.png,https://derpicdn.net/img/view/2015/12/11/1041958.png,0,0.995924711,51,0,1883,1749,1832,1749,twilight sparkle
1042227.png,https://derpicdn.net/img/view/2015/12/11/1042227.png,0,0.994634688,136,0,644,459,508,459,twilight sparkle
1042646.png,https://derpicdn.net/img/view/2015/12/12/1042646.png,0,0.986346781,160,0,640,447,480,447,twilight sparkle
1042957.png,https://derpicdn.net/img/view/2015/12/12/1042957.png,0,0.964293897,825,75,1277,527,452,452,twilight sparkle
104801.jpg,https://derpicdn.net/img/view/2012/9/23/104801.jpg,0,0.99549222,248,15,600,367,352,352,twilight sparkle
1048841.jpg,https://derpicdn.net/img/view/2015/12/20/1048841.jpg,0,0.941651344,257,58,1061,862,804,804,twilight sparkle
1051149.jpg,https://derpicdn.net/img/view/2015/12/23/1051149.jpg,0,0.982330084,241,33,1269,1061,1028,1028,twilight sparkle
1051268.png,https://derpicdn.net/img/view/2015/12/23/1051268.png,0,0.934775352,79,0,723,639,644,639,twilight sparkle
1054761.jpg,https://derpicdn.net/img/view/2015/12/29/1054761.jpg,0,0.981588125,22,32,380,390,358,358,twilight sparkle
1055438.png,https://derpicdn.net/img/view/2015/12/30/1055438.png,0,0.996971905,104,107,772,775,668,668,twilight sparkle
1056697.png,https://derpicdn.net/img/view/2015/12/31/1056697.png,0,0.914011419,15,168,325,478,310,310,twilight sparkle
1057062.jpg,https://derpicdn.net/img/view/2016/1/1/1057062.jpg,0,0.980250657,0,40,455,522,455,482,twilight sparkle
1059057.png,https://derpicdn.net/img/view/2016/1/3/1059057.png,0,0.997413039,65,0,1061,907,996,907,twilight sparkle
1059577.png,https://derpicdn.net/img/view/2016/1/4/1059577.png,0,0.998243988,239,4,629,394,390,390,twilight sparkle
1060761.png,https://derpicdn.net/img/view/2016/1/6/1060761.png,0,0.98511368,157,221,589,653,432,432,twilight sparkle
1063004.png,https://derpicdn.net/img/view/2016/1/9/1063004.png,0,0.997788489,180,0,516,305,336,305,twilight sparkle
1065604.png,https://derpicdn.net/img/view/2016/1/13/1065604.png,0,0.989544034,13,48,355,390,342,342,twilight sparkle
1066323.png,https://derpicdn.net/img/view/2016/1/14/1066323.png,0,0.925627053,0,74,159,246,159,172,twilight sparkle
1066467.png,https://derpicdn.net/img/view/2016/1/14/1066467.png,0,0.992373288,550,0,1462,817,912,817,twilight sparkle
1067029.png,https://derpicdn.net/img/view/2016/1/15/1067029.png,0,0.980968893,432,340,814,722,382,382,twilight sparkle
1068195.png,https://derpicdn.net/img/view/2016/1/17/1068195.png,0,0.998451471,370,0,1148,717,778,717,twilight sparkle
1068335.png,https://derpicdn.net/img/view/2016/1/17/1068335.png,0,0.992926657,477,321,983,827,506,506,twilight sparkle
1069409.jpg,https://derpicdn.net/img/view/2016/1/19/1069409.jpg,0,0.9993819,111,0,501,366,390,366,twilight sparkle
1070374.png,https://derpicdn.net/img/view/2016/1/20/1070374.png,0,0.998369157,214,59,1232,1077,1018,1018,twilight sparkle
1076058.png,https://derpicdn.net/img/view/2016/1/29/1076058.png,0,0.982096255,1202,0,2648,1381,1446,1381,twilight sparkle
1078793.png,https://derpicdn.net/img/view/2016/2/2/1078793.png,0,0.998639464,234,0,1302,1067,1068,1067,twilight sparkle
1082657.jpg,https://derpicdn.net/img/view/2016/2/7/1082657.jpg,0,0.993425369,828,5,1408,585,580,580,twilight sparkle
1085765.png,https://derpicdn.net/img/view/2016/2/11/1085765.png,0,0.995593011,873,163,2091,1381,1218,1218,twilight sparkle
1085868.jpg,https://derpicdn.net/img/view/2016/2/12/1085868.jpg,0,0.993471563,302,0,836,526,534,526,twilight sparkle
1086119.png,https://derpicdn.net/img/view/2016/2/12/1086119.png,0,0.998137891,503,1524,1259,2280,756,756,twilight sparkle
1086119.png,https://derpicdn.net/img/view/2016/2/12/1086119.png,1,0.997774899,1821,0,2603,782,782,782,twilight sparkle
1086119.png,https://derpicdn.net/img/view/2016/2/12/1086119.png,2,0.941030502,146,25,720,599,574,574,twilight sparkle
1086831.png,https://derpicdn.net/img/view/2016/2/13/1086831.png,0,0.996872544,1629,314,2239,924,610,610,twilight sparkle
1086831.png,https://derpicdn.net/img/view/2016/2/13/1086831.png,2,0.984634876,0,439,485,939,485,500,twilight sparkle
1086831.png,https://derpicdn.net/img/view/2016/2/13/1086831.png,3,0.942265689,942,0,1714,720,772,720,twilight sparkle
1088145.png,https://derpicdn.net/img/view/2016/2/14/1088145.png,0,0.99651134,301,90,859,648,558,558,twilight sparkle
1089845.jpg,https://derpicdn.net/img/view/2016/2/16/1089845.jpg,0,0.9941715,37,33,699,695,662,662,twilight sparkle
1090000.png,https://derpicdn.net/img/view/2016/2/16/1090000.png,0,0.93749398,525,130,911,516,386,386,twilight sparkle
1091202.jpg,https://derpicdn.net/img/view/2016/2/18/1091202.jpg,0,0.99771142,372,13,1058,699,686,686,twilight sparkle
1093007.png,https://derpicdn.net/img/view/2016/2/20/1093007.png,0,0.998379529,222,1,644,423,422,422,twilight sparkle
1093026.png,https://derpicdn.net/img/view/2016/2/20/1093026.png,0,0.998373806,222,1,644,423,422,422,twilight sparkle
1101114.png,https://derpicdn.net/img/view/2016/3/3/1101114.png,0,0.97683239,183,153,2400,2627,2217,2474,twilight sparkle
1102615.png,https://derpicdn.net/img/view/2016/3/5/1102615.png,0,0.92693615,0,0,1024,1157,1024,1157,twilight sparkle
1104702.png,https://derpicdn.net/img/view/2016/3/8/1104702.png,0,0.917618036,94,0,548,417,454,417,twilight sparkle
1105619.png,https://derpicdn.net/img/view/2016/3/9/1105619.png,0,0.989251554,11,24,575,588,564,564,twilight sparkle
1106339.jpg,https://derpicdn.net/img/view/2016/3/11/1106339.jpg,0,0.986039996,300,0,1524,1183,1224,1183,twilight sparkle
1107294.jpg,https://derpicdn.net/img/view/2016/3/12/1107294.jpg,0,0.997854948,74,16,526,468,452,452,twilight sparkle
1107294.jpg,https://derpicdn.net/img/view/2016/3/12/1107294.jpg,1,0.990918994,514,12,1024,524,510,512,twilight sparkle
1107747.png,https://derpicdn.net/img/view/2016/3/13/1107747.png,0,0.915646851,681,0,1169,398,488,398,twilight sparkle
1110939.png,https://derpicdn.net/img/view/2016/3/17/1110939.png,0,0.995675266,646,80,1492,926,846,846,twilight sparkle
1112115.png,https://derpicdn.net/img/view/2016/3/19/1112115.png,0,0.984908402,255,0,673,417,418,417,twilight sparkle
1116869.png,https://derpicdn.net/img/view/2016/3/26/1116869.png,0,0.994366169,186,0,616,412,430,412,twilight sparkle
1117591.png,https://derpicdn.net/img/view/2016/3/26/1117591.png,0,0.98920542,403,59,887,543,484,484,twilight sparkle
1118620.png,https://derpicdn.net/img/view/2016/3/28/1118620.png,0,0.993150592,145,0,2777,2406,2632,2406,twilight sparkle
1118901.png,https://derpicdn.net/img/view/2016/3/28/1118901.png,0,0.997868001,82,0,656,539,574,539,twilight sparkle
1119734.png,https://derpicdn.net/img/view/2016/3/29/1119734.png,0,0.978086233,2,23,1100,1133,1098,1110,twilight sparkle
1120643.png,https://derpicdn.net/img/view/2016/3/30/1120643.png,0,0.999287605,114,1,326,213,212,212,twilight sparkle
1123771.png,https://derpicdn.net/img/view/2016/4/3/1123771.png,0,0.995176077,248,0,650,372,402,372,twilight sparkle
1125303.png,https://derpicdn.net/img/view/2016/4/5/1125303.png,0,0.96273911,10,0,584,559,574,559,twilight sparkle
1126262.jpg,https://derpicdn.net/img/view/2016/4/6/1126262.jpg,0,0.991335809,619,0,3625,2528,3006,2528,twilight sparkle
1127321.png,https://derpicdn.net/img/view/2016/4/8/1127321.png,0,0.998247325,459,13,1737,1291,1278,1278,twilight sparkle
1127321.png,https://derpicdn.net/img/view/2016/4/8/1127321.png,1,0.995561302,1918,161,2898,1141,980,980,twilight sparkle
1128781.png,https://derpicdn.net/img/view/2016/4/10/1128781.png,0,0.975946188,337,50,800,560,463,510,twilight sparkle
1132639.png,https://derpicdn.net/img/view/2016/4/15/1132639.png,0,0.990010142,0,73,614,825,614,752,twilight sparkle
1135424.png,https://derpicdn.net/img/view/2016/4/19/1135424.png,0,0.973358333,91,1,641,551,550,550,twilight sparkle
1136455.png,https://derpicdn.net/img/view/2016/4/20/1136455.png,0,0.976494014,47,0,919,794,872,794,twilight sparkle
1136781.jpg,https://derpicdn.net/img/view/2016/4/20/1136781.jpg,0,0.999040186,992,322,1828,1158,836,836,twilight sparkle
1137624.png,https://derpicdn.net/img/view/2016/4/22/1137624.png,0,0.997897506,270,104,772,606,502,502,twilight sparkle
1139926.png,https://derpicdn.net/img/view/2016/4/25/1139926.png,0,0.998872161,86,0,510,421,424,421,twilight sparkle
1140906.png,https://derpicdn.net/img/view/2016/4/27/1140906.png,0,0.992354631,96,3,640,547,544,544,twilight sparkle
1141953.png,https://derpicdn.net/img/view/2016/4/28/1141953.png,0,0.980037868,138,33,726,653,588,620,twilight sparkle
1146516.png,https://derpicdn.net/img/view/2016/5/4/1146516.png,0,0.995174706,552,0,1676,1016,1124,1016,twilight sparkle
1147592.jpg,https://derpicdn.net/img/view/2016/5/6/1147592.jpg,0,0.952286065,47,0,343,268,296,268,twilight sparkle
1147593.jpg,https://derpicdn.net/img/view/2016/5/6/1147593.jpg,0,0.980625093,40,0,474,408,434,408,twilight sparkle
1151120.png,https://derpicdn.net/img/view/2016/5/10/1151120.png,0,0.917319894,390,0,1764,1282,1374,1282,twilight sparkle
1156277.png,https://derpicdn.net/img/view/2016/5/17/1156277.png,0,0.996121228,822,0,4946,3937,4124,3937,twilight sparkle
1156826.png,https://derpicdn.net/img/view/2016/5/18/1156826.png,0,0.964711785,372,13,720,361,348,348,twilight sparkle
1159279.png,https://derpicdn.net/img/view/2016/5/21/1159279.png,0,0.940852404,143,52,1041,950,898,898,twilight sparkle
1159833.png,https://derpicdn.net/img/view/2016/5/21/1159833.png,0,0.958781362,394,3,1302,911,908,908,twilight sparkle
1159869.png,https://derpicdn.net/img/view/2016/5/21/1159869.png,0,0.940275252,0,26,3901,4318,3901,4292,twilight sparkle
1160603.png,https://derpicdn.net/img/view/2016/5/22/1160603.png,0,0.949154139,227,0,831,543,604,543,twilight sparkle
1161687.png,https://derpicdn.net/img/view/2016/5/24/1161687.png,0,0.987926245,207,25,1600,1531,1393,1506,twilight sparkle
1162951.jpg,https://derpicdn.net/img/view/2016/5/25/1162951.jpg,0,0.996912956,784,0,1710,821,926,821,twilight sparkle
1163540.png,https://derpicdn.net/img/view/2016/5/26/1163540.png,0,0.995447218,48,0,748,669,700,669,twilight sparkle
1168432.jpg,https://derpicdn.net/img/view/2016/6/2/1168432.jpg,0,0.916400373,223,0,929,676,706,676,twilight sparkle
1168442.png,https://derpicdn.net/img/view/2016/6/2/1168442.png,0,0.980106592,531,497,1727,1693,1196,1196,twilight sparkle
1169709.png,https://derpicdn.net/img/view/2016/6/4/1169709.png,0,0.991146624,176,117,772,713,596,596,twilight sparkle
1171248.png,https://derpicdn.net/img/view/2016/6/5/1171248.png,0,0.968115509,168,103,416,351,248,248,twilight sparkle
1172376.png,https://derpicdn.net/img/view/2016/6/7/1172376.png,0,0.968658149,67,0,819,719,752,719,twilight sparkle
1172377.png,https://derpicdn.net/img/view/2016/6/7/1172377.png,0,0.995562613,346,0,1254,868,908,868,twilight sparkle
1173415.png,https://derpicdn.net/img/view/2016/6/8/1173415.png,0,0.993326426,96,0,598,496,502,496,twilight sparkle
1175033.png,https://derpicdn.net/img/view/2016/6/10/1175033.png,0,0.967859864,152,64,500,412,348,348,twilight sparkle
1177649.png,https://derpicdn.net/img/view/2016/6/13/1177649.png,0,0.996903181,874,0,1780,902,906,902,twilight sparkle
1179393.png,https://derpicdn.net/img/view/2016/6/16/1179393.png,0,0.997627854,41,0,515,438,474,438,twilight sparkle
1180301.jpg,https://derpicdn.net/img/view/2016/6/17/1180301.jpg,0,0.98655504,649,314,985,650,336,336,twilight sparkle
1181773.png,https://derpicdn.net/img/view/2016/6/19/1181773.png,0,0.968242586,0,35,584,683,584,648,twilight sparkle
1183719.jpg,https://derpicdn.net/img/view/2016/6/21/1183719.jpg,0,0.999387741,493,44,1063,614,570,570,twilight sparkle
1184290.png,https://derpicdn.net/img/view/2016/6/22/1184290.png,0,0.982413709,161,100,415,354,254,254,twilight sparkle
1184890.png,https://derpicdn.net/img/view/2016/6/23/1184890.png,0,0.96467644,78,168,504,594,426,426,twilight sparkle
1186742.png,https://derpicdn.net/img/view/2016/6/25/1186742.png,0,0.995516956,379,0,1025,572,646,572,twilight sparkle
1186976.png,https://derpicdn.net/img/view/2016/6/26/1186976.png,0,0.981299222,375,54,887,566,512,512,twilight sparkle
1187018.png,https://derpicdn.net/img/view/2016/6/26/1187018.png,0,0.994146705,666,207,1188,729,522,522,twilight sparkle
1188047.jpg,https://derpicdn.net/img/view/2016/6/27/1188047.jpg,0,0.996488214,9,38,839,868,830,830,twilight sparkle
11899.jpg,https://derpicdn.net/img/view/2012/6/20/11899.jpg,0,0.994548738,274,0,652,359,378,359,twilight sparkle
1191445.png,https://derpicdn.net/img/view/2016/7/2/1191445.png,0,0.992858946,243,209,653,619,410,410,twilight sparkle
1191445.png,https://derpicdn.net/img/view/2016/7/2/1191445.png,1,0.984361887,610,53,1052,495,442,442,twilight sparkle
1191730.png,https://derpicdn.net/img/view/2016/7/2/1191730.png,0,0.981408954,297,0,743,445,446,445,twilight sparkle
1191781.png,https://derpicdn.net/img/view/2016/7/2/1191781.png,0,0.97739315,121,48,467,394,346,346,twilight sparkle
1192078.png,https://derpicdn.net/img/view/2016/7/2/1192078.png,0,0.988944769,317,49,837,569,520,520,twilight sparkle
1194719.png,https://derpicdn.net/img/view/2016/7/6/1194719.png,2,0.942324936,178,160,558,540,380,380,twilight sparkle
1195872.png,https://derpicdn.net/img/view/2016/7/8/1195872.png,0,0.990579784,207,134,915,842,708,708,twilight sparkle
1196491.png,https://derpicdn.net/img/view/2016/7/8/1196491.png,0,0.991823375,947,0,1303,310,356,310,twilight sparkle
1197954.png,https://derpicdn.net/img/view/2016/7/10/1197954.png,0,0.976565182,359,0,2599,2114,2240,2114,twilight sparkle
1199249.png,https://derpicdn.net/img/view/2016/7/12/1199249.png,0,0.998108268,297,0,1141,826,844,826,twilight sparkle
1199806.png,https://derpicdn.net/img/view/2016/7/13/1199806.png,0,0.99832648,49,23,383,357,334,334,twilight sparkle
1201219.png,https://derpicdn.net/img/view/2016/7/15/1201219.png,0,0.992390454,70,0,1160,1041,1090,1041,twilight sparkle
1206400.png,https://derpicdn.net/img/view/2016/7/22/1206400.png,0,0.902367353,959,131,2171,1343,1212,1212,twilight sparkle
1206484.png,https://derpicdn.net/img/view/2016/7/22/1206484.png,0,0.977884531,0,228,1024,1333,1024,1105,twilight sparkle
1207302.png,https://derpicdn.net/img/view/2016/7/23/1207302.png,0,0.985229492,5,3,391,389,386,386,twilight sparkle
1208205.png,https://derpicdn.net/img/view/2016/7/24/1208205.png,0,0.968519509,50,0,758,663,708,663,twilight sparkle
1209964.png,https://derpicdn.net/img/view/2016/7/26/1209964.png,0,0.999346972,586,0,2090,1480,1504,1480,twilight sparkle
1212783.png,https://derpicdn.net/img/view/2016/7/30/1212783.png,0,0.998753548,504,108,1324,928,820,820,twilight sparkle
1214471.png,https://derpicdn.net/img/view/2016/8/1/1214471.png,0,0.983138084,13,0,613,558,600,558,twilight sparkle
1217615.png,https://derpicdn.net/img/view/2016/8/5/1217615.png,0,0.951150358,0,150,1782,1964,1782,1814,twilight sparkle
1218138.png,https://derpicdn.net/img/view/2016/8/6/1218138.png,0,0.961263061,213,0,631,414,418,414,twilight sparkle
1218334.png,https://derpicdn.net/img/view/2016/8/6/1218334.png,0,0.96701926,215,0,629,414,414,414,twilight sparkle
1218725.png,https://derpicdn.net/img/view/2016/8/6/1218725.png,0,0.995132089,698,0,2098,1370,1400,1370,twilight sparkle
1219888.png,https://derpicdn.net/img/view/2016/8/8/1219888.png,0,0.993610084,650,0,1404,616,754,616,twilight sparkle
1219932.png,https://derpicdn.net/img/view/2016/8/8/1219932.png,0,0.996664286,656,159,1472,975,816,816,twilight sparkle
1220790.png,https://derpicdn.net/img/view/2016/8/9/1220790.png,0,0.981588721,67,0,1699,1249,1632,1249,twilight sparkle
1221306.png,https://derpicdn.net/img/view/2016/8/9/1221306.png,0,0.966123939,378,21,1460,1103,1082,1082,twilight sparkle
1223004.png,https://derpicdn.net/img/view/2016/8/12/1223004.png,0,0.905246973,185,0,775,549,590,549,twilight sparkle
1225954.png,https://derpicdn.net/img/view/2016/8/15/1225954.png,0,0.999215007,985,1174,1815,2004,830,830,twilight sparkle
1226155.png,https://derpicdn.net/img/view/2016/8/15/1226155.png,0,0.9964692,193,0,539,314,346,314,twilight sparkle
1226229.png,https://derpicdn.net/img/view/2016/8/16/1226229.png,0,0.970279634,520,113,1132,725,612,612,twilight sparkle
1226304.png,https://derpicdn.net/img/view/2016/8/16/1226304.png,0,0.986993492,41,0,619,544,578,544,twilight sparkle
1229631.png,https://derpicdn.net/img/view/2016/8/20/1229631.png,0,0.996691942,835,299,1357,821,522,522,twilight sparkle
1232179.png,https://derpicdn.net/img/view/2016/8/23/1232179.png,0,0.974782586,230,332,838,940,608,608,twilight sparkle
1232179.png,https://derpicdn.net/img/view/2016/8/23/1232179.png,1,0.964659572,1025,357,1577,909,552,552,twilight sparkle
1233023.png,https://derpicdn.net/img/view/2016/8/24/1233023.png,0,0.988636374,712,0,2464,1641,1752,1641,twilight sparkle
1233239.png,https://derpicdn.net/img/view/2016/8/25/1233239.png,0,0.991287768,230,0,1558,1274,1328,1274,twilight sparkle
1234396.png,https://derpicdn.net/img/view/2016/8/26/1234396.png,0,0.936932743,0,16,340,362,340,346,twilight sparkle
1235628.png,https://derpicdn.net/img/view/2016/8/28/1235628.png,0,0.996202171,6,27,370,391,364,364,twilight sparkle
1237203.png,https://derpicdn.net/img/view/2016/8/30/1237203.png,0,0.99260062,381,0,991,601,610,601,twilight sparkle
1237711.png,https://derpicdn.net/img/view/2016/8/30/1237711.png,0,0.994409204,1587,0,3967,2377,2380,2377,twilight sparkle
1238026.png,https://derpicdn.net/img/view/2016/8/30/1238026.png,0,0.998585105,293,42,1017,766,724,724,twilight sparkle
12402.jpg,https://derpicdn.net/img/view/2012/6/20/12402.jpg,0,0.961259186,123,0,753,503,630,503,twilight sparkle
1240622.png,https://derpicdn.net/img/view/2016/9/3/1240622.png,0,0.958554268,0,34,3116,4720,3116,4686,twilight sparkle
1241567.png,https://derpicdn.net/img/view/2016/9/4/1241567.png,0,0.997830689,36,1,326,291,290,290,twilight sparkle
1244448.png,https://derpicdn.net/img/view/2016/9/8/1244448.png,0,0.992894351,96,0,524,414,428,414,twilight sparkle
1244764.png,https://derpicdn.net/img/view/2016/9/8/1244764.png,0,0.999517798,488,90,990,592,502,502,twilight sparkle
1246403.png,https://derpicdn.net/img/view/2016/9/11/1246403.png,0,0.976778984,156,13,1646,1503,1490,1490,twilight sparkle
1249700.png,https://derpicdn.net/img/view/2016/9/15/1249700.png,0,0.933050573,423,6,2031,1614,1608,1608,twilight sparkle
1249709.png,https://derpicdn.net/img/view/2016/9/15/1249709.png,0,0.998261571,323,215,653,545,330,330,twilight sparkle
1250740.png,https://derpicdn.net/img/view/2016/9/16/1250740.png,0,0.929410636,0,5,180,193,180,188,twilight sparkle
1255830.png,https://derpicdn.net/img/view/2016/9/22/1255830.png,0,0.997916639,556,0,1570,982,1014,982,twilight sparkle
1259739.png,https://derpicdn.net/img/view/2016/9/27/1259739.png,0,0.989659309,1054,31,1816,793,762,762,twilight sparkle
1260027.png,https://derpicdn.net/img/view/2016/9/28/1260027.png,0,0.995075643,646,0,1280,587,634,587,twilight sparkle
1260388.png,https://derpicdn.net/img/view/2016/9/28/1260388.png,0,0.942481995,904,298,1898,1292,994,994,twilight sparkle
1263674.png,https://derpicdn.net/img/view/2016/10/2/1263674.png,0,0.94942534,747,0,1723,821,976,821,twilight sparkle
1265872.png,https://derpicdn.net/img/view/2016/10/6/1265872.png,0,0.98073709,176,0,974,750,798,750,twilight sparkle
1266569.png,https://derpicdn.net/img/view/2016/10/6/1266569.png,0,0.99839437,541,21,1185,665,644,644,twilight sparkle
1268035.png,https://derpicdn.net/img/view/2016/10/8/1268035.png,0,0.937023163,403,164,1521,1282,1118,1118,twilight sparkle
1269029.png,https://derpicdn.net/img/view/2016/10/9/1269029.png,0,0.990661323,221,73,1601,1453,1380,1380,twilight sparkle
1271874.png,https://derpicdn.net/img/view/2016/10/13/1271874.png,0,0.90909493,0,96,1517,1836,1517,1740,twilight sparkle
1272737.png,https://derpicdn.net/img/view/2016/10/14/1272737.png,0,0.993430197,505,235,1003,733,498,498,twilight sparkle
1276262.png,https://derpicdn.net/img/view/2016/10/18/1276262.png,0,0.908958018,505,0,2321,1723,1816,1723,twilight sparkle
127643.jpg,https://derpicdn.net/img/view/2012/10/20/127643.jpg,0,0.979602873,434,0,792,328,358,328,twilight sparkle
1276568.png,https://derpicdn.net/img/view/2016/10/19/1276568.png,0,0.98926878,408,0,1280,833,872,833,twilight sparkle
1280530.png,https://derpicdn.net/img/view/2016/10/24/1280530.png,0,0.997916222,357,63,1323,1029,966,966,twilight sparkle
1281853.png,https://derpicdn.net/img/view/2016/10/26/1281853.png,0,0.918653727,828,49,1402,623,574,574,twilight sparkle
1283988.png,https://derpicdn.net/img/view/2016/10/29/1283988.png,0,0.964590967,1218,0,4099,2972,2881,2972,twilight sparkle
1285292.png,https://derpicdn.net/img/view/2016/10/31/1285292.png,0,0.991637886,127,126,645,644,518,518,twilight sparkle
1289098.png,https://derpicdn.net/img/view/2016/11/5/1289098.png,0,0.985740304,225,0,1200,906,975,906,twilight sparkle
1289098.png,https://derpicdn.net/img/view/2016/11/5/1289098.png,1,0.922480345,0,0,878,919,878,919,twilight sparkle
1296504.png,https://derpicdn.net/img/view/2016/11/15/1296504.png,0,0.984632015,94,0,830,684,736,684,twilight sparkle
1297814.png,https://derpicdn.net/img/view/2016/11/17/1297814.png,0,0.999360621,763,85,1287,609,524,524,twilight sparkle
1297907.png,https://derpicdn.net/img/view/2016/11/17/1297907.png,0,0.98910737,118,0,1006,876,888,876,twilight sparkle
1298855.png,https://derpicdn.net/img/view/2016/11/19/1298855.png,0,0.998171687,302,0,3298,2861,2996,2861,twilight sparkle
1300579.png,https://derpicdn.net/img/view/2016/11/21/1300579.png,0,0.98447603,77,104,392,413,315,309,twilight sparkle
1302355.png,https://derpicdn.net/img/view/2016/11/24/1302355.png,0,0.994967461,1676,124,4492,2940,2816,2816,twilight sparkle
1304494.png,https://derpicdn.net/img/view/2016/11/27/1304494.png,0,0.978139102,61,0,477,387,416,387,twilight sparkle
1306949.png,https://derpicdn.net/img/view/2016/11/30/1306949.png,0,0.97079283,314,16,918,620,604,604,twilight sparkle
1311205.png,https://derpicdn.net/img/view/2016/12/6/1311205.png,0,0.996448576,295,6,747,458,452,452,twilight sparkle
1313645.png,https://derpicdn.net/img/view/2016/12/10/1313645.png,0,0.989464045,184,0,792,587,608,587,twilight sparkle
1318889.png,https://derpicdn.net/img/view/2016/12/16/1318889.png,0,0.990526199,1484,84,2492,1092,1008,1008,twilight sparkle
1321034.png,https://derpicdn.net/img/view/2016/12/19/1321034.png,0,0.996893704,162,0,582,364,420,364,twilight sparkle
1321316.png,https://derpicdn.net/img/view/2016/12/20/1321316.png,0,0.960281968,150,0,444,289,294,289,twilight sparkle
1323782.png,https://derpicdn.net/img/view/2016/12/24/1323782.png,0,0.996262491,139,0,421,276,282,276,twilight sparkle
1327300.png,https://derpicdn.net/img/view/2016/12/28/1327300.png,0,0.998574257,346,51,664,369,318,318,twilight sparkle
1329069.png,https://derpicdn.net/img/view/2016/12/31/1329069.png,0,0.998472393,3667,0,7631,3579,3964,3579,twilight sparkle
1329265.png,https://derpicdn.net/img/view/2016/12/31/1329265.png,0,0.924657702,340,137,1496,1266,1156,1129,twilight sparkle
1331603.png,https://derpicdn.net/img/view/2017/1/3/1331603.png,0,0.91234982,1423,395,2341,1313,918,918,twilight sparkle
1332732.png,https://derpicdn.net/img/view/2017/1/5/1332732.png,0,0.962274551,111,45,955,889,844,844,twilight sparkle
1333140.png,https://derpicdn.net/img/view/2017/1/6/1333140.png,0,0.99895817,13,0,887,862,874,862,twilight sparkle
1333418.png,https://derpicdn.net/img/view/2017/1/6/1333418.png,0,0.999038815,231,1004,1929,2702,1698,1698,twilight sparkle
1335821.png,https://derpicdn.net/img/view/2017/1/9/1335821.png,0,0.996500134,4020,375,8090,4567,4070,4192,twilight sparkle
1336620.png,https://derpicdn.net/img/view/2017/1/10/1336620.png,0,0.997008562,56,0,458,364,402,364,twilight sparkle
1336620.png,https://derpicdn.net/img/view/2017/1/10/1336620.png,1,0.953068018,625,0,961,336,336,336,twilight sparkle
1340739.png,https://derpicdn.net/img/view/2017/1/16/1340739.png,0,0.961676836,0,0,1868,2009,1868,2009,twilight sparkle
1340883.png,https://derpicdn.net/img/view/2017/1/16/1340883.png,0,0.997035384,317,0,981,600,664,600,twilight sparkle
1341112.png,https://derpicdn.net/img/view/2017/1/17/1341112.png,0,0.998274624,436,4,894,462,458,458,twilight sparkle
1342552.png,https://derpicdn.net/img/view/2017/1/19/1342552.png,0,0.996395707,464,45,684,265,220,220,twilight sparkle
1342552.png,https://derpicdn.net/img/view/2017/1/19/1342552.png,1,0.992619276,94,18,332,256,238,238,twilight sparkle
1349361.png,https://derpicdn.net/img/view/2017/1/27/1349361.png,0,0.993186474,273,174,2127,2028,1854,1854,twilight sparkle
1349770.png,https://derpicdn.net/img/view/2017/1/28/1349770.png,0,0.979952753,432,130,956,654,524,524,twilight sparkle
1351134.png,https://derpicdn.net/img/view/2017/1/30/1351134.png,0,0.924664497,0,243,1588,1887,1588,1644,twilight sparkle
1354331.png,https://derpicdn.net/img/view/2017/2/3/1354331.png,0,0.998968303,333,0,883,523,550,523,twilight sparkle
1355052.png,https://derpicdn.net/img/view/2017/2/4/1355052.png,0,0.991326571,0,0,371,364,371,364,twilight sparkle
1355703.png,https://derpicdn.net/img/view/2017/2/5/1355703.png,0,0.988823891,112,0,644,521,532,521,twilight sparkle
1357816.png,https://derpicdn.net/img/view/2017/2/8/1357816.png,0,0.961275518,1155,0,2339,1082,1184,1082,twilight sparkle
1358315.png,https://derpicdn.net/img/view/2017/2/8/1358315.png,0,0.994693577,511,113,1211,813,700,700,twilight sparkle
1358503.png,https://derpicdn.net/img/view/2017/2/9/1358503.png,0,0.99545908,93,0,485,391,392,391,twilight sparkle
1358516.png,https://derpicdn.net/img/view/2017/2/9/1358516.png,0,0.994058669,18,0,442,408,424,408,twilight sparkle
1360840.png,https://derpicdn.net/img/view/2017/2/12/1360840.png,0,0.983006954,104,0,758,645,654,645,twilight sparkle
1361875.png,https://derpicdn.net/img/view/2017/2/13/1361875.png,0,0.988338113,477,0,1299,786,822,786,twilight sparkle
1361950.png,https://derpicdn.net/img/view/2017/2/13/1361950.png,0,0.994597316,1675,479,2659,1463,984,984,twilight sparkle
1362664.png,https://derpicdn.net/img/view/2017/2/14/1362664.png,0,0.990900934,580,1103,984,1507,404,404,twilight sparkle
1363368.png,https://derpicdn.net/img/view/2017/2/15/1363368.png,0,0.986868858,173,85,493,405,320,320,twilight sparkle
1364186.png,https://derpicdn.net/img/view/2017/2/16/1364186.png,0,0.982346177,352,0,1226,762,874,762,twilight sparkle
1365780.png,https://derpicdn.net/img/view/2017/2/17/1365780.png,0,0.994713843,392,0,1378,957,986,957,twilight sparkle
1365837.png,https://derpicdn.net/img/view/2017/2/18/1365837.png,0,0.979837179,84,8,716,640,632,632,twilight sparkle
1366206.png,https://derpicdn.net/img/view/2017/2/18/1366206.png,0,0.977057397,264,1,1692,1467,1428,1466,twilight sparkle
1367718.png,https://derpicdn.net/img/view/2017/2/19/1367718.png,0,0.974427998,162,454,1818,2110,1656,1656,twilight sparkle
1368373.png,https://derpicdn.net/img/view/2017/2/20/1368373.png,0,0.965898991,61,0,903,840,842,840,twilight sparkle
1368497.png,https://derpicdn.net/img/view/2017/2/20/1368497.png,0,0.972821116,73,7,893,827,820,820,twilight sparkle
1370130.png,https://derpicdn.net/img/view/2017/2/22/1370130.png,0,0.998107553,1030,0,1574,532,544,532,twilight sparkle
1370130.png,https://derpicdn.net/img/view/2017/2/22/1370130.png,1,0.968395591,212,186,1050,1024,838,838,twilight sparkle
1375535.png,https://derpicdn.net/img/view/2017/2/28/1375535.png,0,0.997160554,122,0,760,609,638,609,twilight sparkle
1380327.png,https://derpicdn.net/img/view/2017/3/5/1380327.png,0,0.981417954,68,0,540,437,472,437,twilight sparkle
1380349.png,https://derpicdn.net/img/view/2017/3/5/1380349.png,0,0.979935825,597,597,1131,1131,534,534,twilight sparkle
1380487.png,https://derpicdn.net/img/view/2017/3/6/1380487.png,0,0.97781229,176,0,938,621,762,621,twilight sparkle
1381035.png,https://derpicdn.net/img/view/2017/3/6/1381035.png,0,0.998554468,0,149,792,969,792,820,twilight sparkle
1381035.png,https://derpicdn.net/img/view/2017/3/6/1381035.png,1,0.972266316,513,82,1335,932,822,850,twilight sparkle
1382923.png,https://derpicdn.net/img/view/2017/3/9/1382923.png,0,0.966310918,249,28,663,442,414,414,twilight sparkle
1382925.png,https://derpicdn.net/img/view/2017/3/9/1382925.png,0,0.971201122,254,32,658,436,404,404,twilight sparkle
1383191.png,https://derpicdn.net/img/view/2017/3/9/1383191.png,0,0.989083648,333,54,689,410,356,356,twilight sparkle
1385537.png,https://derpicdn.net/img/view/2017/3/12/1385537.png,0,0.998962164,513,245,1071,803,558,558,twilight sparkle
1385798.png,https://derpicdn.net/img/view/2017/3/13/1385798.png,0,0.998714328,266,62,684,480,418,418,twilight sparkle
1387395.png,https://derpicdn.net/img/view/2017/3/15/1387395.png,0,0.995764852,0,0,477,499,477,499,twilight sparkle
1389541.png,https://derpicdn.net/img/view/2017/3/17/1389541.png,0,0.997699916,2239,1414,2815,1990,576,576,twilight sparkle
1391135.png,https://derpicdn.net/img/view/2017/3/19/1391135.png,0,0.991571486,1568,0,2708,1005,1140,1005,twilight sparkle
1392541.png,https://derpicdn.net/img/view/2017/3/20/1392541.png,0,0.991452932,150,0,802,629,652,629,twilight sparkle
1394005.png,https://derpicdn.net/img/view/2017/3/22/1394005.png,0,0.995110512,583,0,1543,957,960,957,twilight sparkle
1394070.png,https://derpicdn.net/img/view/2017/3/22/1394070.png,0,0.92705667,293,0,681,347,388,347,twilight sparkle
1394183.png,https://derpicdn.net/img/view/2017/3/23/1394183.png,0,0.995805621,583,1,1539,957,956,956,twilight sparkle
1394184.png,https://derpicdn.net/img/view/2017/3/23/1394184.png,0,0.995760143,583,1,1539,957,956,956,twilight sparkle
1394394.png,https://derpicdn.net/img/view/2017/3/23/1394394.png,0,0.999388516,563,0,1865,1261,1302,1261,twilight sparkle
1394520.png,https://derpicdn.net/img/view/2017/3/23/1394520.png,0,0.914576948,0,21,766,835,766,814,twilight sparkle
1397402.png,https://derpicdn.net/img/view/2017/3/27/1397402.png,0,0.995752275,1522,0,4114,2522,2592,2522,twilight sparkle
1400279.png,https://derpicdn.net/img/view/2017/3/31/1400279.png,0,0.957915843,158,13,929,785,771,772,twilight sparkle
1403790.png,https://derpicdn.net/img/view/2017/4/4/1403790.png,0,0.961248279,176,63,880,767,704,704,twilight sparkle
1403794.png,https://derpicdn.net/img/view/2017/4/4/1403794.png,0,0.99922967,407,18,753,364,346,346,twilight sparkle
1405530.png,https://derpicdn.net/img/view/2017/4/6/1405530.png,0,0.954899669,242,0,504,256,262,256,twilight sparkle
1405646.png,https://derpicdn.net/img/view/2017/4/6/1405646.png,0,0.951571286,251,160,1677,1586,1426,1426,twilight sparkle
1406089.png,https://derpicdn.net/img/view/2017/4/7/1406089.png,0,0.998639405,111,76,1023,988,912,912,twilight sparkle
1407140.png,https://derpicdn.net/img/view/2017/4/8/1407140.png,0,0.984909117,1028,731,1264,1035,236,304,twilight sparkle
1407140.png,https://derpicdn.net/img/view/2017/4/8/1407140.png,1,0.958214939,114,67,354,307,240,240,twilight sparkle
1407482.png,https://derpicdn.net/img/view/2017/4/9/1407482.png,0,0.966091812,0,0,1890,2182,1890,2182,twilight sparkle
1408285.png,https://derpicdn.net/img/view/2017/4/10/1408285.png,0,0.900580466,103,0,2005,1881,1902,1881,twilight sparkle
1415505.png,https://derpicdn.net/img/view/2017/4/18/1415505.png,0,0.956088185,408,51,828,471,420,420,twilight sparkle
1415798.png,https://derpicdn.net/img/view/2017/4/19/1415798.png,0,0.912084103,29,2,157,136,128,134,twilight sparkle
1420232.png,https://derpicdn.net/img/view/2017/4/24/1420232.png,0,0.987488151,593,0,1573,969,980,969,twilight sparkle
1420337.png,https://derpicdn.net/img/view/2017/4/24/1420337.png,0,0.995333433,230,37,920,727,690,690,twilight sparkle
1422868.png,https://derpicdn.net/img/view/2017/4/27/1422868.png,0,0.978280902,522,0,1872,1153,1350,1153,twilight sparkle
1423457.png,https://derpicdn.net/img/view/2017/4/28/1423457.png,0,0.938088477,272,328,1842,1898,1570,1570,twilight sparkle
1425122.png,https://derpicdn.net/img/view/2017/4/30/1425122.png,0,0.996566355,376,557,752,933,376,376,twilight sparkle
1426976.png,https://derpicdn.net/img/view/2017/5/2/1426976.png,0,0.925421834,178,0,1136,930,958,930,twilight sparkle
1430866.png,https://derpicdn.net/img/view/2017/5/7/1430866.png,0,0.979891181,319,444,1091,1216,772,772,twilight sparkle
1432280.png,https://derpicdn.net/img/view/2017/5/9/1432280.png,0,0.932591319,601,0,1397,705,796,705,twilight sparkle
1432731.png,https://derpicdn.net/img/view/2017/5/9/1432731.png,0,0.980610013,4,0,775,785,771,785,twilight sparkle
1433757.png,https://derpicdn.net/img/view/2017/5/11/1433757.png,0,0.935552418,76,0,1134,1048,1058,1048,twilight sparkle
1434024.png,https://derpicdn.net/img/view/2017/5/11/1434024.png,0,0.978619933,0,0,1066,972,1066,972,twilight sparkle
1435576.png,https://derpicdn.net/img/view/2017/5/13/1435576.png,0,0.975605309,1239,143,3091,1995,1852,1852,twilight sparkle
1435954.png,https://derpicdn.net/img/view/2017/5/14/1435954.png,0,0.986449361,199,58,851,710,652,652,twilight sparkle
1437832.png,https://derpicdn.net/img/view/2017/5/16/1437832.png,0,0.998599172,57,0,1389,1292,1332,1292,twilight sparkle
1438070.png,https://derpicdn.net/img/view/2017/5/16/1438070.png,0,0.968613029,220,0,1214,919,994,919,twilight sparkle
1438145.png,https://derpicdn.net/img/view/2017/5/16/1438145.png,0,0.997380257,253,83,1461,1291,1208,1208,twilight sparkle
1441743.png,https://derpicdn.net/img/view/2017/5/21/1441743.png,0,0.937035739,775,0,1619,824,844,824,twilight sparkle
1442147.png,https://derpicdn.net/img/view/2017/5/21/1442147.png,0,0.994949758,217,5,867,655,650,650,twilight sparkle
1445478.png,https://derpicdn.net/img/view/2017/5/25/1445478.png,0,0.948112726,0,27,459,495,459,468,twilight sparkle
1445644.png,https://derpicdn.net/img/view/2017/5/25/1445644.png,0,0.996645451,710,63,3096,2449,2386,2386,twilight sparkle
1446367.png,https://derpicdn.net/img/view/2017/5/26/1446367.png,0,0.998651624,487,30,1261,804,774,774,twilight sparkle
1450943.png,https://derpicdn.net/img/view/2017/5/31/1450943.png,0,0.999863148,0,63,705,809,705,746,twilight sparkle
1450943.png,https://derpicdn.net/img/view/2017/5/31/1450943.png,1,0.968627512,728,110,1424,806,696,696,twilight sparkle
1452226.png,https://derpicdn.net/img/view/2017/6/2/1452226.png,0,0.99759239,29,17,505,493,476,476,twilight sparkle
1452911.png,https://derpicdn.net/img/view/2017/6/3/1452911.png,0,0.993464947,391,0,1419,985,1028,985,twilight sparkle
1456645.png,https://derpicdn.net/img/view/2017/6/8/1456645.png,0,0.9948982,430,11,1388,969,958,958,twilight sparkle
1457359.png,https://derpicdn.net/img/view/2017/6/9/1457359.png,0,0.985200942,302,102,632,432,330,330,twilight sparkle
1458343.png,https://derpicdn.net/img/view/2017/6/10/1458343.png,0,0.953556001,348,46,658,356,310,310,twilight sparkle
1458491.png,https://derpicdn.net/img/view/2017/6/10/1458491.png,0,0.995738029,826,585,1432,1191,606,606,twilight sparkle
1460793.png,https://derpicdn.net/img/view/2017/6/13/1460793.png,0,0.950080812,679,0,2789,2004,2110,2004,twilight sparkle
1465921.png,https://derpicdn.net/img/view/2017/6/19/1465921.png,0,0.996334732,186,41,694,549,508,508,twilight sparkle
1468576.png,https://derpicdn.net/img/view/2017/6/22/1468576.png,0,0.985652685,1673,70,5475,3872,3802,3802,twilight sparkle
1470794.png,https://derpicdn.net/img/view/2017/6/24/1470794.png,0,0.996924162,279,72,793,586,514,514,twilight sparkle
1475507.png,https://derpicdn.net/img/view/2017/6/30/1475507.png,0,0.977890313,1093,0,2959,1863,1866,1863,twilight sparkle
1477827.png,https://derpicdn.net/img/view/2017/7/3/1477827.png,0,0.985419393,37,107,359,429,322,322,twilight sparkle
1478364.png,https://derpicdn.net/img/view/2017/7/4/1478364.png,0,0.967556059,146,8,336,198,190,190,twilight sparkle
1481903.png,https://derpicdn.net/img/view/2017/7/8/1481903.png,0,0.986981571,861,151,1911,1201,1050,1050,twilight sparkle
1481909.png,https://derpicdn.net/img/view/2017/7/8/1481909.png,0,0.971339583,523,117,1177,771,654,654,twilight sparkle
1483920.png,https://derpicdn.net/img/view/2017/7/11/1483920.png,0,0.956813157,205,0,1401,1143,1196,1143,twilight sparkle
1485699.png,https://derpicdn.net/img/view/2017/7/14/1485699.png,0,0.994638383,0,83,1148,1285,1148,1202,twilight sparkle
1485699.png,https://derpicdn.net/img/view/2017/7/14/1485699.png,1,0.972414374,2807,138,3840,1276,1033,1138,twilight sparkle
1485718.png,https://derpicdn.net/img/view/2017/7/14/1485718.png,0,0.955642819,410,0,1020,543,610,543,twilight sparkle
1486863.png,https://derpicdn.net/img/view/2017/7/15/1486863.png,0,0.975841641,1026,83,1596,653,570,570,twilight sparkle
1487121.png,https://derpicdn.net/img/view/2017/7/15/1487121.png,0,0.987047732,341,0,2753,1957,2412,1957,twilight sparkle
1487248.png,https://derpicdn.net/img/view/2017/7/16/1487248.png,0,0.996596932,837,42,1375,606,538,564,twilight sparkle
1489116.png,https://derpicdn.net/img/view/2017/7/18/1489116.png,0,0.944571853,64,93,902,931,838,838,twilight sparkle
1491222.png,https://derpicdn.net/img/view/2017/7/21/1491222.png,0,0.973947108,1,0,585,468,584,468,twilight sparkle
1498046.png,https://derpicdn.net/img/view/2017/7/30/1498046.png,0,0.993704736,248,0,1570,1130,1322,1130,twilight sparkle
1499446.png,https://derpicdn.net/img/view/2017/7/31/1499446.png,0,0.99017942,278,336,920,978,642,642,twilight sparkle
1500428.png,https://derpicdn.net/img/view/2017/8/1/1500428.png,0,0.965306699,685,0,2213,1367,1528,1367,twilight sparkle
1500428.png,https://derpicdn.net/img/view/2017/8/1/1500428.png,1,0.909230351,2135,343,2995,1203,860,860,twilight sparkle
1503088.png,https://derpicdn.net/img/view/2017/8/5/1503088.png,0,0.90275234,249,0,855,601,606,601,twilight sparkle
1503950.png,https://derpicdn.net/img/view/2017/8/6/1503950.png,0,0.954462171,770,32,1702,964,932,932,twilight sparkle
1504928.png,https://derpicdn.net/img/view/2017/8/7/1504928.png,0,0.962588668,83,118,1089,1124,1006,1006,twilight sparkle
150656.png,https://derpicdn.net/img/view/2012/11/13/150656.png,0,0.905491531,989,1000,2087,2098,1098,1098,twilight sparkle
1507534.png,https://derpicdn.net/img/view/2017/8/10/1507534.png,0,0.986363053,0,0,2165,2295,2165,2295,twilight sparkle
1507692.png,https://derpicdn.net/img/view/2017/8/11/1507692.png,0,0.995862246,1102,10,4718,3626,3616,3616,twilight sparkle
1510207.png,https://derpicdn.net/img/view/2017/8/14/1510207.png,0,0.947744012,61,12,855,806,794,794,twilight sparkle
1510697.png,https://derpicdn.net/img/view/2017/8/14/1510697.png,0,0.978680313,366,138,710,482,344,344,twilight sparkle
1512.jpg,https://derpicdn.net/img/view/2012/1/22/1512.jpg,0,0.990796208,106,18,420,332,314,314,twilight sparkle
1515650.png,https://derpicdn.net/img/view/2017/8/20/1515650.png,0,0.99101907,192,128,1326,1262,1134,1134,twilight sparkle
1516868.png,https://derpicdn.net/img/view/2017/8/22/1516868.png,0,0.950939834,498,1048,1162,1712,664,664,twilight sparkle
1517372.png,https://derpicdn.net/img/view/2017/8/22/1517372.png,0,0.900251985,836,140,1760,1064,924,924,twilight sparkle
1518526.png,https://derpicdn.net/img/view/2017/8/24/1518526.png,0,0.999146581,925,0,2787,1814,1862,1814,twilight sparkle
1519179.png,https://derpicdn.net/img/view/2017/8/25/1519179.png,0,0.995851278,449,13,1809,1373,1360,1360,twilight sparkle
1519230.png,https://derpicdn.net/img/view/2017/8/25/1519230.png,0,0.988777697,1038,138,2444,1544,1406,1406,twilight sparkle
1519751.png,https://derpicdn.net/img/view/2017/8/26/1519751.png,0,0.99094373,471,0,2995,2300,2524,2300,twilight sparkle
1522016.png,https://derpicdn.net/img/view/2017/8/28/1522016.png,0,0.954466701,109,26,807,724,698,698,twilight sparkle
1523155.png,https://derpicdn.net/img/view/2017/8/30/1523155.png,0,0.990731359,1347,4,2949,1606,1602,1602,twilight sparkle
1523600.png,https://derpicdn.net/img/view/2017/8/30/1523600.png,0,0.979197741,148,61,866,779,718,718,twilight sparkle
1524491.png,https://derpicdn.net/img/view/2017/8/31/1524491.png,0,0.995284081,205,0,697,460,492,460,twilight sparkle
1524795.png,https://derpicdn.net/img/view/2017/9/1/1524795.png,0,0.998915434,64,40,500,476,436,436,twilight sparkle
1525734.png,https://derpicdn.net/img/view/2017/9/2/1525734.png,0,0.959036708,0,0,361,415,361,415,twilight sparkle
1527401.png,https://derpicdn.net/img/view/2017/9/4/1527401.png,0,0.963464558,1074,0,2826,1747,1752,1747,twilight sparkle
1527937.png,https://derpicdn.net/img/view/2017/9/4/1527937.png,0,0.996895134,719,89,2293,1663,1574,1574,twilight sparkle
1528814.png,https://derpicdn.net/img/view/2017/9/5/1528814.png,0,0.996869147,719,88,2295,1664,1576,1576,twilight sparkle
1529057.png,https://derpicdn.net/img/view/2017/9/6/1529057.png,0,0.993929923,817,395,2623,2201,1806,1806,twilight sparkle
1531523.png,https://derpicdn.net/img/view/2017/9/9/1531523.png,0,0.970475376,276,280,1330,1334,1054,1054,twilight sparkle
1531593.png,https://derpicdn.net/img/view/2017/9/9/1531593.png,0,0.97397697,263,272,1373,1382,1110,1110,twilight sparkle
1531820.png,https://derpicdn.net/img/view/2017/9/10/1531820.png,0,0.92947042,892,307,1742,1157,850,850,twilight sparkle
1532220.png,https://derpicdn.net/img/view/2017/9/10/1532220.png,0,0.929392397,142,716,2442,3016,2300,2300,twilight sparkle
1534435.png,https://derpicdn.net/img/view/2017/9/13/1534435.png,0,0.981349945,12,0,2604,2489,2592,2489,twilight sparkle
1534625.png,https://derpicdn.net/img/view/2017/9/13/1534625.png,0,0.972483516,329,103,733,507,404,404,twilight sparkle
1536258.png,https://derpicdn.net/img/view/2017/9/15/1536258.png,0,0.9861871,606,0,1782,1142,1176,1142,twilight sparkle
1537588.png,https://derpicdn.net/img/view/2017/9/17/1537588.png,0,0.98462534,771,3,1400,689,629,686,twilight sparkle
1539623.png,https://derpicdn.net/img/view/2017/9/19/1539623.png,0,0.985878348,40,0,2346,2005,2306,2005,twilight sparkle
1540832.png,https://derpicdn.net/img/view/2017/9/21/1540832.png,0,0.990242183,102,0,880,639,778,639,twilight sparkle
1542560.png,https://derpicdn.net/img/view/2017/9/23/1542560.png,0,0.9753474,104,152,1424,1472,1320,1320,twilight sparkle
1542806.png,https://derpicdn.net/img/view/2017/9/23/1542806.png,0,0.942278206,137,0,909,743,772,743,twilight sparkle
1542946.png,https://derpicdn.net/img/view/2017/9/23/1542946.png,0,0.927148461,313,12,1829,1558,1516,1546,twilight sparkle
1543270.png,https://derpicdn.net/img/view/2017/9/24/1543270.png,0,0.988054216,8,0,252,226,244,226,twilight sparkle
1544783.png,https://derpicdn.net/img/view/2017/9/25/1544783.png,0,0.994954526,85,0,1145,1013,1060,1013,twilight sparkle
1545394.png,https://derpicdn.net/img/view/2017/9/26/1545394.png,0,0.940894127,338,43,1829,1535,1491,1492,twilight sparkle
1545828.png,https://derpicdn.net/img/view/2017/9/27/1545828.png,0,0.918282509,193,0,685,451,492,451,twilight sparkle
1548948.png,https://derpicdn.net/img/view/2017/10/1/1548948.png,0,0.906755388,80,0,610,506,530,506,twilight sparkle
1550077.png,https://derpicdn.net/img/view/2017/10/2/1550077.png,0,0.995667219,164,0,602,426,438,426,twilight sparkle
1553668.png,https://derpicdn.net/img/view/2017/10/6/1553668.png,0,0.962033093,237,0,897,644,660,644,twilight sparkle
1553803.png,https://derpicdn.net/img/view/2017/10/6/1553803.png,0,0.95775038,0,6,3741,3770,3741,3764,twilight sparkle
1554682.png,https://derpicdn.net/img/view/2017/10/7/1554682.png,0,0.996383905,391,0,1161,765,770,765,twilight sparkle
1554733.png,https://derpicdn.net/img/view/2017/10/7/1554733.png,0,0.99879092,426,23,770,367,344,344,twilight sparkle
1554856.png,https://derpicdn.net/img/view/2017/10/8/1554856.png,0,0.991927326,1255,205,2701,1651,1446,1446,twilight sparkle
1557701.png,https://derpicdn.net/img/view/2017/10/10/1557701.png,0,0.999205947,89,51,591,553,502,502,twilight sparkle
1558656.png,https://derpicdn.net/img/view/2017/10/11/1558656.png,0,0.987097323,54,0,1800,1080,1746,1080,twilight sparkle
1559400.png,https://derpicdn.net/img/view/2017/10/12/1559400.png,0,0.998324335,776,1511,1170,1905,394,394,twilight sparkle
1561483.png,https://derpicdn.net/img/view/2017/10/15/1561483.png,0,0.988222301,155,0,1024,1087,869,1087,twilight sparkle
1563892.png,https://derpicdn.net/img/view/2017/10/17/1563892.png,0,0.998657346,330,1546,1122,2338,792,792,twilight sparkle
1563892.png,https://derpicdn.net/img/view/2017/10/17/1563892.png,1,0.98969084,2165,112,3427,1374,1262,1262,twilight sparkle
1563899.png,https://derpicdn.net/img/view/2017/10/17/1563899.png,0,0.993981659,1394,0,5821,4369,4427,4369,twilight sparkle
1564568.png,https://derpicdn.net/img/view/2017/10/18/1564568.png,0,0.972899735,1061,681,1681,1301,620,620,twilight sparkle
1566306.png,https://derpicdn.net/img/view/2017/10/21/1566306.png,0,0.990496635,0,0,809,766,809,766,twilight sparkle
1567509.png,https://derpicdn.net/img/view/2017/10/22/1567509.png,0,0.959469497,124,0,1092,844,968,844,twilight sparkle
1567670.png,https://derpicdn.net/img/view/2017/10/22/1567670.png,0,0.998026967,95,0,1263,1153,1168,1153,twilight sparkle
1568525.png,https://derpicdn.net/img/view/2017/10/23/1568525.png,0,0.948697567,0,7,304,323,304,316,twilight sparkle
1569880.png,https://derpicdn.net/img/view/2017/10/25/1569880.png,0,0.981660187,60,0,754,665,694,665,twilight sparkle
1573567.png,https://derpicdn.net/img/view/2017/10/30/1573567.png,0,0.994002163,441,0,1317,844,876,844,twilight sparkle
1576102.png,https://derpicdn.net/img/view/2017/11/2/1576102.png,0,0.999827027,4,9,326,331,322,322,twilight sparkle
1576272.png,https://derpicdn.net/img/view/2017/11/2/1576272.png,0,0.991030276,794,0,2344,1483,1550,1483,twilight sparkle
1578303.png,https://derpicdn.net/img/view/2017/11/5/1578303.png,0,0.960271239,0,0,799,798,799,798,twilight sparkle
1578505.png,https://derpicdn.net/img/view/2017/11/5/1578505.png,0,0.932146311,501,0,2287,1719,1786,1719,twilight sparkle
1579721.png,https://derpicdn.net/img/view/2017/11/6/1579721.png,0,0.990585744,252,0,854,584,602,584,twilight sparkle
1582175.png,https://derpicdn.net/img/view/2017/11/9/1582175.png,0,0.959288478,653,177,1311,835,658,658,twilight sparkle
1582175.png,https://derpicdn.net/img/view/2017/11/9/1582175.png,1,0.958963811,31,91,665,725,634,634,twilight sparkle
1582175.png,https://derpicdn.net/img/view/2017/11/9/1582175.png,2,0.939402878,1096,0,1918,786,822,786,twilight sparkle
1583386.png,https://derpicdn.net/img/view/2017/11/11/1583386.png,0,0.996840417,632,0,2244,1587,1612,1587,twilight sparkle
15844.jpg,https://derpicdn.net/img/view/2012/6/22/15844.jpg,0,0.966305554,863,93,1491,721,628,628,twilight sparkle
1585112.png,https://derpicdn.net/img/view/2017/11/13/1585112.png,0,0.997294843,490,21,926,457,436,436,twilight sparkle
15879.jpg,https://derpicdn.net/img/view/2012/6/22/15879.jpg,0,0.96254921,162,28,604,470,442,442,twilight sparkle
1588080.png,https://derpicdn.net/img/view/2017/11/17/1588080.png,0,0.979603887,578,188,1246,856,668,668,twilight sparkle
1588639.png,https://derpicdn.net/img/view/2017/11/17/1588639.png,0,0.999517202,2061,0,2885,736,824,736,twilight sparkle
1588639.png,https://derpicdn.net/img/view/2017/11/17/1588639.png,1,0.99669075,329,359,1121,1151,792,792,twilight sparkle
1594968.png,https://derpicdn.net/img/view/2017/11/26/1594968.png,0,0.991523325,88,36,624,572,536,536,twilight sparkle
1595055.png,https://derpicdn.net/img/view/2017/11/26/1595055.png,0,0.973731875,128,181,988,1041,860,860,twilight sparkle
1595268.png,https://derpicdn.net/img/view/2017/11/27/1595268.png,0,0.941691279,649,56,1185,592,536,536,twilight sparkle
1597373.png,https://derpicdn.net/img/view/2017/11/30/1597373.png,0,0.965442836,132,6,606,480,474,474,twilight sparkle
1597853.png,https://derpicdn.net/img/view/2017/12/1/1597853.png,0,0.998270094,73,43,1821,1791,1748,1748,twilight sparkle
1598021.png,https://derpicdn.net/img/view/2017/12/1/1598021.png,0,0.981025994,309,0,741,406,432,406,twilight sparkle
1599246.png,https://derpicdn.net/img/view/2017/12/3/1599246.png,0,0.972361863,0,0,531,529,531,529,twilight sparkle
1603736.png,https://derpicdn.net/img/view/2017/12/9/1603736.png,0,0.902992129,807,97,2163,1453,1356,1356,twilight sparkle
1605704.png,https://derpicdn.net/img/view/2017/12/12/1605704.png,0,0.992471039,43,0,729,656,686,656,twilight sparkle
1606113.png,https://derpicdn.net/img/view/2017/12/12/1606113.png,0,0.902150273,274,0,1132,942,858,942,twilight sparkle
1610007.png,https://derpicdn.net/img/view/2017/12/17/1610007.png,0,0.928806007,342,228,1112,998,770,770,twilight sparkle
1610711.png,https://derpicdn.net/img/view/2017/12/18/1610711.png,0,0.98779285,1,353,401,753,400,400,twilight sparkle
16113.png,https://derpicdn.net/img/view/2012/6/23/16113.png,0,0.964870572,719,731,1485,1497,766,766,twilight sparkle
1611698.png,https://derpicdn.net/img/view/2017/12/20/1611698.png,0,0.980044007,0,0,506,545,506,545,twilight sparkle
1612231.png,https://derpicdn.net/img/view/2017/12/20/1612231.png,0,0.995061457,929,122,2441,1634,1512,1512,twilight sparkle
1612293.png,https://derpicdn.net/img/view/2017/12/20/1612293.png,0,0.980411351,315,219,1413,1317,1098,1098,twilight sparkle
1613201.png,https://derpicdn.net/img/view/2017/12/22/1613201.png,0,0.981697559,0,0,751,752,751,752,twilight sparkle
1613735.png,https://derpicdn.net/img/view/2017/12/23/1613735.png,0,0.95838666,1148,346,1772,970,624,624,twilight sparkle
1613853.png,https://derpicdn.net/img/view/2017/12/23/1613853.png,0,0.989840448,865,0,3783,2789,2918,2789,twilight sparkle
1614046.png,https://derpicdn.net/img/view/2017/12/23/1614046.png,0,0.998132586,16,0,856,808,840,808,twilight sparkle
1614990.png,https://derpicdn.net/img/view/2017/12/24/1614990.png,0,0.928548276,767,367,1619,1219,852,852,twilight sparkle
1614990.png,https://derpicdn.net/img/view/2017/12/24/1614990.png,1,0.90610671,1315,448,2091,1224,776,776,twilight sparkle
1615612.png,https://derpicdn.net/img/view/2017/12/25/1615612.png,0,0.995600462,286,0,1954,1617,1668,1617,twilight sparkle
1619975.png,https://derpicdn.net/img/view/2017/12/30/1619975.png,0,0.975451648,12,0,1142,1089,1130,1089,twilight sparkle
1620358.png,https://derpicdn.net/img/view/2017/12/31/1620358.png,0,0.999627233,249,0,891,621,642,621,twilight sparkle
1620840.png,https://derpicdn.net/img/view/2017/12/31/1620840.png,0,0.902554333,242,96,602,456,360,360,twilight sparkle
1621867.png,https://derpicdn.net/img/view/2018/1/1/1621867.png,0,0.997207582,757,0,2427,1642,1670,1642,twilight sparkle
1622954.png,https://derpicdn.net/img/view/2018/1/3/1622954.png,0,0.922958434,320,0,1162,821,842,821,twilight sparkle
1624358.png,https://derpicdn.net/img/view/2018/1/5/1624358.png,0,0.997278571,737,0,1519,759,782,759,twilight sparkle
1624718.png,https://derpicdn.net/img/view/2018/1/5/1624718.png,0,0.976154208,520,572,950,1002,430,430,twilight sparkle
1626438.png,https://derpicdn.net/img/view/2018/1/7/1626438.png,0,0.985531449,161,9,387,235,226,226,twilight sparkle
1630957.png,https://derpicdn.net/img/view/2018/1/13/1630957.png,0,0.995805621,309,11,649,351,340,340,twilight sparkle
1631460.png,https://derpicdn.net/img/view/2018/1/13/1631460.png,0,0.999229789,182,0,690,485,508,485,twilight sparkle
1631843.png,https://derpicdn.net/img/view/2018/1/14/1631843.png,0,0.988704324,625,102,1843,1320,1218,1218,twilight sparkle
1632310.png,https://derpicdn.net/img/view/2018/1/14/1632310.png,0,0.9807989,352,128,1328,1104,976,976,twilight sparkle
1633395.png,https://derpicdn.net/img/view/2018/1/16/1633395.png,0,0.996110201,980,0,1972,953,992,953,twilight sparkle
1633631.png,https://derpicdn.net/img/view/2018/1/16/1633631.png,0,0.990686774,428,22,906,500,478,478,twilight sparkle
1636642.png,https://derpicdn.net/img/view/2018/1/20/1636642.png,0,0.992059231,1588,0,3153,1663,1565,1663,twilight sparkle
1639541.png,https://derpicdn.net/img/view/2018/1/24/1639541.png,0,0.932835281,282,137,582,437,300,300,twilight sparkle
1640714.png,https://derpicdn.net/img/view/2018/1/25/1640714.png,0,0.994719982,789,110,1739,1060,950,950,twilight sparkle
1641652.png,https://derpicdn.net/img/view/2018/1/26/1641652.png,0,0.939216435,573,84,1171,682,598,598,twilight sparkle
1642823.png,https://derpicdn.net/img/view/2018/1/28/1642823.png,0,0.997644365,0,71,633,761,633,690,twilight sparkle
1642825.png,https://derpicdn.net/img/view/2018/1/28/1642825.png,0,0.996725619,0,71,635,763,635,692,twilight sparkle
1645894.png,https://derpicdn.net/img/view/2018/2/1/1645894.png,0,0.993834674,123,34,479,390,356,356,twilight sparkle
1647091.png,https://derpicdn.net/img/view/2018/2/3/1647091.png,0,0.966848671,476,116,1372,1012,896,896,twilight sparkle
1647214.png,https://derpicdn.net/img/view/2018/2/3/1647214.png,0,0.980656266,39,0,350,316,311,316,twilight sparkle
1648615.png,https://derpicdn.net/img/view/2018/2/4/1648615.png,0,0.99688518,157,450,381,674,224,224,twilight sparkle
1648616.png,https://derpicdn.net/img/view/2018/2/4/1648616.png,0,0.995996237,162,456,378,672,216,216,twilight sparkle
1648687.png,https://derpicdn.net/img/view/2018/2/5/1648687.png,0,0.988315523,1341,0,3321,1952,1980,1952,twilight sparkle
1650858.png,https://derpicdn.net/img/view/2018/2/8/1650858.png,0,0.985328138,693,39,1951,1297,1258,1258,twilight sparkle
1650866.png,https://derpicdn.net/img/view/2018/2/8/1650866.png,0,0.985328138,693,39,1951,1297,1258,1258,twilight sparkle
1651197.png,https://derpicdn.net/img/view/2018/2/8/1651197.png,0,0.953387856,354,81,568,295,214,214,twilight sparkle
1652811.png,https://derpicdn.net/img/view/2018/2/10/1652811.png,0,0.998032033,398,0,2224,1753,1826,1753,twilight sparkle
1653660.png,https://derpicdn.net/img/view/2018/2/11/1653660.png,0,0.97829628,684,12,1770,1098,1086,1086,twilight sparkle
1653660.png,https://derpicdn.net/img/view/2018/2/11/1653660.png,1,0.95895493,379,1150,1281,2052,902,902,twilight sparkle
1653660.png,https://derpicdn.net/img/view/2018/2/11/1653660.png,2,0.936932027,0,42,866,914,866,872,twilight sparkle
1655803.png,https://derpicdn.net/img/view/2018/2/14/1655803.png,0,0.995850086,89,135,423,469,334,334,twilight sparkle
1656985.png,https://derpicdn.net/img/view/2018/2/15/1656985.png,0,0.954754293,425,389,1381,1345,956,956,twilight sparkle
1659310.png,https://derpicdn.net/img/view/2018/2/18/1659310.png,0,0.97081548,0,0,2812,2685,2812,2685,twilight sparkle
1660294.png,https://derpicdn.net/img/view/2018/2/19/1660294.png,0,0.994119525,477,398,2209,2130,1732,1732,twilight sparkle
1660689.png,https://derpicdn.net/img/view/2018/2/19/1660689.png,0,0.983091056,553,0,1079,464,526,464,twilight sparkle
1662703.png,https://derpicdn.net/img/view/2018/2/22/1662703.png,0,0.94539839,435,0,1103,589,668,589,twilight sparkle
16638.png,https://derpicdn.net/img/view/2012/6/23/16638.png,0,0.995052695,263,99,1627,1463,1364,1364,twilight sparkle
1666391.png,https://derpicdn.net/img/view/2018/2/26/1666391.png,0,0.920335174,82,4,274,196,192,192,twilight sparkle
1667569.png,https://derpicdn.net/img/view/2018/2/27/1667569.png,0,0.995376587,264,61,542,339,278,278,twilight sparkle
1668919.png,https://derpicdn.net/img/view/2018/3/1/1668919.png,0,0.94945097,89,0,701,585,612,585,twilight sparkle
1671775.png,https://derpicdn.net/img/view/2018/3/4/1671775.png,0,0.995990276,612,326,1922,1636,1310,1310,twilight sparkle
1672040.png,https://derpicdn.net/img/view/2018/3/5/1672040.png,0,0.989481091,395,177,709,491,314,314,twilight sparkle
1673736.png,https://derpicdn.net/img/view/2018/3/7/1673736.png,0,0.981553733,4,0,492,442,488,442,twilight sparkle
1677560.png,https://derpicdn.net/img/view/2018/3/11/1677560.png,0,0.984086871,19,0,357,336,338,336,twilight sparkle
1679060.png,https://derpicdn.net/img/view/2018/3/13/1679060.png,0,0.913229823,146,4,424,282,278,278,twilight sparkle
1685685.png,https://derpicdn.net/img/view/2018/3/20/1685685.png,0,0.984466434,194,0,434,230,240,230,twilight sparkle
1686749.png,https://derpicdn.net/img/view/2018/3/21/1686749.png,0,0.99198395,30,0,564,521,534,521,twilight sparkle
1686981.png,https://derpicdn.net/img/view/2018/3/21/1686981.png,0,0.965621054,415,0,837,398,422,398,twilight sparkle
1687594.png,https://derpicdn.net/img/view/2018/3/22/1687594.png,0,0.975946128,381,0,1439,1049,1058,1049,twilight sparkle
1688501.png,https://derpicdn.net/img/view/2018/3/23/1688501.png,0,0.948551774,0,16,963,1000,963,984,twilight sparkle
1688625.png,https://derpicdn.net/img/view/2018/3/24/1688625.png,0,0.918335259,19,0,551,486,532,486,twilight sparkle
1689751.png,https://derpicdn.net/img/view/2018/3/25/1689751.png,0,0.982637167,0,57,731,885,731,828,twilight sparkle
1689957.png,https://derpicdn.net/img/view/2018/3/25/1689957.png,0,0.98844713,124,122,1702,1700,1578,1578,twilight sparkle
1690402.png,https://derpicdn.net/img/view/2018/3/25/1690402.png,0,0.972589254,55,27,950,965,895,938,twilight sparkle
1691421.png,https://derpicdn.net/img/view/2018/3/26/1691421.png,0,0.997688234,743,86,1379,722,636,636,twilight sparkle
1691562.png,https://derpicdn.net/img/view/2018/3/26/1691562.png,0,0.999171138,1009,0,2417,1252,1408,1252,twilight sparkle
1693038.png,https://derpicdn.net/img/view/2018/3/28/1693038.png,0,0.975035727,0,0,527,471,527,471,twilight sparkle
1694087.png,https://derpicdn.net/img/view/2018/3/29/1694087.png,0,0.994149387,373,2,1169,798,796,796,twilight sparkle
1694380.png,https://derpicdn.net/img/view/2018/3/30/1694380.png,0,0.990268409,0,0,774,812,774,812,twilight sparkle
1697382.png,https://derpicdn.net/img/view/2018/4/2/1697382.png,0,0.999478817,224,90,586,452,362,362,twilight sparkle
1702303.png,https://derpicdn.net/img/view/2018/4/8/1702303.png,0,0.999239504,829,75,2031,1277,1202,1202,twilight sparkle
1704685.png,https://derpicdn.net/img/view/2018/4/11/1704685.png,0,0.964919508,889,132,2339,1582,1450,1450,twilight sparkle
1705334.png,https://derpicdn.net/img/view/2018/4/11/1705334.png,0,0.967027724,137,190,1044,1286,907,1096,twilight sparkle
1706056.png,https://derpicdn.net/img/view/2018/4/12/1706056.png,0,0.936703146,54,0,598,517,544,517,twilight sparkle
1706733.png,https://derpicdn.net/img/view/2018/4/13/1706733.png,0,0.966259062,121,0,1079,826,958,826,twilight sparkle
170723.jpg,https://derpicdn.net/img/view/2012/12/2/170723.jpg,0,0.968610287,758,80,1106,428,348,348,twilight sparkle
1707666.png,https://derpicdn.net/img/view/2018/4/14/1707666.png,0,0.985675395,856,41,1762,947,906,906,twilight sparkle
1709288.png,https://derpicdn.net/img/view/2018/4/16/1709288.png,0,0.98552388,14,0,360,340,346,340,twilight sparkle
1709777.png,https://derpicdn.net/img/view/2018/4/16/1709777.png,0,0.985726178,396,304,2054,1962,1658,1658,twilight sparkle
1710633.png,https://derpicdn.net/img/view/2018/4/18/1710633.png,0,0.993476391,345,190,943,788,598,598,twilight sparkle
1710918.png,https://derpicdn.net/img/view/2018/4/18/1710918.png,0,0.99105829,711,124,1413,826,702,702,twilight sparkle
1718831.png,https://derpicdn.net/img/view/2018/4/28/1718831.png,0,0.919649303,126,17,858,749,732,732,twilight sparkle
1719634.png,https://derpicdn.net/img/view/2018/4/29/1719634.png,0,0.998278439,1065,1187,2047,2169,982,982,twilight sparkle
1719732.png,https://derpicdn.net/img/view/2018/4/29/1719732.png,0,0.993700564,0,536,872,1434,872,898,twilight sparkle
1722307.png,https://derpicdn.net/img/view/2018/5/2/1722307.png,0,0.999045014,1004,186,2220,1402,1216,1216,twilight sparkle
1723312.png,https://derpicdn.net/img/view/2018/5/3/1723312.png,0,0.957269251,507,0,1841,1240,1334,1240,twilight sparkle
1723429.png,https://derpicdn.net/img/view/2018/5/3/1723429.png,0,0.977716744,92,0,600,529,508,529,twilight sparkle
1725014.png,https://derpicdn.net/img/view/2018/5/5/1725014.png,0,0.984779,110,0,2128,1883,2018,1883,twilight sparkle
1725033.png,https://derpicdn.net/img/view/2018/5/5/1725033.png,0,0.961367369,553,172,1197,816,644,644,twilight sparkle
1725044.png,https://derpicdn.net/img/view/2018/5/5/1725044.png,0,0.969528198,1636,1496,2124,1984,488,488,twilight sparkle
1725046.png,https://derpicdn.net/img/view/2018/5/5/1725046.png,0,0.991728544,745,0,2457,1636,1712,1636,twilight sparkle
1725052.png,https://derpicdn.net/img/view/2018/5/5/1725052.png,0,0.998680532,854,0,2000,1114,1146,1114,twilight sparkle
1726311.png,https://derpicdn.net/img/view/2018/5/6/1726311.png,0,0.984475672,968,436,2368,1836,1400,1400,twilight sparkle
1727015.png,https://derpicdn.net/img/view/2018/5/7/1727015.png,0,0.983837008,354,8,818,472,464,464,twilight sparkle
1727867.png,https://derpicdn.net/img/view/2018/5/8/1727867.png,0,0.992310643,715,318,1667,1270,952,952,twilight sparkle
1728768.png,https://derpicdn.net/img/view/2018/5/10/1728768.png,0,0.943864703,1352,687,2202,1537,850,850,twilight sparkle
1730769.png,https://derpicdn.net/img/view/2018/5/12/1730769.png,0,0.986085594,201,242,729,770,528,528,twilight sparkle
1731023.png,https://derpicdn.net/img/view/2018/5/12/1731023.png,0,0.997702837,51,0,507,388,456,388,twilight sparkle
1735946.png,https://derpicdn.net/img/view/2018/5/18/1735946.png,0,0.994676709,320,106,600,386,280,280,twilight sparkle
1735946.png,https://derpicdn.net/img/view/2018/5/18/1735946.png,1,0.952739298,70,52,386,368,316,316,twilight sparkle
1736187.png,https://derpicdn.net/img/view/2018/5/19/1736187.png,0,0.959902108,228,24,690,486,462,462,twilight sparkle
1736188.png,https://derpicdn.net/img/view/2018/5/19/1736188.png,0,0.913649976,214,0,690,474,476,474,twilight sparkle
1737754.png,https://derpicdn.net/img/view/2018/5/20/1737754.png,0,0.946792841,0,34,835,998,835,964,twilight sparkle
1739138.png,https://derpicdn.net/img/view/2018/5/22/1739138.png,0,0.996219993,220,38,500,318,280,280,twilight sparkle
1739154.png,https://derpicdn.net/img/view/2018/5/22/1739154.png,0,0.998206854,498,0,1022,487,524,487,twilight sparkle
1739969.png,https://derpicdn.net/img/view/2018/5/24/1739969.png,0,0.975769341,154,0,1172,982,1018,982,twilight sparkle
1741803.png,https://derpicdn.net/img/view/2018/5/26/1741803.png,0,0.987803161,246,0,1438,1029,1192,1029,twilight sparkle
1742104.png,https://derpicdn.net/img/view/2018/5/26/1742104.png,0,0.99874723,1143,176,1985,1018,842,842,twilight sparkle
1742238.png,https://derpicdn.net/img/view/2018/5/26/1742238.png,0,0.983864069,44,0,2250,2192,2206,2192,twilight sparkle
1743177.png,https://derpicdn.net/img/view/2018/5/27/1743177.png,0,0.999601722,135,0,887,696,752,696,twilight sparkle
1746114.png,https://derpicdn.net/img/view/2018/5/31/1746114.png,0,0.997147441,43,0,1035,973,992,973,twilight sparkle
1747046.png,https://derpicdn.net/img/view/2018/6/1/1747046.png,0,0.979863882,83,0,1691,1591,1608,1591,twilight sparkle
1748930.png,https://derpicdn.net/img/view/2018/6/3/1748930.png,0,0.942932904,85,3,751,669,666,666,twilight sparkle
1749854.png,https://derpicdn.net/img/view/2018/6/4/1749854.png,0,0.954572082,215,0,1095,865,880,865,twilight sparkle
1751038.png,https://derpicdn.net/img/view/2018/6/6/1751038.png,0,0.971922874,67,0,393,289,326,289,twilight sparkle
1751376.png,https://derpicdn.net/img/view/2018/6/6/1751376.png,0,0.99672693,354,120,1690,1456,1336,1336,twilight sparkle
1752482.png,https://derpicdn.net/img/view/2018/6/8/1752482.png,0,0.992274046,55,0,627,495,572,495,twilight sparkle
1752716.png,https://derpicdn.net/img/view/2018/6/8/1752716.png,1,0.945737541,1126,1028,1594,1496,468,468,twilight sparkle
1757320.png,https://derpicdn.net/img/view/2018/6/14/1757320.png,0,0.980066121,362,214,758,610,396,396,twilight sparkle
1758153.png,https://derpicdn.net/img/view/2018/6/15/1758153.png,0,0.996607602,908,141,1676,909,768,768,twilight sparkle
1758901.png,https://derpicdn.net/img/view/2018/6/16/1758901.png,0,0.992277861,0,0,1149,1104,1149,1104,twilight sparkle
1760804.png,https://derpicdn.net/img/view/2018/6/18/1760804.png,0,0.969038248,265,0,689,421,424,421,twilight sparkle
1760807.png,https://derpicdn.net/img/view/2018/6/18/1760807.png,0,0.988962591,266,0,688,420,422,420,twilight sparkle
1760882.png,https://derpicdn.net/img/view/2018/6/18/1760882.png,0,0.986505032,231,0,925,691,694,691,twilight sparkle
1760912.png,https://derpicdn.net/img/view/2018/6/18/1760912.png,0,0.99642539,524,0,3948,3090,3424,3090,twilight sparkle
1761219.png,https://derpicdn.net/img/view/2018/6/19/1761219.png,0,0.993503332,120,0,794,593,674,593,twilight sparkle
1762174.png,https://derpicdn.net/img/view/2018/6/20/1762174.png,0,0.986698568,86,2,560,476,474,474,twilight sparkle
1762626.png,https://derpicdn.net/img/view/2018/6/21/1762626.png,0,0.992583096,143,0,579,404,436,404,twilight sparkle
1762874.png,https://derpicdn.net/img/view/2018/6/21/1762874.png,0,0.994834781,380,28,760,408,380,380,twilight sparkle
1763234.png,https://derpicdn.net/img/view/2018/6/22/1763234.png,0,0.998108625,311,8,539,236,228,228,twilight sparkle
1765038.png,https://derpicdn.net/img/view/2018/6/24/1765038.png,0,0.980143368,273,0,833,456,560,456,twilight sparkle
1765103.png,https://derpicdn.net/img/view/2018/6/24/1765103.png,0,0.984331071,727,184,2455,1912,1728,1728,twilight sparkle
1766589.png,https://derpicdn.net/img/view/2018/6/26/1766589.png,0,0.935536563,48,103,998,1053,950,950,twilight sparkle
1768009.png,https://derpicdn.net/img/view/2018/6/28/1768009.png,0,0.969424188,106,6,422,322,316,316,twilight sparkle
1770174.png,https://derpicdn.net/img/view/2018/7/1/1770174.png,0,0.996697545,568,41,1494,967,926,926,twilight sparkle
1777677.png,https://derpicdn.net/img/view/2018/7/10/1777677.png,0,0.968639374,893,0,1825,931,932,931,twilight sparkle
1777894.png,https://derpicdn.net/img/view/2018/7/10/1777894.png,0,0.999153256,580,31,1980,1431,1400,1400,twilight sparkle
1780591.png,https://derpicdn.net/img/view/2018/7/14/1780591.png,0,0.998389423,339,353,721,735,382,382,twilight sparkle
1781661.png,https://derpicdn.net/img/view/2018/7/15/1781661.png,0,0.983672082,0,0,644,710,644,710,twilight sparkle
1781939.png,https://derpicdn.net/img/view/2018/7/16/1781939.png,0,0.941396713,0,51,724,809,724,758,twilight sparkle
1782510.png,https://derpicdn.net/img/view/2018/7/16/1782510.png,0,0.937857807,665,91,1747,1173,1082,1082,twilight sparkle
1782878.png,https://derpicdn.net/img/view/2018/7/17/1782878.png,0,0.96250087,790,162,1220,592,430,430,twilight sparkle
1783138.png,https://derpicdn.net/img/view/2018/7/17/1783138.png,0,0.973796844,139,9,609,479,470,470,twilight sparkle
1783411.png,https://derpicdn.net/img/view/2018/7/17/1783411.png,0,0.993312955,24,15,690,681,666,666,twilight sparkle
1788603.png,https://derpicdn.net/img/view/2018/7/24/1788603.png,0,0.997901976,1050,0,1716,558,666,558,twilight sparkle
1795189.png,https://derpicdn.net/img/view/2018/8/1/1795189.png,0,0.967391968,0,0,2186,2118,2186,2118,twilight sparkle
1796.png,https://derpicdn.net/img/view/2012/1/23/1796.png,0,0.999172568,79,0,477,369,398,369,twilight sparkle
1797029.png,https://derpicdn.net/img/view/2018/8/3/1797029.png,0,0.923650324,0,239,748,1057,748,818,twilight sparkle
1797115.png,https://derpicdn.net/img/view/2018/8/3/1797115.png,0,0.998276234,446,0,1948,1476,1502,1476,twilight sparkle
1800332.png,https://derpicdn.net/img/view/2018/8/7/1800332.png,0,0.984878838,1713,0,3600,1815,1887,1815,twilight sparkle
1800952.png,https://derpicdn.net/img/view/2018/8/7/1800952.png,0,0.996851087,196,19,626,449,430,430,twilight sparkle
1801705.png,https://derpicdn.net/img/view/2018/8/8/1801705.png,0,0.938457966,296,210,1134,1048,838,838,twilight sparkle
1802344.png,https://derpicdn.net/img/view/2018/8/9/1802344.png,0,0.98171401,460,44,694,278,234,234,twilight sparkle
1802675.png,https://derpicdn.net/img/view/2018/8/9/1802675.png,0,0.969989538,1323,88,2205,970,882,882,twilight sparkle
1803370.png,https://derpicdn.net/img/view/2018/8/10/1803370.png,0,0.969311059,718,51,1476,809,758,758,twilight sparkle
1804584.png,https://derpicdn.net/img/view/2018/8/12/1804584.png,0,0.989161611,1209,293,3431,2515,2222,2222,twilight sparkle
1805867.png,https://derpicdn.net/img/view/2018/8/13/1805867.png,0,0.927499115,619,366,2317,2064,1698,1698,twilight sparkle
1806072.png,https://derpicdn.net/img/view/2018/8/13/1806072.png,0,0.964924097,71,140,1523,1592,1452,1452,twilight sparkle
1807241.png,https://derpicdn.net/img/view/2018/8/15/1807241.png,0,0.966329694,78,94,832,848,754,754,twilight sparkle
1809399.png,https://derpicdn.net/img/view/2018/8/17/1809399.png,0,0.979827881,87,0,1833,1668,1746,1668,twilight sparkle
1816177.png,https://derpicdn.net/img/view/2018/8/25/1816177.png,0,0.99817878,1,0,569,542,568,542,twilight sparkle
1818016.png,https://derpicdn.net/img/view/2018/8/27/1818016.png,0,0.994961083,1121,0,2961,1792,1840,1792,twilight sparkle
1819320.png,https://derpicdn.net/img/view/2018/8/29/1819320.png,0,0.99491477,116,0,906,771,790,771,twilight sparkle
1820669.png,https://derpicdn.net/img/view/2018/8/30/1820669.png,0,0.970074534,21,0,1596,1600,1575,1600,twilight sparkle
1821674.png,https://derpicdn.net/img/view/2018/9/1/1821674.png,0,0.998838723,0,0,389,387,389,387,twilight sparkle
1823039.png,https://derpicdn.net/img/view/2018/9/2/1823039.png,0,0.958347976,181,138,571,528,390,390,twilight sparkle
1830581.png,https://derpicdn.net/img/view/2018/9/11/1830581.png,0,0.99301362,81,9,579,507,498,498,twilight sparkle
1830620.png,https://derpicdn.net/img/view/2018/9/12/1830620.png,0,0.99312371,96,17,428,349,332,332,twilight sparkle
1830923.png,https://derpicdn.net/img/view/2018/9/12/1830923.png,0,0.99053967,42,0,594,512,552,512,twilight sparkle
1831422.png,https://derpicdn.net/img/view/2018/9/13/1831422.png,0,0.969485402,389,39,1409,1059,1020,1020,twilight sparkle
1832349.png,https://derpicdn.net/img/view/2018/9/14/1832349.png,0,0.952949464,204,151,528,475,324,324,twilight sparkle
1832458.png,https://derpicdn.net/img/view/2018/9/14/1832458.png,0,0.952949464,204,151,528,475,324,324,twilight sparkle
1833534.png,https://derpicdn.net/img/view/2018/9/15/1833534.png,0,0.973065555,95,0,1065,931,970,931,twilight sparkle
1835889.png,https://derpicdn.net/img/view/2018/9/18/1835889.png,0,0.991615355,273,647,823,1197,550,550,twilight sparkle
1835890.png,https://derpicdn.net/img/view/2018/9/18/1835890.png,0,0.991375208,279,654,819,1194,540,540,twilight sparkle
1836879.png,https://derpicdn.net/img/view/2018/9/20/1836879.png,0,0.931157649,48,24,486,462,438,438,twilight sparkle
1837903.png,https://derpicdn.net/img/view/2018/9/21/1837903.png,0,0.998415112,879,250,2797,2168,1918,1918,twilight sparkle
1838625.png,https://derpicdn.net/img/view/2018/9/22/1838625.png,0,0.993968308,98,85,518,505,420,420,twilight sparkle
1838639.png,https://derpicdn.net/img/view/2018/9/22/1838639.png,0,0.995566487,98,85,518,505,420,420,twilight sparkle
1839849.png,https://derpicdn.net/img/view/2018/9/23/1839849.png,0,0.982593298,551,89,1549,1087,998,998,twilight sparkle
1840835.png,https://derpicdn.net/img/view/2018/9/25/1840835.png,0,0.994082034,98,85,518,505,420,420,twilight sparkle
1840839.png,https://derpicdn.net/img/view/2018/9/25/1840839.png,0,0.994082034,98,85,518,505,420,420,twilight sparkle
1841275.png,https://derpicdn.net/img/view/2018/9/25/1841275.png,0,0.977125287,252,92,480,320,228,228,twilight sparkle
1842190.png,https://derpicdn.net/img/view/2018/9/27/1842190.png,0,0.964992046,249,312,781,844,532,532,twilight sparkle
1846581.png,https://derpicdn.net/img/view/2018/10/2/1846581.png,0,0.987930596,0,0,480,480,480,480,twilight sparkle
1847179.png,https://derpicdn.net/img/view/2018/10/3/1847179.png,0,0.987430274,52,2,484,434,432,432,twilight sparkle
1848228.png,https://derpicdn.net/img/view/2018/10/4/1848228.png,0,0.986032665,422,473,898,949,476,476,twilight sparkle
1852746.png,https://derpicdn.net/img/view/2018/10/10/1852746.png,1,0.990980983,357,174,793,610,436,436,twilight sparkle
1853348.png,https://derpicdn.net/img/view/2018/10/10/1853348.png,0,0.992222548,661,0,1345,619,684,619,twilight sparkle
1854104.png,https://derpicdn.net/img/view/2018/10/11/1854104.png,0,0.994246125,489,0,1215,685,726,685,twilight sparkle
1855513.png,https://derpicdn.net/img/view/2018/10/13/1855513.png,0,0.986097276,0,0,1260,1232,1260,1232,twilight sparkle
1855638.png,https://derpicdn.net/img/view/2018/10/13/1855638.png,0,0.987656295,385,51,745,411,360,360,twilight sparkle
1857627.png,https://derpicdn.net/img/view/2018/10/15/1857627.png,0,0.940810323,753,0,1953,1093,1200,1093,twilight sparkle
1858240.png,https://derpicdn.net/img/view/2018/10/16/1858240.png,0,0.988384962,309,0,1183,835,874,835,twilight sparkle
1858575.png,https://derpicdn.net/img/view/2018/10/17/1858575.png,0,0.999002814,1773,0,3035,1164,1262,1164,twilight sparkle
1858892.png,https://derpicdn.net/img/view/2018/10/17/1858892.png,0,0.995376587,151,0,459,297,308,297,twilight sparkle
1858892.png,https://derpicdn.net/img/view/2018/10/17/1858892.png,1,0.993104339,860,0,1158,292,298,292,twilight sparkle
1858897.png,https://derpicdn.net/img/view/2018/10/17/1858897.png,0,0.99966085,279,0,691,409,412,409,twilight sparkle
1858897.png,https://derpicdn.net/img/view/2018/10/17/1858897.png,1,0.999649882,1203,0,1615,412,412,412,twilight sparkle
1862667.png,https://derpicdn.net/img/view/2018/10/21/1862667.png,0,0.925299644,199,24,1718,1782,1519,1758,twilight sparkle
1862915.png,https://derpicdn.net/img/view/2018/10/22/1862915.png,0,0.965625942,493,111,1005,637,512,526,twilight sparkle
1863739.png,https://derpicdn.net/img/view/2018/10/23/1863739.png,0,0.990163982,642,0,2450,1731,1808,1731,twilight sparkle
1863817.png,https://derpicdn.net/img/view/2018/10/23/1863817.png,0,0.947435856,124,19,642,537,518,518,twilight sparkle
1864948.png,https://derpicdn.net/img/view/2018/10/24/1864948.png,0,0.987412632,174,36,548,410,374,374,twilight sparkle
1865786.png,https://derpicdn.net/img/view/2018/10/25/1865786.png,0,0.965194046,108,0,468,314,360,314,twilight sparkle
1865950.png,https://derpicdn.net/img/view/2018/10/25/1865950.png,0,0.996764958,0,0,2386,2015,2386,2015,twilight sparkle
1865950.png,https://derpicdn.net/img/view/2018/10/25/1865950.png,1,0.99282819,1449,321,4093,2894,2644,2573,twilight sparkle
1870005.png,https://derpicdn.net/img/view/2018/10/30/1870005.png,0,0.991353571,20,0,1824,1080,1804,1080,twilight sparkle
1871295.png,https://derpicdn.net/img/view/2018/10/31/1871295.png,0,0.993446767,455,71,959,575,504,504,twilight sparkle
1873666.png,https://derpicdn.net/img/view/2018/11/3/1873666.png,0,0.992090762,7,0,1077,869,1070,869,twilight sparkle
1874829.png,https://derpicdn.net/img/view/2018/11/4/1874829.png,0,0.965062857,203,36,663,496,460,460,twilight sparkle
187484.png,https://derpicdn.net/img/view/2012/12/19/187484.png,0,0.991186142,0,0,665,614,665,614,twilight sparkle
1875153.png,https://derpicdn.net/img/view/2018/11/4/1875153.png,0,0.999148726,598,0,994,388,396,388,twilight sparkle
1876036.png,https://derpicdn.net/img/view/2018/11/6/1876036.png,0,0.96375829,160,300,2088,2228,1928,1928,twilight sparkle
1876037.png,https://derpicdn.net/img/view/2018/11/6/1876037.png,0,0.963807464,160,300,2088,2228,1928,1928,twilight sparkle
1876038.png,https://derpicdn.net/img/view/2018/11/6/1876038.png,0,0.973035216,174,315,2072,2213,1898,1898,twilight sparkle
1877247.png,https://derpicdn.net/img/view/2018/11/7/1877247.png,0,0.997752249,1868,0,3850,2086,1982,2086,twilight sparkle
1880177.png,https://derpicdn.net/img/view/2018/11/11/1880177.png,0,0.987297654,12,116,760,864,748,748,twilight sparkle
188728.png,https://derpicdn.net/img/view/2012/12/20/188728.png,0,0.992976725,277,0,485,201,208,201,twilight sparkle
1889569.png,https://derpicdn.net/img/view/2018/11/24/1889569.png,0,0.994803667,223,181,1441,1399,1218,1218,twilight sparkle
1890092.png,https://derpicdn.net/img/view/2018/11/24/1890092.png,0,0.961297333,0,7,1004,1079,1004,1072,twilight sparkle
1893668.png,https://derpicdn.net/img/view/2018/11/29/1893668.png,1,0.952365756,1237,0,1909,608,672,608,twilight sparkle
1895206.png,https://derpicdn.net/img/view/2018/12/1/1895206.png,0,0.980912626,339,59,1433,1153,1094,1094,twilight sparkle
1895678.png,https://derpicdn.net/img/view/2018/12/1/1895678.png,0,0.953091383,153,45,617,509,464,464,twilight sparkle
1895888.png,https://derpicdn.net/img/view/2018/12/2/1895888.png,0,0.985471845,886,45,1832,991,946,946,twilight sparkle
1897795.png,https://derpicdn.net/img/view/2018/12/4/1897795.png,0,0.997651875,175,36,639,500,464,464,twilight sparkle
1903696.png,https://derpicdn.net/img/view/2018/12/9/1903696.png,0,0.992518425,420,0,1320,861,900,861,twilight sparkle
1904560.png,https://derpicdn.net/img/view/2018/12/10/1904560.png,0,0.996734679,700,90,1036,426,336,336,twilight sparkle
1904560.png,https://derpicdn.net/img/view/2018/12/10/1904560.png,1,0.991452277,903,362,1235,694,332,332,twilight sparkle
1904560.png,https://derpicdn.net/img/view/2018/12/10/1904560.png,2,0.98228699,361,100,769,508,408,408,twilight sparkle
1904694.png,https://derpicdn.net/img/view/2018/12/10/1904694.png,0,0.993777156,851,429,1281,859,430,430,twilight sparkle
1908438.png,https://derpicdn.net/img/view/2018/12/14/1908438.png,0,0.923889279,569,337,1957,1725,1388,1388,twilight sparkle
1908994.png,https://derpicdn.net/img/view/2018/12/15/1908994.png,0,0.999711573,16,0,858,807,842,807,twilight sparkle
1911782.png,https://derpicdn.net/img/view/2018/12/18/1911782.png,0,0.987136781,123,30,1139,1046,1016,1016,twilight sparkle
1912829.png,https://derpicdn.net/img/view/2018/12/19/1912829.png,0,0.998829365,200,39,428,267,228,228,twilight sparkle
1912842.png,https://derpicdn.net/img/view/2018/12/19/1912842.png,0,0.991307557,32,0,1728,1783,1696,1783,twilight sparkle
1913108.png,https://derpicdn.net/img/view/2018/12/19/1913108.png,0,0.923636496,0,0,1045,1076,1045,1076,twilight sparkle
1913385.png,https://derpicdn.net/img/view/2018/12/20/1913385.png,0,0.991213322,2764,212,3612,1060,848,848,twilight sparkle
1914815.png,https://derpicdn.net/img/view/2018/12/21/1914815.png,0,0.994638205,326,0,1422,1035,1096,1035,twilight sparkle
1917305.png,https://derpicdn.net/img/view/2018/12/24/1917305.png,0,0.999136746,0,1445,310,1859,310,414,twilight sparkle
1917412.png,https://derpicdn.net/img/view/2018/12/24/1917412.png,0,0.993066907,1002,927,1600,1525,598,598,twilight sparkle
1917412.png,https://derpicdn.net/img/view/2018/12/24/1917412.png,2,0.936234593,1433,242,1913,722,480,480,twilight sparkle
1917791.png,https://derpicdn.net/img/view/2018/12/24/1917791.png,0,0.944330871,1410,163,3830,2583,2420,2420,twilight sparkle
1919254.png,https://derpicdn.net/img/view/2018/12/26/1919254.png,0,0.999046862,121,0,459,318,338,318,twilight sparkle
1923076.png,https://derpicdn.net/img/view/2018/12/31/1923076.png,0,0.994040668,1013,0,2671,1326,1658,1326,twilight sparkle
1925307.png,https://derpicdn.net/img/view/2019/1/3/1925307.png,0,0.97969228,0,0,642,540,642,540,twilight sparkle
1925353.png,https://derpicdn.net/img/view/2019/1/3/1925353.png,0,0.998670936,73,0,593,470,520,470,twilight sparkle
1925353.png,https://derpicdn.net/img/view/2019/1/3/1925353.png,1,0.997156441,706,0,1236,494,530,494,twilight sparkle
1927313.png,https://derpicdn.net/img/view/2019/1/5/1927313.png,0,0.997938037,730,0,1874,1030,1144,1030,twilight sparkle
1931410.png,https://derpicdn.net/img/view/2019/1/10/1931410.png,0,0.992775381,50,0,2500,2340,2450,2340,twilight sparkle
1931596.png,https://derpicdn.net/img/view/2019/1/10/1931596.png,0,0.965631247,679,0,1609,787,930,787,twilight sparkle
1932563.png,https://derpicdn.net/img/view/2019/1/11/1932563.png,0,0.998217225,123,0,911,758,788,758,twilight sparkle
1932793.png,https://derpicdn.net/img/view/2019/1/12/1932793.png,0,0.998456955,318,0,716,386,398,386,twilight sparkle
1934007.png,https://derpicdn.net/img/view/2019/1/13/1934007.png,0,0.901494384,19,122,979,1082,960,960,twilight sparkle
1936134.png,https://derpicdn.net/img/view/2019/1/15/1936134.png,0,0.998305202,549,0,2039,1327,1490,1327,twilight sparkle
1936286.png,https://derpicdn.net/img/view/2019/1/15/1936286.png,0,0.997692525,209,10,745,546,536,536,twilight sparkle
1937145.png,https://derpicdn.net/img/view/2019/1/16/1937145.png,0,0.953692615,19,34,1507,1522,1488,1488,twilight sparkle
1937742.png,https://derpicdn.net/img/view/2019/1/17/1937742.png,1,0.949867964,294,31,1114,851,820,820,twilight sparkle
1940205.png,https://derpicdn.net/img/view/2019/1/20/1940205.png,0,0.997397661,590,116,1918,1444,1328,1328,twilight sparkle
1943410.png,https://derpicdn.net/img/view/2019/1/24/1943410.png,0,0.982766509,511,61,1679,1229,1168,1168,twilight sparkle
1945167.png,https://derpicdn.net/img/view/2019/1/26/1945167.png,0,0.94573766,2019,0,5915,3525,3896,3525,twilight sparkle
1947877.png,https://derpicdn.net/img/view/2019/1/29/1947877.png,0,0.99433136,56,0,1300,1152,1244,1152,twilight sparkle
1949492.png,https://derpicdn.net/img/view/2019/1/31/1949492.png,0,0.998002291,73,32,711,670,638,638,twilight sparkle
1951237.png,https://derpicdn.net/img/view/2019/2/2/1951237.png,0,0.999528766,1738,133,2456,851,718,718,twilight sparkle
1951237.png,https://derpicdn.net/img/view/2019/2/2/1951237.png,1,0.999002695,656,17,1434,795,778,778,twilight sparkle
1951243.png,https://derpicdn.net/img/view/2019/2/2/1951243.png,0,0.999528885,1738,133,2456,851,718,718,twilight sparkle
1951243.png,https://derpicdn.net/img/view/2019/2/2/1951243.png,1,0.999002457,656,17,1434,795,778,778,twilight sparkle
1952560.png,https://derpicdn.net/img/view/2019/2/3/1952560.png,0,0.999024332,173,24,729,580,556,556,twilight sparkle
1952561.png,https://derpicdn.net/img/view/2019/2/3/1952561.png,0,0.998964369,174,24,728,578,554,554,twilight sparkle
1955213.png,https://derpicdn.net/img/view/2019/2/6/1955213.png,0,0.98670429,306,0,2130,1794,1824,1794,twilight sparkle
1960514.png,https://derpicdn.net/img/view/2019/2/13/1960514.png,0,0.974309802,145,1182,971,2008,826,826,twilight sparkle
1962762.png,https://derpicdn.net/img/view/2019/2/15/1962762.png,0,0.995042026,99,53,1149,1103,1050,1050,twilight sparkle
1962762.png,https://derpicdn.net/img/view/2019/2/15/1962762.png,1,0.930269778,889,629,1985,1725,1096,1096,twilight sparkle
1964657.png,https://derpicdn.net/img/view/2019/2/17/1964657.png,0,0.915242136,308,83,1272,1047,964,964,twilight sparkle
1965360.png,https://derpicdn.net/img/view/2019/2/18/1965360.png,0,0.926676393,302,0,2706,2192,2404,2192,twilight sparkle
1965767.png,https://derpicdn.net/img/view/2019/2/19/1965767.png,0,0.983703613,105,0,741,614,636,614,twilight sparkle
1967572.png,https://derpicdn.net/img/view/2019/2/21/1967572.png,0,0.992509365,289,99,1031,841,742,742,twilight sparkle
1969007.png,https://derpicdn.net/img/view/2019/2/22/1969007.png,0,0.953735292,145,54,645,554,500,500,twilight sparkle
1969372.png,https://derpicdn.net/img/view/2019/2/23/1969372.png,0,0.962920249,386,0,1026,627,640,627,twilight sparkle
1970122.png,https://derpicdn.net/img/view/2019/2/24/1970122.png,0,0.914085031,274,67,1012,805,738,738,twilight sparkle
1970973.png,https://derpicdn.net/img/view/2019/2/24/1970973.png,0,0.917091906,886,103,1868,1085,982,982,twilight sparkle
1971169.png,https://derpicdn.net/img/view/2019/2/25/1971169.png,0,0.961222827,257,0,821,573,564,573,twilight sparkle
1971575.png,https://derpicdn.net/img/view/2019/2/25/1971575.png,0,0.953856468,301,0,3625,3307,3324,3307,twilight sparkle
1974438.png,https://derpicdn.net/img/view/2019/3/1/1974438.png,0,0.996422887,185,0,757,543,572,543,twilight sparkle
1974514.png,https://derpicdn.net/img/view/2019/3/1/1974514.png,0,0.981595635,43,99,793,849,750,750,twilight sparkle
1976192.png,https://derpicdn.net/img/view/2019/3/3/1976192.png,0,0.93604672,181,126,495,440,314,314,twilight sparkle
1976567.png,https://derpicdn.net/img/view/2019/3/3/1976567.png,0,0.997264147,681,731,2831,2881,2150,2150,twilight sparkle
1978644.png,https://derpicdn.net/img/view/2019/3/6/1978644.png,0,0.988986611,232,0,1792,1493,1560,1493,twilight sparkle
1979892.png,https://derpicdn.net/img/view/2019/3/7/1979892.png,0,0.964601338,491,465,1157,1131,666,666,twilight sparkle
1983143.png,https://derpicdn.net/img/view/2019/3/11/1983143.png,0,0.993951142,832,62,2242,1472,1410,1410,twilight sparkle
1986144.png,https://derpicdn.net/img/view/2019/3/15/1986144.png,0,0.904939413,196,0,574,368,378,368,twilight sparkle
1986580.png,https://derpicdn.net/img/view/2019/3/16/1986580.png,0,0.996233106,1332,14,2728,1410,1396,1396,twilight sparkle
1989972.png,https://derpicdn.net/img/view/2019/3/19/1989972.png,0,0.995463133,857,0,1941,1064,1084,1064,twilight sparkle
1990218.png,https://derpicdn.net/img/view/2019/3/19/1990218.png,0,0.986832559,172,0,628,428,456,428,twilight sparkle
1992024.png,https://derpicdn.net/img/view/2019/3/22/1992024.png,0,0.996751666,49,14,399,364,350,350,twilight sparkle
1992024.png,https://derpicdn.net/img/view/2019/3/22/1992024.png,1,0.996439993,376,11,752,387,376,376,twilight sparkle
1992963.png,https://derpicdn.net/img/view/2019/3/23/1992963.png,0,0.920303762,0,75,1036,1257,1036,1182,twilight sparkle
1993749.png,https://derpicdn.net/img/view/2019/3/24/1993749.png,0,0.938269496,1478,716,2736,1974,1258,1258,twilight sparkle
1995100.png,https://derpicdn.net/img/view/2019/3/26/1995100.png,0,0.979776144,65,0,517,376,452,376,twilight sparkle
1997990.png,https://derpicdn.net/img/view/2019/3/30/1997990.png,0,0.983394265,47,0,4201,3777,4154,3777,twilight sparkle
1998855.png,https://derpicdn.net/img/view/2019/3/31/1998855.png,0,0.978289485,2480,309,3238,1067,758,758,twilight sparkle
1999268.png,https://derpicdn.net/img/view/2019/3/31/1999268.png,0,0.946452141,417,86,877,546,460,460,twilight sparkle
1999268.png,https://derpicdn.net/img/view/2019/3/31/1999268.png,1,0.944880307,781,21,1263,503,482,482,twilight sparkle
2003213.png,https://derpicdn.net/img/view/2019/4/5/2003213.png,0,0.950398207,166,0,432,244,266,244,twilight sparkle
2003286.png,https://derpicdn.net/img/view/2019/4/5/2003286.png,0,0.927784264,384,459,1510,1585,1126,1126,twilight sparkle
2009124.png,https://derpicdn.net/img/view/2019/4/11/2009124.png,0,0.927399993,495,459,3385,3349,2890,2890,twilight sparkle
2009866.png,https://derpicdn.net/img/view/2019/4/12/2009866.png,0,0.967239738,822,1218,1472,1868,650,650,twilight sparkle
2010224.png,https://derpicdn.net/img/view/2019/4/12/2010224.png,0,0.929157436,130,169,968,1000,838,831,twilight sparkle
2010699.png,https://derpicdn.net/img/view/2019/4/13/2010699.png,0,0.976795018,0,0,2327,2348,2327,2348,twilight sparkle
20146.jpg,https://derpicdn.net/img/view/2012/6/25/20146.jpg,0,0.989464998,122,97,378,353,256,256,twilight sparkle
2015014.png,https://derpicdn.net/img/view/2019/4/17/2015014.png,0,0.97760731,0,193,821,1087,821,894,twilight sparkle
2015134.png,https://derpicdn.net/img/view/2019/4/17/2015134.png,0,0.935756922,0,72,625,708,625,636,twilight sparkle
2015173.png,https://derpicdn.net/img/view/2019/4/17/2015173.png,0,0.98665601,582,170,1514,1102,932,932,twilight sparkle
2015325.png,https://derpicdn.net/img/view/2019/4/17/2015325.png,0,0.989932835,0,0,604,615,604,615,twilight sparkle
2015499.png,https://derpicdn.net/img/view/2019/4/18/2015499.png,0,0.998208344,30,0,604,553,574,553,twilight sparkle
2016569.png,https://derpicdn.net/img/view/2019/4/19/2016569.png,0,0.975627422,24,0,474,407,450,407,twilight sparkle
2022362.png,https://derpicdn.net/img/view/2019/4/25/2022362.png,0,0.99892211,49,35,605,591,556,556,twilight sparkle
2022362.png,https://derpicdn.net/img/view/2019/4/25/2022362.png,1,0.985627711,602,40,1112,550,510,510,twilight sparkle
2022920.png,https://derpicdn.net/img/view/2019/4/25/2022920.png,0,0.998731732,497,0,1089,544,592,544,twilight sparkle
2023289.png,https://derpicdn.net/img/view/2019/4/26/2023289.png,0,0.951192796,1179,124,1987,932,808,808,twilight sparkle
2023663.png,https://derpicdn.net/img/view/2019/4/26/2023663.png,0,0.957531452,183,281,2265,2363,2082,2082,twilight sparkle
2028045.png,https://derpicdn.net/img/view/2019/5/1/2028045.png,0,0.930691421,104,499,414,809,310,310,twilight sparkle
2028287.png,https://derpicdn.net/img/view/2019/5/1/2028287.png,0,0.98416537,366,0,1306,898,940,898,twilight sparkle
202840.png,https://derpicdn.net/img/view/2013/1/5/202840.png,0,0.992954075,0,608,269,898,269,290,twilight sparkle
202840.png,https://derpicdn.net/img/view/2013/1/5/202840.png,1,0.986126065,258,0,756,453,498,453,twilight sparkle
2028803.png,https://derpicdn.net/img/view/2019/5/2/2028803.png,0,0.99544704,557,0,1017,443,460,443,twilight sparkle
2032024.png,https://derpicdn.net/img/view/2019/5/6/2032024.png,0,0.995221198,750,42,1914,1206,1164,1164,twilight sparkle
2033633.png,https://derpicdn.net/img/view/2019/5/8/2033633.png,0,0.998894691,137,0,795,627,658,627,twilight sparkle
2033633.png,https://derpicdn.net/img/view/2019/5/8/2033633.png,1,0.990805387,769,0,1554,754,785,754,twilight sparkle
2033869.png,https://derpicdn.net/img/view/2019/5/8/2033869.png,0,0.915536046,197,0,2480,2321,2283,2321,twilight sparkle
2040318.png,https://derpicdn.net/img/view/2019/5/16/2040318.png,0,0.961496234,91,0,573,475,482,475,twilight sparkle
2044040.png,https://derpicdn.net/img/view/2019/5/20/2044040.png,0,0.989440382,0,3,1926,1983,1926,1980,twilight sparkle
2044966.png,https://derpicdn.net/img/view/2019/5/21/2044966.png,0,0.995860577,152,0,706,546,554,546,twilight sparkle
2045646.png,https://derpicdn.net/img/view/2019/5/22/2045646.png,0,0.977851868,185,0,1413,1146,1228,1146,twilight sparkle
2047798.png,https://derpicdn.net/img/view/2019/5/24/2047798.png,0,0.92507267,67,60,1200,1252,1133,1192,twilight sparkle
2051925.png,https://derpicdn.net/img/view/2019/5/28/2051925.png,0,0.984753489,1104,0,1832,705,728,705,twilight sparkle
2059226.png,https://derpicdn.net/img/view/2019/6/6/2059226.png,0,0.971782744,522,224,1898,1600,1376,1376,twilight sparkle
2059660.png,https://derpicdn.net/img/view/2019/6/7/2059660.png,0,0.998714209,1022,375,1654,1007,632,632,twilight sparkle
2062245.png,https://derpicdn.net/img/view/2019/6/10/2062245.png,0,0.997516811,586,647,1016,1077,430,430,twilight sparkle
2062245.png,https://derpicdn.net/img/view/2019/6/10/2062245.png,2,0.993036687,1002,651,1332,981,330,330,twilight sparkle
2062245.png,https://derpicdn.net/img/view/2019/6/10/2062245.png,3,0.954952717,1529,204,1893,568,364,364,twilight sparkle
2062245.png,https://derpicdn.net/img/view/2019/6/10/2062245.png,4,0.942937613,500,212,820,532,320,320,twilight sparkle
2065918.png,https://derpicdn.net/img/view/2019/6/15/2065918.png,0,0.971603096,370,18,1152,800,782,782,twilight sparkle
2066857.png,https://derpicdn.net/img/view/2019/6/16/2066857.png,0,0.984808922,164,0,1368,1144,1204,1144,twilight sparkle
2068626.png,https://derpicdn.net/img/view/2019/6/18/2068626.png,1,0.927333415,0,2672,946,3618,946,946,twilight sparkle
2068629.png,https://derpicdn.net/img/view/2019/6/18/2068629.png,1,0.932315886,0,2542,1012,3612,1012,1070,twilight sparkle
2072128.png,https://derpicdn.net/img/view/2019/6/22/2072128.png,0,0.999464869,347,0,795,426,448,426,twilight sparkle
2073204.png,https://derpicdn.net/img/view/2019/6/23/2073204.png,0,0.989033103,53,161,361,469,308,308,twilight sparkle
2073207.png,https://derpicdn.net/img/view/2019/6/23/2073207.png,0,0.98692739,53,161,361,469,308,308,twilight sparkle
2076652.png,https://derpicdn.net/img/view/2019/6/27/2076652.png,0,0.974599659,172,0,1262,820,1090,820,twilight sparkle
2076707.png,https://derpicdn.net/img/view/2019/6/27/2076707.png,0,0.991709352,190,0,756,541,566,541,twilight sparkle
2077225.png,https://derpicdn.net/img/view/2019/6/28/2077225.png,0,0.989003658,662,5,1060,403,398,398,twilight sparkle
2083572.png,https://derpicdn.net/img/view/2019/7/5/2083572.png,0,0.976047099,211,0,873,624,662,624,twilight sparkle
2084785.png,https://derpicdn.net/img/view/2019/7/6/2084785.png,0,0.988268912,965,0,2500,1394,1535,1394,twilight sparkle
2084792.png,https://derpicdn.net/img/view/2019/7/6/2084792.png,0,0.973055005,921,0,2632,1628,1711,1628,twilight sparkle
2085639.png,https://derpicdn.net/img/view/2019/7/7/2085639.png,0,0.939083755,296,134,2200,2038,1904,1904,twilight sparkle
2086382.png,https://derpicdn.net/img/view/2019/7/8/2086382.png,0,0.972582161,676,60,1896,1280,1220,1220,twilight sparkle
2087665.png,https://derpicdn.net/img/view/2019/7/10/2087665.png,0,0.960389674,785,26,1343,584,558,558,twilight sparkle
2089246.png,https://derpicdn.net/img/view/2019/7/11/2089246.png,0,0.935057163,215,0,1084,973,869,973,twilight sparkle
2089447.png,https://derpicdn.net/img/view/2019/7/12/2089447.png,0,0.996610403,54,65,410,421,356,356,twilight sparkle
2089447.png,https://derpicdn.net/img/view/2019/7/12/2089447.png,1,0.990127742,404,0,834,425,430,425,twilight sparkle
2090284.png,https://derpicdn.net/img/view/2019/7/13/2090284.png,0,0.999592245,420,13,926,519,506,506,twilight sparkle
2090929.png,https://derpicdn.net/img/view/2019/7/13/2090929.png,0,0.996542633,53,0,631,575,578,575,twilight sparkle
2090929.png,https://derpicdn.net/img/view/2019/7/13/2090929.png,1,0.993993461,655,27,1171,543,516,516,twilight sparkle
20910.png,https://derpicdn.net/img/view/2012/6/25/20910.png,0,0.992993712,18,0,314,289,296,289,twilight sparkle
2092648.png,https://derpicdn.net/img/view/2019/7/15/2092648.png,0,0.984705329,652,1,1368,717,716,716,twilight sparkle
2093271.png,https://derpicdn.net/img/view/2019/7/16/2093271.png,0,0.953878939,363,65,1069,771,706,706,twilight sparkle
2093272.png,https://derpicdn.net/img/view/2019/7/16/2093272.png,0,0.906540453,458,109,1068,719,610,610,twilight sparkle
2094913.png,https://derpicdn.net/img/view/2019/7/18/2094913.png,0,0.983950913,118,0,719,591,601,591,twilight sparkle
2095789.png,https://derpicdn.net/img/view/2019/7/19/2095789.png,0,0.990634739,167,17,519,369,352,352,twilight sparkle
2099061.png,https://derpicdn.net/img/view/2019/7/23/2099061.png,0,0.919141531,396,0,820,421,424,421,twilight sparkle
2099460.png,https://derpicdn.net/img/view/2019/7/23/2099460.png,0,0.993571043,175,52,727,604,552,552,twilight sparkle
2105841.png,https://derpicdn.net/img/view/2019/7/31/2105841.png,0,0.94801861,533,0,2439,1828,1906,1828,twilight sparkle
2106248.png,https://derpicdn.net/img/view/2019/8/1/2106248.png,0,0.956037581,34,1,1200,1261,1166,1260,twilight sparkle
2108941.png,https://derpicdn.net/img/view/2019/8/4/2108941.png,0,0.966113687,1009,216,1685,892,676,676,twilight sparkle
2112920.png,https://derpicdn.net/img/view/2019/8/9/2112920.png,0,0.989826918,317,43,5293,4961,4976,4918,twilight sparkle
2113120.png,https://derpicdn.net/img/view/2019/8/9/2113120.png,0,0.943982363,821,159,1601,939,780,780,twilight sparkle
2114111.png,https://derpicdn.net/img/view/2019/8/10/2114111.png,0,0.989331901,474,448,966,940,492,492,twilight sparkle
2114440.png,https://derpicdn.net/img/view/2019/8/10/2114440.png,0,0.999815285,473,14,783,324,310,310,twilight sparkle
2114881.png,https://derpicdn.net/img/view/2019/8/11/2114881.png,0,0.99934727,54,0,716,644,662,644,twilight sparkle
2115427.png,https://derpicdn.net/img/view/2019/8/11/2115427.png,0,0.987052023,141,1,573,433,432,432,twilight sparkle
2117140.png,https://derpicdn.net/img/view/2019/8/13/2117140.png,0,0.931355536,288,0,1112,802,824,802,twilight sparkle
2119748.png,https://derpicdn.net/img/view/2019/8/16/2119748.png,0,0.988815188,459,0,2127,1702,1668,1702,twilight sparkle
2121093.png,https://derpicdn.net/img/view/2019/8/18/2121093.png,0,0.990421891,0,8,613,680,613,672,twilight sparkle
2121655.png,https://derpicdn.net/img/view/2019/8/18/2121655.png,0,0.942750692,251,0,1297,981,1046,981,twilight sparkle
2121799.png,https://derpicdn.net/img/view/2019/8/18/2121799.png,0,0.991458178,886,0,1198,262,312,262,twilight sparkle
2124706.png,https://derpicdn.net/img/view/2019/8/22/2124706.png,0,0.983140051,0,0,631,622,631,622,twilight sparkle
2125069.png,https://derpicdn.net/img/view/2019/8/23/2125069.png,0,0.997719407,91,41,451,401,360,360,twilight sparkle
2126851.png,https://derpicdn.net/img/view/2019/8/25/2126851.png,0,0.99463129,101,0,817,694,716,694,twilight sparkle
2129364.png,https://derpicdn.net/img/view/2019/8/27/2129364.png,0,0.967422664,103,0,935,816,832,816,twilight sparkle
2130211.png,https://derpicdn.net/img/view/2019/8/28/2130211.png,0,0.999713123,921,1781,2343,3203,1422,1422,twilight sparkle
2133443.png,https://derpicdn.net/img/view/2019/9/1/2133443.png,0,0.942630708,279,85,709,515,430,430,twilight sparkle
2134715.png,https://derpicdn.net/img/view/2019/9/2/2134715.png,0,0.991930425,357,0,673,294,316,294,twilight sparkle
2137097.png,https://derpicdn.net/img/view/2019/9/5/2137097.png,0,0.999499857,0,0,378,353,378,353,twilight sparkle
2137198.png,https://derpicdn.net/img/view/2019/9/5/2137198.png,0,0.999045014,685,148,1485,948,800,800,twilight sparkle
2139913.png,https://derpicdn.net/img/view/2019/9/9/2139913.png,0,0.999363303,160,48,1296,1184,1136,1136,twilight sparkle
2140403.png,https://derpicdn.net/img/view/2019/9/9/2140403.png,0,0.998951912,1474,0,3184,1623,1710,1623,twilight sparkle
2141305.png,https://derpicdn.net/img/view/2019/9/11/2141305.png,0,0.97877264,23,20,299,296,276,276,twilight sparkle
2141436.png,https://derpicdn.net/img/view/2019/9/11/2141436.png,0,0.909081936,1167,0,4763,3508,3596,3508,twilight sparkle
2141787.png,https://derpicdn.net/img/view/2019/9/11/2141787.png,0,0.995250821,377,0,991,526,614,526,twilight sparkle
2141788.png,https://derpicdn.net/img/view/2019/9/11/2141788.png,0,0.998932123,387,0,977,513,590,513,twilight sparkle
2145039.png,https://derpicdn.net/img/view/2019/9/15/2145039.png,0,0.967548788,0,0,1416,974,1416,974,twilight sparkle
2145045.png,https://derpicdn.net/img/view/2019/9/15/2145045.png,0,0.937003195,868,88,1402,622,534,534,twilight sparkle
2147673.png,https://derpicdn.net/img/view/2019/9/19/2147673.png,0,0.993765891,99,0,865,760,766,760,twilight sparkle
2147831.png,https://derpicdn.net/img/view/2019/9/19/2147831.png,0,0.995097458,44,0,1938,1694,1894,1694,twilight sparkle
2152067.png,https://derpicdn.net/img/view/2019/9/24/2152067.png,0,0.954588354,2577,280,5285,2988,2708,2708,twilight sparkle
2156763.png,https://derpicdn.net/img/view/2019/9/30/2156763.png,0,0.997511923,20,0,258,232,238,232,twilight sparkle
2158107.png,https://derpicdn.net/img/view/2019/10/2/2158107.png,0,0.990583718,151,0,957,749,806,749,twilight sparkle
2160817.png,https://derpicdn.net/img/view/2019/10/5/2160817.png,0,0.944837391,499,157,1669,1327,1170,1170,twilight sparkle
216533.png,https://derpicdn.net/img/view/2013/1/18/216533.png,0,0.995449543,1382,128,2354,1100,972,972,twilight sparkle
2165574.png,https://derpicdn.net/img/view/2019/10/11/2165574.png,0,0.993610919,0,0,1133,1097,1133,1097,twilight sparkle
2166130.png,https://derpicdn.net/img/view/2019/10/12/2166130.png,0,0.984216869,66,0,666,534,600,534,twilight sparkle
2167980.png,https://derpicdn.net/img/view/2019/10/13/2167980.png,0,0.937478542,547,395,825,673,278,278,twilight sparkle
2168637.png,https://derpicdn.net/img/view/2019/10/14/2168637.png,0,0.93492043,75,49,1029,1003,954,954,twilight sparkle
2168836.png,https://derpicdn.net/img/view/2019/10/14/2168836.png,0,0.951671064,136,7,800,671,664,664,twilight sparkle
2170028.png,https://derpicdn.net/img/view/2019/10/15/2170028.png,0,0.984108388,1036,0,2798,1755,1762,1755,twilight sparkle
2170273.png,https://derpicdn.net/img/view/2019/10/16/2170273.png,0,0.978019357,891,404,2419,1932,1528,1528,twilight sparkle
2174873.png,https://derpicdn.net/img/view/2019/10/20/2174873.png,0,0.9706586,895,203,1577,885,682,682,twilight sparkle
2175730.png,https://derpicdn.net/img/view/2019/10/21/2175730.png,0,0.938724399,387,33,879,525,492,492,twilight sparkle
2176290.png,https://derpicdn.net/img/view/2019/10/22/2176290.png,0,0.910792172,322,0,2860,2473,2538,2473,twilight sparkle
2177976.png,https://derpicdn.net/img/view/2019/10/24/2177976.png,0,0.937772274,228,0,2550,2464,2322,2464,twilight sparkle
2178379.png,https://derpicdn.net/img/view/2019/10/25/2178379.png,0,0.9828282,654,0,1575,1024,921,1024,twilight sparkle
2182006.png,https://derpicdn.net/img/view/2019/10/29/2182006.png,0,0.996025026,347,0,981,609,634,609,twilight sparkle
2183261.png,https://derpicdn.net/img/view/2019/10/30/2183261.png,0,0.900005996,669,70,2137,1538,1468,1468,twilight sparkle
2185605.png,https://derpicdn.net/img/view/2019/11/2/2185605.png,0,0.991355956,129,15,305,191,176,176,twilight sparkle
2186404.png,https://derpicdn.net/img/view/2019/11/3/2186404.png,0,0.979095101,4,52,708,756,704,704,twilight sparkle
2186536.png,https://derpicdn.net/img/view/2019/11/3/2186536.png,0,0.996456861,136,61,1010,935,874,874,twilight sparkle
2188292.png,https://derpicdn.net/img/view/2019/11/5/2188292.png,0,0.998997331,283,10,609,336,326,326,twilight sparkle
218897.png,https://derpicdn.net/img/view/2013/1/20/218897.png,0,0.95174861,145,595,981,1431,836,836,twilight sparkle
2189332.png,https://derpicdn.net/img/view/2019/11/7/2189332.png,0,0.914321423,0,0,1277,1318,1277,1318,twilight sparkle
2191348.png,https://derpicdn.net/img/view/2019/11/9/2191348.png,0,0.973348141,847,270,1838,1298,991,1028,twilight sparkle
2191845.png,https://derpicdn.net/img/view/2019/11/10/2191845.png,0,0.998389184,783,147,1515,879,732,732,twilight sparkle
2197725.png,https://derpicdn.net/img/view/2019/11/16/2197725.png,0,0.995707989,84,0,1692,1575,1608,1575,twilight sparkle
2199021.png,https://derpicdn.net/img/view/2019/11/17/2199021.png,0,0.993825376,638,0,1282,544,644,544,twilight sparkle
2199021.png,https://derpicdn.net/img/view/2019/11/17/2199021.png,1,0.968603551,203,453,659,909,456,456,twilight sparkle
2200721.png,https://derpicdn.net/img/view/2019/11/20/2200721.png,0,0.978926897,827,174,3000,2706,2173,2532,twilight sparkle
2201435.png,https://derpicdn.net/img/view/2019/11/21/2201435.png,0,0.974809706,326,0,1080,881,754,881,twilight sparkle
2204522.png,https://derpicdn.net/img/view/2019/11/24/2204522.png,0,0.995109975,73,0,399,291,326,291,twilight sparkle
2205348.png,https://derpicdn.net/img/view/2019/11/25/2205348.png,0,0.991497636,225,0,637,379,412,379,twilight sparkle
2207303.png,https://derpicdn.net/img/view/2019/11/27/2207303.png,0,0.969527781,285,99,989,803,704,704,twilight sparkle
2210106.png,https://derpicdn.net/img/view/2019/12/1/2210106.png,0,0.994080961,952,105,1682,835,730,730,twilight sparkle
2210650.png,https://derpicdn.net/img/view/2019/12/2/2210650.png,0,0.994044542,1596,881,2304,1589,708,708,twilight sparkle
2210650.png,https://derpicdn.net/img/view/2019/12/2/2210650.png,1,0.982047498,526,23,1716,1213,1190,1190,twilight sparkle
2210823.png,https://derpicdn.net/img/view/2019/12/2/2210823.png,0,0.99474889,97,0,1139,945,1042,945,twilight sparkle
2211657.png,https://derpicdn.net/img/view/2019/12/3/2211657.png,0,0.994081914,555,132,1449,1026,894,894,twilight sparkle
2213227.png,https://derpicdn.net/img/view/2019/12/5/2213227.png,0,0.939935148,325,0,2027,1700,1702,1700,twilight sparkle
2216038.png,https://derpicdn.net/img/view/2019/12/8/2216038.png,0,0.953350306,318,0,1248,741,930,741,twilight sparkle
2216184.png,https://derpicdn.net/img/view/2019/12/8/2216184.png,0,0.981841326,327,0,991,656,664,656,twilight sparkle
2216185.png,https://derpicdn.net/img/view/2019/12/8/2216185.png,0,0.996553123,602,172,1042,612,440,440,twilight sparkle
2217071.png,https://derpicdn.net/img/view/2019/12/10/2217071.png,0,0.995513082,353,43,1127,817,774,774,twilight sparkle
2217378.png,https://derpicdn.net/img/view/2019/12/10/2217378.png,0,0.985130966,75,23,367,315,292,292,twilight sparkle
2217410.png,https://derpicdn.net/img/view/2019/12/10/2217410.png,0,0.998098671,318,0,1280,837,962,837,twilight sparkle
2217737.png,https://derpicdn.net/img/view/2019/12/10/2217737.png,0,0.94980967,257,33,793,595,536,562,twilight sparkle
2221270.png,https://derpicdn.net/img/view/2019/12/15/2221270.png,0,0.926725209,717,740,1537,1560,820,820,twilight sparkle
2221461.png,https://derpicdn.net/img/view/2019/12/15/2221461.png,0,0.961681902,201,0,511,305,310,305,twilight sparkle
2223504.png,https://derpicdn.net/img/view/2019/12/18/2223504.png,0,0.968066156,379,260,1851,1732,1472,1472,twilight sparkle
2225583.png,https://derpicdn.net/img/view/2019/12/21/2225583.png,0,0.962902963,496,53,1300,857,804,804,twilight sparkle
2226113.png,https://derpicdn.net/img/view/2019/12/21/2226113.png,0,0.939162731,0,0,2005,1798,2005,1798,twilight sparkle
2226167.png,https://derpicdn.net/img/view/2019/12/21/2226167.png,0,0.990009189,2018,583,2730,1295,712,712,twilight sparkle
2226880.png,https://derpicdn.net/img/view/2019/12/22/2226880.png,0,0.995327115,1720,161,2912,1353,1192,1192,twilight sparkle
2227028.png,https://derpicdn.net/img/view/2019/12/22/2227028.png,0,0.933063149,751,0,3165,1921,2414,1921,twilight sparkle
2228439.jpg,https://derpicdn.net/img/view/2019/12/24/2228439.jpg,0,0.928858817,614,0,1984,1125,1370,1125,twilight sparkle
2228440.jpg,https://derpicdn.net/img/view/2019/12/24/2228440.jpg,0,0.998747528,382,0,1084,658,702,658,twilight sparkle
2228845.png,https://derpicdn.net/img/view/2019/12/24/2228845.png,0,0.999788225,660,56,1908,1304,1248,1248,twilight sparkle
2230649.png,https://derpicdn.net/img/view/2019/12/26/2230649.png,0,0.987986505,0,0,1328,1331,1328,1331,twilight sparkle
2234959.png,https://derpicdn.net/img/view/2019/12/31/2234959.png,0,0.997816026,903,177,2283,1557,1380,1380,twilight sparkle
2234959.png,https://derpicdn.net/img/view/2019/12/31/2234959.png,1,0.980765224,0,2007,1944,4083,1944,2076,twilight sparkle
2237187.jpg,https://derpicdn.net/img/view/2020/1/3/2237187.jpg,0,0.95795083,61,162,1073,1174,1012,1012,twilight sparkle
2238329.png,https://derpicdn.net/img/view/2020/1/4/2238329.png,0,0.995996058,32,13,594,575,562,562,twilight sparkle
2239240.png,https://derpicdn.net/img/view/2020/1/5/2239240.png,0,0.9996925,840,0,1560,711,720,711,twilight sparkle
2239767.png,https://derpicdn.net/img/view/2020/1/5/2239767.png,0,0.991635382,484,263,806,585,322,322,twilight sparkle
2241700.png,https://derpicdn.net/img/view/2020/1/8/2241700.png,0,0.951944172,2105,0,3861,1695,1756,1695,twilight sparkle
2243607.png,https://derpicdn.net/img/view/2020/1/10/2243607.png,0,0.978813291,64,0,632,553,568,553,twilight sparkle
2245381.png,https://derpicdn.net/img/view/2020/1/12/2245381.png,0,0.995670259,195,0,1151,895,956,895,twilight sparkle
2245572.png,https://derpicdn.net/img/view/2020/1/12/2245572.png,0,0.954677761,1995,54,4250,2372,2255,2318,twilight sparkle
2245759.jpg,https://derpicdn.net/img/view/2020/1/12/2245759.jpg,0,0.985498607,41,0,1185,1060,1144,1060,twilight sparkle
2247245.png,https://derpicdn.net/img/view/2020/1/14/2247245.png,0,0.998787999,811,1103,1713,2005,902,902,twilight sparkle
2252552.png,https://derpicdn.net/img/view/2020/1/20/2252552.png,0,0.984853566,71,0,957,866,886,866,twilight sparkle
2254423.jpg,https://derpicdn.net/img/view/2020/1/23/2254423.jpg,0,0.998809636,0,8,566,584,566,576,twilight sparkle
2254966.png,https://derpicdn.net/img/view/2020/1/23/2254966.png,0,0.978712142,376,0,764,369,388,369,twilight sparkle
2254967.png,https://derpicdn.net/img/view/2020/1/23/2254967.png,0,0.978712142,376,0,764,369,388,369,twilight sparkle
2255275.jpg,https://derpicdn.net/img/view/2020/1/24/2255275.jpg,0,0.970431089,47,0,889,820,842,820,twilight sparkle
2256115.jpg,https://derpicdn.net/img/view/2020/1/25/2256115.jpg,0,0.996744037,449,386,785,722,336,336,twilight sparkle
2257348.jpg,https://derpicdn.net/img/view/2020/1/26/2257348.jpg,0,0.997930884,295,28,987,720,692,692,twilight sparkle
2257913.png,https://derpicdn.net/img/view/2020/1/26/2257913.png,0,0.958556056,279,0,583,259,304,259,twilight sparkle
2259891.png,https://derpicdn.net/img/view/2020/1/29/2259891.png,0,0.900358617,188,232,588,632,400,400,twilight sparkle
2260838.jpg,https://derpicdn.net/img/view/2020/1/30/2260838.jpg,0,0.99824208,19,0,673,536,654,536,twilight sparkle
2261645.jpg,https://derpicdn.net/img/view/2020/1/31/2261645.jpg,1,0.948932707,222,1072,1386,2236,1164,1164,twilight sparkle
2262200.png,https://derpicdn.net/img/view/2020/1/31/2262200.png,0,0.998464584,1091,0,2429,1300,1338,1300,twilight sparkle
2264032.png,https://derpicdn.net/img/view/2020/2/2/2264032.png,0,0.998717844,519,51,1053,585,534,534,twilight sparkle
2264365.jpg,https://derpicdn.net/img/view/2020/2/3/2264365.jpg,0,0.995068431,295,536,921,1162,626,626,twilight sparkle
2264557.jpg,https://derpicdn.net/img/view/2020/2/3/2264557.jpg,0,0.994242132,395,53,819,477,424,424,twilight sparkle
2264813.jpg,https://derpicdn.net/img/view/2020/2/3/2264813.jpg,0,0.970373452,1251,885,2583,2217,1332,1332,twilight sparkle
2265380.png,https://derpicdn.net/img/view/2020/2/4/2265380.png,0,0.972325981,42,6,1000,1164,958,1158,twilight sparkle
2265733.png,https://derpicdn.net/img/view/2020/2/4/2265733.png,0,0.954516232,309,0,1861,1516,1552,1516,twilight sparkle
2265913.png,https://derpicdn.net/img/view/2020/2/4/2265913.png,0,0.908858538,130,0,912,718,782,718,twilight sparkle
2266697.jpg,https://derpicdn.net/img/view/2020/2/5/2266697.jpg,0,0.916130722,21,64,645,688,624,624,twilight sparkle
2267526.png,https://derpicdn.net/img/view/2020/2/7/2267526.png,0,0.982389092,423,123,1161,861,738,738,twilight sparkle
2267948.jpg,https://derpicdn.net/img/view/2020/2/7/2267948.jpg,0,0.937078953,318,42,1378,1102,1060,1060,twilight sparkle
2268093.jpg,https://derpicdn.net/img/view/2020/2/7/2268093.jpg,0,0.990660727,315,75,1077,837,762,762,twilight sparkle
2268474.jpg,https://derpicdn.net/img/view/2020/2/8/2268474.jpg,0,0.977961957,468,214,984,730,516,516,twilight sparkle
2269843.png,https://derpicdn.net/img/view/2020/2/9/2269843.png,0,0.954051137,895,197,1637,939,742,742,twilight sparkle
2269844.png,https://derpicdn.net/img/view/2020/2/9/2269844.png,0,0.982855022,576,0,1424,844,848,844,twilight sparkle
2270756.png,https://derpicdn.net/img/view/2020/2/10/2270756.png,0,0.999267578,115,0,679,534,564,534,twilight sparkle
2271553.png,https://derpicdn.net/img/view/2020/2/11/2271553.png,0,0.99635911,633,114,1071,552,438,438,twilight sparkle
2271668.png,https://derpicdn.net/img/view/2020/2/11/2271668.png,0,0.905754209,37,7,425,395,388,388,twilight sparkle
2272815.png,https://derpicdn.net/img/view/2020/2/13/2272815.png,0,0.961760998,188,0,558,347,370,347,twilight sparkle
2274009.jpg,https://derpicdn.net/img/view/2020/2/14/2274009.jpg,0,0.959153354,113,142,627,656,514,514,twilight sparkle
227505.png,https://derpicdn.net/img/view/2013/1/29/227505.png,0,0.947867811,0,110,534,652,534,542,twilight sparkle
2276366.png,https://derpicdn.net/img/view/2020/2/17/2276366.png,0,0.997287273,30,0,730,595,700,595,twilight sparkle
2277759.jpg,https://derpicdn.net/img/view/2020/2/18/2277759.jpg,1,0.975429952,193,29,1047,883,854,854,twilight sparkle
2278192.jpg,https://derpicdn.net/img/view/2020/2/19/2278192.jpg,0,0.989655197,724,114,1022,412,298,298,twilight sparkle
2279119.png,https://derpicdn.net/img/view/2020/2/20/2279119.png,0,0.947387993,368,87,1178,897,810,810,twilight sparkle
2279256.jpg,https://derpicdn.net/img/view/2020/2/20/2279256.jpg,0,0.959958136,17,0,513,447,496,447,twilight sparkle
2279430.png,https://derpicdn.net/img/view/2020/2/20/2279430.png,0,0.995517373,1113,0,3145,1872,2032,1872,twilight sparkle
2281383.jpg,https://derpicdn.net/img/view/2020/2/23/2281383.jpg,0,0.989613175,243,11,773,541,530,530,twilight sparkle
2282284.png,https://derpicdn.net/img/view/2020/2/23/2282284.png,0,0.972744405,1437,201,4157,2921,2720,2720,twilight sparkle
2283063.jpg,https://derpicdn.net/img/view/2020/2/25/2283063.jpg,0,0.991463184,328,0,1000,655,672,655,twilight sparkle
2284810.jpg,https://derpicdn.net/img/view/2020/2/27/2284810.jpg,0,0.961409271,165,0,1015,847,850,847,twilight sparkle
2285098.jpg,https://derpicdn.net/img/view/2020/2/28/2285098.jpg,0,0.991807222,140,0,756,586,616,586,twilight sparkle
2286555.png,https://derpicdn.net/img/view/2020/2/29/2286555.png,0,0.973949254,0,15,346,377,346,362,twilight sparkle
2288209.png,https://derpicdn.net/img/view/2020/3/2/2288209.png,0,0.989473939,108,0,438,327,330,327,twilight sparkle
2289529.jpg,https://derpicdn.net/img/view/2020/3/4/2289529.jpg,0,0.9783687,1304,947,2300,1943,996,996,twilight sparkle
2293207.png,https://derpicdn.net/img/view/2020/3/9/2293207.png,0,0.992903888,650,71,1390,811,740,740,twilight sparkle
2293853.jpg,https://derpicdn.net/img/view/2020/3/9/2293853.jpg,0,0.995319307,98,0,1506,1231,1408,1231,twilight sparkle
2295142.png,https://derpicdn.net/img/view/2020/3/11/2295142.png,0,0.962722659,222,89,502,369,280,280,twilight sparkle
2296723.png,https://derpicdn.net/img/view/2020/3/13/2296723.png,0,0.992878318,673,160,1895,1382,1222,1222,twilight sparkle
2296799.png,https://derpicdn.net/img/view/2020/3/13/2296799.png,0,0.991056383,188,0,1636,1314,1448,1314,twilight sparkle
2301551.png,https://derpicdn.net/img/view/2020/3/20/2301551.png,0,0.998625576,1010,1792,1944,2726,934,934,twilight sparkle
2301965.png,https://derpicdn.net/img/view/2020/3/20/2301965.png,0,0.996452808,1632,196,3280,1868,1648,1672,twilight sparkle
2302220.jpg,https://derpicdn.net/img/view/2020/3/20/2302220.jpg,0,0.996971428,168,153,858,843,690,690,twilight sparkle
2302762.png,https://derpicdn.net/img/view/2020/3/21/2302762.png,0,0.999849558,505,0,1289,738,784,738,twilight sparkle
2302854.jpg,https://derpicdn.net/img/view/2020/3/21/2302854.jpg,0,0.97129333,505,0,1663,1103,1158,1103,twilight sparkle
2308796.png,https://derpicdn.net/img/view/2020/3/29/2308796.png,0,0.991499901,901,116,1403,618,502,502,twilight sparkle
2309867.png,https://derpicdn.net/img/view/2020/3/30/2309867.png,0,0.962887228,108,4,970,866,862,862,twilight sparkle
2309923.png,https://derpicdn.net/img/view/2020/3/30/2309923.png,0,0.997140288,328,91,1462,1225,1134,1134,twilight sparkle
2310923.jpg,https://derpicdn.net/img/view/2020/3/31/2310923.jpg,0,0.999127984,316,247,1014,945,698,698,twilight sparkle
2311394.png,https://derpicdn.net/img/view/2020/4/1/2311394.png,0,0.936991811,403,164,1521,1282,1118,1118,twilight sparkle
2311982.png,https://derpicdn.net/img/view/2020/4/2/2311982.png,0,0.970399141,0,0,1216,1258,1216,1258,twilight sparkle
2312483.jpg,https://derpicdn.net/img/view/2020/4/2/2312483.jpg,0,0.961118102,68,3,832,767,764,764,twilight sparkle
2313099.jpg,https://derpicdn.net/img/view/2020/4/3/2313099.jpg,0,0.980308294,0,0,878,849,878,849,twilight sparkle
2313440.jpg,https://derpicdn.net/img/view/2020/4/3/2313440.jpg,0,0.994997978,54,0,1620,1430,1566,1430,twilight sparkle
2313469.png,https://derpicdn.net/img/view/2020/4/4/2313469.png,0,0.965138793,228,0,1330,1075,1102,1075,twilight sparkle
2314166.jpg,https://derpicdn.net/img/view/2020/4/4/2314166.jpg,0,0.997674108,691,52,2379,1740,1688,1688,twilight sparkle
2317925.jpg,https://derpicdn.net/img/view/2020/4/9/2317925.jpg,0,0.957463801,1322,99,2136,913,814,814,twilight sparkle
2320524.jpg,https://derpicdn.net/img/view/2020/4/12/2320524.jpg,0,0.99056083,96,0,620,507,524,507,twilight sparkle
2324674.jpg,https://derpicdn.net/img/view/2020/4/17/2324674.jpg,0,0.988038778,0,0,1192,1196,1192,1196,twilight sparkle
2325359.png,https://derpicdn.net/img/view/2020/4/18/2325359.png,0,0.971428514,219,9,1309,1099,1090,1090,twilight sparkle
2325673.png,https://derpicdn.net/img/view/2020/4/18/2325673.png,0,0.991151571,1477,0,2791,1039,1314,1039,twilight sparkle
2326014.png,https://derpicdn.net/img/view/2020/4/19/2326014.png,0,0.988549888,1518,127,2996,1605,1478,1478,twilight sparkle
2326137.jpg,https://derpicdn.net/img/view/2020/4/19/2326137.jpg,0,0.992944121,118,0,826,643,708,643,twilight sparkle
2326700.jpg,https://derpicdn.net/img/view/2020/4/20/2326700.jpg,0,0.994409859,612,0,1438,768,826,768,twilight sparkle
2327363.jpg,https://derpicdn.net/img/view/2020/4/20/2327363.jpg,0,0.999647498,639,0,1569,909,930,909,twilight sparkle
2331437.png,https://derpicdn.net/img/view/2020/4/25/2331437.png,0,0.945142686,1259,0,2823,1436,1564,1436,twilight sparkle
233354.jpg,https://derpicdn.net/img/view/2013/2/4/233354.jpg,0,0.96727109,97,73,1105,1081,1008,1008,twilight sparkle
2333804.jpg,https://derpicdn.net/img/view/2020/4/28/2333804.jpg,0,0.993748784,216,18,944,746,728,728,twilight sparkle
2335173.jpg,https://derpicdn.net/img/view/2020/4/30/2335173.jpg,0,0.999485016,2373,872,4053,2552,1680,1680,twilight sparkle
2335173.jpg,https://derpicdn.net/img/view/2020/4/30/2335173.jpg,1,0.901290774,1648,1677,2610,2639,962,962,twilight sparkle
2335962.png,https://derpicdn.net/img/view/2020/4/30/2335962.png,0,0.993318319,501,263,859,621,358,358,twilight sparkle
2337470.jpg,https://derpicdn.net/img/view/2020/5/2/2337470.jpg,0,0.980899632,85,0,791,677,706,677,twilight sparkle
2337574.jpg,https://derpicdn.net/img/view/2020/5/2/2337574.jpg,0,0.980624557,91,7,595,511,504,504,twilight sparkle
2338432.jpg,https://derpicdn.net/img/view/2020/5/3/2338432.jpg,0,0.995142221,488,83,1186,781,698,698,twilight sparkle
2340805.png,https://derpicdn.net/img/view/2020/5/6/2340805.png,0,0.966844797,548,0,1684,1073,1136,1073,twilight sparkle
2346240.png,https://derpicdn.net/img/view/2020/5/12/2346240.png,0,0.933399856,2109,0,3299,1079,1190,1079,twilight sparkle
2347512.png,https://derpicdn.net/img/view/2020/5/13/2347512.png,0,0.924243748,1672,0,3312,1614,1640,1614,twilight sparkle
2348566.jpg,https://derpicdn.net/img/view/2020/5/14/2348566.jpg,0,0.965493023,1724,94,3136,1506,1412,1412,twilight sparkle
2349121.png,https://derpicdn.net/img/view/2020/5/15/2349121.png,0,0.977169394,0,0,2083,2113,2083,2113,twilight sparkle
2349172.png,https://derpicdn.net/img/view/2020/5/15/2349172.png,0,0.963073611,121,0,473,342,352,342,twilight sparkle
2349833.png,https://derpicdn.net/img/view/2020/5/16/2349833.png,0,0.989841998,133,107,517,491,384,384,twilight sparkle
235044.png,https://derpicdn.net/img/view/2013/2/6/235044.png,0,0.976997197,312,397,1000,1085,688,688,twilight sparkle
2351204.jpg,https://derpicdn.net/img/view/2020/5/17/2351204.jpg,0,0.999573886,460,207,838,585,378,378,twilight sparkle
2352540.png,https://derpicdn.net/img/view/2020/5/19/2352540.png,0,0.999468565,444,0,1220,734,776,734,twilight sparkle
2354648.png,https://derpicdn.net/img/view/2020/5/21/2354648.png,0,0.9874053,166,0,1318,895,1152,895,twilight sparkle
2354844.png,https://derpicdn.net/img/view/2020/5/22/2354844.png,0,0.994094074,265,0,1109,832,844,832,twilight sparkle
242027.png,https://derpicdn.net/img/view/2013/2/13/242027.png,0,0.973406255,0,48,517,626,517,578,twilight sparkle
242027.png,https://derpicdn.net/img/view/2013/2/13/242027.png,1,0.919581354,71,0,565,537,494,537,twilight sparkle
261410.jpg,https://derpicdn.net/img/view/2013/3/3/261410.jpg,0,0.99903059,88,24,388,324,300,300,twilight sparkle
261552.png,https://derpicdn.net/img/view/2013/3/3/261552.png,0,0.996753454,208,25,460,277,252,252,twilight sparkle
27469.png,https://derpicdn.net/img/view/2012/7/1/27469.png,0,0.98512435,72,104,864,860,792,756,twilight sparkle
275562.png,https://derpicdn.net/img/view/2013/3/21/275562.png,0,0.994669974,191,193,629,631,438,438,twilight sparkle
275562.png,https://derpicdn.net/img/view/2013/3/21/275562.png,1,0.972938359,558,292,964,698,406,406,twilight sparkle
283686.png,https://derpicdn.net/img/view/2013/3/30/283686.png,0,0.993893027,922,108,1556,742,634,634,twilight sparkle
283887.jpg,https://derpicdn.net/img/view/2013/3/31/283887.jpg,0,0.99601686,156,177,454,475,298,298,twilight sparkle
285489.png,https://derpicdn.net/img/view/2013/4/1/285489.png,0,0.998926282,53,0,509,425,456,425,twilight sparkle
291638.png,https://derpicdn.net/img/view/2013/4/8/291638.png,0,0.983059883,71,36,281,246,210,210,twilight sparkle
293943.jpg,https://derpicdn.net/img/view/2013/4/10/293943.jpg,0,0.991368234,160,71,406,317,246,246,twilight sparkle
295195.png,https://derpicdn.net/img/view/2013/4/12/295195.png,0,0.916215062,233,0,581,321,348,321,twilight sparkle
29622.jpg,https://derpicdn.net/img/view/2012/7/3/29622.jpg,0,0.995054483,34,52,942,960,908,908,twilight sparkle
298209.png,https://derpicdn.net/img/view/2013/4/14/298209.png,0,0.994236588,15,0,471,449,456,449,twilight sparkle
303661.png,https://derpicdn.net/img/view/2013/4/20/303661.png,0,0.992936075,665,970,1277,1582,612,612,twilight sparkle
308178.jpg,https://derpicdn.net/img/view/2013/4/25/308178.jpg,0,0.996772587,390,0,950,553,560,553,twilight sparkle
315404.png,https://derpicdn.net/img/view/2013/5/3/315404.png,0,0.985591233,341,0,913,536,572,536,twilight sparkle
315448.png,https://derpicdn.net/img/view/2013/5/3/315448.png,0,0.998352468,704,54,1160,510,456,456,twilight sparkle
317646.jpg,https://derpicdn.net/img/view/2013/5/5/317646.jpg,0,0.987886786,1856,0,2224,315,368,315,twilight sparkle
317646.jpg,https://derpicdn.net/img/view/2013/5/5/317646.jpg,3,0.970107257,30,889,502,1361,472,472,twilight sparkle
317646.jpg,https://derpicdn.net/img/view/2013/5/5/317646.jpg,6,0.926759124,2501,1481,2823,1803,322,322,twilight sparkle
319244.png,https://derpicdn.net/img/view/2013/5/7/319244.png,0,0.998579383,262,0,684,396,422,396,twilight sparkle
323611.png,https://derpicdn.net/img/view/2013/5/13/323611.png,0,0.998377025,613,170,797,354,184,184,twilight sparkle
324788.jpg,https://derpicdn.net/img/view/2013/5/14/324788.jpg,0,0.989456117,420,0,1104,670,684,670,twilight sparkle
339042.png,https://derpicdn.net/img/view/2013/6/2/339042.png,0,0.998396277,665,0,1225,555,560,555,twilight sparkle
343425.jpg,https://derpicdn.net/img/view/2013/6/8/343425.jpg,0,0.971316278,436,113,884,561,448,448,twilight sparkle
344993.png,https://derpicdn.net/img/view/2013/6/10/344993.png,0,0.963480353,12,0,454,423,442,423,twilight sparkle
346463.png,https://derpicdn.net/img/view/2013/6/12/346463.png,0,0.979371727,75,0,685,567,610,567,twilight sparkle
349651.png,https://derpicdn.net/img/view/2013/6/16/349651.png,0,0.966102421,38,26,590,578,552,552,twilight sparkle
354280.jpg,https://derpicdn.net/img/view/2013/6/22/354280.jpg,0,0.991402924,64,0,408,339,344,339,twilight sparkle
359286.png,https://derpicdn.net/img/view/2013/6/28/359286.png,0,0.939058185,0,0,1727,1959,1727,1959,twilight sparkle
360116.png,https://derpicdn.net/img/view/2013/6/29/360116.png,0,0.976240098,0,0,4820,4550,4820,4550,twilight sparkle
362538.png,https://derpicdn.net/img/view/2013/7/2/362538.png,0,0.998373866,358,79,776,497,418,418,twilight sparkle
363978.png,https://derpicdn.net/img/view/2013/7/4/363978.png,0,0.992742717,328,0,759,415,431,415,twilight sparkle
365049.png,https://derpicdn.net/img/view/2013/7/5/365049.png,0,0.995920837,517,29,959,471,442,442,twilight sparkle
368867.jpg,https://derpicdn.net/img/view/2013/7/9/368867.jpg,0,0.988089263,225,0,777,547,552,547,twilight sparkle
369748.png,https://derpicdn.net/img/view/2013/7/10/369748.png,0,0.987878501,31,0,993,880,962,880,twilight sparkle
372829.png,https://derpicdn.net/img/view/2013/7/13/372829.png,0,0.996251702,2381,272,3781,1672,1400,1400,twilight sparkle
381434.png,https://derpicdn.net/img/view/2013/7/22/381434.png,0,0.963413179,131,0,1279,1108,1148,1108,twilight sparkle
382632.png,https://derpicdn.net/img/view/2013/7/24/382632.png,0,0.998736918,668,9,1756,1097,1088,1088,twilight sparkle
382760.png,https://derpicdn.net/img/view/2013/7/24/382760.png,0,0.969292223,5,0,517,489,512,489,twilight sparkle
388197.png,https://derpicdn.net/img/view/2013/8/1/388197.png,0,0.99769479,568,220,974,626,406,406,twilight sparkle
390953.png,https://derpicdn.net/img/view/2013/8/4/390953.png,0,0.997919679,349,20,945,616,596,596,twilight sparkle
393768.png,https://derpicdn.net/img/view/2013/8/7/393768.png,0,0.970514119,553,0,897,341,344,341,twilight sparkle
395557.png,https://derpicdn.net/img/view/2013/8/9/395557.png,0,0.935535312,83,39,331,287,248,248,twilight sparkle
407491.png,https://derpicdn.net/img/view/2013/8/22/407491.png,0,0.996379912,81,54,445,418,364,364,twilight sparkle
410675.png,https://derpicdn.net/img/view/2013/8/26/410675.png,0,0.9906407,0,0,500,465,500,465,twilight sparkle
411419.png,https://derpicdn.net/img/view/2013/8/26/411419.png,0,0.980630457,427,84,981,638,554,554,twilight sparkle
411530.png,https://derpicdn.net/img/view/2013/8/26/411530.png,0,0.997638404,216,14,494,292,278,278,twilight sparkle
413372.png,https://derpicdn.net/img/view/2013/8/29/413372.png,0,0.993957877,517,576,805,864,288,288,twilight sparkle
413372.png,https://derpicdn.net/img/view/2013/8/29/413372.png,1,0.970104873,235,18,545,328,310,310,twilight sparkle
413818.jpg,https://derpicdn.net/img/view/2013/8/29/413818.jpg,0,0.981790602,723,193,1629,1099,906,906,twilight sparkle
415424.png,https://derpicdn.net/img/view/2013/8/31/415424.png,0,0.997852862,1319,457,2559,1697,1240,1240,twilight sparkle
416369.png,https://derpicdn.net/img/view/2013/9/1/416369.png,0,0.964648426,434,39,1240,845,806,806,twilight sparkle
418174.png,https://derpicdn.net/img/view/2013/9/3/418174.png,0,0.993816197,392,0,1620,1098,1228,1098,twilight sparkle
419890.png,https://derpicdn.net/img/view/2013/9/5/419890.png,0,0.998570204,1139,0,2405,1131,1266,1131,twilight sparkle
420414.png,https://derpicdn.net/img/view/2013/9/6/420414.png,0,0.992058277,120,0,724,589,604,589,twilight sparkle
4240.png,https://derpicdn.net/img/view/2012/6/3/4240.png,0,0.917744339,19,41,341,363,322,322,twilight sparkle
4247.png,https://derpicdn.net/img/view/2012/6/3/4247.png,0,0.995074749,128,27,492,391,364,364,twilight sparkle
429322.png,https://derpicdn.net/img/view/2013/9/17/429322.png,0,0.913288653,2377,610,4677,2910,2300,2300,twilight sparkle
429527.jpg,https://derpicdn.net/img/view/2013/9/17/429527.jpg,0,0.995316386,188,6,606,424,418,418,twilight sparkle
430503.jpg,https://derpicdn.net/img/view/2013/9/19/430503.jpg,0,0.975086033,245,14,1163,932,918,918,twilight sparkle
430680.png,https://derpicdn.net/img/view/2013/9/19/430680.png,0,0.970809221,0,0,864,902,864,902,twilight sparkle
431779.png,https://derpicdn.net/img/view/2013/9/21/431779.png,0,0.902519464,2350,581,4704,2935,2354,2354,twilight sparkle
4323.png,https://derpicdn.net/img/view/2012/6/5/4323.png,0,0.931048572,1407,0,2397,885,990,885,twilight sparkle
4331.png,https://derpicdn.net/img/view/2012/6/5/4331.png,0,0.994100094,83,0,1349,985,1266,985,twilight sparkle
437067.png,https://derpicdn.net/img/view/2013/9/28/437067.png,0,0.997983038,0,0,356,359,356,359,twilight sparkle
437711.png,https://derpicdn.net/img/view/2013/9/29/437711.png,0,0.984049559,587,0,1677,1074,1090,1074,twilight sparkle
442823.png,https://derpicdn.net/img/view/2013/10/6/442823.png,0,0.958328485,285,21,943,719,658,698,twilight sparkle
444976.png,https://derpicdn.net/img/view/2013/10/9/444976.png,0,0.998491943,2260,0,4000,1564,1740,1564,twilight sparkle
446361.jpg,https://derpicdn.net/img/view/2013/10/11/446361.jpg,0,0.968849242,118,7,500,389,382,382,twilight sparkle
455846.jpg,https://derpicdn.net/img/view/2013/10/25/455846.jpg,0,0.999272704,327,23,1405,1101,1078,1078,twilight sparkle
458514.png,https://derpicdn.net/img/view/2013/10/28/458514.png,0,0.99789077,238,31,530,323,292,292,twilight sparkle
467679.png,https://derpicdn.net/img/view/2013/11/9/467679.png,0,0.993681192,488,0,5450,4356,4962,4356,twilight sparkle
467995.jpg,https://derpicdn.net/img/view/2013/11/9/467995.jpg,0,0.991954267,692,142,1602,1052,910,910,twilight sparkle
468088.png,https://derpicdn.net/img/view/2013/11/9/468088.png,0,0.993948162,330,0,986,627,656,627,twilight sparkle
4717.png,https://derpicdn.net/img/view/2012/6/17/4717.png,0,0.998707533,1237,384,1721,868,484,484,twilight sparkle
472085.png,https://derpicdn.net/img/view/2013/11/13/472085.png,0,0.997476637,559,0,1029,458,470,458,twilight sparkle
473090.png,https://derpicdn.net/img/view/2013/11/15/473090.png,0,0.989326298,2521,625,5477,3581,2956,2956,twilight sparkle
473483.png,https://derpicdn.net/img/view/2013/11/16/473483.png,0,0.94955045,75,0,521,420,446,420,twilight sparkle
480075.png,https://derpicdn.net/img/view/2013/11/24/480075.png,0,0.984784544,447,22,845,420,398,398,twilight sparkle
480470.jpg,https://derpicdn.net/img/view/2013/11/24/480470.jpg,0,0.983977795,0,5,517,607,517,602,twilight sparkle
480915.png,https://derpicdn.net/img/view/2013/11/25/480915.png,0,0.982864618,638,0,2050,1301,1412,1301,twilight sparkle
481348.png,https://derpicdn.net/img/view/2013/11/25/481348.png,0,0.94833374,0,415,308,737,308,322,twilight sparkle
486200.jpg,https://derpicdn.net/img/view/2013/11/30/486200.jpg,0,0.990790069,21,0,417,379,396,379,twilight sparkle
488570.jpg,https://derpicdn.net/img/view/2013/12/3/488570.jpg,0,0.998762727,41,0,409,344,368,344,twilight sparkle
488570.jpg,https://derpicdn.net/img/view/2013/12/3/488570.jpg,1,0.996109068,623,0,911,262,288,262,twilight sparkle
488570.jpg,https://derpicdn.net/img/view/2013/12/3/488570.jpg,2,0.980728149,1215,0,1567,336,352,336,twilight sparkle
488570.jpg,https://derpicdn.net/img/view/2013/12/3/488570.jpg,3,0.901308656,438,265,946,773,508,508,twilight sparkle
493890.png,https://derpicdn.net/img/view/2013/12/10/493890.png,0,0.992255867,108,0,532,386,424,386,twilight sparkle
493894.png,https://derpicdn.net/img/view/2013/12/10/493894.png,0,0.986137152,132,0,542,380,410,380,twilight sparkle
501597.png,https://derpicdn.net/img/view/2013/12/20/501597.png,0,0.996684611,58,0,404,344,346,344,twilight sparkle
501776.png,https://derpicdn.net/img/view/2013/12/20/501776.png,0,0.98529321,350,42,816,508,466,466,twilight sparkle
512172.png,https://derpicdn.net/img/view/2014/1/1/512172.png,0,0.923570395,0,0,1904,1804,1904,1804,twilight sparkle
513847.png,https://derpicdn.net/img/view/2014/1/3/513847.png,0,0.90279901,25,271,545,791,520,520,twilight sparkle
514190.png,https://derpicdn.net/img/view/2014/1/3/514190.png,0,0.976204455,554,0,1026,441,472,441,twilight sparkle
517137.png,https://derpicdn.net/img/view/2014/1/6/517137.png,0,0.99026376,772,322,1810,1360,1038,1038,twilight sparkle
518577.png,https://derpicdn.net/img/view/2014/1/8/518577.png,0,0.999325991,75,0,393,308,318,308,twilight sparkle
519430.png,https://derpicdn.net/img/view/2014/1/9/519430.png,0,0.945754528,514,562,1332,1380,818,818,twilight sparkle
520201.png,https://derpicdn.net/img/view/2014/1/10/520201.png,0,0.993243039,758,811,1730,1783,972,972,twilight sparkle
521592.png,https://derpicdn.net/img/view/2014/1/11/521592.png,0,0.986738443,66,65,502,501,436,436,twilight sparkle
524591.png,https://derpicdn.net/img/view/2014/1/14/524591.png,0,0.943982899,234,250,466,482,232,232,twilight sparkle
527169.png,https://derpicdn.net/img/view/2014/1/18/527169.png,0,0.987129688,322,139,800,627,478,488,twilight sparkle
528769.jpg,https://derpicdn.net/img/view/2014/1/19/528769.jpg,0,0.998372793,284,256,862,834,578,578,twilight sparkle
530754.png,https://derpicdn.net/img/view/2014/1/21/530754.png,0,0.907504022,0,11,789,863,789,852,twilight sparkle
534138.png,https://derpicdn.net/img/view/2014/1/25/534138.png,0,0.973243177,7,27,249,250,242,223,twilight sparkle
535218.png,https://derpicdn.net/img/view/2014/1/26/535218.png,0,0.996697426,2613,155,5367,2909,2754,2754,twilight sparkle
540766.png,https://derpicdn.net/img/view/2014/2/1/540766.png,0,0.989734173,357,0,1087,698,730,698,twilight sparkle
544780.png,https://derpicdn.net/img/view/2014/2/6/544780.png,0,0.952661514,0,30,462,550,462,520,twilight sparkle
557289.png,https://derpicdn.net/img/view/2014/2/20/557289.png,0,0.995961666,449,463,763,777,314,314,twilight sparkle
559061.png,https://derpicdn.net/img/view/2014/2/22/559061.png,0,0.927182317,1391,728,2705,2042,1314,1314,twilight sparkle
559539.png,https://derpicdn.net/img/view/2014/2/23/559539.png,0,0.995205879,0,180,206,446,206,266,twilight sparkle
559957.png,https://derpicdn.net/img/view/2014/2/23/559957.png,0,0.997081041,386,12,1370,996,984,984,twilight sparkle
563316.jpg,https://derpicdn.net/img/view/2014/2/28/563316.jpg,0,0.990618706,30,0,800,764,770,764,twilight sparkle
563507.png,https://derpicdn.net/img/view/2014/2/28/563507.png,0,0.959460557,403,905,983,1485,580,580,twilight sparkle
567070.png,https://derpicdn.net/img/view/2014/3/5/567070.png,0,0.97402215,0,0,393,504,393,504,twilight sparkle
569051.png,https://derpicdn.net/img/view/2014/3/8/569051.png,0,0.993305683,0,0,390,376,390,376,twilight sparkle
572912.png,https://derpicdn.net/img/view/2014/3/12/572912.png,0,0.969391227,0,0,427,555,427,555,twilight sparkle
573289.jpg,https://derpicdn.net/img/view/2014/3/12/573289.jpg,0,0.971052945,98,4,658,564,560,560,twilight sparkle
5746.png,https://derpicdn.net/img/view/2012/6/18/5746.png,0,0.985988498,149,0,1257,1047,1108,1047,twilight sparkle
576380.png,https://derpicdn.net/img/view/2014/3/16/576380.png,0,0.980795681,431,0,899,417,468,417,twilight sparkle
578972.png,https://derpicdn.net/img/view/2014/3/18/578972.png,0,0.977236569,36,15,292,271,256,256,twilight sparkle
580541.png,https://derpicdn.net/img/view/2014/3/20/580541.png,0,0.994703889,652,296,942,586,290,290,twilight sparkle
580541.png,https://derpicdn.net/img/view/2014/3/20/580541.png,1,0.986682773,239,0,647,377,408,377,twilight sparkle
581109.png,https://derpicdn.net/img/view/2014/3/21/581109.png,0,0.990375042,256,197,520,461,264,264,twilight sparkle
584308.png,https://derpicdn.net/img/view/2014/3/24/584308.png,0,0.953830004,2626,705,5038,3117,2412,2412,twilight sparkle
585228.png,https://derpicdn.net/img/view/2014/3/26/585228.png,0,0.94550705,130,18,544,432,414,414,twilight sparkle
589340.png,https://derpicdn.net/img/view/2014/3/31/589340.png,0,0.984882951,37,0,343,306,306,306,twilight sparkle
593634.png,https://derpicdn.net/img/view/2014/4/5/593634.png,0,0.999560237,0,0,428,453,428,453,twilight sparkle
593634.png,https://derpicdn.net/img/view/2014/4/5/593634.png,1,0.994424641,396,18,800,440,404,422,twilight sparkle
598166.jpg,https://derpicdn.net/img/view/2014/4/11/598166.jpg,0,0.944293439,81,0,417,333,336,333,twilight sparkle
599099.png,https://derpicdn.net/img/view/2014/4/13/599099.png,0,0.9986763,603,13,1533,943,930,930,twilight sparkle
601045.png,https://derpicdn.net/img/view/2014/4/15/601045.png,0,0.958419323,235,37,737,539,502,502,twilight sparkle
603466.png,https://derpicdn.net/img/view/2014/4/18/603466.png,0,0.998782396,828,112,2406,1690,1578,1578,twilight sparkle
605272.png,https://derpicdn.net/img/view/2014/4/20/605272.png,0,0.996197164,356,243,928,815,572,572,twilight sparkle
606925.png,https://derpicdn.net/img/view/2014/4/22/606925.png,0,0.989201784,594,0,1036,405,442,405,twilight sparkle
612684.png,https://derpicdn.net/img/view/2014/4/29/612684.png,0,0.995777845,252,0,630,362,378,362,twilight sparkle
614134.png,https://derpicdn.net/img/view/2014/4/30/614134.png,0,0.982056677,23,11,299,287,276,276,twilight sparkle
614492.png,https://derpicdn.net/img/view/2014/5/1/614492.png,0,0.980870247,75,0,695,615,620,615,twilight sparkle
61770.png,https://derpicdn.net/img/view/2012/7/30/61770.png,0,0.910582304,241,34,619,412,378,378,twilight sparkle
623293.png,https://derpicdn.net/img/view/2014/5/11/623293.png,0,0.959021986,253,16,900,700,647,684,twilight sparkle
623345.png,https://derpicdn.net/img/view/2014/5/11/623345.png,0,0.923899114,352,163,818,629,466,466,twilight sparkle
623750.png,https://derpicdn.net/img/view/2014/5/11/623750.png,0,0.997258723,0,11,438,457,438,446,twilight sparkle
624839.png,https://derpicdn.net/img/view/2014/5/12/624839.png,0,0.907764137,169,20,633,484,464,464,twilight sparkle
628116.png,https://derpicdn.net/img/view/2014/5/16/628116.png,0,0.99690026,1011,401,1893,1283,882,882,twilight sparkle
631115.png,https://derpicdn.net/img/view/2014/5/19/631115.png,0,0.990728796,370,109,800,539,430,430,twilight sparkle
639137.png,https://derpicdn.net/img/view/2014/5/28/639137.png,0,0.991542935,824,379,1024,599,200,220,twilight sparkle
639137.png,https://derpicdn.net/img/view/2014/5/28/639137.png,1,0.970339954,241,341,519,619,278,278,twilight sparkle
639137.png,https://derpicdn.net/img/view/2014/5/28/639137.png,2,0.961010098,70,0,346,247,276,247,twilight sparkle
639483.jpg,https://derpicdn.net/img/view/2014/5/28/639483.jpg,0,0.973423064,1423,296,2151,1024,728,728,twilight sparkle
640593.png,https://derpicdn.net/img/view/2014/5/30/640593.png,0,0.98957777,1328,5,3258,1935,1930,1930,twilight sparkle
644460.jpg,https://derpicdn.net/img/view/2014/6/4/644460.jpg,0,0.997169256,39,0,1007,905,968,905,twilight sparkle
652005.jpg,https://derpicdn.net/img/view/2014/6/13/652005.jpg,0,0.991612017,72,0,322,239,250,239,twilight sparkle
654697.png,https://derpicdn.net/img/view/2014/6/16/654697.png,0,0.998693526,222,0,534,299,312,299,twilight sparkle
654798.png,https://derpicdn.net/img/view/2014/6/16/654798.png,0,0.921272933,477,190,1041,754,564,564,twilight sparkle
657302.png,https://derpicdn.net/img/view/2014/6/20/657302.png,0,0.997663856,1759,0,3225,1395,1466,1395,twilight sparkle
657836.png,https://derpicdn.net/img/view/2014/6/20/657836.png,0,0.996724904,251,0,499,240,248,240,twilight sparkle
659437.png,https://derpicdn.net/img/view/2014/6/23/659437.png,0,0.998508513,163,0,985,809,822,809,twilight sparkle
664036.png,https://derpicdn.net/img/view/2014/6/29/664036.png,0,0.963603854,368,62,912,606,544,544,twilight sparkle
665991.png,https://derpicdn.net/img/view/2014/7/2/665991.png,1,0.939359903,777,1058,2281,2562,1504,1504,twilight sparkle
666840.png,https://derpicdn.net/img/view/2014/7/3/666840.png,0,0.996142983,781,113,1731,1063,950,950,twilight sparkle
670870.png,https://derpicdn.net/img/view/2014/7/9/670870.png,0,0.997821271,274,272,736,734,462,462,twilight sparkle
672373.jpg,https://derpicdn.net/img/view/2014/7/11/672373.jpg,0,0.986688435,620,0,1604,881,984,881,twilight sparkle
680479.jpg,https://derpicdn.net/img/view/2014/7/21/680479.jpg,0,0.950829983,140,0,378,236,238,236,twilight sparkle
685105.png,https://derpicdn.net/img/view/2014/7/28/685105.png,0,0.988036156,0,4,438,472,438,468,twilight sparkle
691032.png,https://derpicdn.net/img/view/2014/8/4/691032.png,0,0.998062789,90,0,518,424,428,424,twilight sparkle
692637.png,https://derpicdn.net/img/view/2014/8/6/692637.png,0,0.971775055,235,6,1007,778,772,772,twilight sparkle
693635.png,https://derpicdn.net/img/view/2014/8/7/693635.png,0,0.912867129,0,0,1108,1115,1108,1115,twilight sparkle
694003.png,https://derpicdn.net/img/view/2014/8/7/694003.png,0,0.999141514,867,0,1893,809,1026,809,twilight sparkle
696690.png,https://derpicdn.net/img/view/2014/8/10/696690.png,0,0.901373506,924,276,1636,988,712,712,twilight sparkle
696868.png,https://derpicdn.net/img/view/2014/8/11/696868.png,0,0.982398868,75,12,475,412,400,400,twilight sparkle
699329.jpg,https://derpicdn.net/img/view/2014/8/14/699329.jpg,0,0.998310566,753,663,1493,1403,740,740,twilight sparkle
702384.png,https://derpicdn.net/img/view/2014/8/18/702384.png,0,0.990762591,0,0,833,881,833,881,twilight sparkle
706146.jpg,https://derpicdn.net/img/view/2014/8/23/706146.jpg,0,0.99128294,166,1,520,355,354,354,twilight sparkle
706478.png,https://derpicdn.net/img/view/2014/8/23/706478.png,0,0.99939239,90,0,514,418,424,418,twilight sparkle
707538.png,https://derpicdn.net/img/view/2014/8/25/707538.png,1,0.980414391,315,0,685,367,370,367,twilight sparkle
707538.png,https://derpicdn.net/img/view/2014/8/25/707538.png,2,0.942702532,850,81,1210,441,360,360,twilight sparkle
707884.png,https://derpicdn.net/img/view/2014/8/25/707884.png,0,0.973286629,231,27,739,535,508,508,twilight sparkle
708878.jpg,https://derpicdn.net/img/view/2014/8/26/708878.jpg,0,0.99338311,0,0,557,509,557,509,twilight sparkle
709269.png,https://derpicdn.net/img/view/2014/8/27/709269.png,0,0.980076969,613,0,1223,573,610,573,twilight sparkle
710734.png,https://derpicdn.net/img/view/2014/8/30/710734.png,0,0.976877868,718,0,1436,673,718,673,twilight sparkle
712044.png,https://derpicdn.net/img/view/2014/8/31/712044.png,0,0.989966452,510,20,1030,540,520,520,twilight sparkle
713079.png,https://derpicdn.net/img/view/2014/9/1/713079.png,0,0.923997581,262,21,582,341,320,320,twilight sparkle
713220.png,https://derpicdn.net/img/view/2014/9/1/713220.png,0,0.97565645,160,92,590,522,430,430,twilight sparkle
714422.png,https://derpicdn.net/img/view/2014/9/4/714422.png,0,0.902814388,0,0,1207,1231,1207,1231,twilight sparkle
715644.png,https://derpicdn.net/img/view/2014/9/5/715644.png,0,0.997190773,686,116,1386,816,700,700,twilight sparkle
720113.png,https://derpicdn.net/img/view/2014/9/11/720113.png,0,0.983075678,290,25,736,471,446,446,twilight sparkle
721845.png,https://derpicdn.net/img/view/2014/9/14/721845.png,0,0.964102507,2,0,588,543,586,543,twilight sparkle
726279.png,https://derpicdn.net/img/view/2014/9/21/726279.png,0,0.987498045,278,193,588,503,310,310,twilight sparkle
726685.png,https://derpicdn.net/img/view/2014/9/21/726685.png,0,0.996056616,418,339,786,707,368,368,twilight sparkle
733783.png,https://derpicdn.net/img/view/2014/10/2/733783.png,0,0.996477783,214,0,1032,738,818,738,twilight sparkle
733843.png,https://derpicdn.net/img/view/2014/10/2/733843.png,0,0.990914404,404,0,1972,1376,1568,1376,twilight sparkle
735052.png,https://derpicdn.net/img/view/2014/10/3/735052.png,0,0.987946868,45,92,2337,2402,2292,2310,twilight sparkle
736321.png,https://derpicdn.net/img/view/2014/10/5/736321.png,0,0.999940276,21,1002,543,1524,522,522,twilight sparkle
739386.png,https://derpicdn.net/img/view/2014/10/9/739386.png,0,0.996293604,136,30,346,240,210,210,twilight sparkle
741089.png,https://derpicdn.net/img/view/2014/10/12/741089.png,0,0.959011316,205,97,521,413,316,316,twilight sparkle
744559.jpg,https://derpicdn.net/img/view/2014/10/17/744559.jpg,0,0.901875019,65,7,427,369,362,362,twilight sparkle
745607.png,https://derpicdn.net/img/view/2014/10/18/745607.png,0,0.966094971,0,0,540,707,540,707,twilight sparkle
746.png,https://derpicdn.net/img/view/2012/1/17/746.png,0,0.929133773,132,0,668,530,536,530,twilight sparkle
747436.jpg,https://derpicdn.net/img/view/2014/10/21/747436.jpg,0,0.993875206,189,0,1539,1089,1350,1089,twilight sparkle
747443.png,https://derpicdn.net/img/view/2014/10/21/747443.png,0,0.997071445,768,179,1400,811,632,632,twilight sparkle
747490.png,https://derpicdn.net/img/view/2014/10/21/747490.png,0,0.97573632,0,0,1335,1249,1335,1249,twilight sparkle
749015.png,https://derpicdn.net/img/view/2014/10/23/749015.png,0,0.987094998,0,0,1130,1251,1130,1251,twilight sparkle
749036.png,https://derpicdn.net/img/view/2014/10/23/749036.png,0,0.981657922,0,0,1168,1217,1168,1217,twilight sparkle
751708.png,https://derpicdn.net/img/view/2014/10/27/751708.png,0,0.998793423,302,23,1002,723,700,700,twilight sparkle
753643.png,https://derpicdn.net/img/view/2014/10/30/753643.png,0,0.971909165,481,191,1509,1219,1028,1028,twilight sparkle
755627.png,https://derpicdn.net/img/view/2014/11/1/755627.png,0,0.91874975,186,0,884,619,698,619,twilight sparkle
755876.png,https://derpicdn.net/img/view/2014/11/2/755876.png,0,0.984244466,702,321,1356,975,654,654,twilight sparkle
760039.png,https://derpicdn.net/img/view/2014/11/7/760039.png,0,0.985832095,501,0,823,311,322,311,twilight sparkle
760623.png,https://derpicdn.net/img/view/2014/11/8/760623.png,0,0.970327616,270,0,628,350,358,350,twilight sparkle
763034.png,https://derpicdn.net/img/view/2014/11/12/763034.png,0,0.998519778,226,29,600,403,374,374,twilight sparkle
770899.png,https://derpicdn.net/img/view/2014/11/24/770899.png,0,0.980965853,44,0,422,363,378,363,twilight sparkle
770972.png,https://derpicdn.net/img/view/2014/11/24/770972.png,0,0.98201108,221,15,789,583,568,568,twilight sparkle
773882.png,https://derpicdn.net/img/view/2014/11/29/773882.png,0,0.974463522,217,0,737,458,520,458,twilight sparkle
776347.png,https://derpicdn.net/img/view/2014/12/2/776347.png,0,0.987252414,333,313,1161,1141,828,828,twilight sparkle
777499.png,https://derpicdn.net/img/view/2014/12/4/777499.png,0,0.940527916,0,128,418,550,418,422,twilight sparkle
779849.png,https://derpicdn.net/img/view/2014/12/7/779849.png,0,0.990832567,112,138,752,778,640,640,twilight sparkle
781331.png,https://derpicdn.net/img/view/2014/12/9/781331.png,0,0.977482796,332,8,656,332,324,324,twilight sparkle
784293.png,https://derpicdn.net/img/view/2014/12/13/784293.png,0,0.999372721,3060,0,5868,2717,2808,2717,twilight sparkle
784583.png,https://derpicdn.net/img/view/2014/12/14/784583.png,0,0.987145364,93,90,2177,2174,2084,2084,twilight sparkle
784880.png,https://derpicdn.net/img/view/2014/12/14/784880.png,0,0.974969804,191,20,1105,934,914,914,twilight sparkle
78824.jpg,https://derpicdn.net/img/view/2012/8/20/78824.jpg,0,0.981842458,422,69,776,423,354,354,twilight sparkle
790063.png,https://derpicdn.net/img/view/2014/12/22/790063.png,0,0.987346411,905,183,1379,657,474,474,twilight sparkle
790630.png,https://derpicdn.net/img/view/2014/12/22/790630.png,0,0.969377577,0,0,427,556,427,556,twilight sparkle
797572.jpg,https://derpicdn.net/img/view/2015/1/1/797572.jpg,0,0.991609573,323,30,867,574,544,544,twilight sparkle
797845.png,https://derpicdn.net/img/view/2015/1/2/797845.png,0,0.990139067,624,0,1254,609,630,609,twilight sparkle
798946.png,https://derpicdn.net/img/view/2015/1/3/798946.png,0,0.991505802,339,0,769,411,430,411,twilight sparkle
800412.png,https://derpicdn.net/img/view/2015/1/6/800412.png,0,0.999225557,138,0,854,711,716,711,twilight sparkle
800414.png,https://derpicdn.net/img/view/2015/1/6/800414.png,0,0.997502327,119,0,875,729,756,729,twilight sparkle
800415.png,https://derpicdn.net/img/view/2015/1/6/800415.png,0,0.998971879,142,2,842,702,700,700,twilight sparkle
80167.jpg,https://derpicdn.net/img/view/2012/8/22/80167.jpg,0,0.998328626,231,0,445,207,214,207,twilight sparkle
802337.jpg,https://derpicdn.net/img/view/2015/1/8/802337.jpg,0,0.988349974,825,0,1477,534,652,534,twilight sparkle
803454.jpg,https://derpicdn.net/img/view/2015/1/10/803454.jpg,0,0.975189745,85,0,675,567,590,567,twilight sparkle
803972.png,https://derpicdn.net/img/view/2015/1/11/803972.png,0,0.975490868,44,0,524,450,480,450,twilight sparkle
809149.jpg,https://derpicdn.net/img/view/2015/1/18/809149.jpg,0,0.939149022,129,0,795,668,666,668,twilight sparkle
810949.png,https://derpicdn.net/img/view/2015/1/20/810949.png,0,0.987606406,440,58,1036,654,596,596,twilight sparkle
814476.png,https://derpicdn.net/img/view/2015/1/25/814476.png,0,0.980627358,254,39,930,715,676,676,twilight sparkle
814673.png,https://derpicdn.net/img/view/2015/1/25/814673.png,0,0.949583828,244,0,608,352,364,352,twilight sparkle
815955.png,https://derpicdn.net/img/view/2015/1/27/815955.png,0,0.980299532,4,0,440,435,436,435,twilight sparkle
815958.png,https://derpicdn.net/img/view/2015/1/27/815958.png,0,0.998960197,659,0,1277,600,618,600,twilight sparkle
818283.png,https://derpicdn.net/img/view/2015/1/31/818283.png,0,0.926774502,223,0,1595,1033,1372,1033,twilight sparkle
819754.png,https://derpicdn.net/img/view/2015/2/2/819754.png,0,0.916528046,130,0,278,141,148,141,twilight sparkle
822115.png,https://derpicdn.net/img/view/2015/2/5/822115.png,0,0.99092859,46,0,464,374,418,374,twilight sparkle
823139.png,https://derpicdn.net/img/view/2015/2/7/823139.png,0,0.999737561,429,0,885,378,456,378,twilight sparkle
823879.png,https://derpicdn.net/img/view/2015/2/8/823879.png,0,0.993406951,696,0,1348,640,652,640,twilight sparkle
824793.png,https://derpicdn.net/img/view/2015/2/9/824793.png,0,0.999661326,68,1013,476,1421,408,408,twilight sparkle
824793.png,https://derpicdn.net/img/view/2015/2/9/824793.png,2,0.901965797,742,789,1266,1313,524,524,twilight sparkle
825284.png,https://derpicdn.net/img/view/2015/2/10/825284.png,0,0.99357754,19,0,900,1004,881,1004,twilight sparkle
825378.png,https://derpicdn.net/img/view/2015/2/10/825378.png,0,0.990304947,119,6,1355,1242,1236,1236,twilight sparkle
826847.png,https://derpicdn.net/img/view/2015/2/12/826847.png,0,0.970246136,278,0,800,529,522,529,twilight sparkle
828323.png,https://derpicdn.net/img/view/2015/2/14/828323.png,0,0.977997065,352,224,628,500,276,276,twilight sparkle
828374.png,https://derpicdn.net/img/view/2015/2/14/828374.png,0,0.98517549,228,117,590,479,362,362,twilight sparkle
83036.png,https://derpicdn.net/img/view/2012/8/26/83036.png,0,0.982287943,149,251,907,1009,758,758,twilight sparkle
832434.png,https://derpicdn.net/img/view/2015/2/19/832434.png,0,0.926404715,325,0,999,670,674,670,twilight sparkle
833751.png,https://derpicdn.net/img/view/2015/2/21/833751.png,0,0.996515989,336,0,778,417,442,417,twilight sparkle
834057.jpg,https://derpicdn.net/img/view/2015/2/21/834057.jpg,0,0.977389872,19,16,457,454,438,438,twilight sparkle
834306.png,https://derpicdn.net/img/view/2015/2/21/834306.png,0,0.997902155,167,0,703,488,536,488,twilight sparkle
836978.png,https://derpicdn.net/img/view/2015/2/25/836978.png,0,0.919510484,532,118,730,316,198,198,twilight sparkle
837040.png,https://derpicdn.net/img/view/2015/2/25/837040.png,0,0.976087451,187,0,828,624,641,624,twilight sparkle
837626.png,https://derpicdn.net/img/view/2015/2/26/837626.png,0,0.997518122,649,33,939,323,290,290,twilight sparkle
837795.png,https://derpicdn.net/img/view/2015/2/26/837795.png,0,0.993926883,144,22,652,530,508,508,twilight sparkle
839976.png,https://derpicdn.net/img/view/2015/3/1/839976.png,0,0.986769438,21,0,299,273,278,273,twilight sparkle
8400.png,https://derpicdn.net/img/view/2012/6/18/8400.png,0,0.991450131,359,55,889,585,530,530,twilight sparkle
841256.png,https://derpicdn.net/img/view/2015/3/3/841256.png,1,0.975025475,4,0,394,375,390,375,twilight sparkle
842069.png,https://derpicdn.net/img/view/2015/3/4/842069.png,0,0.990604639,263,4,793,534,530,530,twilight sparkle
842092.png,https://derpicdn.net/img/view/2015/3/4/842092.png,0,0.977745831,0,78,1077,1260,1077,1182,twilight sparkle
842099.png,https://derpicdn.net/img/view/2015/3/4/842099.png,0,0.977194369,10,112,868,970,858,858,twilight sparkle
848814.png,https://derpicdn.net/img/view/2015/3/13/848814.png,0,0.976626635,1014,0,3144,1950,2130,1950,twilight sparkle
853347.png,https://derpicdn.net/img/view/2015/3/20/853347.png,0,0.9972381,437,26,729,318,292,292,twilight sparkle
853347.png,https://derpicdn.net/img/view/2015/3/20/853347.png,1,0.978064537,58,0,384,302,326,302,twilight sparkle
855513.png,https://derpicdn.net/img/view/2015/3/23/855513.png,0,0.997088671,379,78,991,690,612,612,twilight sparkle
857376.png,https://derpicdn.net/img/view/2015/3/26/857376.png,0,0.99653399,242,0,1492,1205,1250,1205,twilight sparkle
858028.png,https://derpicdn.net/img/view/2015/3/27/858028.png,1,0.967221439,901,86,1153,338,252,252,twilight sparkle
860003.png,https://derpicdn.net/img/view/2015/3/29/860003.png,0,0.987593949,123,444,625,946,502,502,twilight sparkle
860434.png,https://derpicdn.net/img/view/2015/3/30/860434.png,0,0.98651433,87,0,479,381,392,381,twilight sparkle
862250.png,https://derpicdn.net/img/view/2015/4/1/862250.png,0,0.981378734,115,0,1000,912,885,912,twilight sparkle
863790.png,https://derpicdn.net/img/view/2015/4/3/863790.png,0,0.972188532,225,0,1913,1622,1688,1622,twilight sparkle
864039.png,https://derpicdn.net/img/view/2015/4/3/864039.png,0,0.963901341,126,52,414,340,288,288,twilight sparkle
865763.png,https://derpicdn.net/img/view/2015/4/5/865763.png,0,0.967731893,159,0,800,654,641,654,twilight sparkle
868603.png,https://derpicdn.net/img/view/2015/4/8/868603.png,0,0.931712627,531,134,1703,1306,1172,1172,twilight sparkle
871123.png,https://derpicdn.net/img/view/2015/4/11/871123.png,0,0.978676498,654,1466,1174,1986,520,520,twilight sparkle
871123.png,https://derpicdn.net/img/view/2015/4/11/871123.png,1,0.968519032,480,869,962,1351,482,482,twilight sparkle
871441.png,https://derpicdn.net/img/view/2015/4/11/871441.png,0,0.922353625,0,0,2112,1963,2112,1963,twilight sparkle
871443.jpg,https://derpicdn.net/img/view/2015/4/11/871443.jpg,0,0.996958077,10,0,600,540,590,540,twilight sparkle
871479.png,https://derpicdn.net/img/view/2015/4/11/871479.png,0,0.980052531,0,19,678,707,678,688,twilight sparkle
871490.png,https://derpicdn.net/img/view/2015/4/11/871490.png,0,0.980609059,104,7,926,829,822,822,twilight sparkle
871595.png,https://derpicdn.net/img/view/2015/4/11/871595.png,0,0.998282611,399,1657,833,2091,434,434,twilight sparkle
871664.png,https://derpicdn.net/img/view/2015/4/11/871664.png,0,0.994980693,1330,36,2152,858,822,822,twilight sparkle
871701.png,https://derpicdn.net/img/view/2015/4/11/871701.png,0,0.98214215,377,32,759,414,382,382,twilight sparkle
871731.png,https://derpicdn.net/img/view/2015/4/11/871731.png,0,0.920883656,0,0,972,720,972,720,twilight sparkle
871865.png,https://derpicdn.net/img/view/2015/4/11/871865.png,0,0.992055655,0,0,2219,2284,2219,2284,twilight sparkle
871914.png,https://derpicdn.net/img/view/2015/4/11/871914.png,0,0.932578683,603,489,4806,4937,4203,4448,twilight sparkle
872000.png,https://derpicdn.net/img/view/2015/4/12/872000.png,0,0.985733688,865,909,5500,5717,4635,4808,twilight sparkle
872039.png,https://derpicdn.net/img/view/2015/4/12/872039.png,0,0.996209502,1081,0,3139,2022,2058,2022,twilight sparkle
872060.png,https://derpicdn.net/img/view/2015/4/12/872060.png,0,0.936230063,124,0,730,591,606,591,twilight sparkle
872500.png,https://derpicdn.net/img/view/2015/4/12/872500.png,0,0.967498183,92,86,1223,1222,1131,1136,twilight sparkle
872788.png,https://derpicdn.net/img/view/2015/4/12/872788.png,0,0.998096108,51,75,469,493,418,418,twilight sparkle
872890.png,https://derpicdn.net/img/view/2015/4/13/872890.png,0,0.975840867,250,390,2840,2980,2590,2590,twilight sparkle
873291.png,https://derpicdn.net/img/view/2015/4/13/873291.png,0,0.910095692,112,60,636,584,524,524,twilight sparkle
873474.png,https://derpicdn.net/img/view/2015/4/13/873474.png,0,0.982936025,0,45,1297,1413,1297,1368,twilight sparkle
873510.png,https://derpicdn.net/img/view/2015/4/13/873510.png,0,0.97548008,1363,877,4806,4591,3443,3714,twilight sparkle
873714.png,https://derpicdn.net/img/view/2015/4/14/873714.png,0,0.962046444,1099,0,1701,533,602,533,twilight sparkle
873821.png,https://derpicdn.net/img/view/2015/4/14/873821.png,0,0.986531496,0,0,961,957,961,957,twilight sparkle
873848.png,https://derpicdn.net/img/view/2015/4/14/873848.png,0,0.971817553,0,0,409,340,409,340,twilight sparkle
874011.png,https://derpicdn.net/img/view/2015/4/14/874011.png,0,0.978317857,100,99,850,849,750,750,twilight sparkle
875232.png,https://derpicdn.net/img/view/2015/4/16/875232.png,0,0.995606482,544,499,768,723,224,224,twilight sparkle
875232.png,https://derpicdn.net/img/view/2015/4/16/875232.png,1,0.994512856,111,0,371,256,260,256,twilight sparkle
875232.png,https://derpicdn.net/img/view/2015/4/16/875232.png,2,0.961132824,407,70,777,440,370,370,twilight sparkle
876291.png,https://derpicdn.net/img/view/2015/4/17/876291.png,0,0.958159328,584,214,962,592,378,378,twilight sparkle
876472.png,https://derpicdn.net/img/view/2015/4/18/876472.png,0,0.983281136,223,0,1441,1169,1218,1169,twilight sparkle
876540.png,https://derpicdn.net/img/view/2015/4/18/876540.png,0,0.991866767,1,0,827,755,826,755,twilight sparkle
879621.png,https://derpicdn.net/img/view/2015/4/21/879621.png,0,0.919722378,449,135,2543,2229,2094,2094,twilight sparkle
880720.png,https://derpicdn.net/img/view/2015/4/23/880720.png,0,0.980907619,451,0,847,389,396,389,twilight sparkle
881305.jpg,https://derpicdn.net/img/view/2015/4/24/881305.jpg,0,0.997615874,459,0,1167,689,708,689,twilight sparkle
882000.png,https://derpicdn.net/img/view/2015/4/25/882000.png,0,0.997484684,506,63,896,453,390,390,twilight sparkle
883624.png,https://derpicdn.net/img/view/2015/4/26/883624.png,0,0.988938987,601,370,1463,1232,862,862,twilight sparkle
885709.png,https://derpicdn.net/img/view/2015/4/30/885709.png,0,0.98666501,270,34,614,378,344,344,twilight sparkle
886275.png,https://derpicdn.net/img/view/2015/4/30/886275.png,0,0.921646655,64,12,456,404,392,392,twilight sparkle
889268.png,https://derpicdn.net/img/view/2015/5/4/889268.png,0,0.975920677,50,0,1110,1040,1060,1040,twilight sparkle
891462.png,https://derpicdn.net/img/view/2015/5/8/891462.png,1,0.989916146,222,21,752,551,530,530,twilight sparkle
891763.png,https://derpicdn.net/img/view/2015/5/8/891763.png,0,0.99485141,223,50,791,618,568,568,twilight sparkle
892612.png,https://derpicdn.net/img/view/2015/5/10/892612.png,0,0.997801721,236,0,700,513,464,513,twilight sparkle
892613.png,https://derpicdn.net/img/view/2015/5/10/892613.png,0,0.997660756,232,0,700,518,468,518,twilight sparkle
898230.png,https://derpicdn.net/img/view/2015/5/17/898230.png,0,0.977869928,142,10,482,350,340,340,twilight sparkle
898578.png,https://derpicdn.net/img/view/2015/5/17/898578.png,0,0.99627912,91,0,745,635,654,635,twilight sparkle
899110.png,https://derpicdn.net/img/view/2015/5/18/899110.png,0,0.984000981,0,0,295,292,295,292,twilight sparkle
900095.png,https://derpicdn.net/img/view/2015/5/19/900095.png,0,0.976653993,0,0,1682,1668,1682,1668,twilight sparkle
903065.png,https://derpicdn.net/img/view/2015/5/24/903065.png,0,0.984692335,107,0,1121,720,1014,720,twilight sparkle
903775.png,https://derpicdn.net/img/view/2015/5/25/903775.png,0,0.986045778,872,0,1856,974,984,974,twilight sparkle
904512.png,https://derpicdn.net/img/view/2015/5/26/904512.png,0,0.933668435,37,0,405,326,368,326,twilight sparkle
905081.png,https://derpicdn.net/img/view/2015/5/27/905081.png,0,0.995056987,55,99,529,573,474,474,twilight sparkle
910084.png,https://derpicdn.net/img/view/2015/6/4/910084.png,0,0.998690188,655,157,1247,749,592,592,twilight sparkle
91174.png,https://derpicdn.net/img/view/2012/9/6/91174.png,0,0.976635814,34,429,244,639,210,210,twilight sparkle
913013.png,https://derpicdn.net/img/view/2015/6/8/913013.png,0,0.926204324,214,79,754,619,540,540,twilight sparkle
913302.png,https://derpicdn.net/img/view/2015/6/8/913302.png,0,0.987266719,129,0,1944,1823,1815,1823,twilight sparkle
914003.png,https://derpicdn.net/img/view/2015/6/10/914003.png,0,0.998139679,219,15,485,281,266,266,twilight sparkle
914991.png,https://derpicdn.net/img/view/2015/6/11/914991.png,0,0.972352445,281,16,903,638,622,622,twilight sparkle
915003.png,https://derpicdn.net/img/view/2015/6/11/915003.png,0,0.999184072,1282,24,1980,722,698,698,twilight sparkle
915474.png,https://derpicdn.net/img/view/2015/6/12/915474.png,0,0.959390223,110,4,528,422,418,418,twilight sparkle
916787.png,https://derpicdn.net/img/view/2015/6/14/916787.png,0,0.911814272,140,492,970,1322,830,830,twilight sparkle
919758.png,https://derpicdn.net/img/view/2015/6/19/919758.png,0,0.977752328,111,477,717,1083,606,606,twilight sparkle
920237.png,https://derpicdn.net/img/view/2015/6/20/920237.png,0,0.993639231,1235,45,2849,1659,1614,1614,twilight sparkle
920699.png,https://derpicdn.net/img/view/2015/6/21/920699.png,0,0.969646454,227,36,733,542,506,506,twilight sparkle
921583.png,https://derpicdn.net/img/view/2015/6/22/921583.png,0,0.96943152,61,13,845,797,784,784,twilight sparkle
922194.png,https://derpicdn.net/img/view/2015/6/23/922194.png,0,0.999267995,303,64,615,376,312,312,twilight sparkle
922960.png,https://derpicdn.net/img/view/2015/6/24/922960.png,0,0.955312848,189,126,885,822,696,696,twilight sparkle
924457.png,https://derpicdn.net/img/view/2015/6/27/924457.png,0,0.995465517,215,257,545,587,330,330,twilight sparkle
924832.jpg,https://derpicdn.net/img/view/2015/6/27/924832.jpg,0,0.99106127,7,0,981,917,974,917,twilight sparkle
924899.png,https://derpicdn.net/img/view/2015/6/27/924899.png,0,0.947308481,157,0,1393,1017,1236,1017,twilight sparkle
925210.png,https://derpicdn.net/img/view/2015/6/28/925210.png,0,0.99638027,141,50,483,392,342,342,twilight sparkle
925661.png,https://derpicdn.net/img/view/2015/6/28/925661.png,0,0.995529592,230,0,878,635,648,635,twilight sparkle
926292.jpg,https://derpicdn.net/img/view/2015/6/29/926292.jpg,0,0.991209149,1436,415,2048,1043,612,628,twilight sparkle
927785.png,https://derpicdn.net/img/view/2015/7/1/927785.png,0,0.993453026,0,0,1675,1742,1675,1742,twilight sparkle
927789.png,https://derpicdn.net/img/view/2015/7/1/927789.png,0,0.965303302,48,57,1412,1421,1364,1364,twilight sparkle
929898.png,https://derpicdn.net/img/view/2015/7/4/929898.png,0,0.995150506,1,31,471,501,470,470,twilight sparkle
929898.png,https://derpicdn.net/img/view/2015/7/4/929898.png,1,0.966606796,302,37,790,525,488,488,twilight sparkle
929905.png,https://derpicdn.net/img/view/2015/7/4/929905.png,1,0.961773872,732,584,1064,916,332,332,twilight sparkle
930351.png,https://derpicdn.net/img/view/2015/7/5/930351.png,0,0.997724891,1021,85,1745,809,724,724,twilight sparkle
931132.png,https://derpicdn.net/img/view/2015/7/6/931132.png,0,0.957494259,109,213,645,749,536,536,twilight sparkle
932590.png,https://derpicdn.net/img/view/2015/7/8/932590.png,0,0.970148504,0,0,1880,1690,1880,1690,twilight sparkle
932604.png,https://derpicdn.net/img/view/2015/7/8/932604.png,1,0.95784086,85,157,553,625,468,468,twilight sparkle
932679.png,https://derpicdn.net/img/view/2015/7/8/932679.png,0,0.99350971,0,0,504,512,504,512,twilight sparkle
932792.png,https://derpicdn.net/img/view/2015/7/8/932792.png,0,0.982274294,4,0,460,441,456,441,twilight sparkle
933505.png,https://derpicdn.net/img/view/2015/7/9/933505.png,0,0.985177159,228,117,590,479,362,362,twilight sparkle
9337.png,https://derpicdn.net/img/view/2012/6/19/9337.png,0,0.969653189,103,0,429,291,326,291,twilight sparkle
934155.png,https://derpicdn.net/img/view/2015/7/10/934155.png,0,0.969626248,169,61,655,547,486,486,twilight sparkle
934260.jpg,https://derpicdn.net/img/view/2015/7/10/934260.jpg,0,0.981692731,600,133,1014,547,414,414,twilight sparkle
937184.png,https://derpicdn.net/img/view/2015/7/15/937184.png,0,0.991225839,88,0,708,570,620,570,twilight sparkle
938066.jpg,https://derpicdn.net/img/view/2015/7/16/938066.jpg,0,0.978104234,40,4,390,354,350,350,twilight sparkle
939454.png,https://derpicdn.net/img/view/2015/7/18/939454.png,0,0.970178545,2,0,733,729,731,729,twilight sparkle
939978.png,https://derpicdn.net/img/view/2015/7/19/939978.png,0,0.994469225,31,0,659,579,628,579,twilight sparkle
943084.jpg,https://derpicdn.net/img/view/2015/7/24/943084.jpg,0,0.984255433,744,0,2226,1353,1482,1353,twilight sparkle
943243.jpg,https://derpicdn.net/img/view/2015/7/25/943243.jpg,0,0.991158903,250,433,646,829,396,396,twilight sparkle
943305.png,https://derpicdn.net/img/view/2015/7/25/943305.png,0,0.991877735,270,18,1474,1222,1204,1204,twilight sparkle
947661.jpg,https://derpicdn.net/img/view/2015/7/31/947661.jpg,0,0.982053876,0,0,2021,1831,2021,1831,twilight sparkle
947954.png,https://derpicdn.net/img/view/2015/7/31/947954.png,0,0.997614145,405,48,735,378,330,330,twilight sparkle
949549.png,https://derpicdn.net/img/view/2015/8/3/949549.png,0,0.99827081,225,0,775,525,550,525,twilight sparkle
950618.png,https://derpicdn.net/img/view/2015/8/4/950618.png,0,0.933483064,16,0,3000,3031,2984,3031,twilight sparkle
952054.png,https://derpicdn.net/img/view/2015/8/6/952054.png,0,0.966952264,294,15,632,353,338,338,twilight sparkle
952217.jpg,https://derpicdn.net/img/view/2015/8/6/952217.jpg,0,0.99937582,940,24,1930,1014,990,990,twilight sparkle
952948.png,https://derpicdn.net/img/view/2015/8/7/952948.png,0,0.992140174,220,0,728,476,508,476,twilight sparkle
953235.png,https://derpicdn.net/img/view/2015/8/7/953235.png,0,0.902903318,30,75,496,541,466,466,twilight sparkle
954815.png,https://derpicdn.net/img/view/2015/8/10/954815.png,0,0.983206213,534,146,1258,870,724,724,twilight sparkle
955971.png,https://derpicdn.net/img/view/2015/8/12/955971.png,0,0.991423368,431,0,861,400,430,400,twilight sparkle
959795.png,https://derpicdn.net/img/view/2015/8/17/959795.png,0,0.94008857,100,13,694,607,594,594,twilight sparkle
962042.jpg,https://derpicdn.net/img/view/2015/8/20/962042.jpg,0,0.977045417,180,0,1732,1503,1552,1503,twilight sparkle
962286.png,https://derpicdn.net/img/view/2015/8/21/962286.png,0,0.948877275,356,86,886,616,530,530,twilight sparkle
963047.png,https://derpicdn.net/img/view/2015/8/22/963047.png,0,0.967198253,622,67,892,337,270,270,twilight sparkle
963617.png,https://derpicdn.net/img/view/2015/8/23/963617.png,0,0.980902493,0,0,1240,1236,1240,1236,twilight sparkle
963768.png,https://derpicdn.net/img/view/2015/8/23/963768.png,0,0.980736554,4,0,734,689,730,689,twilight sparkle
964446.jpg,https://derpicdn.net/img/view/2015/8/24/964446.jpg,0,0.989037097,436,82,1244,890,808,808,twilight sparkle
965304.png,https://derpicdn.net/img/view/2015/8/25/965304.png,0,0.99868536,443,61,1339,957,896,896,twilight sparkle
965304.png,https://derpicdn.net/img/view/2015/8/25/965304.png,1,0.992191255,1200,78,2162,1040,962,962,twilight sparkle
966332.png,https://derpicdn.net/img/view/2015/8/26/966332.png,0,0.988022268,171,32,891,752,720,720,twilight sparkle
966624.png,https://derpicdn.net/img/view/2015/8/27/966624.png,0,0.957215786,477,67,1451,1041,974,974,twilight sparkle
967844.png,https://derpicdn.net/img/view/2015/8/29/967844.png,0,0.998260379,539,0,1161,582,622,582,twilight sparkle
967886.png,https://derpicdn.net/img/view/2015/8/29/967886.png,0,0.983797848,1493,0,2883,1378,1390,1378,twilight sparkle
968014.png,https://derpicdn.net/img/view/2015/8/29/968014.png,0,0.9302001,367,31,829,493,462,462,twilight sparkle
971275.png,https://derpicdn.net/img/view/2015/9/2/971275.png,0,0.995318115,318,73,1278,1033,960,960,twilight sparkle
974586.jpg,https://derpicdn.net/img/view/2015/9/7/974586.jpg,0,0.996966243,275,0,2495,1801,2220,1801,twilight sparkle
975696.png,https://derpicdn.net/img/view/2015/9/9/975696.png,0,0.979907155,163,45,663,545,500,500,twilight sparkle
976076.png,https://derpicdn.net/img/view/2015/9/9/976076.png,0,0.991778255,127,0,593,423,466,423,twilight sparkle
976732.png,https://derpicdn.net/img/view/2015/9/10/976732.png,0,0.90258795,692,246,1358,912,666,666,twilight sparkle
977781.png,https://derpicdn.net/img/view/2015/9/12/977781.png,0,0.998522222,739,10,1525,796,786,786,twilight sparkle
978125.png,https://derpicdn.net/img/view/2015/9/12/978125.png,0,0.982894123,266,357,912,1003,646,646,twilight sparkle
978125.png,https://derpicdn.net/img/view/2015/9/12/978125.png,1,0.96920985,1967,621,2489,1143,522,522,twilight sparkle
978125.png,https://derpicdn.net/img/view/2015/9/12/978125.png,2,0.962814093,1045,593,1543,1091,498,498,twilight sparkle
978231.png,https://derpicdn.net/img/view/2015/9/12/978231.png,0,0.990826905,154,70,434,350,280,280,twilight sparkle
978279.png,https://derpicdn.net/img/view/2015/9/12/978279.png,0,0.940760136,392,0,794,400,402,400,twilight sparkle
984749.png,https://derpicdn.net/img/view/2015/9/21/984749.png,0,0.941738129,0,92,2049,2272,2049,2180,twilight sparkle
986058.png,https://derpicdn.net/img/view/2015/9/23/986058.png,0,0.994276583,110,0,864,676,754,676,twilight sparkle
987092.png,https://derpicdn.net/img/view/2015/9/24/987092.png,0,0.989251316,181,4,467,290,286,286,twilight sparkle
991331.png,https://derpicdn.net/img/view/2015/9/30/991331.png,0,0.9804582,70,0,790,627,720,627,twilight sparkle
992826.png,https://derpicdn.net/img/view/2015/10/2/992826.png,0,0.992786705,435,85,806,495,371,410,twilight sparkle
993619.jpg,https://derpicdn.net/img/view/2015/10/3/993619.jpg,0,0.980298519,157,88,613,544,456,456,twilight sparkle
993619.jpg,https://derpicdn.net/img/view/2015/10/3/993619.jpg,1,0.975608706,618,74,1058,514,440,440,twilight sparkle
994691.png,https://derpicdn.net/img/view/2015/10/4/994691.png,0,0.988755047,270,0,604,320,334,320,twilight sparkle
994969.png,https://derpicdn.net/img/view/2015/10/5/994969.png,0,0.95762527,297,0,1233,896,936,896,twilight sparkle
998040.png,https://derpicdn.net/img/view/2015/10/9/998040.png,0,0.96826148,315,24,799,508,484,484,twilight sparkle
998226.jpg,https://derpicdn.net/img/view/2015/10/10/998226.jpg,0,0.917760968,79,0,403,296,324,296,twilight sparkle
999524.png,https://derpicdn.net/img/view/2015/10/11/999524.png,0,0.989432871,1,16,693,708,692,692,twilight sparkle
1001995.jpg,https://derpicdn.net/img/view/2015/10/14/1001995.jpg,0,0.966966867,187,0,1151,856,964,856,twilight sparkle
1003822.png,https://derpicdn.net/img/view/2015/10/17/1003822.png,0,0.995758116,19,28,505,514,486,486,twilight sparkle
1003822.png,https://derpicdn.net/img/view/2015/10/17/1003822.png,0,0.995758116,19,28,505,514,486,486,twilight sparkle
1006385.jpg,https://derpicdn.net/img/view/2015/10/20/1006385.jpg,0,0.965721667,91,24,1187,1120,1096,1096,twilight sparkle
1006888.png,https://derpicdn.net/img/view/2015/10/21/1006888.png,0,0.976898313,542,875,1800,2133,1258,1258,twilight sparkle
1008628.png,https://derpicdn.net/img/view/2015/10/24/1008628.png,0,0.992218554,114,60,518,464,404,404,twilight sparkle
1009718.png,https://derpicdn.net/img/view/2015/10/25/1009718.png,0,0.985197842,36,0,484,428,448,428,twilight sparkle
1010511.png,https://derpicdn.net/img/view/2015/10/28/1010511.png,0,0.941590071,1013,125,1571,683,558,558,twilight sparkle
1010624.png,https://derpicdn.net/img/view/2015/10/28/1010624.png,0,0.935890257,257,0,647,375,390,375,twilight sparkle
1011620.png,https://derpicdn.net/img/view/2015/10/29/1011620.png,0,0.96128267,545,347,1257,1059,712,712,twilight sparkle
1011652.jpg,https://derpicdn.net/img/view/2015/10/29/1011652.jpg,0,0.985290229,79,8,297,226,218,218,twilight sparkle
1012054.png,https://derpicdn.net/img/view/2015/10/29/1012054.png,0,0.968226612,325,53,967,695,642,642,twilight sparkle
1012423.png,https://derpicdn.net/img/view/2015/10/30/1012423.png,0,0.996639848,471,0,1753,1097,1282,1097,twilight sparkle
1012879.jpg,https://derpicdn.net/img/view/2015/10/31/1012879.jpg,0,0.980592966,36,102,416,482,380,380,twilight sparkle
1013064.png,https://derpicdn.net/img/view/2015/10/31/1013064.png,0,0.996196687,4615,0,6863,2008,2248,2008,twilight sparkle
1013520.png,https://derpicdn.net/img/view/2015/10/31/1013520.png,0,0.994391561,2682,369,3156,869,474,500,twilight sparkle
1013558.png,https://derpicdn.net/img/view/2015/10/31/1013558.png,0,0.923199654,512,204,1222,914,710,710,twilight sparkle
1014423.png,https://derpicdn.net/img/view/2015/11/1/1014423.png,0,0.991499603,0,11,269,293,269,282,twilight sparkle
1015562.png,https://derpicdn.net/img/view/2015/11/3/1015562.png,0,0.993145943,1685,0,4693,2852,3008,2852,twilight sparkle
1018217.png,https://derpicdn.net/img/view/2015/11/7/1018217.png,0,0.906285405,21,20,443,442,422,422,twilight sparkle
1020673.png,https://derpicdn.net/img/view/2015/11/11/1020673.png,0,0.981757522,573,101,1467,995,894,894,twilight sparkle
1022069.jpg,https://derpicdn.net/img/view/2015/11/13/1022069.jpg,0,0.999209881,0,3,354,361,354,358,twilight sparkle
1022238.png,https://derpicdn.net/img/view/2015/11/13/1022238.png,0,0.964514732,0,252,1837,2752,1837,2500,twilight sparkle
1023314.png,https://derpicdn.net/img/view/2015/11/15/1023314.png,0,0.98308152,0,84,2357,2686,2357,2602,twilight sparkle
1023513.png,https://derpicdn.net/img/view/2015/11/15/1023513.png,0,0.994508028,103,0,705,519,602,519,twilight sparkle
1023513.png,https://derpicdn.net/img/view/2015/11/15/1023513.png,0,0.994508028,103,0,705,519,602,519,twilight sparkle
1023522.png,https://derpicdn.net/img/view/2015/11/15/1023522.png,0,0.972806096,0,43,3283,3543,3283,3500,twilight sparkle
1023593.png,https://derpicdn.net/img/view/2015/11/15/1023593.png,0,0.995905161,0,0,828,821,828,821,twilight sparkle
1023593.png,https://derpicdn.net/img/view/2015/11/15/1023593.png,0,0.995905161,0,0,828,821,828,821,twilight sparkle
1024781.png,https://derpicdn.net/img/view/2015/11/17/1024781.png,0,0.930486977,0,0,2638,2614,2638,2614,twilight sparkle
1025381.png,https://derpicdn.net/img/view/2015/11/18/1025381.png,0,0.993344545,3471,274,7000,3982,3529,3708,twilight sparkle
1028882.png,https://derpicdn.net/img/view/2015/11/23/1028882.png,0,0.991443098,397,116,633,352,236,236,twilight sparkle
1029318.png,https://derpicdn.net/img/view/2015/11/24/1029318.png,0,0.998041987,0,0,1377,1359,1377,1359,twilight sparkle
1033846.png,https://derpicdn.net/img/view/2015/11/30/1033846.png,0,0.9946208,463,820,4699,5000,4236,4180,twilight sparkle
1033847.png,https://derpicdn.net/img/view/2015/11/30/1033847.png,0,0.99194169,19,0,395,339,376,339,twilight sparkle
1035007.png,https://derpicdn.net/img/view/2015/12/2/1035007.png,0,0.922973156,1042,1573,3930,4987,2888,3414,twilight sparkle
1036160.png,https://derpicdn.net/img/view/2015/12/3/1036160.png,0,0.997989893,235,173,737,675,502,502,twilight sparkle
1040332.png,https://derpicdn.net/img/view/2015/12/9/1040332.png,0,0.917678118,588,17,984,413,396,396,twilight sparkle
1050403.png,https://derpicdn.net/img/view/2015/12/22/1050403.png,0,0.987020552,2949,0,5963,2757,3014,2757,twilight sparkle
1050985.png,https://derpicdn.net/img/view/2015/12/23/1050985.png,0,0.999084532,397,0,947,535,550,535,twilight sparkle
1052130.png,https://derpicdn.net/img/view/2015/12/25/1052130.png,0,0.987298071,789,0,1683,888,894,888,twilight sparkle
1053171.png,https://derpicdn.net/img/view/2015/12/26/1053171.png,0,0.990522027,478,908,1000,1430,522,522,twilight sparkle
1054039.jpg,https://derpicdn.net/img/view/2015/12/28/1054039.jpg,0,0.977710962,39,5,447,413,408,408,twilight sparkle
1057155.png,https://derpicdn.net/img/view/2016/1/1/1057155.png,0,0.955697834,70,0,460,365,390,365,twilight sparkle
1057386.png,https://derpicdn.net/img/view/2016/1/1/1057386.png,0,0.975454926,1295,405,1959,1069,664,664,twilight sparkle
1057404.png,https://derpicdn.net/img/view/2016/1/1/1057404.png,0,0.999405622,518,34,1104,620,586,586,twilight sparkle
1059137.png,https://derpicdn.net/img/view/2016/1/4/1059137.png,1,0.991694391,374,341,770,737,396,396,twilight sparkle
1059137.png,https://derpicdn.net/img/view/2016/1/4/1059137.png,1,0.991694391,374,341,770,737,396,396,twilight sparkle
1059281.png,https://derpicdn.net/img/view/2016/1/4/1059281.png,0,0.960597515,289,40,819,572,530,532,twilight sparkle
1059718.png,https://derpicdn.net/img/view/2016/1/4/1059718.png,0,0.996973574,158,0,1230,1020,1072,1020,twilight sparkle
1060138.png,https://derpicdn.net/img/view/2016/1/5/1060138.png,0,0.987725675,299,0,4980,4834,4681,4834,twilight sparkle
1060167.png,https://derpicdn.net/img/view/2016/1/5/1060167.png,0,0.995479763,1896,0,3500,1582,1604,1582,twilight sparkle
1060401.png,https://derpicdn.net/img/view/2016/1/5/1060401.png,0,0.992396951,216,0,628,412,412,412,twilight sparkle
1064070.png,https://derpicdn.net/img/view/2016/1/11/1064070.png,0,0.994412899,412,0,1354,884,942,884,twilight sparkle
106409.jpg,https://derpicdn.net/img/view/2012/9/25/106409.jpg,0,0.966929197,122,67,574,519,452,452,twilight sparkle
1064395.png,https://derpicdn.net/img/view/2016/1/11/1064395.png,0,0.994727492,308,161,518,371,210,210,twilight sparkle
1064859.png,https://derpicdn.net/img/view/2016/1/12/1064859.png,0,0.99190861,283,0,833,523,550,523,twilight sparkle
1065066.png,https://derpicdn.net/img/view/2016/1/12/1065066.png,0,0.98919642,413,0,1231,781,818,781,twilight sparkle
1065410.png,https://derpicdn.net/img/view/2016/1/12/1065410.png,0,0.996643603,3568,0,5874,2209,2306,2209,twilight sparkle
1065503.png,https://derpicdn.net/img/view/2016/1/13/1065503.png,0,0.988976657,188,145,570,527,382,382,twilight sparkle
1066852.jpg,https://derpicdn.net/img/view/2016/1/15/1066852.jpg,0,0.999266446,200,76,498,374,298,298,twilight sparkle
1068371.png,https://derpicdn.net/img/view/2016/1/17/1068371.png,0,0.997624874,172,33,456,317,284,284,twilight sparkle
1069468.png,https://derpicdn.net/img/view/2016/1/19/1069468.png,0,0.952138484,2498,169,4546,2217,2048,2048,twilight sparkle
1071868.png,https://derpicdn.net/img/view/2016/1/23/1071868.png,0,0.98489362,8,0,900,851,892,851,twilight sparkle
1074460.png,https://derpicdn.net/img/view/2016/1/27/1074460.png,0,0.989829242,124,82,436,394,312,312,twilight sparkle
1077219.png,https://derpicdn.net/img/view/2016/1/31/1077219.png,0,0.934867799,308,0,1218,946,910,946,twilight sparkle
1078063.png,https://derpicdn.net/img/view/2016/2/1/1078063.png,0,0.995847225,463,29,2367,1933,1904,1904,twilight sparkle
1078063.png,https://derpicdn.net/img/view/2016/2/1/1078063.png,0,0.995847225,463,29,2367,1933,1904,1904,twilight sparkle
1078121.png,https://derpicdn.net/img/view/2016/2/1/1078121.png,0,0.917150736,449,0,1159,684,710,684,twilight sparkle
1080020.png,https://derpicdn.net/img/view/2016/2/4/1080020.png,0,0.968028963,48,75,580,607,532,532,twilight sparkle
1082393.png,https://derpicdn.net/img/view/2016/2/7/1082393.png,0,0.996231318,417,219,895,697,478,478,twilight sparkle
1083335.png,https://derpicdn.net/img/view/2016/2/8/1083335.png,0,0.998116791,0,26,2957,3302,2957,3276,twilight sparkle
1084689.png,https://derpicdn.net/img/view/2016/2/10/1084689.png,0,0.970759213,0,915,2906,4175,2906,3260,twilight sparkle
1086984.png,https://derpicdn.net/img/view/2016/2/13/1086984.png,0,0.972589552,445,0,1465,990,1020,990,twilight sparkle
1089834.png,https://derpicdn.net/img/view/2016/2/16/1089834.png,0,0.99784255,275,0,1087,700,812,700,twilight sparkle
1089892.jpg,https://derpicdn.net/img/view/2016/2/16/1089892.jpg,0,0.983205616,169,28,973,832,804,804,twilight sparkle
1089991.png,https://derpicdn.net/img/view/2016/2/16/1089991.png,0,0.986203074,1133,0,2007,828,874,828,twilight sparkle
1094510.jpg,https://derpicdn.net/img/view/2016/2/22/1094510.jpg,0,0.965861976,48,61,488,501,440,440,twilight sparkle
1098915.png,https://derpicdn.net/img/view/2016/2/28/1098915.png,0,0.977374911,1,0,501,441,500,441,twilight sparkle
1100403.png,https://derpicdn.net/img/view/2016/3/2/1100403.png,0,0.99001503,9,69,379,405,370,336,twilight sparkle
1100403.png,https://derpicdn.net/img/view/2016/3/2/1100403.png,1,0.919784725,87,1,405,355,318,354,twilight sparkle
1101104.png,https://derpicdn.net/img/view/2016/3/3/1101104.png,0,0.990627646,279,71,593,385,314,314,twilight sparkle
1103544.jpg,https://derpicdn.net/img/view/2016/3/7/1103544.jpg,0,0.929912329,254,14,564,324,310,310,twilight sparkle
1103547.jpg,https://derpicdn.net/img/view/2016/3/7/1103547.jpg,0,0.932087541,250,7,568,325,318,318,twilight sparkle
1103550.jpg,https://derpicdn.net/img/view/2016/3/7/1103550.jpg,0,0.994077027,264,6,566,308,302,302,twilight sparkle
1103929.png,https://derpicdn.net/img/view/2016/3/7/1103929.png,0,0.989063203,2860,312,4260,1712,1400,1400,twilight sparkle
1103930.png,https://derpicdn.net/img/view/2016/3/7/1103930.png,0,0.976870179,0,42,1014,1108,1014,1066,twilight sparkle
1105442.png,https://derpicdn.net/img/view/2016/3/9/1105442.png,0,0.953312755,2210,0,5000,2859,2790,2859,twilight sparkle
1105982.jpg,https://derpicdn.net/img/view/2016/3/10/1105982.jpg,0,0.993876219,952,0,1546,563,594,563,twilight sparkle
1106651.jpg,https://derpicdn.net/img/view/2016/3/11/1106651.jpg,0,0.987836957,426,0,1894,1429,1468,1429,twilight sparkle
1108021.png,https://derpicdn.net/img/view/2016/3/13/1108021.png,0,0.928703666,0,67,1184,1369,1184,1302,twilight sparkle
1109146.png,https://derpicdn.net/img/view/2016/3/15/1109146.png,0,0.998807907,26,0,2066,1948,2040,1948,twilight sparkle
1109610.png,https://derpicdn.net/img/view/2016/3/15/1109610.png,0,0.984481692,119,41,715,637,596,596,twilight sparkle
1112333.png,https://derpicdn.net/img/view/2016/3/19/1112333.png,0,0.996979594,3583,0,5851,2166,2268,2166,twilight sparkle
1113074.png,https://derpicdn.net/img/view/2016/3/20/1113074.png,0,0.90381217,472,198,1260,986,788,788,twilight sparkle
1115512.jpg,https://derpicdn.net/img/view/2016/3/24/1115512.jpg,0,0.998296559,150,22,558,430,408,408,twilight sparkle
1115643.png,https://derpicdn.net/img/view/2016/3/24/1115643.png,0,0.997616231,571,52,895,376,324,324,twilight sparkle
1116866.png,https://derpicdn.net/img/view/2016/3/26/1116866.png,0,0.990543485,190,0,612,408,422,408,twilight sparkle
1116867.png,https://derpicdn.net/img/view/2016/3/26/1116867.png,0,0.992645383,224,21,576,373,352,352,twilight sparkle
1116868.png,https://derpicdn.net/img/view/2016/3/26/1116868.png,0,0.990600705,189,0,609,406,420,406,twilight sparkle
1116870.png,https://derpicdn.net/img/view/2016/3/26/1116870.png,0,0.988963127,334,0,1920,1545,1586,1545,twilight sparkle
1116978.png,https://derpicdn.net/img/view/2016/3/26/1116978.png,0,0.997817159,439,42,989,592,550,550,twilight sparkle
1123487.png,https://derpicdn.net/img/view/2016/4/3/1123487.png,0,0.95085907,634,284,982,632,348,348,twilight sparkle
1125304.png,https://derpicdn.net/img/view/2016/4/5/1125304.png,0,0.995069921,33,0,601,512,568,512,twilight sparkle
1128991.png,https://derpicdn.net/img/view/2016/4/10/1128991.png,0,0.984713018,23,0,1131,1061,1108,1061,twilight sparkle
113126.jpg,https://derpicdn.net/img/view/2012/10/4/113126.jpg,0,0.985059917,94,46,544,496,450,450,twilight sparkle
1132934.jpg,https://derpicdn.net/img/view/2016/4/16/1132934.jpg,0,0.910830319,0,31,1020,1119,1020,1088,twilight sparkle
1137211.png,https://derpicdn.net/img/view/2016/4/21/1137211.png,0,0.956313848,0,9,294,339,294,330,twilight sparkle
1138031.jpg,https://derpicdn.net/img/view/2016/4/22/1138031.jpg,0,0.986446142,363,0,1261,889,898,889,twilight sparkle
1138158.png,https://derpicdn.net/img/view/2016/4/23/1138158.png,0,0.961815298,0,111,784,915,784,804,twilight sparkle
1138158.png,https://derpicdn.net/img/view/2016/4/23/1138158.png,1,0.9518556,395,15,1300,959,905,944,twilight sparkle
1138829.png,https://derpicdn.net/img/view/2016/4/24/1138829.png,0,0.989630044,1349,0,3395,2020,2046,2020,twilight sparkle
1139047.png,https://derpicdn.net/img/view/2016/4/24/1139047.png,0,0.996875882,122,0,354,221,232,221,twilight sparkle
1139047.png,https://derpicdn.net/img/view/2016/4/24/1139047.png,0,0.996875882,122,0,354,221,232,221,twilight sparkle
1139368.png,https://derpicdn.net/img/view/2016/4/24/1139368.png,0,0.997788787,366,61,800,525,434,464,twilight sparkle
1139887.png,https://derpicdn.net/img/view/2016/4/25/1139887.png,0,0.997142017,606,52,1168,614,562,562,twilight sparkle
1139887.png,https://derpicdn.net/img/view/2016/4/25/1139887.png,0,0.997142017,606,52,1168,614,562,562,twilight sparkle
1140344.png,https://derpicdn.net/img/view/2016/4/26/1140344.png,0,0.965886235,515,62,759,306,244,244,twilight sparkle
1141607.png,https://derpicdn.net/img/view/2016/4/28/1141607.png,0,0.96897763,13,0,1080,1088,1067,1088,twilight sparkle
1142304.jpg,https://derpicdn.net/img/view/2016/4/29/1142304.jpg,0,0.976397395,277,0,855,545,578,545,twilight sparkle
1142859.png,https://derpicdn.net/img/view/2016/4/30/1142859.png,0,0.973413646,63,0,523,499,460,499,twilight sparkle
1143784.png,https://derpicdn.net/img/view/2016/5/1/1143784.png,0,0.997426927,141,72,501,432,360,360,twilight sparkle
1144014.png,https://derpicdn.net/img/view/2016/5/1/1144014.png,0,0.989353299,138,9,1254,1125,1116,1116,twilight sparkle
1144767.png,https://derpicdn.net/img/view/2016/5/2/1144767.png,0,0.990995884,119,0,405,281,286,281,twilight sparkle
1144854.png,https://derpicdn.net/img/view/2016/5/2/1144854.png,0,0.982017875,369,104,815,550,446,446,twilight sparkle
1145705.png,https://derpicdn.net/img/view/2016/5/3/1145705.png,0,0.969177961,262,363,3000,3137,2738,2774,twilight sparkle
1148342.png,https://derpicdn.net/img/view/2016/5/7/1148342.png,0,0.998751581,280,0,700,410,420,410,twilight sparkle
1148478.png,https://derpicdn.net/img/view/2016/5/7/1148478.png,0,0.989031374,164,0,790,611,626,611,twilight sparkle
1148478.png,https://derpicdn.net/img/view/2016/5/7/1148478.png,1,0.941367328,517,475,815,773,298,298,twilight sparkle
1149454.png,https://derpicdn.net/img/view/2016/5/8/1149454.png,0,0.998850405,126,71,562,507,436,436,twilight sparkle
1149962.png,https://derpicdn.net/img/view/2016/5/9/1149962.png,0,0.982310534,255,57,535,337,280,280,twilight sparkle
115087.png,https://derpicdn.net/img/view/2012/10/6/115087.png,0,0.96269232,283,0,3981,3656,3698,3656,twilight sparkle
115087.png,https://derpicdn.net/img/view/2012/10/6/115087.png,0,0.96269232,283,0,3981,3656,3698,3656,twilight sparkle
1155551.png,https://derpicdn.net/img/view/2016/5/16/1155551.png,0,0.99609226,1044,160,2258,1374,1214,1214,twilight sparkle
1155571.jpg,https://derpicdn.net/img/view/2016/5/16/1155571.jpg,0,0.979808152,39,0,569,490,530,490,twilight sparkle
1157921.png,https://derpicdn.net/img/view/2016/5/19/1157921.png,0,0.995578587,362,0,1478,924,1116,924,twilight sparkle
1158560.png,https://derpicdn.net/img/view/2016/5/20/1158560.png,0,0.989674747,302,0,768,460,466,460,twilight sparkle
1159086.png,https://derpicdn.net/img/view/2016/5/21/1159086.png,0,0.970300257,27,0,1743,1591,1716,1591,twilight sparkle
1160365.png,https://derpicdn.net/img/view/2016/5/22/1160365.png,0,0.926386714,0,86,4697,5606,4697,5520,twilight sparkle
1160419.png,https://derpicdn.net/img/view/2016/5/22/1160419.png,0,0.987058163,0,0,2441,2620,2441,2620,twilight sparkle
1161063.png,https://derpicdn.net/img/view/2016/5/23/1161063.png,0,0.986080468,193,13,653,473,460,460,twilight sparkle
1161626.png,https://derpicdn.net/img/view/2016/5/24/1161626.png,0,0.952962101,246,111,980,845,734,734,twilight sparkle
1162549.png,https://derpicdn.net/img/view/2016/5/25/1162549.png,0,0.977591276,715,117,1207,609,492,492,twilight sparkle
1164967.png,https://derpicdn.net/img/view/2016/5/28/1164967.png,0,0.996771097,134,120,2000,1986,1866,1866,twilight sparkle
1165303.jpg,https://derpicdn.net/img/view/2016/5/29/1165303.jpg,0,0.986080408,36,0,718,655,682,655,twilight sparkle
1167378.png,https://derpicdn.net/img/view/2016/5/31/1167378.png,0,0.995051742,309,0,725,415,416,415,twilight sparkle
1169246.png,https://derpicdn.net/img/view/2016/6/3/1169246.png,0,0.974864006,9,0,627,561,618,561,twilight sparkle
1170365.png,https://derpicdn.net/img/view/2016/6/4/1170365.png,0,0.980112135,14,51,894,931,880,880,twilight sparkle
1171504.png,https://derpicdn.net/img/view/2016/6/6/1171504.png,0,0.944351554,114,77,1214,1177,1100,1100,twilight sparkle
1175616.png,https://derpicdn.net/img/view/2016/6/11/1175616.png,0,0.996011198,126,35,600,509,474,474,twilight sparkle
1176390.jpg,https://derpicdn.net/img/view/2016/6/12/1176390.jpg,0,0.950186431,247,143,525,421,278,278,twilight sparkle
1176390.jpg,https://derpicdn.net/img/view/2016/6/12/1176390.jpg,0,0.950186431,247,143,525,421,278,278,twilight sparkle
1177450.png,https://derpicdn.net/img/view/2016/6/13/1177450.png,0,0.902259052,231,0,713,466,482,466,twilight sparkle
1178451.png,https://derpicdn.net/img/view/2016/6/14/1178451.png,0,0.994918346,44,0,2180,2058,2136,2058,twilight sparkle
1178958.png,https://derpicdn.net/img/view/2016/6/15/1178958.png,0,0.993060708,0,0,893,880,893,880,twilight sparkle
1179654.png,https://derpicdn.net/img/view/2016/6/16/1179654.png,0,0.990912855,0,0,2682,2515,2682,2515,twilight sparkle
1180979.png,https://derpicdn.net/img/view/2016/6/18/1180979.png,0,0.95078516,139,45,559,465,420,420,twilight sparkle
1183436.png,https://derpicdn.net/img/view/2016/6/21/1183436.png,0,0.993334293,3272,653,4946,2327,1674,1674,twilight sparkle
1187240.png,https://derpicdn.net/img/view/2016/6/26/1187240.png,0,0.995333612,58,38,724,657,666,619,twilight sparkle
1187949.png,https://derpicdn.net/img/view/2016/6/27/1187949.png,0,0.992517412,164,0,892,692,728,692,twilight sparkle
1191077.png,https://derpicdn.net/img/view/2016/7/1/1191077.png,0,0.993749261,549,0,1113,549,564,549,twilight sparkle
1191359.png,https://derpicdn.net/img/view/2016/7/2/1191359.png,0,0.97603327,149,0,965,808,816,808,twilight sparkle
1196203.png,https://derpicdn.net/img/view/2016/7/8/1196203.png,0,0.971051157,537,0,2039,1470,1502,1470,twilight sparkle
1199171.png,https://derpicdn.net/img/view/2016/7/12/1199171.png,0,0.997249544,321,225,713,617,392,392,twilight sparkle
1200430.png,https://derpicdn.net/img/view/2016/7/14/1200430.png,0,0.988350153,192,55,918,781,726,726,twilight sparkle
1200556.png,https://derpicdn.net/img/view/2016/7/14/1200556.png,0,0.980762422,2140,82,4176,2118,2036,2036,twilight sparkle
1202022.png,https://derpicdn.net/img/view/2016/7/16/1202022.png,0,0.933582544,559,431,1069,941,510,510,twilight sparkle
1203049.png,https://derpicdn.net/img/view/2016/7/17/1203049.png,0,0.926772416,266,211,710,655,444,444,twilight sparkle
1205476.png,https://derpicdn.net/img/view/2016/7/20/1205476.png,0,0.97845304,554,593,1040,1079,486,486,twilight sparkle
1206024.png,https://derpicdn.net/img/view/2016/7/21/1206024.png,0,0.984192133,253,0,523,259,270,259,twilight sparkle
1207314.png,https://derpicdn.net/img/view/2016/7/23/1207314.png,0,0.961186767,180,34,538,392,358,358,twilight sparkle
1208108.png,https://derpicdn.net/img/view/2016/7/24/1208108.png,0,0.914850354,536,198,814,476,278,278,twilight sparkle
1211306.png,https://derpicdn.net/img/view/2016/7/28/1211306.png,0,0.9946419,422,128,1102,808,680,680,twilight sparkle
1211306.png,https://derpicdn.net/img/view/2016/7/28/1211306.png,0,0.9946419,422,128,1102,808,680,680,twilight sparkle
1211966.png,https://derpicdn.net/img/view/2016/7/29/1211966.png,0,0.99062866,291,0,747,420,456,420,twilight sparkle
1214629.png,https://derpicdn.net/img/view/2016/8/1/1214629.png,0,0.980225801,42,17,436,411,394,394,twilight sparkle
1217281.png,https://derpicdn.net/img/view/2016/8/5/1217281.png,0,0.994617879,350,0,760,388,410,388,twilight sparkle
1217701.png,https://derpicdn.net/img/view/2016/8/5/1217701.png,0,0.995526552,1240,12,2418,1312,1178,1300,twilight sparkle
1218504.png,https://derpicdn.net/img/view/2016/8/6/1218504.png,0,0.997409463,24,0,802,722,778,722,twilight sparkle
1225587.png,https://derpicdn.net/img/view/2016/8/15/1225587.png,0,0.999152362,1457,1,2829,1373,1372,1372,twilight sparkle
1225886.png,https://derpicdn.net/img/view/2016/8/15/1225886.png,0,0.976483643,286,120,524,358,238,238,twilight sparkle
1227034.png,https://derpicdn.net/img/view/2016/8/17/1227034.png,0,0.996337414,856,146,1772,1062,916,916,twilight sparkle
1233372.png,https://derpicdn.net/img/view/2016/8/25/1233372.png,0,0.998835802,707,36,995,324,288,288,twilight sparkle
1233372.png,https://derpicdn.net/img/view/2016/8/25/1233372.png,1,0.995184302,468,6,688,226,220,220,twilight sparkle
1236723.png,https://derpicdn.net/img/view/2016/8/29/1236723.png,0,0.923353314,0,148,620,820,620,672,twilight sparkle
1240928.png,https://derpicdn.net/img/view/2016/9/3/1240928.png,0,0.991437018,879,254,1749,1124,870,870,twilight sparkle
1241599.png,https://derpicdn.net/img/view/2016/9/4/1241599.png,0,0.990184247,324,7,798,481,474,474,twilight sparkle
1242750.png,https://derpicdn.net/img/view/2016/9/5/1242750.png,0,0.963754416,511,0,1533,810,1022,810,twilight sparkle
1242768.png,https://derpicdn.net/img/view/2016/9/5/1242768.png,0,0.986317933,355,0,10071,9469,9716,9469,twilight sparkle
1244147.png,https://derpicdn.net/img/view/2016/9/7/1244147.png,0,0.986082435,412,117,1140,845,728,728,twilight sparkle
1245303.png,https://derpicdn.net/img/view/2016/9/9/1245303.png,0,0.989179015,0,0,10131,9963,10131,9963,twilight sparkle
1245423.png,https://derpicdn.net/img/view/2016/9/9/1245423.png,0,0.995571911,85,0,577,482,492,482,twilight sparkle
1247901.png,https://derpicdn.net/img/view/2016/9/12/1247901.png,0,0.988147795,229,0,4257,3953,4028,3953,twilight sparkle
1250371.png,https://derpicdn.net/img/view/2016/9/16/1250371.png,0,0.991599083,269,97,715,543,446,446,twilight sparkle
1252821.png,https://derpicdn.net/img/view/2016/9/18/1252821.png,0,0.995658994,135,210,619,694,484,484,twilight sparkle
1255619.png,https://derpicdn.net/img/view/2016/9/22/1255619.png,0,0.975071669,97,19,587,509,490,490,twilight sparkle
1255741.png,https://derpicdn.net/img/view/2016/9/22/1255741.png,0,0.981357634,175,0,645,437,470,437,twilight sparkle
1255743.png,https://derpicdn.net/img/view/2016/9/22/1255743.png,0,0.991204381,173,0,647,441,474,441,twilight sparkle
1258665.png,https://derpicdn.net/img/view/2016/9/26/1258665.png,0,0.926784635,55,3,529,477,474,474,twilight sparkle
1261102.png,https://derpicdn.net/img/view/2016/9/29/1261102.png,0,0.947578609,617,968,6959,7310,6342,6342,twilight sparkle
1261169.png,https://derpicdn.net/img/view/2016/9/29/1261169.png,0,0.998196244,54,53,1180,1179,1126,1126,twilight sparkle
1263236.png,https://derpicdn.net/img/view/2016/10/2/1263236.png,0,0.995546877,0,49,1507,1621,1507,1572,twilight sparkle
1263236.png,https://derpicdn.net/img/view/2016/10/2/1263236.png,0,0.995546877,0,49,1507,1621,1507,1572,twilight sparkle
1264021.png,https://derpicdn.net/img/view/2016/10/3/1264021.png,0,0.996863127,0,0,1685,1744,1685,1744,twilight sparkle
1266358.png,https://derpicdn.net/img/view/2016/10/6/1266358.png,0,0.986038387,34,29,409,457,375,428,twilight sparkle
1266358.png,https://derpicdn.net/img/view/2016/10/6/1266358.png,1,0.915822685,0,0,328,382,328,382,twilight sparkle
1269954.png,https://derpicdn.net/img/view/2016/10/10/1269954.png,0,0.989175677,10,0,552,467,542,467,twilight sparkle
1272249.png,https://derpicdn.net/img/view/2016/10/14/1272249.png,0,0.995640516,419,47,915,543,496,496,twilight sparkle
1280397.png,https://derpicdn.net/img/view/2016/10/24/1280397.png,0,0.995716512,1061,0,3000,2049,1939,2049,twilight sparkle
1282119.png,https://derpicdn.net/img/view/2016/10/26/1282119.png,0,0.992570937,610,56,1128,574,518,518,twilight sparkle
1283306.png,https://derpicdn.net/img/view/2016/10/28/1283306.png,0,0.955493808,210,36,998,824,788,788,twilight sparkle
1283306.png,https://derpicdn.net/img/view/2016/10/28/1283306.png,0,0.955493808,210,36,998,824,788,788,twilight sparkle
1284000.png,https://derpicdn.net/img/view/2016/10/29/1284000.png,0,0.992293656,1080,706,1988,1614,908,908,twilight sparkle
1286366.png,https://derpicdn.net/img/view/2016/11/1/1286366.png,0,0.993262053,479,95,991,607,512,512,twilight sparkle
1286929.png,https://derpicdn.net/img/view/2016/11/2/1286929.png,0,0.999072015,553,0,1511,915,958,915,twilight sparkle
1287306.png,https://derpicdn.net/img/view/2016/11/2/1287306.png,0,0.957879066,914,0,1998,1007,1084,1007,twilight sparkle
1289584.png,https://derpicdn.net/img/view/2016/11/5/1289584.png,0,0.999505222,20,0,276,256,256,256,twilight sparkle
1290604.png,https://derpicdn.net/img/view/2016/11/7/1290604.png,0,0.993076384,187,0,1005,730,818,730,twilight sparkle
1291282.png,https://derpicdn.net/img/view/2016/11/8/1291282.png,0,0.990989268,220,0,1238,1015,1018,1015,twilight sparkle
1293229.png,https://derpicdn.net/img/view/2016/11/11/1293229.png,0,0.960427344,296,188,1128,1020,832,832,twilight sparkle
1293640.png,https://derpicdn.net/img/view/2016/11/12/1293640.png,0,0.998728931,239,42,767,570,528,528,twilight sparkle
1296525.png,https://derpicdn.net/img/view/2016/11/15/1296525.png,0,0.988096118,282,0,942,587,660,587,twilight sparkle
1297952.png,https://derpicdn.net/img/view/2016/11/17/1297952.png,0,0.988021672,186,69,610,493,424,424,twilight sparkle
1298226.png,https://derpicdn.net/img/view/2016/11/18/1298226.png,0,0.957870424,0,129,2442,2629,2442,2500,twilight sparkle
1298226.png,https://derpicdn.net/img/view/2016/11/18/1298226.png,0,0.957870424,0,129,2442,2629,2442,2500,twilight sparkle
1298275.png,https://derpicdn.net/img/view/2016/11/18/1298275.png,0,0.998753667,114,0,856,728,742,728,twilight sparkle
1302633.png,https://derpicdn.net/img/view/2016/11/24/1302633.png,0,0.947051585,95,0,1331,1098,1236,1098,twilight sparkle
1306944.png,https://derpicdn.net/img/view/2016/11/30/1306944.png,0,0.983694375,299,4,935,640,636,636,twilight sparkle
1306948.png,https://derpicdn.net/img/view/2016/11/30/1306948.png,0,0.987781346,191,0,959,710,768,710,twilight sparkle
1306948.png,https://derpicdn.net/img/view/2016/11/30/1306948.png,0,0.987781346,191,0,959,710,768,710,twilight sparkle
1306950.png,https://derpicdn.net/img/view/2016/11/30/1306950.png,0,0.98500061,201,0,951,703,750,703,twilight sparkle
1306951.png,https://derpicdn.net/img/view/2016/11/30/1306951.png,0,0.975124598,303,8,929,634,626,626,twilight sparkle
1307302.png,https://derpicdn.net/img/view/2016/12/1/1307302.png,0,0.998129368,265,15,783,533,518,518,twilight sparkle
1308538.png,https://derpicdn.net/img/view/2016/12/2/1308538.png,0,0.904396892,0,45,2934,3035,2934,2990,twilight sparkle
1308732.png,https://derpicdn.net/img/view/2016/12/3/1308732.png,0,0.974630177,538,0,1068,450,530,450,twilight sparkle
1308732.png,https://derpicdn.net/img/view/2016/12/3/1308732.png,1,0.919154584,249,18,585,354,336,336,twilight sparkle
1309390.png,https://derpicdn.net/img/view/2016/12/4/1309390.png,0,0.994762659,18,0,574,541,556,541,twilight sparkle
1315444.png,https://derpicdn.net/img/view/2016/12/12/1315444.png,0,0.987005234,191,23,897,729,706,706,twilight sparkle
1317367.png,https://derpicdn.net/img/view/2016/12/14/1317367.png,0,0.981308937,0,21,585,673,585,652,twilight sparkle
1318777.png,https://derpicdn.net/img/view/2016/12/16/1318777.png,0,0.990169942,236,200,3498,3462,3262,3262,twilight sparkle
1320050.png,https://derpicdn.net/img/view/2016/12/18/1320050.png,0,0.936763585,204,0,848,601,644,601,twilight sparkle
1322450.png,https://derpicdn.net/img/view/2016/12/22/1322450.png,0,0.940530479,318,44,588,314,270,270,twilight sparkle
1322794.png,https://derpicdn.net/img/view/2016/12/22/1322794.png,0,0.914412379,239,0,1200,960,961,960,twilight sparkle
1322814.png,https://derpicdn.net/img/view/2016/12/22/1322814.png,0,0.990017354,0,0,270,272,270,272,twilight sparkle
1322814.png,https://derpicdn.net/img/view/2016/12/22/1322814.png,1,0.922430754,40,51,350,383,310,332,twilight sparkle
132322.jpg,https://derpicdn.net/img/view/2012/10/25/132322.jpg,0,0.996677697,677,0,1225,483,548,483,twilight sparkle
1323910.png,https://derpicdn.net/img/view/2016/12/24/1323910.png,0,0.999199748,69,39,565,535,496,496,twilight sparkle
1324295.png,https://derpicdn.net/img/view/2016/12/24/1324295.png,0,0.962534904,31,0,1033,811,1002,811,twilight sparkle
1326564.png,https://derpicdn.net/img/view/2016/12/27/1326564.png,0,0.99257499,439,279,2221,2061,1782,1782,twilight sparkle
1328099.png,https://derpicdn.net/img/view/2016/12/30/1328099.png,0,0.988488138,166,1355,636,1825,470,470,twilight sparkle
1329498.png,https://derpicdn.net/img/view/2017/1/1/1329498.png,0,0.994109154,138,274,484,620,346,346,twilight sparkle
1330152.png,https://derpicdn.net/img/view/2017/1/2/1330152.png,0,0.994453549,425,0,1195,707,770,707,twilight sparkle
1332127.png,https://derpicdn.net/img/view/2017/1/4/1332127.png,0,0.994723976,206,16,692,502,486,486,twilight sparkle
1333840.png,https://derpicdn.net/img/view/2017/1/7/1333840.png,0,0.982655466,20,9,812,801,792,792,twilight sparkle
1335264.png,https://derpicdn.net/img/view/2017/1/9/1335264.png,0,0.968519866,0,0,8370,9720,8370,9720,twilight sparkle
1335264.png,https://derpicdn.net/img/view/2017/1/9/1335264.png,1,0.929392815,0,0,10012,10493,10012,10493,twilight sparkle
1335740.png,https://derpicdn.net/img/view/2017/1/9/1335740.png,0,0.996379077,3635,959,10502,8621,6867,7662,twilight sparkle
1335741.png,https://derpicdn.net/img/view/2017/1/9/1335741.png,0,0.983262837,4170,1854,10502,8458,6332,6604,twilight sparkle
1338197.png,https://derpicdn.net/img/view/2017/1/13/1338197.png,0,0.997291148,322,12,818,508,496,496,twilight sparkle
1340095.png,https://derpicdn.net/img/view/2017/1/15/1340095.png,0,0.987917304,157,38,957,838,800,800,twilight sparkle
1343044.png,https://derpicdn.net/img/view/2017/1/19/1343044.png,0,0.998979688,18,0,1118,1069,1100,1069,twilight sparkle
1343512.png,https://derpicdn.net/img/view/2017/1/20/1343512.png,0,0.991702497,918,82,1608,772,690,690,twilight sparkle
1345787.png,https://derpicdn.net/img/view/2017/1/23/1345787.png,0,0.980454206,111,0,565,407,454,407,twilight sparkle
1346357.png,https://derpicdn.net/img/view/2017/1/23/1346357.png,0,0.989405513,154,0,564,391,410,391,twilight sparkle
1351.jpg,https://derpicdn.net/img/view/2012/1/22/1351.jpg,0,0.994837463,327,27,721,421,394,394,twilight sparkle
1352989.png,https://derpicdn.net/img/view/2017/2/1/1352989.png,0,0.993927658,0,17,1854,1983,1854,1966,twilight sparkle
1355815.png,https://derpicdn.net/img/view/2017/2/5/1355815.png,0,0.988730848,294,28,1278,1012,984,984,twilight sparkle
1356265.png,https://derpicdn.net/img/view/2017/2/6/1356265.png,0,0.996142507,151,0,483,330,332,330,twilight sparkle
135741.png,https://derpicdn.net/img/view/2012/10/29/135741.png,0,0.900140584,0,0,427,601,427,601,twilight sparkle
1358546.png,https://derpicdn.net/img/view/2017/2/9/1358546.png,0,0.999657989,27,0,475,429,448,429,twilight sparkle
1358546.png,https://derpicdn.net/img/view/2017/2/9/1358546.png,1,0.999294281,1050,0,1480,411,430,411,twilight sparkle
1358546.png,https://derpicdn.net/img/view/2017/2/9/1358546.png,2,0.998809338,2184,0,2670,445,486,445,twilight sparkle
1358546.png,https://derpicdn.net/img/view/2017/2/9/1358546.png,3,0.99880302,1590,0,2082,453,492,453,twilight sparkle
1358546.png,https://derpicdn.net/img/view/2017/2/9/1358546.png,4,0.983776689,566,0,978,410,412,410,twilight sparkle
1358546.png,https://derpicdn.net/img/view/2017/2/9/1358546.png,6,0.96867156,2142,513,2648,1019,506,506,twilight sparkle
1362307.png,https://derpicdn.net/img/view/2017/2/14/1362307.png,0,0.978260279,183,0,1046,791,863,791,twilight sparkle
1362307.png,https://derpicdn.net/img/view/2017/2/14/1362307.png,0,0.978260279,183,0,1046,791,863,791,twilight sparkle
1362441.png,https://derpicdn.net/img/view/2017/2/14/1362441.png,0,0.955288649,0,45,520,591,520,546,twilight sparkle
1364962.png,https://derpicdn.net/img/view/2017/2/16/1364962.png,0,0.998430908,563,0,1247,674,684,674,twilight sparkle
1366365.png,https://derpicdn.net/img/view/2017/2/18/1366365.png,0,0.968599141,1,14,303,316,302,302,twilight sparkle
1368357.png,https://derpicdn.net/img/view/2017/2/20/1368357.png,0,0.978548765,0,218,5401,6562,5401,6344,twilight sparkle
1369473.png,https://derpicdn.net/img/view/2017/2/21/1369473.png,0,0.993319094,0,46,2894,3484,2894,3438,twilight sparkle
1369780.png,https://derpicdn.net/img/view/2017/2/22/1369780.png,0,0.984432399,62,30,400,368,338,338,twilight sparkle
1370487.png,https://derpicdn.net/img/view/2017/2/22/1370487.png,1,0.9209764,406,0,1280,866,874,866,twilight sparkle
1372695.png,https://derpicdn.net/img/view/2017/2/25/1372695.png,0,0.986826956,106,5,564,463,458,458,twilight sparkle
1372867.png,https://derpicdn.net/img/view/2017/2/25/1372867.png,0,0.959580421,75,0,4619,3327,4544,3327,twilight sparkle
1372867.png,https://derpicdn.net/img/view/2017/2/25/1372867.png,0,0.959580421,75,0,4619,3327,4544,3327,twilight sparkle
1377.jpg,https://derpicdn.net/img/view/2012/1/22/1377.jpg,0,0.991145194,570,0,1060,488,490,488,twilight sparkle
1379055.png,https://derpicdn.net/img/view/2017/3/4/1379055.png,0,0.998950779,267,0,799,447,532,447,twilight sparkle
1379222.png,https://derpicdn.net/img/view/2017/3/4/1379222.png,0,0.975976646,617,38,1433,854,816,816,twilight sparkle
1383.jpg,https://derpicdn.net/img/view/2012/1/22/1383.jpg,0,0.992284715,208,0,796,562,588,562,twilight sparkle
1383075.png,https://derpicdn.net/img/view/2017/3/9/1383075.png,0,0.989431918,721,627,1197,1103,476,476,twilight sparkle
1383075.png,https://derpicdn.net/img/view/2017/3/9/1383075.png,1,0.988707244,2469,620,2949,1100,480,480,twilight sparkle
1383075.png,https://derpicdn.net/img/view/2017/3/9/1383075.png,3,0.911037445,1986,654,2420,1088,434,434,twilight sparkle
1385090.png,https://derpicdn.net/img/view/2017/3/12/1385090.png,0,0.980588675,105,54,309,258,204,204,twilight sparkle
1387684.png,https://derpicdn.net/img/view/2017/3/15/1387684.png,0,0.998955965,27,0,967,890,940,890,twilight sparkle
1390916.png,https://derpicdn.net/img/view/2017/3/19/1390916.png,0,0.913506091,32,19,554,541,522,522,twilight sparkle
1395371.png,https://derpicdn.net/img/view/2017/3/24/1395371.png,0,0.999712288,449,3,819,373,370,370,twilight sparkle
1396948.png,https://derpicdn.net/img/view/2017/3/26/1396948.png,0,0.998039544,468,287,2564,2383,2096,2096,twilight sparkle
1398173.png,https://derpicdn.net/img/view/2017/3/28/1398173.png,0,0.991326928,129,0,1067,848,938,848,twilight sparkle
1398790.png,https://derpicdn.net/img/view/2017/3/29/1398790.png,0,0.992942572,129,9,693,573,564,564,twilight sparkle
1400159.png,https://derpicdn.net/img/view/2017/3/31/1400159.png,0,0.993582368,97,0,545,430,448,430,twilight sparkle
1401415.png,https://derpicdn.net/img/view/2017/4/1/1401415.png,0,0.998486876,8,0,442,428,434,428,twilight sparkle
140327.jpg,https://derpicdn.net/img/view/2012/11/3/140327.jpg,0,0.995796502,23,0,483,399,460,399,twilight sparkle
1403821.png,https://derpicdn.net/img/view/2017/4/4/1403821.png,0,0.94052285,152,35,904,787,752,752,twilight sparkle
1404764.png,https://derpicdn.net/img/view/2017/4/5/1404764.png,0,0.998618066,438,100,846,508,408,408,twilight sparkle
1404883.png,https://derpicdn.net/img/view/2017/4/5/1404883.png,0,0.925652444,113,159,523,569,410,410,twilight sparkle
1405449.png,https://derpicdn.net/img/view/2017/4/6/1405449.png,0,0.997926772,355,20,697,362,342,342,twilight sparkle
1406708.png,https://derpicdn.net/img/view/2017/4/8/1406708.png,0,0.992092371,216,2,972,758,756,756,twilight sparkle
1408428.png,https://derpicdn.net/img/view/2017/4/10/1408428.png,1,0.966621578,1964,2225,3976,4237,2012,2012,twilight sparkle
1408962.png,https://derpicdn.net/img/view/2017/4/11/1408962.png,0,0.989405334,398,35,882,519,484,484,twilight sparkle
1412846.png,https://derpicdn.net/img/view/2017/4/16/1412846.png,0,0.915025413,592,87,1582,1077,990,990,twilight sparkle
1413479.png,https://derpicdn.net/img/view/2017/4/16/1413479.png,0,0.995772243,1,5,289,293,288,288,twilight sparkle
1417062.png,https://derpicdn.net/img/view/2017/4/20/1417062.png,0,0.993222535,123,49,2121,2047,1998,1998,twilight sparkle
1420278.png,https://derpicdn.net/img/view/2017/4/24/1420278.png,0,0.948671103,0,0,427,513,427,513,twilight sparkle
1421184.png,https://derpicdn.net/img/view/2017/4/25/1421184.png,0,0.995845735,123,0,465,290,342,290,twilight sparkle
1421184.png,https://derpicdn.net/img/view/2017/4/25/1421184.png,1,0.970473886,304,8,640,344,336,336,twilight sparkle
1421522.png,https://derpicdn.net/img/view/2017/4/25/1421522.png,0,0.984009445,113,0,845,699,732,699,twilight sparkle
1421522.png,https://derpicdn.net/img/view/2017/4/25/1421522.png,0,0.984009445,113,0,845,699,732,699,twilight sparkle
1422965.png,https://derpicdn.net/img/view/2017/4/27/1422965.png,0,0.984787405,132,0,900,772,768,772,twilight sparkle
1425966.png,https://derpicdn.net/img/view/2017/5/1/1425966.png,0,0.991111577,59,166,1163,1270,1104,1104,twilight sparkle
1426557.png,https://derpicdn.net/img/view/2017/5/1/1426557.png,0,0.999036491,93,0,1959,1772,1866,1772,twilight sparkle
1427235.png,https://derpicdn.net/img/view/2017/5/2/1427235.png,0,0.912944257,245,0,1329,1066,1084,1066,twilight sparkle
1429699.png,https://derpicdn.net/img/view/2017/5/6/1429699.png,0,0.993308663,289,0,837,530,548,530,twilight sparkle
1432746.png,https://derpicdn.net/img/view/2017/5/9/1432746.png,0,0.964845955,1439,331,2791,1683,1352,1352,twilight sparkle
1434481.png,https://derpicdn.net/img/view/2017/5/12/1434481.png,0,0.977191985,59,18,579,538,520,520,twilight sparkle
1435917.png,https://derpicdn.net/img/view/2017/5/14/1435917.png,1,0.98806107,2090,816,2570,1296,480,480,twilight sparkle
1435953.png,https://derpicdn.net/img/view/2017/5/14/1435953.png,0,0.968330324,206,58,850,702,644,644,twilight sparkle
1437826.png,https://derpicdn.net/img/view/2017/5/16/1437826.png,0,0.985055923,114,33,598,517,484,484,twilight sparkle
1442881.png,https://derpicdn.net/img/view/2017/5/22/1442881.png,0,0.952359021,0,0,747,700,747,700,twilight sparkle
1442881.png,https://derpicdn.net/img/view/2017/5/22/1442881.png,0,0.952359021,0,0,747,700,747,700,twilight sparkle
1443393.png,https://derpicdn.net/img/view/2017/5/22/1443393.png,0,0.950954378,470,0,2420,1712,1950,1712,twilight sparkle
1445421.png,https://derpicdn.net/img/view/2017/5/25/1445421.png,0,0.938274801,379,137,3531,3289,3152,3152,twilight sparkle
1445576.png,https://derpicdn.net/img/view/2017/5/25/1445576.png,0,0.974143863,549,179,887,517,338,338,twilight sparkle
1445576.png,https://derpicdn.net/img/view/2017/5/25/1445576.png,0,0.974143863,549,179,887,517,338,338,twilight sparkle
1446211.png,https://derpicdn.net/img/view/2017/5/26/1446211.png,0,0.991755068,1133,1444,2437,2748,1304,1304,twilight sparkle
1446375.png,https://derpicdn.net/img/view/2017/5/26/1446375.png,0,0.951039076,1198,111,2908,1821,1710,1710,twilight sparkle
1446891.png,https://derpicdn.net/img/view/2017/5/27/1446891.png,0,0.934034288,292,0,1128,819,836,819,twilight sparkle
1450650.png,https://derpicdn.net/img/view/2017/5/31/1450650.png,0,0.93971622,214,182,682,650,468,468,twilight sparkle
1454208.png,https://derpicdn.net/img/view/2017/6/5/1454208.png,0,0.933320999,311,103,901,693,590,590,twilight sparkle
1454746.png,https://derpicdn.net/img/view/2017/6/5/1454746.png,0,0.999682307,1147,0,1585,419,438,419,twilight sparkle
1454746.png,https://derpicdn.net/img/view/2017/6/5/1454746.png,1,0.979533732,27,320,817,1110,790,790,twilight sparkle
1456211.png,https://derpicdn.net/img/view/2017/6/7/1456211.png,0,0.963008046,2601,1014,3855,2268,1254,1254,twilight sparkle
1459084.png,https://derpicdn.net/img/view/2017/6/11/1459084.png,0,0.917283714,294,0,1850,1080,1556,1080,twilight sparkle
1460850.png,https://derpicdn.net/img/view/2017/6/13/1460850.png,0,0.973181963,455,64,943,552,488,488,twilight sparkle
1463539.png,https://derpicdn.net/img/view/2017/6/17/1463539.png,0,0.993127823,812,368,1170,726,358,358,twilight sparkle
1464187.png,https://derpicdn.net/img/view/2017/6/17/1464187.png,0,0.98249799,211,1200,1175,2164,964,964,twilight sparkle
1464498.png,https://derpicdn.net/img/view/2017/6/18/1464498.png,1,0.995482028,289,340,999,1050,710,710,twilight sparkle
1470108.png,https://derpicdn.net/img/view/2017/6/24/1470108.png,0,0.97111088,1339,185,4737,3583,3398,3398,twilight sparkle
1470435.png,https://derpicdn.net/img/view/2017/6/24/1470435.png,0,0.995864034,1007,358,1945,1296,938,938,twilight sparkle
1473155.png,https://derpicdn.net/img/view/2017/6/28/1473155.png,0,0.989589155,785,415,1707,1337,922,922,twilight sparkle
1473300.png,https://derpicdn.net/img/view/2017/6/28/1473300.png,0,0.989436269,159,0,1891,1515,1732,1515,twilight sparkle
1474219.png,https://derpicdn.net/img/view/2017/6/29/1474219.png,0,0.94692874,55,14,332,334,277,320,twilight sparkle
1475040.png,https://derpicdn.net/img/view/2017/6/30/1475040.png,0,0.990057707,15,0,499,468,484,468,twilight sparkle
1476478.png,https://derpicdn.net/img/view/2017/7/2/1476478.png,0,0.98132813,350,0,858,491,508,491,twilight sparkle
1480135.png,https://derpicdn.net/img/view/2017/7/6/1480135.png,0,0.996508777,181,0,631,393,450,393,twilight sparkle
148161.png,https://derpicdn.net/img/view/2012/11/11/148161.png,0,0.969678342,2098,0,5112,2735,3014,2735,twilight sparkle
1483916.png,https://derpicdn.net/img/view/2017/7/11/1483916.png,0,0.996922553,28,33,336,341,308,308,twilight sparkle
1485751.png,https://derpicdn.net/img/view/2017/7/14/1485751.png,0,0.994520128,33,72,453,492,420,420,twilight sparkle
1488.jpg,https://derpicdn.net/img/view/2012/1/22/1488.jpg,0,0.984771669,0,0,462,480,462,480,twilight sparkle
1488661.png,https://derpicdn.net/img/view/2017/7/17/1488661.png,0,0.98818177,428,0,1010,564,582,564,twilight sparkle
1492734.png,https://derpicdn.net/img/view/2017/7/23/1492734.png,0,0.994120479,225,0,1211,975,986,975,twilight sparkle
1495182.png,https://derpicdn.net/img/view/2017/7/26/1495182.png,0,0.970706463,25,0,323,312,298,312,twilight sparkle
1497543.png,https://derpicdn.net/img/view/2017/7/29/1497543.png,0,0.939724207,6,132,646,772,640,640,twilight sparkle
1500495.png,https://derpicdn.net/img/view/2017/8/1/1500495.png,0,0.987923861,0,0,908,891,908,891,twilight sparkle
1500495.png,https://derpicdn.net/img/view/2017/8/1/1500495.png,0,0.987923861,0,0,908,891,908,891,twilight sparkle
1500641.png,https://derpicdn.net/img/view/2017/8/2/1500641.png,0,0.998109281,488,0,2070,1560,1582,1560,twilight sparkle
1501773.png,https://derpicdn.net/img/view/2017/8/3/1501773.png,0,0.997532368,85,7,607,529,522,522,twilight sparkle
1502042.png,https://derpicdn.net/img/view/2017/8/3/1502042.png,0,0.988402784,335,0,1693,1218,1358,1218,twilight sparkle
1502341.png,https://derpicdn.net/img/view/2017/8/4/1502341.png,0,0.994684815,537,43,1343,849,806,806,twilight sparkle
1503810.png,https://derpicdn.net/img/view/2017/8/6/1503810.png,0,0.969671726,97,0,651,548,554,548,twilight sparkle
150473.png,https://derpicdn.net/img/view/2012/11/13/150473.png,0,0.998488665,466,0,888,388,422,388,twilight sparkle
1507557.png,https://derpicdn.net/img/view/2017/8/10/1507557.png,0,0.989020944,244,0,1526,1249,1282,1249,twilight sparkle
1507557.png,https://derpicdn.net/img/view/2017/8/10/1507557.png,0,0.989020944,244,0,1526,1249,1282,1249,twilight sparkle
1508055.png,https://derpicdn.net/img/view/2017/8/11/1508055.png,0,0.915953994,79,0,1127,959,1048,959,twilight sparkle
1508891.png,https://derpicdn.net/img/view/2017/8/12/1508891.png,0,0.960153639,0,29,488,557,488,528,twilight sparkle
1511276.png,https://derpicdn.net/img/view/2017/8/15/1511276.png,0,0.980549753,130,270,2269,2866,2139,2596,twilight sparkle
1511276.png,https://derpicdn.net/img/view/2017/8/15/1511276.png,1,0.945444584,0,129,2161,2785,2161,2656,twilight sparkle
1511282.png,https://derpicdn.net/img/view/2017/8/15/1511282.png,0,0.932100952,254,17,920,683,666,666,twilight sparkle
1512730.png,https://derpicdn.net/img/view/2017/8/17/1512730.png,0,0.994834185,50,245,1370,1565,1320,1320,twilight sparkle
1512757.png,https://derpicdn.net/img/view/2017/8/17/1512757.png,0,0.956760645,151,13,1200,1139,1049,1126,twilight sparkle
1513385.png,https://derpicdn.net/img/view/2017/8/18/1513385.png,0,0.978893816,117,0,730,600,613,600,twilight sparkle
1513609.png,https://derpicdn.net/img/view/2017/8/18/1513609.png,0,0.95214051,0,11,873,971,873,960,twilight sparkle
1514755.png,https://derpicdn.net/img/view/2017/8/19/1514755.png,0,0.910206676,63,0,501,422,438,422,twilight sparkle
1515617.png,https://derpicdn.net/img/view/2017/8/20/1515617.png,0,0.990562677,273,181,873,781,600,600,twilight sparkle
1515617.png,https://derpicdn.net/img/view/2017/8/20/1515617.png,0,0.990562677,273,181,873,781,600,600,twilight sparkle
1516177.png,https://derpicdn.net/img/view/2017/8/21/1516177.png,0,0.952177286,3843,418,5434,2084,1591,1666,twilight sparkle
1518064.png,https://derpicdn.net/img/view/2017/8/23/1518064.png,2,0.951571226,892,301,2148,1557,1256,1256,twilight sparkle
1518064.png,https://derpicdn.net/img/view/2017/8/23/1518064.png,2,0.951571226,892,301,2148,1557,1256,1256,twilight sparkle
1519191.png,https://derpicdn.net/img/view/2017/8/25/1519191.png,0,0.997805655,764,26,1218,480,454,454,twilight sparkle
1520516.png,https://derpicdn.net/img/view/2017/8/26/1520516.png,0,0.988993466,1407,385,3589,2567,2182,2182,twilight sparkle
1521248.png,https://derpicdn.net/img/view/2017/8/27/1521248.png,0,0.983793378,857,0,2011,1046,1154,1046,twilight sparkle
1521773.png,https://derpicdn.net/img/view/2017/8/28/1521773.png,0,0.991115987,0,0,325,360,325,360,twilight sparkle
1526786.png,https://derpicdn.net/img/view/2017/9/3/1526786.png,0,0.993130922,540,14,936,410,396,396,twilight sparkle
1526786.png,https://derpicdn.net/img/view/2017/9/3/1526786.png,1,0.923380375,22,20,450,448,428,428,twilight sparkle
1527841.png,https://derpicdn.net/img/view/2017/9/4/1527841.png,0,0.92211318,248,634,678,1064,430,430,twilight sparkle
1529217.png,https://derpicdn.net/img/view/2017/9/6/1529217.png,0,0.996121287,656,0,1636,911,980,911,twilight sparkle
1529860.png,https://derpicdn.net/img/view/2017/9/7/1529860.png,0,0.995601654,214,0,1060,831,846,831,twilight sparkle
1529860.png,https://derpicdn.net/img/view/2017/9/7/1529860.png,0,0.995601654,214,0,1060,831,846,831,twilight sparkle
1532766.png,https://derpicdn.net/img/view/2017/9/11/1532766.png,0,0.980573714,185,117,389,321,204,204,twilight sparkle
1534263.png,https://derpicdn.net/img/view/2017/9/13/1534263.png,0,0.933557212,181,109,3093,3021,2912,2912,twilight sparkle
1537.jpg,https://derpicdn.net/img/view/2012/1/23/1537.jpg,0,0.997047007,100,8,450,358,350,350,twilight sparkle
1537509.png,https://derpicdn.net/img/view/2017/9/17/1537509.png,0,0.957778096,777,0,1251,401,474,401,twilight sparkle
1537509.png,https://derpicdn.net/img/view/2017/9/17/1537509.png,0,0.957778096,777,0,1251,401,474,401,twilight sparkle
1538541.png,https://derpicdn.net/img/view/2017/9/18/1538541.png,0,0.997547269,526,0,1710,1184,1184,1184,twilight sparkle
1538541.png,https://derpicdn.net/img/view/2017/9/18/1538541.png,0,0.997547269,526,0,1710,1184,1184,1184,twilight sparkle
1538766.png,https://derpicdn.net/img/view/2017/9/18/1538766.png,0,0.997385204,1191,316,1500,632,309,316,twilight sparkle
1538766.png,https://derpicdn.net/img/view/2017/9/18/1538766.png,1,0.973394275,78,0,460,320,382,320,twilight sparkle
1538770.png,https://derpicdn.net/img/view/2017/9/18/1538770.png,0,0.958809793,26,37,356,351,330,314,twilight sparkle
1538770.png,https://derpicdn.net/img/view/2017/9/18/1538770.png,0,0.958809793,26,37,356,351,330,314,twilight sparkle
1539014.png,https://derpicdn.net/img/view/2017/9/18/1539014.png,0,0.959108651,161,231,431,501,270,270,twilight sparkle
1540.jpg,https://derpicdn.net/img/view/2012/1/23/1540.jpg,0,0.99146086,50,28,542,520,492,492,twilight sparkle
1540945.png,https://derpicdn.net/img/view/2017/9/21/1540945.png,0,0.999038041,215,92,831,708,616,616,twilight sparkle
1541033.png,https://derpicdn.net/img/view/2017/9/21/1541033.png,0,0.973260224,1402,290,2468,1356,1066,1066,twilight sparkle
1541912.png,https://derpicdn.net/img/view/2017/9/22/1541912.png,0,0.997363985,568,0,1362,753,794,753,twilight sparkle
15428.jpg,https://derpicdn.net/img/view/2012/6/22/15428.jpg,0,0.973683476,288,0,1048,661,760,661,twilight sparkle
1542839.png,https://derpicdn.net/img/view/2017/9/23/1542839.png,0,0.96919173,136,0,1408,996,1272,996,twilight sparkle
1543897.png,https://derpicdn.net/img/view/2017/9/24/1543897.png,0,0.998785615,472,40,1030,598,558,558,twilight sparkle
1544145.png,https://derpicdn.net/img/view/2017/9/25/1544145.png,0,0.987040997,0,0,1759,1827,1759,1827,twilight sparkle
1544586.png,https://derpicdn.net/img/view/2017/9/25/1544586.png,0,0.985100389,809,78,1617,886,808,808,twilight sparkle
1546886.png,https://derpicdn.net/img/view/2017/9/28/1546886.png,0,0.98265326,226,96,1164,1034,938,938,twilight sparkle
1552895.png,https://derpicdn.net/img/view/2017/10/5/1552895.png,0,0.956207991,1017,369,1713,1065,696,696,twilight sparkle
1552899.png,https://derpicdn.net/img/view/2017/10/5/1552899.png,0,0.988481939,648,467,1144,963,496,496,twilight sparkle
1554347.png,https://derpicdn.net/img/view/2017/10/7/1554347.png,0,0.948223352,310,0,1682,1080,1372,1080,twilight sparkle
1554347.png,https://derpicdn.net/img/view/2017/10/7/1554347.png,0,0.948223352,310,0,1682,1080,1372,1080,twilight sparkle
1554965.png,https://derpicdn.net/img/view/2017/10/8/1554965.png,0,0.985328436,166,0,2610,1800,2444,1800,twilight sparkle
1556000.png,https://derpicdn.net/img/view/2017/10/9/1556000.png,0,0.990203917,621,128,2265,1772,1644,1644,twilight sparkle
1557068.png,https://derpicdn.net/img/view/2017/10/10/1557068.png,0,0.982643247,1366,337,2218,1189,852,852,twilight sparkle
1557068.png,https://derpicdn.net/img/view/2017/10/10/1557068.png,1,0.975970507,589,252,1489,1152,900,900,twilight sparkle
1557399.png,https://derpicdn.net/img/view/2017/10/10/1557399.png,0,0.99556011,387,53,673,339,286,286,twilight sparkle
1557513.png,https://derpicdn.net/img/view/2017/10/10/1557513.png,0,0.998614967,626,304,1272,950,646,646,twilight sparkle
1558033.png,https://derpicdn.net/img/view/2017/10/11/1558033.png,0,0.998226106,155,283,709,837,554,554,twilight sparkle
1558033.png,https://derpicdn.net/img/view/2017/10/11/1558033.png,1,0.98570627,730,181,1250,701,520,520,twilight sparkle
1563793.png,https://derpicdn.net/img/view/2017/10/17/1563793.png,0,0.972484112,727,0,1765,895,1038,895,twilight sparkle
1564573.png,https://derpicdn.net/img/view/2017/10/18/1564573.png,0,0.934200048,163,0,655,444,492,444,twilight sparkle
1565090.png,https://derpicdn.net/img/view/2017/10/19/1565090.png,0,0.989227176,217,0,627,406,410,406,twilight sparkle
1566358.png,https://derpicdn.net/img/view/2017/10/21/1566358.png,0,0.988193989,877,18,1595,736,718,718,twilight sparkle
1566500.png,https://derpicdn.net/img/view/2017/10/21/1566500.png,0,0.980535269,0,0,965,1088,965,1088,twilight sparkle
1567161.png,https://derpicdn.net/img/view/2017/10/22/1567161.png,0,0.962826371,247,0,4654,5161,4407,5161,twilight sparkle
1567459.png,https://derpicdn.net/img/view/2017/10/22/1567459.png,0,0.952610552,0,0,434,484,434,484,twilight sparkle
1567600.png,https://derpicdn.net/img/view/2017/10/22/1567600.png,0,0.988528967,368,126,790,548,422,422,twilight sparkle
1567920.png,https://derpicdn.net/img/view/2017/10/22/1567920.png,0,0.997734904,3742,0,6842,2953,3100,2953,twilight sparkle
1568469.png,https://derpicdn.net/img/view/2017/10/23/1568469.png,0,0.994935274,68,0,626,530,558,530,twilight sparkle
1568761.png,https://derpicdn.net/img/view/2017/10/24/1568761.png,0,0.921235085,289,1,913,625,624,624,twilight sparkle
1570056.png,https://derpicdn.net/img/view/2017/10/25/1570056.png,0,0.981379092,87,84,431,428,344,344,twilight sparkle
1572900.png,https://derpicdn.net/img/view/2017/10/29/1572900.png,0,0.908731997,284,216,4064,3996,3780,3780,twilight sparkle
1579598.png,https://derpicdn.net/img/view/2017/11/6/1579598.png,0,0.997461259,1467,535,2155,1223,688,688,twilight sparkle
1580693.png,https://derpicdn.net/img/view/2017/11/7/1580693.png,0,0.956764221,15,0,449,416,434,416,twilight sparkle
1582675.png,https://derpicdn.net/img/view/2017/11/10/1582675.png,0,0.993620217,155,0,2963,2719,2808,2719,twilight sparkle
1583211.png,https://derpicdn.net/img/view/2017/11/10/1583211.png,0,0.964902461,67,189,3477,3599,3410,3410,twilight sparkle
1583556.png,https://derpicdn.net/img/view/2017/11/11/1583556.png,0,0.954925835,0,70,814,964,814,894,twilight sparkle
1585255.png,https://derpicdn.net/img/view/2017/11/13/1585255.png,0,0.987954199,45,0,1915,1732,1870,1732,twilight sparkle
1586882.png,https://derpicdn.net/img/view/2017/11/15/1586882.png,0,0.964077771,638,0,3516,2407,2878,2407,twilight sparkle
1587612.png,https://derpicdn.net/img/view/2017/11/16/1587612.png,0,0.9665187,157,21,807,671,650,650,twilight sparkle
1588738.png,https://derpicdn.net/img/view/2017/11/18/1588738.png,0,0.933710873,182,343,1238,1399,1056,1056,twilight sparkle
1589485.png,https://derpicdn.net/img/view/2017/11/19/1589485.png,0,0.996057808,62,0,470,396,408,396,twilight sparkle
1590265.png,https://derpicdn.net/img/view/2017/11/19/1590265.png,0,0.919215739,377,101,1919,1643,1542,1542,twilight sparkle
159105.jpg,https://derpicdn.net/img/view/2012/11/21/159105.jpg,0,0.975652337,40,0,500,451,460,451,twilight sparkle
1591101.png,https://derpicdn.net/img/view/2017/11/21/1591101.png,0,0.996989071,297,0,657,342,360,342,twilight sparkle
1591101.png,https://derpicdn.net/img/view/2017/11/21/1591101.png,0,0.996989071,297,0,657,342,360,342,twilight sparkle
1592024.png,https://derpicdn.net/img/view/2017/11/22/1592024.png,0,0.984567702,4,0,1038,996,1034,996,twilight sparkle
1594315.png,https://derpicdn.net/img/view/2017/11/26/1594315.png,0,0.999009371,196,22,742,568,546,546,twilight sparkle
1594367.png,https://derpicdn.net/img/view/2017/11/26/1594367.png,0,0.995315969,105,0,1139,988,1034,988,twilight sparkle
1594619.png,https://derpicdn.net/img/view/2017/11/26/1594619.png,0,0.923158109,171,306,1215,1350,1044,1044,twilight sparkle
1594812.png,https://derpicdn.net/img/view/2017/11/26/1594812.png,0,0.997018278,245,134,557,446,312,312,twilight sparkle
1596366.png,https://derpicdn.net/img/view/2017/11/28/1596366.png,0,0.97962749,222,0,576,344,354,344,twilight sparkle
1596947.png,https://derpicdn.net/img/view/2017/11/29/1596947.png,0,0.99617821,727,0,2589,1567,1862,1567,twilight sparkle
1597092.png,https://derpicdn.net/img/view/2017/11/29/1597092.png,0,0.915903986,629,194,1167,732,538,538,twilight sparkle
1600541.png,https://derpicdn.net/img/view/2017/12/4/1600541.png,0,0.98985976,197,103,1527,1433,1330,1330,twilight sparkle
1600608.png,https://derpicdn.net/img/view/2017/12/4/1600608.png,0,0.987305522,66,141,1024,1099,958,958,twilight sparkle
1601298.png,https://derpicdn.net/img/view/2017/12/5/1601298.png,0,0.954233289,1080,857,1424,1201,344,344,twilight sparkle
1601298.png,https://derpicdn.net/img/view/2017/12/5/1601298.png,0,0.954233289,1080,857,1424,1201,344,344,twilight sparkle
1605360.png,https://derpicdn.net/img/view/2017/12/11/1605360.png,0,0.996729434,416,6,946,536,530,530,twilight sparkle
1605949.png,https://derpicdn.net/img/view/2017/12/12/1605949.png,0,0.995265007,872,39,1324,491,452,452,twilight sparkle
1608937.png,https://derpicdn.net/img/view/2017/12/16/1608937.png,0,0.903315485,105,51,369,315,264,264,twilight sparkle
1610369.png,https://derpicdn.net/img/view/2017/12/18/1610369.png,0,0.960426152,0,0,962,974,962,974,twilight sparkle
1610446.png,https://derpicdn.net/img/view/2017/12/18/1610446.png,0,0.997236848,1115,0,2309,1151,1194,1151,twilight sparkle
1611591.png,https://derpicdn.net/img/view/2017/12/19/1611591.png,0,0.995012045,101,0,1011,874,910,874,twilight sparkle
1611985.png,https://derpicdn.net/img/view/2017/12/20/1611985.png,0,0.969117403,227,0,1063,810,836,810,twilight sparkle
1612625.png,https://derpicdn.net/img/view/2017/12/21/1612625.png,0,0.993829131,148,0,1720,1490,1572,1490,twilight sparkle
1612814.png,https://derpicdn.net/img/view/2017/12/21/1612814.png,0,0.994020045,212,0,1472,1164,1260,1164,twilight sparkle
1613291.png,https://derpicdn.net/img/view/2017/12/22/1613291.png,0,0.916918576,635,46,955,366,320,320,twilight sparkle
1614076.png,https://derpicdn.net/img/view/2017/12/23/1614076.png,0,0.933886349,233,48,857,672,624,624,twilight sparkle
1614867.png,https://derpicdn.net/img/view/2017/12/24/1614867.png,0,0.991894186,998,0,2520,1274,1522,1274,twilight sparkle
1615622.png,https://derpicdn.net/img/view/2017/12/25/1615622.png,0,0.998382449,79,314,319,554,240,240,twilight sparkle
1615622.png,https://derpicdn.net/img/view/2017/12/25/1615622.png,1,0.995356023,460,306,708,554,248,248,twilight sparkle
1615622.png,https://derpicdn.net/img/view/2017/12/25/1615622.png,0,0.998382449,79,314,319,554,240,240,twilight sparkle
1615622.png,https://derpicdn.net/img/view/2017/12/25/1615622.png,1,0.995356023,460,306,708,554,248,248,twilight sparkle
1616046.png,https://derpicdn.net/img/view/2017/12/25/1616046.png,0,0.919886947,977,231,2411,1665,1434,1434,twilight sparkle
1617406.png,https://derpicdn.net/img/view/2017/12/27/1617406.png,0,0.928186476,336,0,1804,1444,1468,1444,twilight sparkle
1617640.png,https://derpicdn.net/img/view/2017/12/27/1617640.png,0,0.961280227,797,677,1777,1657,980,980,twilight sparkle
1618412.png,https://derpicdn.net/img/view/2017/12/28/1618412.png,0,0.99867183,990,0,1600,592,610,592,twilight sparkle
1618652.png,https://derpicdn.net/img/view/2017/12/29/1618652.png,0,0.948396623,1284,1154,2990,2860,1706,1706,twilight sparkle
1619291.png,https://derpicdn.net/img/view/2017/12/29/1619291.png,0,0.997228622,372,48,956,632,584,584,twilight sparkle
1619344.png,https://derpicdn.net/img/view/2017/12/30/1619344.png,0,0.953913569,573,131,2325,1883,1752,1752,twilight sparkle
1620303.png,https://derpicdn.net/img/view/2017/12/31/1620303.png,0,0.995054364,87,0,531,405,444,405,twilight sparkle
1621161.png,https://derpicdn.net/img/view/2018/1/1/1621161.png,0,0.999011636,954,74,1750,870,796,796,twilight sparkle
1623039.png,https://derpicdn.net/img/view/2018/1/3/1623039.png,0,0.91331172,1890,722,3146,1978,1256,1256,twilight sparkle
1627500.png,https://derpicdn.net/img/view/2018/1/8/1627500.png,0,0.993145525,1386,310,3400,2326,2014,2016,twilight sparkle
1627695.png,https://derpicdn.net/img/view/2018/1/9/1627695.png,0,0.991914153,56,17,596,557,540,540,twilight sparkle
1628499.png,https://derpicdn.net/img/view/2018/1/10/1628499.png,0,0.999334633,14,0,366,346,352,346,twilight sparkle
1630115.png,https://derpicdn.net/img/view/2018/1/12/1630115.png,0,0.999604344,0,0,557,548,557,548,twilight sparkle
1630158.png,https://derpicdn.net/img/view/2018/1/12/1630158.png,0,0.998158753,2266,0,4770,2464,2504,2464,twilight sparkle
1630446.png,https://derpicdn.net/img/view/2018/1/12/1630446.png,0,0.974585593,131,224,835,928,704,704,twilight sparkle
1630446.png,https://derpicdn.net/img/view/2018/1/12/1630446.png,0,0.974585593,131,224,835,928,704,704,twilight sparkle
163278.jpg,https://derpicdn.net/img/view/2012/11/26/163278.jpg,1,0.951883554,1187,0,2000,814,813,814,twilight sparkle
1633145.png,https://derpicdn.net/img/view/2018/1/15/1633145.png,0,0.957565904,18,0,454,390,436,390,twilight sparkle
1633338.png,https://derpicdn.net/img/view/2018/1/16/1633338.png,0,0.986321807,213,33,813,633,600,600,twilight sparkle
1634232.png,https://derpicdn.net/img/view/2018/1/17/1634232.png,0,0.951108277,17,0,711,648,694,648,twilight sparkle
1635035.png,https://derpicdn.net/img/view/2018/1/18/1635035.png,0,0.960856855,579,0,967,376,388,376,twilight sparkle
1635543.png,https://derpicdn.net/img/view/2018/1/19/1635543.png,0,0.996786654,67,3,495,431,428,428,twilight sparkle
1636141.png,https://derpicdn.net/img/view/2018/1/19/1636141.png,0,0.998658955,569,21,1109,561,540,540,twilight sparkle
1636865.png,https://derpicdn.net/img/view/2018/1/20/1636865.png,0,0.994224668,452,0,1680,1197,1228,1197,twilight sparkle
1637341.png,https://derpicdn.net/img/view/2018/1/21/1637341.png,0,0.98617363,419,20,775,376,356,356,twilight sparkle
1638712.png,https://derpicdn.net/img/view/2018/1/23/1638712.png,0,0.943450749,273,0,729,450,456,450,twilight sparkle
1639070.png,https://derpicdn.net/img/view/2018/1/23/1639070.png,0,0.998915732,187,16,1047,876,860,860,twilight sparkle
1641142.png,https://derpicdn.net/img/view/2018/1/26/1641142.png,0,0.990757942,0,0,679,751,679,751,twilight sparkle
1645627.png,https://derpicdn.net/img/view/2018/2/1/1645627.png,0,0.914456964,336,0,600,257,264,257,twilight sparkle
164580.jpg,https://derpicdn.net/img/view/2012/11/27/164580.jpg,0,0.99961412,657,3,1245,591,588,588,twilight sparkle
164580.jpg,https://derpicdn.net/img/view/2012/11/27/164580.jpg,1,0.997484446,106,267,586,747,480,480,twilight sparkle
1646871.png,https://derpicdn.net/img/view/2018/2/2/1646871.png,0,0.981433153,445,120,2504,2188,2059,2068,twilight sparkle
1647490.png,https://derpicdn.net/img/view/2018/2/3/1647490.png,0,0.997775614,0,56,441,534,441,478,twilight sparkle
1649114.png,https://derpicdn.net/img/view/2018/2/5/1649114.png,0,0.973095536,6,51,658,703,652,652,twilight sparkle
1651124.png,https://derpicdn.net/img/view/2018/2/8/1651124.png,0,0.966055691,493,1031,1067,1605,574,574,twilight sparkle
1653190.png,https://derpicdn.net/img/view/2018/2/11/1653190.png,0,0.999020457,193,0,883,650,690,650,twilight sparkle
1653671.png,https://derpicdn.net/img/view/2018/2/11/1653671.png,0,0.929499447,62,118,660,700,598,582,twilight sparkle
1657187.png,https://derpicdn.net/img/view/2018/2/16/1657187.png,0,0.98631835,2,0,406,384,404,384,twilight sparkle
1659510.png,https://derpicdn.net/img/view/2018/2/18/1659510.png,0,0.984756589,155,182,2719,2746,2564,2564,twilight sparkle
1661202.png,https://derpicdn.net/img/view/2018/2/20/1661202.png,0,0.997228086,195,0,1383,1037,1188,1037,twilight sparkle
1667414.png,https://derpicdn.net/img/view/2018/2/27/1667414.png,0,0.945302188,840,445,1584,1189,744,744,twilight sparkle
1669106.png,https://derpicdn.net/img/view/2018/3/1/1669106.png,0,0.997234643,539,0,1359,647,820,647,twilight sparkle
1669750.png,https://derpicdn.net/img/view/2018/3/2/1669750.png,0,0.983656406,0,0,1058,1054,1058,1054,twilight sparkle
1669966.png,https://derpicdn.net/img/view/2018/3/2/1669966.png,0,0.968642712,1000,0,2216,1126,1216,1126,twilight sparkle
1674692.png,https://derpicdn.net/img/view/2018/3/8/1674692.png,0,0.997075379,475,0,1209,690,734,690,twilight sparkle
1675501.png,https://derpicdn.net/img/view/2018/3/9/1675501.png,0,0.905262113,158,0,464,250,306,250,twilight sparkle
1675798.png,https://derpicdn.net/img/view/2018/3/10/1675798.png,0,0.989844501,1084,0,3674,2357,2590,2357,twilight sparkle
1677545.png,https://derpicdn.net/img/view/2018/3/11/1677545.png,0,0.920150757,97,0,789,624,692,624,twilight sparkle
1679203.png,https://derpicdn.net/img/view/2018/3/13/1679203.png,0,0.987049758,0,19,607,723,607,704,twilight sparkle
1680748.png,https://derpicdn.net/img/view/2018/3/15/1680748.png,0,0.96066308,438,0,1452,968,1014,968,twilight sparkle
1681428.png,https://derpicdn.net/img/view/2018/3/15/1681428.png,0,0.998369515,409,8,1031,630,622,622,twilight sparkle
1684468.png,https://derpicdn.net/img/view/2018/3/18/1684468.png,0,0.997910559,0,60,361,430,361,370,twilight sparkle
1684468.png,https://derpicdn.net/img/view/2018/3/18/1684468.png,1,0.996812165,836,545,1234,943,398,398,twilight sparkle
1684468.png,https://derpicdn.net/img/view/2018/3/18/1684468.png,2,0.987362266,569,0,997,423,428,423,twilight sparkle
1684643.png,https://derpicdn.net/img/view/2018/3/19/1684643.png,0,0.98622185,69,0,877,761,808,761,twilight sparkle
1685679.png,https://derpicdn.net/img/view/2018/3/20/1685679.png,0,0.990032256,104,0,462,352,358,352,twilight sparkle
1685697.png,https://derpicdn.net/img/view/2018/3/20/1685697.png,0,0.951668441,12,27,586,601,574,574,twilight sparkle
1687777.png,https://derpicdn.net/img/view/2018/3/23/1687777.png,0,0.987352371,41,25,497,481,456,456,twilight sparkle
1687952.png,https://derpicdn.net/img/view/2018/3/23/1687952.png,0,0.984839201,12,156,1752,1896,1740,1740,twilight sparkle
1691738.png,https://derpicdn.net/img/view/2018/3/27/1691738.png,0,0.991817892,231,3,575,347,344,344,twilight sparkle
1692749.png,https://derpicdn.net/img/view/2018/3/28/1692749.png,0,0.99780941,1370,870,1840,1340,470,470,twilight sparkle
1692749.png,https://derpicdn.net/img/view/2018/3/28/1692749.png,1,0.98540771,0,373,671,1045,671,672,twilight sparkle
1693355.png,https://derpicdn.net/img/view/2018/3/28/1693355.png,0,0.989142835,354,119,776,541,422,422,twilight sparkle
1694819.png,https://derpicdn.net/img/view/2018/3/30/1694819.png,0,0.977087736,0,0,1190,1049,1190,1049,twilight sparkle
1694948.png,https://derpicdn.net/img/view/2018/3/31/1694948.png,0,0.928645611,814,0,4964,4516,4150,4516,twilight sparkle
1696238.png,https://derpicdn.net/img/view/2018/4/1/1696238.png,0,0.986310959,73,0,685,548,612,548,twilight sparkle
1698034.png,https://derpicdn.net/img/view/2018/4/3/1698034.png,0,0.979499698,836,681,1138,968,302,287,twilight sparkle
1699259.png,https://derpicdn.net/img/view/2018/4/4/1699259.png,0,0.994747519,418,0,1486,1026,1068,1026,twilight sparkle
1699259.png,https://derpicdn.net/img/view/2018/4/4/1699259.png,0,0.994747519,418,0,1486,1026,1068,1026,twilight sparkle
1699907.png,https://derpicdn.net/img/view/2018/4/5/1699907.png,0,0.950353265,272,753,1662,2143,1390,1390,twilight sparkle
1702264.png,https://derpicdn.net/img/view/2018/4/8/1702264.png,0,0.971721232,0,194,1796,2030,1796,1836,twilight sparkle
1702574.png,https://derpicdn.net/img/view/2018/4/8/1702574.png,0,0.930470407,393,114,1000,746,607,632,twilight sparkle
1703961.png,https://derpicdn.net/img/view/2018/4/10/1703961.png,0,0.996575773,288,14,500,230,212,216,twilight sparkle
1703961.png,https://derpicdn.net/img/view/2018/4/10/1703961.png,0,0.996575773,288,14,500,230,212,216,twilight sparkle
1704402.png,https://derpicdn.net/img/view/2018/4/10/1704402.png,0,0.994156241,265,328,877,940,612,612,twilight sparkle
1711009.png,https://derpicdn.net/img/view/2018/4/18/1711009.png,0,0.983120918,109,0,520,426,411,426,twilight sparkle
1711009.png,https://derpicdn.net/img/view/2018/4/18/1711009.png,0,0.983120918,109,0,520,426,411,426,twilight sparkle
1711548.png,https://derpicdn.net/img/view/2018/4/19/1711548.png,0,0.909005404,0,138,480,624,480,486,twilight sparkle
1712073.png,https://derpicdn.net/img/view/2018/4/19/1712073.png,0,0.938265324,438,0,1582,929,1144,929,twilight sparkle
1712076.png,https://derpicdn.net/img/view/2018/4/19/1712076.png,0,0.957244933,101,215,885,999,784,784,twilight sparkle
1715125.png,https://derpicdn.net/img/view/2018/4/23/1715125.png,0,0.953704178,3553,558,6439,3444,2886,2886,twilight sparkle
1715813.png,https://derpicdn.net/img/view/2018/4/24/1715813.png,0,0.986270308,665,0,2069,1349,1404,1349,twilight sparkle
1716809.png,https://derpicdn.net/img/view/2018/4/25/1716809.png,0,0.992180407,0,503,3768,4526,3768,4023,twilight sparkle
1717295.png,https://derpicdn.net/img/view/2018/4/26/1717295.png,0,0.920148134,447,131,1075,759,628,628,twilight sparkle
1718832.png,https://derpicdn.net/img/view/2018/4/28/1718832.png,0,0.98816359,81,0,841,729,760,729,twilight sparkle
1718850.png,https://derpicdn.net/img/view/2018/4/28/1718850.png,0,0.90089494,347,352,2983,2988,2636,2636,twilight sparkle
1718883.png,https://derpicdn.net/img/view/2018/4/28/1718883.png,0,0.98916322,373,326,837,790,464,464,twilight sparkle
1718928.png,https://derpicdn.net/img/view/2018/4/28/1718928.png,0,0.996730626,240,0,786,543,546,543,twilight sparkle
1719345.png,https://derpicdn.net/img/view/2018/4/28/1719345.png,0,0.974467695,143,3,539,399,396,396,twilight sparkle
1719355.png,https://derpicdn.net/img/view/2018/4/28/1719355.png,0,0.933753371,35,0,661,604,626,604,twilight sparkle
1719373.png,https://derpicdn.net/img/view/2018/4/28/1719373.png,0,0.985630989,340,0,1292,950,952,950,twilight sparkle
1719571.png,https://derpicdn.net/img/view/2018/4/29/1719571.png,0,0.99874109,2584,20,5142,2578,2558,2558,twilight sparkle
1719651.png,https://derpicdn.net/img/view/2018/4/29/1719651.png,0,0.984993577,0,0,1394,1690,1394,1690,twilight sparkle
1720169.png,https://derpicdn.net/img/view/2018/4/29/1720169.png,0,0.918717444,114,125,2004,2015,1890,1890,twilight sparkle
1721340.png,https://derpicdn.net/img/view/2018/5/1/1721340.png,0,0.990641117,0,19,2711,2809,2711,2790,twilight sparkle
1721991.png,https://derpicdn.net/img/view/2018/5/1/1721991.png,0,0.940692186,94,133,1562,1601,1468,1468,twilight sparkle
1722141.png,https://derpicdn.net/img/view/2018/5/2/1722141.png,0,0.989606977,2331,307,5049,3025,2718,2718,twilight sparkle
1722198.png,https://derpicdn.net/img/view/2018/5/2/1722198.png,0,0.995444834,426,35,1796,1405,1370,1370,twilight sparkle
1724558.png,https://derpicdn.net/img/view/2018/5/5/1724558.png,0,0.982813239,126,20,826,720,700,700,twilight sparkle
1725555.png,https://derpicdn.net/img/view/2018/5/6/1725555.png,0,0.966606021,423,43,1301,921,878,878,twilight sparkle
1734418.png,https://derpicdn.net/img/view/2018/5/16/1734418.png,0,0.996678114,368,0,634,264,266,264,twilight sparkle
1735147.png,https://derpicdn.net/img/view/2018/5/17/1735147.png,0,0.966367841,28,0,634,593,606,593,twilight sparkle
1735682.png,https://derpicdn.net/img/view/2018/5/18/1735682.png,0,0.991545379,18,426,386,794,368,368,twilight sparkle
1735682.png,https://derpicdn.net/img/view/2018/5/18/1735682.png,1,0.98933959,325,5,1021,701,696,696,twilight sparkle
1737287.png,https://derpicdn.net/img/view/2018/5/20/1737287.png,0,0.99718976,515,0,1000,472,485,472,twilight sparkle
1737985.png,https://derpicdn.net/img/view/2018/5/21/1737985.png,0,0.990245104,283,225,1557,1499,1274,1274,twilight sparkle
1740629.png,https://derpicdn.net/img/view/2018/5/24/1740629.png,0,0.948201656,0,0,3475,3701,3475,3701,twilight sparkle
1741909.png,https://derpicdn.net/img/view/2018/5/26/1741909.png,0,0.976201713,1,0,931,845,930,845,twilight sparkle
1741909.png,https://derpicdn.net/img/view/2018/5/26/1741909.png,0,0.976201713,1,0,931,845,930,845,twilight sparkle
1744598.png,https://derpicdn.net/img/view/2018/5/29/1744598.png,0,0.997801661,390,37,2186,1833,1796,1796,twilight sparkle
1744598.png,https://derpicdn.net/img/view/2018/5/29/1744598.png,0,0.997801661,390,37,2186,1833,1796,1796,twilight sparkle
1745782.png,https://derpicdn.net/img/view/2018/5/31/1745782.png,0,0.991325736,26,3,254,231,228,228,twilight sparkle
1747.jpg,https://derpicdn.net/img/view/2012/1/23/1747.jpg,1,0.967901409,1267,0,2339,833,1072,833,twilight sparkle
1747641.png,https://derpicdn.net/img/view/2018/6/2/1747641.png,0,0.937319934,272,0,1006,721,734,721,twilight sparkle
1750693.png,https://derpicdn.net/img/view/2018/6/5/1750693.png,0,0.991450191,5,29,695,719,690,690,twilight sparkle
1750807.png,https://derpicdn.net/img/view/2018/6/5/1750807.png,0,0.945664644,0,11,197,215,197,204,twilight sparkle
1751037.png,https://derpicdn.net/img/view/2018/6/6/1751037.png,0,0.907176375,49,0,619,498,570,498,twilight sparkle
1751080.png,https://derpicdn.net/img/view/2018/6/6/1751080.png,0,0.99018091,4,99,632,727,628,628,twilight sparkle
1753239.png,https://derpicdn.net/img/view/2018/6/9/1753239.png,0,0.992674232,27,3,255,231,228,228,twilight sparkle
1755108.png,https://derpicdn.net/img/view/2018/6/11/1755108.png,0,0.982424498,368,61,790,483,422,422,twilight sparkle
1756562.png,https://derpicdn.net/img/view/2018/6/13/1756562.png,0,0.990401328,90,32,784,726,694,694,twilight sparkle
1758347.png,https://derpicdn.net/img/view/2018/6/15/1758347.png,0,0.997252047,1797,0,3473,1660,1676,1660,twilight sparkle
1761340.png,https://derpicdn.net/img/view/2018/6/19/1761340.png,0,0.988316417,500,127,1362,989,862,862,twilight sparkle
1761872.png,https://derpicdn.net/img/view/2018/6/20/1761872.png,0,0.998048306,126,16,848,738,722,722,twilight sparkle
1762343.png,https://derpicdn.net/img/view/2018/6/20/1762343.png,0,0.964971125,35,0,377,312,342,312,twilight sparkle
1762476.png,https://derpicdn.net/img/view/2018/6/21/1762476.png,0,0.999599338,330,0,1864,1509,1534,1509,twilight sparkle
1762527.png,https://derpicdn.net/img/view/2018/6/21/1762527.png,0,0.986715376,484,40,882,438,398,398,twilight sparkle
1762933.png,https://derpicdn.net/img/view/2018/6/21/1762933.png,0,0.999285936,313,0,1873,1551,1560,1551,twilight sparkle
1764723.png,https://derpicdn.net/img/view/2018/6/24/1764723.png,0,0.976246715,197,201,661,665,464,464,twilight sparkle
1764723.png,https://derpicdn.net/img/view/2018/6/24/1764723.png,0,0.976246715,197,201,661,665,464,464,twilight sparkle
1770901.png,https://derpicdn.net/img/view/2018/7/2/1770901.png,1,0.98216188,287,13,1361,1087,1074,1074,twilight sparkle
1770901.png,https://derpicdn.net/img/view/2018/7/2/1770901.png,2,0.980096161,1696,783,2722,1809,1026,1026,twilight sparkle
1770901.png,https://derpicdn.net/img/view/2018/7/2/1770901.png,3,0.911506474,1769,0,2751,938,982,938,twilight sparkle
1771046.png,https://derpicdn.net/img/view/2018/7/2/1771046.png,0,0.993702292,272,116,4534,4378,4262,4262,twilight sparkle
1772391.png,https://derpicdn.net/img/view/2018/7/4/1772391.png,0,0.942749441,114,106,928,920,814,814,twilight sparkle
1774286.png,https://derpicdn.net/img/view/2018/7/6/1774286.png,0,0.918168724,88,45,716,673,628,628,twilight sparkle
1774286.png,https://derpicdn.net/img/view/2018/7/6/1774286.png,0,0.918168724,88,45,716,673,628,628,twilight sparkle
1774821.png,https://derpicdn.net/img/view/2018/7/7/1774821.png,0,0.996892393,381,115,1637,1371,1256,1256,twilight sparkle
1778272.png,https://derpicdn.net/img/view/2018/7/11/1778272.png,0,0.997407615,0,246,1418,1838,1418,1592,twilight sparkle
1778272.png,https://derpicdn.net/img/view/2018/7/11/1778272.png,1,0.986881733,2446,616,4278,2448,1832,1832,twilight sparkle
1778272.png,https://derpicdn.net/img/view/2018/7/11/1778272.png,2,0.968779266,203,4001,1503,5301,1300,1300,twilight sparkle
1780737.png,https://derpicdn.net/img/view/2018/7/14/1780737.png,0,0.998517513,562,779,1398,1615,836,836,twilight sparkle
1782761.png,https://derpicdn.net/img/view/2018/7/17/1782761.png,0,0.9974069,929,86,1575,732,646,646,twilight sparkle
1783261.png,https://derpicdn.net/img/view/2018/7/17/1783261.png,0,0.921789944,0,106,212,322,212,216,twilight sparkle
1783573.png,https://derpicdn.net/img/view/2018/7/18/1783573.png,0,0.988482535,36,0,726,661,690,661,twilight sparkle
1784513.png,https://derpicdn.net/img/view/2018/7/19/1784513.png,0,0.997653067,275,77,1755,1557,1480,1480,twilight sparkle
1784661.png,https://derpicdn.net/img/view/2018/7/19/1784661.png,0,0.912768602,395,0,809,391,414,391,twilight sparkle
1785202.png,https://derpicdn.net/img/view/2018/7/20/1785202.png,0,0.994782388,236,467,2594,2825,2358,2358,twilight sparkle
1785297.png,https://derpicdn.net/img/view/2018/7/20/1785297.png,0,0.97647649,6,0,1358,1339,1352,1339,twilight sparkle
1786035.png,https://derpicdn.net/img/view/2018/7/21/1786035.png,0,0.961639822,33,46,701,714,668,668,twilight sparkle
1786035.png,https://derpicdn.net/img/view/2018/7/21/1786035.png,0,0.961639822,33,46,701,714,668,668,twilight sparkle
1787647.png,https://derpicdn.net/img/view/2018/7/23/1787647.png,0,0.974723518,308,0,2208,1749,1900,1749,twilight sparkle
1788652.png,https://derpicdn.net/img/view/2018/7/24/1788652.png,0,0.974354446,1629,828,2219,1418,590,590,twilight sparkle
1789009.png,https://derpicdn.net/img/view/2018/7/24/1789009.png,0,0.995989323,23,13,381,371,358,358,twilight sparkle
1792363.png,https://derpicdn.net/img/view/2018/7/29/1792363.png,0,0.996295631,58,0,2384,2309,2326,2309,twilight sparkle
1792363.png,https://derpicdn.net/img/view/2018/7/29/1792363.png,0,0.996295631,58,0,2384,2309,2326,2309,twilight sparkle
1792768.png,https://derpicdn.net/img/view/2018/7/29/1792768.png,0,0.988921642,164,0,2854,2647,2690,2647,twilight sparkle
1793596.png,https://derpicdn.net/img/view/2018/7/30/1793596.png,0,0.993902862,756,120,1124,488,368,368,twilight sparkle
1795648.png,https://derpicdn.net/img/view/2018/8/2/1795648.png,0,0.990044117,0,0,1335,1360,1335,1360,twilight sparkle
1796150.png,https://derpicdn.net/img/view/2018/8/2/1796150.png,0,0.994882822,460,0,1520,802,1060,802,twilight sparkle
1796502.png,https://derpicdn.net/img/view/2018/8/3/1796502.png,0,0.997418821,3086,392,5446,2752,2360,2360,twilight sparkle
1796802.png,https://derpicdn.net/img/view/2018/8/3/1796802.png,0,0.998925924,444,0,1956,1481,1512,1481,twilight sparkle
1796999.png,https://derpicdn.net/img/view/2018/8/3/1796999.png,0,0.990668535,161,0,741,571,580,571,twilight sparkle
1798538.png,https://derpicdn.net/img/view/2018/8/5/1798538.png,0,0.982693672,48,0,2958,2779,2910,2779,twilight sparkle
1799.png,https://derpicdn.net/img/view/2012/1/23/1799.png,0,0.992769301,264,19,624,379,360,360,twilight sparkle
1799482.png,https://derpicdn.net/img/view/2018/8/6/1799482.png,0,0.999159217,77,0,515,426,438,426,twilight sparkle
1799923.png,https://derpicdn.net/img/view/2018/8/6/1799923.png,0,0.989367008,500,15,884,399,384,384,twilight sparkle
1801587.png,https://derpicdn.net/img/view/2018/8/8/1801587.png,0,0.98879081,0,0,449,445,449,445,twilight sparkle
1801671.png,https://derpicdn.net/img/view/2018/8/8/1801671.png,0,0.966831088,346,18,712,384,366,366,twilight sparkle
1802.png,https://derpicdn.net/img/view/2012/1/23/1802.png,0,0.990566611,41,0,625,564,584,564,twilight sparkle
1802121.png,https://derpicdn.net/img/view/2018/8/9/1802121.png,0,0.98850888,935,286,1473,824,538,538,twilight sparkle
1802381.png,https://derpicdn.net/img/view/2018/8/9/1802381.png,0,0.925685823,90,0,464,362,374,362,twilight sparkle
1802746.png,https://derpicdn.net/img/view/2018/8/9/1802746.png,0,0.981546938,51,0,1355,1080,1304,1080,twilight sparkle
1803680.png,https://derpicdn.net/img/view/2018/8/11/1803680.png,0,0.984778404,775,0,1799,900,1024,900,twilight sparkle
1806077.png,https://derpicdn.net/img/view/2018/8/13/1806077.png,0,0.987947106,24,204,2298,2449,2274,2245,twilight sparkle
1806680.png,https://derpicdn.net/img/view/2018/8/14/1806680.png,0,0.976191759,127,0,693,507,566,507,twilight sparkle
1807037.png,https://derpicdn.net/img/view/2018/8/15/1807037.png,0,0.998736143,624,3,1582,961,958,958,twilight sparkle
1807420.png,https://derpicdn.net/img/view/2018/8/15/1807420.png,0,0.98308754,310,0,2768,2340,2458,2340,twilight sparkle
1808510.png,https://derpicdn.net/img/view/2018/8/16/1808510.png,0,0.997377932,259,0,625,315,366,315,twilight sparkle
1809128.png,https://derpicdn.net/img/view/2018/8/17/1809128.png,0,0.973641038,506,99,1148,741,642,642,twilight sparkle
1811161.png,https://derpicdn.net/img/view/2018/8/19/1811161.png,0,0.995836496,484,0,2084,1555,1600,1555,twilight sparkle
1811598.png,https://derpicdn.net/img/view/2018/8/20/1811598.png,0,0.995912075,31,0,319,288,288,288,twilight sparkle
1813824.png,https://derpicdn.net/img/view/2018/8/23/1813824.png,0,0.996214211,66,637,2138,2709,2072,2072,twilight sparkle
1817520.png,https://derpicdn.net/img/view/2018/8/27/1817520.png,0,0.988459289,483,31,1061,609,578,578,twilight sparkle
1820311.png,https://derpicdn.net/img/view/2018/8/30/1820311.png,0,0.973681808,1302,436,1804,938,502,502,twilight sparkle
1822.png,https://derpicdn.net/img/view/2012/1/23/1822.png,0,0.958938718,300,0,700,420,400,420,twilight sparkle
1825665.png,https://derpicdn.net/img/view/2018/9/5/1825665.png,0,0.99246037,426,0,1270,725,844,725,twilight sparkle
1826796.png,https://derpicdn.net/img/view/2018/9/7/1826796.png,0,0.984158754,742,308,1704,1270,962,962,twilight sparkle
1827183.png,https://derpicdn.net/img/view/2018/9/7/1827183.png,0,0.998536348,170,0,2856,2605,2686,2605,twilight sparkle
1827868.png,https://derpicdn.net/img/view/2018/9/8/1827868.png,0,0.985917032,200,0,564,361,364,361,twilight sparkle
1829084.png,https://derpicdn.net/img/view/2018/9/10/1829084.png,0,0.997611761,134,0,670,513,536,513,twilight sparkle
1829084.png,https://derpicdn.net/img/view/2018/9/10/1829084.png,0,0.997611761,134,0,670,513,536,513,twilight sparkle
1829125.png,https://derpicdn.net/img/view/2018/9/10/1829125.png,0,0.940683067,58,5,342,291,284,286,twilight sparkle
1829142.png,https://derpicdn.net/img/view/2018/9/10/1829142.png,0,0.971773148,89,0,739,604,650,604,twilight sparkle
1829303.png,https://derpicdn.net/img/view/2018/9/10/1829303.png,0,0.998966932,740,0,1894,1101,1154,1101,twilight sparkle
1831280.png,https://derpicdn.net/img/view/2018/9/12/1831280.png,0,0.98651433,821,75,1555,809,734,734,twilight sparkle
1831326.png,https://derpicdn.net/img/view/2018/9/12/1831326.png,0,0.998523355,0,0,589,594,589,594,twilight sparkle
18343.png,https://derpicdn.net/img/view/2012/6/24/18343.png,0,0.997555196,232,54,652,474,420,420,twilight sparkle
1835413.png,https://derpicdn.net/img/view/2018/9/18/1835413.png,0,0.967808545,681,0,1187,393,506,393,twilight sparkle
1837218.png,https://derpicdn.net/img/view/2018/9/20/1837218.png,0,0.977757156,2799,0,4695,1705,1896,1705,twilight sparkle
1840758.png,https://derpicdn.net/img/view/2018/9/25/1840758.png,0,0.997968376,153,0,461,301,308,301,twilight sparkle
1842291.png,https://derpicdn.net/img/view/2018/9/27/1842291.png,0,0.922722757,3,0,391,379,388,379,twilight sparkle
1843413.png,https://derpicdn.net/img/view/2018/9/28/1843413.png,0,0.979755402,331,72,629,370,298,298,twilight sparkle
1843413.png,https://derpicdn.net/img/view/2018/9/28/1843413.png,0,0.979755402,331,72,629,370,298,298,twilight sparkle
1844066.png,https://derpicdn.net/img/view/2018/9/29/1844066.png,0,0.995291054,288,29,848,589,560,560,twilight sparkle
1844211.png,https://derpicdn.net/img/view/2018/9/29/1844211.png,0,0.999707043,682,21,1382,721,700,700,twilight sparkle
1844697.png,https://derpicdn.net/img/view/2018/9/30/1844697.png,0,0.998716354,115,0,913,784,798,784,twilight sparkle
1844899.png,https://derpicdn.net/img/view/2018/9/30/1844899.png,0,0.996574163,400,38,3262,2900,2862,2862,twilight sparkle
1844960.png,https://derpicdn.net/img/view/2018/9/30/1844960.png,0,0.937071502,1398,806,2138,1546,740,740,twilight sparkle
1846769.png,https://derpicdn.net/img/view/2018/10/3/1846769.png,0,0.99726218,514,250,1332,1068,818,818,twilight sparkle
1846792.png,https://derpicdn.net/img/view/2018/10/3/1846792.png,0,0.981419981,288,184,912,808,624,624,twilight sparkle
1846792.png,https://derpicdn.net/img/view/2018/10/3/1846792.png,0,0.981419981,288,184,912,808,624,624,twilight sparkle
1846906.png,https://derpicdn.net/img/view/2018/10/3/1846906.png,0,0.983191192,2456,329,3220,1093,764,764,twilight sparkle
1847071.png,https://derpicdn.net/img/view/2018/10/3/1847071.png,0,0.995623827,161,0,723,549,562,549,twilight sparkle
1847398.png,https://derpicdn.net/img/view/2018/10/3/1847398.png,0,0.979990065,462,168,1304,1010,842,842,twilight sparkle
1848144.png,https://derpicdn.net/img/view/2018/10/4/1848144.png,0,0.930164337,467,240,1183,956,716,716,twilight sparkle
1848932.png,https://derpicdn.net/img/view/2018/10/5/1848932.png,0,0.99039495,121,3,895,777,774,774,twilight sparkle
1849783.png,https://derpicdn.net/img/view/2018/10/6/1849783.png,0,0.994271755,328,0,1340,973,1012,973,twilight sparkle
1852918.png,https://derpicdn.net/img/view/2018/10/10/1852918.png,0,0.954740584,373,140,2459,2342,2086,2202,twilight sparkle
1853777.png,https://derpicdn.net/img/view/2018/10/11/1853777.png,0,0.990451455,738,274,1324,860,586,586,twilight sparkle
1854573.png,https://derpicdn.net/img/view/2018/10/12/1854573.png,0,0.980757356,0,0,3326,3444,3326,3444,twilight sparkle
1855022.png,https://derpicdn.net/img/view/2018/10/13/1855022.png,0,0.979067385,0,0,427,541,427,541,twilight sparkle
1859244.png,https://derpicdn.net/img/view/2018/10/17/1859244.png,0,0.998052895,131,229,363,461,232,232,twilight sparkle
1859244.png,https://derpicdn.net/img/view/2018/10/17/1859244.png,1,0.961514413,311,90,603,382,292,292,twilight sparkle
1859765.png,https://derpicdn.net/img/view/2018/10/18/1859765.png,0,0.97683841,236,0,1120,874,884,874,twilight sparkle
1861370.png,https://derpicdn.net/img/view/2018/10/20/1861370.png,0,0.993894279,79,0,1061,959,982,959,twilight sparkle
1863635.png,https://derpicdn.net/img/view/2018/10/23/1863635.png,0,0.954273045,511,0,2367,1805,1856,1805,twilight sparkle
1865775.png,https://derpicdn.net/img/view/2018/10/25/1865775.png,0,0.994518042,15,0,875,764,860,764,twilight sparkle
1867115.png,https://derpicdn.net/img/view/2018/10/27/1867115.png,0,0.928934574,249,662,1749,2162,1500,1500,twilight sparkle
1869778.png,https://derpicdn.net/img/view/2018/10/29/1869778.png,0,0.961051166,797,71,2037,1311,1240,1240,twilight sparkle
1869823.png,https://derpicdn.net/img/view/2018/10/29/1869823.png,0,0.983234763,221,7,851,637,630,630,twilight sparkle
1870530.png,https://derpicdn.net/img/view/2018/10/30/1870530.png,0,0.99522543,275,0,931,622,656,622,twilight sparkle
18708.jpg,https://derpicdn.net/img/view/2012/6/24/18708.jpg,0,0.993721902,118,72,900,854,782,782,twilight sparkle
1870856.png,https://derpicdn.net/img/view/2018/10/31/1870856.png,0,0.98357439,442,116,1050,724,608,608,twilight sparkle
1872454.png,https://derpicdn.net/img/view/2018/11/1/1872454.png,0,0.96672368,30,0,702,649,672,649,twilight sparkle
1874280.png,https://derpicdn.net/img/view/2018/11/3/1874280.png,0,0.997660995,29,55,197,223,168,168,twilight sparkle
1874421.png,https://derpicdn.net/img/view/2018/11/3/1874421.png,0,0.952613533,41,0,283,204,242,204,twilight sparkle
1876105.png,https://derpicdn.net/img/view/2018/11/6/1876105.png,0,0.999310255,165,161,561,557,396,396,twilight sparkle
1878237.png,https://derpicdn.net/img/view/2018/11/9/1878237.png,0,0.986554086,658,0,1748,897,1090,897,twilight sparkle
1878418.png,https://derpicdn.net/img/view/2018/11/9/1878418.png,0,0.976480007,1330,0,2234,734,904,734,twilight sparkle
1886045.png,https://derpicdn.net/img/view/2018/11/19/1886045.png,0,0.989916682,14,102,548,636,534,534,twilight sparkle
1887693.png,https://derpicdn.net/img/view/2018/11/21/1887693.png,0,0.984905303,255,100,677,522,422,422,twilight sparkle
1890073.png,https://derpicdn.net/img/view/2018/11/24/1890073.png,0,0.990271568,1775,0,4063,2187,2288,2187,twilight sparkle
1890802.png,https://derpicdn.net/img/view/2018/11/25/1890802.png,0,0.988275468,530,549,1378,1397,848,848,twilight sparkle
1891844.png,https://derpicdn.net/img/view/2018/11/27/1891844.png,0,0.99738878,486,615,1580,1709,1094,1094,twilight sparkle
1896568.png,https://derpicdn.net/img/view/2018/12/2/1896568.png,0,0.994108796,503,173,987,657,484,484,twilight sparkle
1899402.png,https://derpicdn.net/img/view/2018/12/5/1899402.png,0,0.966473997,572,155,3256,2839,2684,2684,twilight sparkle
1901144.png,https://derpicdn.net/img/view/2018/12/7/1901144.png,0,0.999181688,41,0,845,783,804,783,twilight sparkle
1902095.png,https://derpicdn.net/img/view/2018/12/8/1902095.png,0,0.998908341,40,0,848,783,808,783,twilight sparkle
1904900.png,https://derpicdn.net/img/view/2018/12/10/1904900.png,0,0.947801948,9,0,1089,1009,1080,1009,twilight sparkle
1911145.png,https://derpicdn.net/img/view/2018/12/17/1911145.png,0,0.970213473,335,62,1375,1102,1040,1040,twilight sparkle
1916454.png,https://derpicdn.net/img/view/2018/12/23/1916454.png,0,0.963792086,472,82,1514,1124,1042,1042,twilight sparkle
1917413.png,https://derpicdn.net/img/view/2018/12/24/1917413.png,0,0.953250706,62,94,450,482,388,388,twilight sparkle
1918985.png,https://derpicdn.net/img/view/2018/12/26/1918985.png,0,0.953271806,173,0,894,852,721,852,twilight sparkle
1919597.png,https://derpicdn.net/img/view/2018/12/26/1919597.png,0,0.971388042,205,0,889,584,684,584,twilight sparkle
1919597.png,https://derpicdn.net/img/view/2018/12/26/1919597.png,0,0.971388042,205,0,889,584,684,584,twilight sparkle
1923316.png,https://derpicdn.net/img/view/2018/12/31/1923316.png,0,0.979763389,313,84,1491,1262,1178,1178,twilight sparkle
1925180.png,https://derpicdn.net/img/view/2019/1/2/1925180.png,0,0.95352757,83,1076,1013,2006,930,930,twilight sparkle
1928208.png,https://derpicdn.net/img/view/2019/1/6/1928208.png,0,0.989192069,1265,0,2011,651,746,651,twilight sparkle
1930029.png,https://derpicdn.net/img/view/2019/1/8/1930029.png,0,0.998645902,168,12,1404,1248,1236,1236,twilight sparkle
1930085.png,https://derpicdn.net/img/view/2019/1/8/1930085.png,0,0.998743296,1051,0,1500,427,449,427,twilight sparkle
1930085.png,https://derpicdn.net/img/view/2019/1/8/1930085.png,1,0.998723805,98,0,490,350,392,350,twilight sparkle
19301.png,https://derpicdn.net/img/view/2012/6/24/19301.png,0,0.952805936,496,94,910,508,414,414,twilight sparkle
1931770.png,https://derpicdn.net/img/view/2019/1/10/1931770.png,0,0.981749237,0,0,707,750,707,750,twilight sparkle
1934691.png,https://derpicdn.net/img/view/2019/1/13/1934691.png,0,0.957848191,831,0,1993,1112,1162,1112,twilight sparkle
1934984.png,https://derpicdn.net/img/view/2019/1/14/1934984.png,0,0.99296993,29,0,629,519,600,519,twilight sparkle
1935020.png,https://derpicdn.net/img/view/2019/1/14/1935020.png,0,0.996438682,38,168,594,724,556,556,twilight sparkle
1937486.png,https://derpicdn.net/img/view/2019/1/17/1937486.png,0,0.99661684,295,0,1095,738,800,738,twilight sparkle
1940048.png,https://derpicdn.net/img/view/2019/1/20/1940048.png,0,0.990092039,292,79,1408,1195,1116,1116,twilight sparkle
1944208.png,https://derpicdn.net/img/view/2019/1/25/1944208.png,0,0.986599088,223,12,429,218,206,206,twilight sparkle
1946797.png,https://derpicdn.net/img/view/2019/1/28/1946797.png,0,0.99845767,1232,0,2382,1137,1150,1137,twilight sparkle
1947228.png,https://derpicdn.net/img/view/2019/1/28/1947228.png,0,0.999081731,0,68,2820,3274,2820,3206,twilight sparkle
1948690.png,https://derpicdn.net/img/view/2019/1/30/1948690.png,0,0.998159885,38,66,496,524,458,458,twilight sparkle
1948957.png,https://derpicdn.net/img/view/2019/1/30/1948957.png,0,0.999003351,285,59,1409,1183,1124,1124,twilight sparkle
1949395.png,https://derpicdn.net/img/view/2019/1/31/1949395.png,0,0.984676361,3023,0,4751,1625,1728,1625,twilight sparkle
1949395.png,https://derpicdn.net/img/view/2019/1/31/1949395.png,1,0.961194158,851,175,2533,1857,1682,1682,twilight sparkle
1949628.png,https://derpicdn.net/img/view/2019/1/31/1949628.png,0,0.948606372,401,249,1231,1079,830,830,twilight sparkle
1950983.png,https://derpicdn.net/img/view/2019/2/2/1950983.png,0,0.986925721,114,68,1152,1106,1038,1038,twilight sparkle
1951818.png,https://derpicdn.net/img/view/2019/2/3/1951818.png,0,0.986393273,709,0,1919,1168,1210,1168,twilight sparkle
1952122.png,https://derpicdn.net/img/view/2019/2/3/1952122.png,0,0.975818574,0,0,2507,2716,2507,2716,twilight sparkle
1952394.png,https://derpicdn.net/img/view/2019/2/3/1952394.png,0,0.978552639,420,0,1542,1108,1122,1108,twilight sparkle
1955713.png,https://derpicdn.net/img/view/2019/2/7/1955713.png,0,0.985193372,312,0,766,424,454,424,twilight sparkle
1955713.png,https://derpicdn.net/img/view/2019/2/7/1955713.png,1,0.92614764,243,336,721,773,478,437,twilight sparkle
1957223.png,https://derpicdn.net/img/view/2019/2/9/1957223.png,0,0.999695361,710,234,1998,1522,1288,1288,twilight sparkle
1958519.png,https://derpicdn.net/img/view/2019/2/10/1958519.png,0,0.993703008,65,63,523,521,458,458,twilight sparkle
1958750.png,https://derpicdn.net/img/view/2019/2/10/1958750.png,0,0.982558668,377,81,2289,1993,1912,1912,twilight sparkle
1958751.png,https://derpicdn.net/img/view/2019/2/10/1958751.png,0,0.995148242,280,0,2400,2022,2120,2022,twilight sparkle
1959104.png,https://derpicdn.net/img/view/2019/2/11/1959104.png,0,0.982862413,0,0,754,693,754,693,twilight sparkle
1959607.png,https://derpicdn.net/img/view/2019/2/11/1959607.png,0,0.97733444,399,373,2231,2205,1832,1832,twilight sparkle
1961026.png,https://derpicdn.net/img/view/2019/2/13/1961026.png,0,0.991064191,483,0,1373,820,890,820,twilight sparkle
1961279.png,https://derpicdn.net/img/view/2019/2/13/1961279.png,0,0.996836364,843,896,3633,3686,2790,2790,twilight sparkle
1962343.png,https://derpicdn.net/img/view/2019/2/15/1962343.png,0,0.997083545,668,433,1562,1327,894,894,twilight sparkle
1963055.png,https://derpicdn.net/img/view/2019/2/15/1963055.png,0,0.911503494,112,66,876,830,764,764,twilight sparkle
1964956.png,https://derpicdn.net/img/view/2019/2/18/1964956.png,0,0.985831201,0,121,903,1024,903,903,twilight sparkle
1964957.png,https://derpicdn.net/img/view/2019/2/18/1964957.png,0,0.981725454,14,72,1000,1024,986,952,twilight sparkle
1965367.png,https://derpicdn.net/img/view/2019/2/18/1965367.png,0,0.996540427,673,0,1701,1025,1028,1025,twilight sparkle
1966662.png,https://derpicdn.net/img/view/2019/2/20/1966662.png,0,0.902795434,566,0,1119,530,553,530,twilight sparkle
1967961.png,https://derpicdn.net/img/view/2019/2/21/1967961.png,0,0.996989667,313,0,971,615,658,615,twilight sparkle
196817.png,https://derpicdn.net/img/view/2012/12/29/196817.png,0,0.918042541,967,152,1855,1040,888,888,twilight sparkle
1970952.png,https://derpicdn.net/img/view/2019/2/24/1970952.png,0,0.986941397,526,0,1346,768,820,768,twilight sparkle
1971163.png,https://derpicdn.net/img/view/2019/2/25/1971163.png,0,0.996363521,428,0,1404,966,976,966,twilight sparkle
1974400.png,https://derpicdn.net/img/view/2019/3/1/1974400.png,0,0.997975409,303,0,915,604,612,604,twilight sparkle
1974870.png,https://derpicdn.net/img/view/2019/3/1/1974870.png,0,0.985221207,459,293,827,661,368,368,twilight sparkle
1975733.png,https://derpicdn.net/img/view/2019/3/2/1975733.png,0,0.92293781,287,0,1543,983,1256,983,twilight sparkle
1976906.png,https://derpicdn.net/img/view/2019/3/3/1976906.png,0,0.976895154,129,53,659,583,530,530,twilight sparkle
1983333.png,https://derpicdn.net/img/view/2019/3/11/1983333.png,0,0.929640174,50,0,906,418,856,418,twilight sparkle
1985764.png,https://derpicdn.net/img/view/2019/3/15/1985764.png,0,0.982634962,654,19,1726,1091,1072,1072,twilight sparkle
1989114.png,https://derpicdn.net/img/view/2019/3/18/1989114.png,0,0.923808992,16,21,428,433,412,412,twilight sparkle
1990190.png,https://derpicdn.net/img/view/2019/3/19/1990190.png,0,0.985675335,263,0,1139,860,876,860,twilight sparkle
1991663.png,https://derpicdn.net/img/view/2019/3/21/1991663.png,0,0.992266715,27,22,2241,2236,2214,2214,twilight sparkle
1993896.png,https://derpicdn.net/img/view/2019/3/24/1993896.png,0,0.989103079,780,0,3524,2638,2744,2638,twilight sparkle
1994591.png,https://derpicdn.net/img/view/2019/3/25/1994591.png,0,0.997671604,301,39,821,559,520,520,twilight sparkle
1996044.png,https://derpicdn.net/img/view/2019/3/27/1996044.png,0,0.967042327,8,0,1394,1236,1386,1236,twilight sparkle
1997449.png,https://derpicdn.net/img/view/2019/3/29/1997449.png,0,0.987752438,423,427,1183,1187,760,760,twilight sparkle
1997449.png,https://derpicdn.net/img/view/2019/3/29/1997449.png,1,0.956801534,1067,534,1897,1364,830,830,twilight sparkle
1999505.png,https://derpicdn.net/img/view/2019/3/31/1999505.png,0,0.960720241,1389,0,4681,3143,3292,3143,twilight sparkle
1999859.png,https://derpicdn.net/img/view/2019/4/1/1999859.png,0,0.99628222,226,16,636,428,410,412,twilight sparkle
2000190.png,https://derpicdn.net/img/view/2019/4/1/2000190.png,0,0.996748328,0,0,546,512,546,512,twilight sparkle
2000738.png,https://derpicdn.net/img/view/2019/4/2/2000738.png,0,0.996964097,1216,0,2750,1492,1534,1492,twilight sparkle
2001711.png,https://derpicdn.net/img/view/2019/4/3/2001711.png,0,0.987123907,1636,1565,3336,3265,1700,1700,twilight sparkle
2002386.png,https://derpicdn.net/img/view/2019/4/4/2002386.png,0,0.999142706,980,433,2452,1905,1472,1472,twilight sparkle
2002420.png,https://derpicdn.net/img/view/2019/4/4/2002420.png,0,0.981579304,446,20,992,594,546,574,twilight sparkle
2002776.png,https://derpicdn.net/img/view/2019/4/4/2002776.png,0,0.987733662,132,0,1108,976,976,976,twilight sparkle
2003082.png,https://derpicdn.net/img/view/2019/4/4/2003082.png,0,0.990926564,197,0,1265,993,1068,993,twilight sparkle
2003377.png,https://derpicdn.net/img/view/2019/4/5/2003377.png,0,0.980350137,128,237,708,817,580,580,twilight sparkle
2005891.png,https://derpicdn.net/img/view/2019/4/7/2005891.png,0,0.956706405,1324,176,2220,1072,896,896,twilight sparkle
2006051.png,https://derpicdn.net/img/view/2019/4/8/2006051.png,0,0.957468688,794,506,1766,1478,972,972,twilight sparkle
2009489.png,https://derpicdn.net/img/view/2019/4/12/2009489.png,0,0.972847581,394,0,872,462,478,462,twilight sparkle
2009499.png,https://derpicdn.net/img/view/2019/4/12/2009499.png,0,0.956188381,0,0,528,521,528,521,twilight sparkle
2009941.png,https://derpicdn.net/img/view/2019/4/12/2009941.png,0,0.991856337,1569,131,2127,689,558,558,twilight sparkle
2009941.png,https://derpicdn.net/img/view/2019/4/12/2009941.png,1,0.959008396,558,773,1158,1373,600,600,twilight sparkle
2012011.png,https://derpicdn.net/img/view/2019/4/14/2012011.png,0,0.985461891,1241,0,2913,1470,1672,1470,twilight sparkle
2013633.png,https://derpicdn.net/img/view/2019/4/15/2013633.png,0,0.99098146,0,217,1805,2181,1805,1964,twilight sparkle
2014338.png,https://derpicdn.net/img/view/2019/4/16/2014338.png,0,0.944042683,575,0,951,374,376,374,twilight sparkle
2014805.png,https://derpicdn.net/img/view/2019/4/17/2014805.png,0,0.99665761,483,0,1027,517,544,517,twilight sparkle
2016871.png,https://derpicdn.net/img/view/2019/4/19/2016871.png,0,0.98748523,35,0,459,411,424,411,twilight sparkle
2018316.png,https://derpicdn.net/img/view/2019/4/20/2018316.png,0,0.987965882,388,372,714,698,326,326,twilight sparkle
2019214.png,https://derpicdn.net/img/view/2019/4/21/2019214.png,0,0.98863095,388,372,714,698,326,326,twilight sparkle
2023219.png,https://derpicdn.net/img/view/2019/4/26/2023219.png,0,0.998024106,634,271,1556,1193,922,922,twilight sparkle
2024251.png,https://derpicdn.net/img/view/2019/4/27/2024251.png,0,0.975916147,28,25,1098,1080,1070,1055,twilight sparkle
2024294.png,https://derpicdn.net/img/view/2019/4/27/2024294.png,0,0.977511466,2,37,432,467,430,430,twilight sparkle
2024603.png,https://derpicdn.net/img/view/2019/4/27/2024603.png,0,0.961255848,0,38,774,860,774,822,twilight sparkle
2024674.png,https://derpicdn.net/img/view/2019/4/27/2024674.png,0,0.99441582,949,0,2663,1674,1714,1674,twilight sparkle
2025323.png,https://derpicdn.net/img/view/2019/4/28/2025323.png,0,0.969142497,172,295,1144,1267,972,972,twilight sparkle
2025847.png,https://derpicdn.net/img/view/2019/4/28/2025847.png,0,0.977104604,0,0,2729,3451,2729,3451,twilight sparkle
2026087.png,https://derpicdn.net/img/view/2019/4/29/2026087.png,0,0.93786937,0,382,5616,6844,5616,6462,twilight sparkle
2026425.png,https://derpicdn.net/img/view/2019/4/29/2026425.png,0,0.99016434,241,127,533,419,292,292,twilight sparkle
2026821.png,https://derpicdn.net/img/view/2019/4/29/2026821.png,0,0.994833171,177,0,851,623,674,623,twilight sparkle
2026821.png,https://derpicdn.net/img/view/2019/4/29/2026821.png,1,0.98235321,128,530,758,1135,630,605,twilight sparkle
2029438.png,https://derpicdn.net/img/view/2019/5/3/2029438.png,0,0.995675802,3385,0,7279,3468,3894,3468,twilight sparkle
2030290.png,https://derpicdn.net/img/view/2019/5/4/2030290.png,0,0.998713195,308,93,768,553,460,460,twilight sparkle
2031320.png,https://derpicdn.net/img/view/2019/5/5/2031320.png,0,0.983476818,595,0,1133,529,538,529,twilight sparkle
2031320.png,https://derpicdn.net/img/view/2019/5/5/2031320.png,1,0.939742327,120,14,684,578,564,564,twilight sparkle
2031320.png,https://derpicdn.net/img/view/2019/5/5/2031320.png,0,0.983476818,595,0,1133,529,538,529,twilight sparkle
2031320.png,https://derpicdn.net/img/view/2019/5/5/2031320.png,1,0.939742327,120,14,684,578,564,564,twilight sparkle
2032842.png,https://derpicdn.net/img/view/2019/5/6/2032842.png,0,0.994392693,63,24,585,546,522,522,twilight sparkle
2032917.png,https://derpicdn.net/img/view/2019/5/7/2032917.png,0,0.99370712,61,0,723,633,662,633,twilight sparkle
2034837.png,https://derpicdn.net/img/view/2019/5/9/2034837.png,0,0.976568639,0,0,3967,4985,3967,4985,twilight sparkle
2043250.png,https://derpicdn.net/img/view/2019/5/19/2043250.png,0,0.95216018,119,0,555,424,436,424,twilight sparkle
2044148.png,https://derpicdn.net/img/view/2019/5/20/2044148.png,0,0.993482709,140,9,572,441,432,432,twilight sparkle
2046668.png,https://derpicdn.net/img/view/2019/5/23/2046668.png,0,0.995481312,351,92,743,484,392,392,twilight sparkle
2048416.png,https://derpicdn.net/img/view/2019/5/25/2048416.png,0,0.924633086,41,0,1191,1000,1150,1000,twilight sparkle
20490.jpg,https://derpicdn.net/img/view/2012/6/25/20490.jpg,0,0.912070036,166,149,502,485,336,336,twilight sparkle
2052809.png,https://derpicdn.net/img/view/2019/5/29/2052809.png,0,0.998044372,365,0,1103,738,738,738,twilight sparkle
2053079.png,https://derpicdn.net/img/view/2019/5/30/2053079.png,0,0.956357896,1083,45,2481,1443,1398,1398,twilight sparkle
2054187.png,https://derpicdn.net/img/view/2019/5/31/2054187.png,0,0.998365998,556,1921,1610,2975,1054,1054,twilight sparkle
2059250.png,https://derpicdn.net/img/view/2019/6/6/2059250.png,0,0.9875983,800,745,2260,2205,1460,1460,twilight sparkle
2062579.png,https://derpicdn.net/img/view/2019/6/10/2062579.png,0,0.989380836,327,124,813,610,486,486,twilight sparkle
206570.png,https://derpicdn.net/img/view/2013/1/8/206570.png,0,0.957872629,61,8,477,424,416,416,twilight sparkle
2065994.png,https://derpicdn.net/img/view/2019/6/15/2065994.png,0,0.993496478,131,0,609,472,478,472,twilight sparkle
2070707.png,https://derpicdn.net/img/view/2019/6/20/2070707.png,0,0.91057539,50,0,2562,2080,2512,2080,twilight sparkle
2070831.png,https://derpicdn.net/img/view/2019/6/20/2070831.png,0,0.994295895,239,339,965,1065,726,726,twilight sparkle
2074082.png,https://derpicdn.net/img/view/2019/6/24/2074082.png,0,0.999270976,155,27,359,231,204,204,twilight sparkle
2074985.jpg,https://derpicdn.net/img/view/2019/6/25/2074985.jpg,0,0.939054906,55,124,1059,1128,1004,1004,twilight sparkle
2075570.png,https://derpicdn.net/img/view/2019/6/26/2075570.png,0,0.908360362,716,449,1566,1299,850,850,twilight sparkle
2076394.png,https://derpicdn.net/img/view/2019/6/27/2076394.png,0,0.992803276,580,0,1292,700,712,700,twilight sparkle
2078490.png,https://derpicdn.net/img/view/2019/6/29/2078490.png,0,0.912925124,168,0,1502,1058,1334,1058,twilight sparkle
2078979.png,https://derpicdn.net/img/view/2019/6/30/2078979.png,0,0.997626722,222,0,608,378,386,378,twilight sparkle
2079205.png,https://derpicdn.net/img/view/2019/6/30/2079205.png,0,0.978623092,99,0,955,825,856,825,twilight sparkle
2079478.png,https://derpicdn.net/img/view/2019/6/30/2079478.png,0,0.989133179,70,26,956,912,886,886,twilight sparkle
2080610.png,https://derpicdn.net/img/view/2019/7/1/2080610.png,0,0.996188521,469,1326,1201,2058,732,732,twilight sparkle
2080942.png,https://derpicdn.net/img/view/2019/7/2/2080942.png,0,0.948533416,139,0,741,580,602,580,twilight sparkle
2081127.png,https://derpicdn.net/img/view/2019/7/2/2081127.png,0,0.991458178,0,0,2041,2167,2041,2167,twilight sparkle
2082233.png,https://derpicdn.net/img/view/2019/7/3/2082233.png,0,0.997704506,133,0,1173,868,1040,868,twilight sparkle
2082345.png,https://derpicdn.net/img/view/2019/7/3/2082345.png,0,0.998266399,548,41,968,461,420,420,twilight sparkle
2082571.png,https://derpicdn.net/img/view/2019/7/4/2082571.png,0,0.964404404,0,61,1530,1925,1530,1864,twilight sparkle
2083571.png,https://derpicdn.net/img/view/2019/7/5/2083571.png,0,0.945527434,0,0,551,532,551,532,twilight sparkle
2084069.png,https://derpicdn.net/img/view/2019/7/6/2084069.png,0,0.989373624,87,0,709,611,622,611,twilight sparkle
2084385.png,https://derpicdn.net/img/view/2019/7/6/2084385.png,0,0.997878909,360,0,1296,901,936,901,twilight sparkle
2084610.png,https://derpicdn.net/img/view/2019/7/6/2084610.png,0,0.999442995,411,0,2239,1639,1828,1639,twilight sparkle
2086900.png,https://derpicdn.net/img/view/2019/7/9/2086900.png,0,0.999444306,616,0,1386,733,770,733,twilight sparkle
2089445.png,https://derpicdn.net/img/view/2019/7/12/2089445.png,0,0.989559412,0,53,702,759,702,706,twilight sparkle
2089505.png,https://derpicdn.net/img/view/2019/7/12/2089505.png,0,0.997721612,271,36,869,634,598,598,twilight sparkle
2092535.png,https://derpicdn.net/img/view/2019/7/15/2092535.png,0,0.959203541,268,964,1068,1764,800,800,twilight sparkle
2092557.png,https://derpicdn.net/img/view/2019/7/15/2092557.png,0,0.976016879,0,189,2579,2809,2579,2620,twilight sparkle
2093508.png,https://derpicdn.net/img/view/2019/7/16/2093508.png,0,0.955795944,200,0,914,707,714,707,twilight sparkle
2095178.png,https://derpicdn.net/img/view/2019/7/18/2095178.png,0,0.994498849,314,8,2260,1954,1946,1946,twilight sparkle
2095269.png,https://derpicdn.net/img/view/2019/7/18/2095269.png,0,0.998370886,0,0,1006,1016,1006,1016,twilight sparkle
2095269.png,https://derpicdn.net/img/view/2019/7/18/2095269.png,1,0.990225494,1042,271,1889,1145,847,874,twilight sparkle
2095880.png,https://derpicdn.net/img/view/2019/7/19/2095880.png,0,0.984030068,187,30,877,720,690,690,twilight sparkle
2096360.png,https://derpicdn.net/img/view/2019/7/20/2096360.png,1,0.997590005,1349,812,1781,1244,432,432,twilight sparkle
2103573.png,https://derpicdn.net/img/view/2019/7/28/2103573.png,0,0.973639846,0,11,1135,1265,1135,1254,twilight sparkle
2103760.png,https://derpicdn.net/img/view/2019/7/29/2103760.png,0,0.997104526,85,0,537,440,452,440,twilight sparkle
2103766.png,https://derpicdn.net/img/view/2019/7/29/2103766.png,0,0.979889274,75,40,456,456,381,416,twilight sparkle
2104148.png,https://derpicdn.net/img/view/2019/7/29/2104148.png,0,0.995425284,481,0,1567,910,1086,910,twilight sparkle
2104435.png,https://derpicdn.net/img/view/2019/7/30/2104435.png,0,0.988441527,0,0,485,441,485,441,twilight sparkle
2104995.png,https://derpicdn.net/img/view/2019/7/30/2104995.png,0,0.990475655,594,296,2160,1992,1566,1696,twilight sparkle
2106548.png,https://derpicdn.net/img/view/2019/8/1/2106548.png,0,0.962558985,0,0,1080,1307,1080,1307,twilight sparkle
2109609.png,https://derpicdn.net/img/view/2019/8/5/2109609.png,0,0.975844085,1324,95,2700,1515,1376,1420,twilight sparkle
2109609.png,https://derpicdn.net/img/view/2019/8/5/2109609.png,0,0.975844085,1324,95,2700,1515,1376,1420,twilight sparkle
2110217.png,https://derpicdn.net/img/view/2019/8/6/2110217.png,0,0.943073511,61,47,889,875,828,828,twilight sparkle
2113526.png,https://derpicdn.net/img/view/2019/8/9/2113526.png,0,0.975829542,0,0,1052,1031,1052,1031,twilight sparkle
2114120.png,https://derpicdn.net/img/view/2019/8/10/2114120.png,0,0.993921399,71,0,3253,3058,3182,3058,twilight sparkle
2114265.png,https://derpicdn.net/img/view/2019/8/10/2114265.png,0,0.922239959,175,0,1517,1264,1342,1264,twilight sparkle
2115868.png,https://derpicdn.net/img/view/2019/8/12/2115868.png,0,0.992170811,676,112,1860,1296,1184,1184,twilight sparkle
2116445.png,https://derpicdn.net/img/view/2019/8/12/2116445.png,0,0.99455744,41,60,1595,1614,1554,1554,twilight sparkle
2116658.png,https://derpicdn.net/img/view/2019/8/13/2116658.png,0,0.922092915,125,0,4125,3747,4000,3747,twilight sparkle
2116822.png,https://derpicdn.net/img/view/2019/8/13/2116822.png,0,0.989373624,27,0,753,695,726,695,twilight sparkle
2119427.png,https://derpicdn.net/img/view/2019/8/16/2119427.png,0,0.988911569,435,52,779,396,344,344,twilight sparkle
2122144.png,https://derpicdn.net/img/view/2019/8/19/2122144.png,0,0.989460647,1473,0,3511,1881,2038,1881,twilight sparkle
2122421.png,https://derpicdn.net/img/view/2019/8/19/2122421.png,0,0.962215185,703,0,1543,794,840,794,twilight sparkle
2123038.png,https://derpicdn.net/img/view/2019/8/20/2123038.png,0,0.982969046,684,106,1040,462,356,356,twilight sparkle
2124515.png,https://derpicdn.net/img/view/2019/8/22/2124515.png,0,0.967130303,160,147,1440,1427,1280,1280,twilight sparkle
2124637.png,https://derpicdn.net/img/view/2019/8/22/2124637.png,0,0.995077848,116,3,666,553,550,550,twilight sparkle
2125222.png,https://derpicdn.net/img/view/2019/8/23/2125222.png,0,0.932000637,1500,976,6850,7206,5350,6230,twilight sparkle
2127195.png,https://derpicdn.net/img/view/2019/8/25/2127195.png,0,0.989396036,480,0,2262,1623,1782,1623,twilight sparkle
2130806.png,https://derpicdn.net/img/view/2019/8/29/2130806.png,0,0.996854663,269,0,797,481,528,481,twilight sparkle
2133354.png,https://derpicdn.net/img/view/2019/9/1/2133354.png,0,0.976765037,80,0,1936,1783,1856,1783,twilight sparkle
2135226.png,https://derpicdn.net/img/view/2019/9/3/2135226.png,0,0.989647269,12,45,376,409,364,364,twilight sparkle
2135227.png,https://derpicdn.net/img/view/2019/9/3/2135227.png,0,0.966543853,245,0,509,257,264,257,twilight sparkle
2135652.png,https://derpicdn.net/img/view/2019/9/3/2135652.png,0,0.927729368,80,0,1318,1080,1238,1080,twilight sparkle
2139150.png,https://derpicdn.net/img/view/2019/9/8/2139150.png,0,0.952114224,599,1858,2297,3556,1698,1698,twilight sparkle
2142322.png,https://derpicdn.net/img/view/2019/9/12/2142322.png,0,0.94370538,65,13,645,593,580,580,twilight sparkle
2146831.png,https://derpicdn.net/img/view/2019/9/18/2146831.png,0,0.980936706,126,87,772,733,646,646,twilight sparkle
2147471.png,https://derpicdn.net/img/view/2019/9/19/2147471.png,0,0.978319824,951,134,2511,1694,1560,1560,twilight sparkle
2148295.png,https://derpicdn.net/img/view/2019/9/20/2148295.png,0,0.991122365,495,0,929,407,434,407,twilight sparkle
2148295.png,https://derpicdn.net/img/view/2019/9/20/2148295.png,1,0.985526979,152,364,438,650,286,286,twilight sparkle
2154608.png,https://derpicdn.net/img/view/2019/9/28/2154608.png,0,0.998698652,2014,135,3640,1761,1626,1626,twilight sparkle
2155215.png,https://derpicdn.net/img/view/2019/9/28/2155215.png,0,0.998792171,878,0,1476,588,598,588,twilight sparkle
2155540.png,https://derpicdn.net/img/view/2019/9/29/2155540.png,0,0.998021781,3218,0,6526,3159,3308,3159,twilight sparkle
2155778.png,https://derpicdn.net/img/view/2019/9/29/2155778.png,0,0.98699075,10,0,854,814,844,814,twilight sparkle
2156089.png,https://derpicdn.net/img/view/2019/9/29/2156089.png,0,0.944608092,599,0,1545,780,946,780,twilight sparkle
2159391.png,https://derpicdn.net/img/view/2019/10/3/2159391.png,0,0.984091341,170,84,1450,1364,1280,1280,twilight sparkle
2160548.png,https://derpicdn.net/img/view/2019/10/5/2160548.png,0,0.936436474,194,191,692,689,498,498,twilight sparkle
2163895.png,https://derpicdn.net/img/view/2019/10/9/2163895.png,0,0.936798513,44,0,544,484,500,484,twilight sparkle
2164467.png,https://derpicdn.net/img/view/2019/10/10/2164467.png,0,0.914188921,388,118,736,466,348,348,twilight sparkle
216520.png,https://derpicdn.net/img/view/2013/1/18/216520.png,0,0.948654532,3067,338,5269,2540,2202,2202,twilight sparkle
2165634.png,https://derpicdn.net/img/view/2019/10/11/2165634.png,0,0.997070909,1731,547,3409,2225,1678,1678,twilight sparkle
2168062.png,https://derpicdn.net/img/view/2019/10/13/2168062.png,0,0.997717083,5,0,1057,993,1052,993,twilight sparkle
2169118.png,https://derpicdn.net/img/view/2019/10/15/2169118.png,0,0.999298155,60,2,304,246,244,244,twilight sparkle
2169938.png,https://derpicdn.net/img/view/2019/10/15/2169938.png,0,0.97888869,0,13,346,405,346,392,twilight sparkle
2171175.png,https://derpicdn.net/img/view/2019/10/17/2171175.png,0,0.978636563,451,0,1079,620,628,620,twilight sparkle
2171235.png,https://derpicdn.net/img/view/2019/10/17/2171235.png,0,0.989694953,143,0,593,439,450,439,twilight sparkle
2171235.png,https://derpicdn.net/img/view/2019/10/17/2171235.png,1,0.904515564,747,411,1059,723,312,312,twilight sparkle
2171993.png,https://derpicdn.net/img/view/2019/10/17/2171993.png,0,0.985197663,515,172,2457,2114,1942,1942,twilight sparkle
2172181.png,https://derpicdn.net/img/view/2019/10/18/2172181.png,0,0.95463109,482,67,802,387,320,320,twilight sparkle
2174204.png,https://derpicdn.net/img/view/2019/10/20/2174204.png,0,0.986884296,592,0,1088,423,496,423,twilight sparkle
2174343.png,https://derpicdn.net/img/view/2019/10/20/2174343.png,0,0.918136537,661,844,1289,1472,628,628,twilight sparkle
2175216.png,https://derpicdn.net/img/view/2019/10/21/2175216.png,0,0.976279497,1223,601,1809,1187,586,586,twilight sparkle
2175736.png,https://derpicdn.net/img/view/2019/10/21/2175736.png,0,0.909005582,157,85,469,397,312,312,twilight sparkle
2176203.png,https://derpicdn.net/img/view/2019/10/22/2176203.png,0,0.900187612,53,17,433,397,380,380,twilight sparkle
2176223.png,https://derpicdn.net/img/view/2019/10/22/2176223.png,0,0.957410216,534,71,1208,745,674,674,twilight sparkle
2176364.png,https://derpicdn.net/img/view/2019/10/22/2176364.png,0,0.996539176,15,2,413,400,398,398,twilight sparkle
2178009.png,https://derpicdn.net/img/view/2019/10/24/2178009.png,0,0.981842816,0,0,643,688,643,688,twilight sparkle
2178159.png,https://derpicdn.net/img/view/2019/10/25/2178159.png,0,0.981182516,193,11,1389,1207,1196,1196,twilight sparkle
2178306.png,https://derpicdn.net/img/view/2019/10/25/2178306.png,0,0.974668682,572,931,1422,1781,850,850,twilight sparkle
2178375.png,https://derpicdn.net/img/view/2019/10/25/2178375.png,0,0.99584794,1599,0,2833,1067,1234,1067,twilight sparkle
2180348.png,https://derpicdn.net/img/view/2019/10/27/2180348.png,0,0.994237542,591,529,1029,967,438,438,twilight sparkle
2180385.png,https://derpicdn.net/img/view/2019/10/27/2180385.png,0,0.959658623,93,227,815,949,722,722,twilight sparkle
2180938.png,https://derpicdn.net/img/view/2019/10/28/2180938.png,0,0.993694544,270,34,710,474,440,440,twilight sparkle
2184817.png,https://derpicdn.net/img/view/2019/11/1/2184817.png,0,0.934249997,970,838,2768,2636,1798,1798,twilight sparkle
2184817.png,https://derpicdn.net/img/view/2019/11/1/2184817.png,0,0.934249997,970,838,2768,2636,1798,1798,twilight sparkle
2186952.png,https://derpicdn.net/img/view/2019/11/4/2186952.png,0,0.970112324,43,0,233,167,190,167,twilight sparkle
2187548.png,https://derpicdn.net/img/view/2019/11/4/2187548.png,0,0.998539507,568,119,1300,851,732,732,twilight sparkle
2188728.png,https://derpicdn.net/img/view/2019/11/6/2188728.png,0,0.970148444,39,32,250,248,211,216,twilight sparkle
2189037.png,https://derpicdn.net/img/view/2019/11/6/2189037.png,0,0.992657304,486,32,882,428,396,396,twilight sparkle
2190401.png,https://derpicdn.net/img/view/2019/11/8/2190401.png,0,0.996625245,577,27,2415,1865,1838,1838,twilight sparkle
2195233.png,https://derpicdn.net/img/view/2019/11/13/2195233.png,0,0.964909136,736,99,3108,2555,2372,2456,twilight sparkle
219712.jpg,https://derpicdn.net/img/view/2013/1/21/219712.jpg,0,0.997498691,173,0,769,586,596,586,twilight sparkle
2197543.png,https://derpicdn.net/img/view/2019/11/16/2197543.png,0,0.979147315,30,0,450,407,420,407,twilight sparkle
2202884.png,https://derpicdn.net/img/view/2019/11/22/2202884.png,0,0.972323418,21,0,461,420,440,420,twilight sparkle
2202884.png,https://derpicdn.net/img/view/2019/11/22/2202884.png,0,0.972323418,21,0,461,420,440,420,twilight sparkle
2202888.png,https://derpicdn.net/img/view/2019/11/22/2202888.png,0,0.983596206,65,21,500,491,435,470,twilight sparkle
2202889.png,https://derpicdn.net/img/view/2019/11/22/2202889.png,0,0.934540331,21,113,421,500,400,387,twilight sparkle
2202889.png,https://derpicdn.net/img/view/2019/11/22/2202889.png,1,0.924911141,149,13,500,387,351,374,twilight sparkle
2202890.png,https://derpicdn.net/img/view/2019/11/22/2202890.png,0,0.942161977,89,0,500,482,411,482,twilight sparkle
2202891.png,https://derpicdn.net/img/view/2019/11/22/2202891.png,0,0.934286535,0,20,400,492,400,472,twilight sparkle
2202891.png,https://derpicdn.net/img/view/2019/11/22/2202891.png,1,0.931707621,76,55,480,459,404,404,twilight sparkle
2202891.png,https://derpicdn.net/img/view/2019/11/22/2202891.png,0,0.934286535,0,20,400,492,400,472,twilight sparkle
2202891.png,https://derpicdn.net/img/view/2019/11/22/2202891.png,1,0.931707621,76,55,480,459,404,404,twilight sparkle
2202892.png,https://derpicdn.net/img/view/2019/11/22/2202892.png,0,0.967057645,43,19,500,487,457,468,twilight sparkle
2203547.png,https://derpicdn.net/img/view/2019/11/23/2203547.png,0,0.92587626,256,0,1914,1625,1658,1625,twilight sparkle
2208292.png,https://derpicdn.net/img/view/2019/11/29/2208292.png,0,0.976293504,0,23,1010,1147,1010,1124,twilight sparkle
2209511.png,https://derpicdn.net/img/view/2019/11/30/2209511.png,0,0.993314147,26,0,1196,1118,1170,1118,twilight sparkle
2212302.png,https://derpicdn.net/img/view/2019/12/4/2212302.png,0,0.938250124,821,115,2223,1517,1402,1402,twilight sparkle
2212302.png,https://derpicdn.net/img/view/2019/12/4/2212302.png,0,0.938250124,821,115,2223,1517,1402,1402,twilight sparkle
2212433.png,https://derpicdn.net/img/view/2019/12/4/2212433.png,0,0.989694357,0,0,807,840,807,840,twilight sparkle
2213498.png,https://derpicdn.net/img/view/2019/12/6/2213498.png,0,0.980913699,757,58,1695,996,938,938,twilight sparkle
2216382.png,https://derpicdn.net/img/view/2019/12/9/2216382.png,0,0.960130274,212,0,741,507,529,507,twilight sparkle
2216636.png,https://derpicdn.net/img/view/2019/12/9/2216636.png,1,0.994893193,392,373,942,923,550,550,twilight sparkle
2217074.png,https://derpicdn.net/img/view/2019/12/10/2217074.png,0,0.998820484,505,6,1377,878,872,872,twilight sparkle
2217543.png,https://derpicdn.net/img/view/2019/12/10/2217543.png,0,0.99807173,621,0,1531,897,910,897,twilight sparkle
2218194.png,https://derpicdn.net/img/view/2019/12/11/2218194.png,0,0.951005399,1236,0,3074,1769,1838,1769,twilight sparkle
2218287.png,https://derpicdn.net/img/view/2019/12/11/2218287.png,0,0.962399244,774,222,1276,724,502,502,twilight sparkle
2219247.png,https://derpicdn.net/img/view/2019/12/13/2219247.png,0,0.994981587,841,4,2167,1330,1326,1326,twilight sparkle
2220138.png,https://derpicdn.net/img/view/2019/12/14/2220138.png,0,0.998652399,363,226,969,832,606,606,twilight sparkle
2226795.png,https://derpicdn.net/img/view/2019/12/22/2226795.png,0,0.925612032,958,0,2696,1539,1738,1539,twilight sparkle
2227554.png,https://derpicdn.net/img/view/2019/12/23/2227554.png,0,0.962216377,1689,53,4263,2627,2574,2574,twilight sparkle
2227935.png,https://derpicdn.net/img/view/2019/12/23/2227935.png,0,0.968166411,74,0,426,339,352,339,twilight sparkle
2228729.jpg,https://derpicdn.net/img/view/2019/12/24/2228729.jpg,0,0.988792658,37,71,1293,1327,1256,1256,twilight sparkle
2229733.png,https://derpicdn.net/img/view/2019/12/25/2229733.png,0,0.95274508,899,31,1855,987,956,956,twilight sparkle
2230955.png,https://derpicdn.net/img/view/2019/12/27/2230955.png,0,0.996944845,296,0,1402,948,1106,948,twilight sparkle
2231539.png,https://derpicdn.net/img/view/2019/12/27/2231539.png,0,0.99871701,515,237,1111,833,596,596,twilight sparkle
2233507.png,https://derpicdn.net/img/view/2019/12/30/2233507.png,0,0.989381492,157,122,1459,1424,1302,1302,twilight sparkle
223487.png,https://derpicdn.net/img/view/2013/1/25/223487.png,0,0.989028513,0,0,525,530,525,530,twilight sparkle
2235154.jpg,https://derpicdn.net/img/view/2019/12/31/2235154.jpg,0,0.98890239,451,95,1361,1005,910,910,twilight sparkle
2235154.jpg,https://derpicdn.net/img/view/2019/12/31/2235154.jpg,0,0.98890239,451,95,1361,1005,910,910,twilight sparkle
2235459.png,https://derpicdn.net/img/view/2020/1/1/2235459.png,0,0.984600246,587,351,1003,767,416,416,twilight sparkle
2237850.png,https://derpicdn.net/img/view/2020/1/3/2237850.png,0,0.987481058,884,630,1764,1510,880,880,twilight sparkle
2238819.jpg,https://derpicdn.net/img/view/2020/1/4/2238819.jpg,0,0.956561565,340,154,978,792,638,638,twilight sparkle
2243973.jpg,https://derpicdn.net/img/view/2020/1/10/2243973.jpg,0,0.982321203,395,168,659,432,264,264,twilight sparkle
2244763.jpg,https://derpicdn.net/img/view/2020/1/11/2244763.jpg,0,0.933005393,458,257,1050,849,592,592,twilight sparkle
2246202.jpg,https://derpicdn.net/img/view/2020/1/13/2246202.jpg,0,0.902830422,237,0,1055,782,818,782,twilight sparkle
2246501.jpg,https://derpicdn.net/img/view/2020/1/13/2246501.jpg,0,0.99075222,0,0,1240,1552,1240,1552,twilight sparkle
2246617.png,https://derpicdn.net/img/view/2020/1/13/2246617.png,0,0.988428891,840,185,1348,693,508,508,twilight sparkle
2247021.jpg,https://derpicdn.net/img/view/2020/1/14/2247021.jpg,0,0.957000077,224,9,990,768,766,759,twilight sparkle
2247034.jpg,https://derpicdn.net/img/view/2020/1/14/2247034.jpg,0,0.990800023,122,198,536,612,414,414,twilight sparkle
2247126.jpg,https://derpicdn.net/img/view/2020/1/14/2247126.jpg,0,0.994961143,673,0,1803,1092,1130,1092,twilight sparkle
2249093.jpg,https://derpicdn.net/img/view/2020/1/16/2249093.jpg,0,0.98562187,355,0,1223,858,868,858,twilight sparkle
2249358.png,https://derpicdn.net/img/view/2020/1/17/2249358.png,0,0.996488512,1836,0,5902,3723,4066,3723,twilight sparkle
2249425.png,https://derpicdn.net/img/view/2020/1/17/2249425.png,0,0.996646762,24,0,732,706,708,706,twilight sparkle
225111.png,https://derpicdn.net/img/view/2013/1/27/225111.png,0,0.987605393,220,10,960,750,740,740,twilight sparkle
2252101.png,https://derpicdn.net/img/view/2020/1/20/2252101.png,0,0.989676476,1377,323,2477,1423,1100,1100,twilight sparkle
2254396.jpg,https://derpicdn.net/img/view/2020/1/23/2254396.jpg,0,0.961391687,96,0,1532,1397,1436,1397,twilight sparkle
2256317.png,https://derpicdn.net/img/view/2020/1/25/2256317.png,1,0.925854445,937,193,1333,589,396,396,twilight sparkle
2257557.png,https://derpicdn.net/img/view/2020/1/26/2257557.png,0,0.99518621,9,0,1337,1284,1328,1284,twilight sparkle
2259153.png,https://derpicdn.net/img/view/2020/1/28/2259153.png,0,0.956488431,0,0,2573,2250,2573,2250,twilight sparkle
2260840.jpg,https://derpicdn.net/img/view/2020/1/30/2260840.jpg,0,0.999017954,387,0,2137,1747,1750,1747,twilight sparkle
2261229.png,https://derpicdn.net/img/view/2020/1/30/2261229.png,0,0.985076427,0,0,732,760,732,760,twilight sparkle
2265195.jpg,https://derpicdn.net/img/view/2020/2/4/2265195.jpg,0,0.916646242,331,0,1469,970,1138,970,twilight sparkle
2265588.png,https://derpicdn.net/img/view/2020/2/4/2265588.png,0,0.998760879,59,0,1187,1102,1128,1102,twilight sparkle
2265588.png,https://derpicdn.net/img/view/2020/2/4/2265588.png,0,0.998760879,59,0,1187,1102,1128,1102,twilight sparkle
2266137.jpg,https://derpicdn.net/img/view/2020/2/5/2266137.jpg,0,0.999099553,401,0,1057,632,656,632,twilight sparkle
2266405.png,https://derpicdn.net/img/view/2020/2/5/2266405.png,0,0.989171207,1458,0,4856,3270,3398,3270,twilight sparkle
2267483.png,https://derpicdn.net/img/view/2020/2/7/2267483.png,0,0.911705554,0,415,3677,4547,3677,4132,twilight sparkle
2268110.png,https://derpicdn.net/img/view/2020/2/7/2268110.png,0,0.932495236,124,63,1500,1609,1376,1546,twilight sparkle
2268224.jpg,https://derpicdn.net/img/view/2020/2/7/2268224.jpg,0,0.989537239,0,0,1197,1238,1197,1238,twilight sparkle
2268752.png,https://derpicdn.net/img/view/2020/2/8/2268752.png,0,0.996086061,961,0,2383,1352,1422,1352,twilight sparkle
2269028.png,https://derpicdn.net/img/view/2020/2/8/2269028.png,0,0.988864303,360,0,2541,2246,2181,2246,twilight sparkle
2269910.png,https://derpicdn.net/img/view/2020/2/9/2269910.png,0,0.997498333,60,3,732,675,672,672,twilight sparkle
2270685.jpg,https://derpicdn.net/img/view/2020/2/10/2270685.jpg,0,0.969886243,20,0,1280,1273,1260,1273,twilight sparkle
2274058.jpg,https://derpicdn.net/img/view/2020/2/14/2274058.jpg,0,0.979593873,79,0,1059,958,980,958,twilight sparkle
227415.png,https://derpicdn.net/img/view/2013/1/29/227415.png,0,0.993540287,0,0,1176,1286,1176,1286,twilight sparkle
2275962.jpg,https://derpicdn.net/img/view/2020/2/16/2275962.jpg,0,0.918501675,419,1,1131,713,712,712,twilight sparkle
2276493.jpg,https://derpicdn.net/img/view/2020/2/17/2276493.jpg,0,0.981154442,38,0,994,1080,956,1080,twilight sparkle
2276493.jpg,https://derpicdn.net/img/view/2020/2/17/2276493.jpg,1,0.922273874,0,0,859,980,859,980,twilight sparkle
2276507.png,https://derpicdn.net/img/view/2020/2/17/2276507.png,0,0.961190879,529,202,1667,1340,1138,1138,twilight sparkle
2277581.png,https://derpicdn.net/img/view/2020/2/18/2277581.png,0,0.901094973,651,243,817,409,166,166,twilight sparkle
2278264.png,https://derpicdn.net/img/view/2020/2/19/2278264.png,0,0.993501425,0,0,567,593,567,593,twilight sparkle
2280601.png,https://derpicdn.net/img/view/2020/2/22/2280601.png,0,0.948151588,6203,479,10493,4769,4290,4290,twilight sparkle
2283688.png,https://derpicdn.net/img/view/2020/2/25/2283688.png,0,0.991145432,24,150,368,494,344,344,twilight sparkle
2283688.png,https://derpicdn.net/img/view/2020/2/25/2283688.png,1,0.943955481,517,244,789,516,272,272,twilight sparkle
2284394.png,https://derpicdn.net/img/view/2020/2/26/2284394.png,0,0.995903373,2221,0,3999,1590,1778,1590,twilight sparkle
2284657.png,https://derpicdn.net/img/view/2020/2/27/2284657.png,0,0.979314864,1088,317,1842,1071,754,754,twilight sparkle
2286500.jpg,https://derpicdn.net/img/view/2020/2/29/2286500.jpg,0,0.97377795,148,0,686,535,538,535,twilight sparkle
2287409.jpg,https://derpicdn.net/img/view/2020/3/1/2287409.jpg,0,0.904476583,0,0,1498,1629,1498,1629,twilight sparkle
2288330.png,https://derpicdn.net/img/view/2020/3/2/2288330.png,0,0.993506908,1119,200,2277,1358,1158,1158,twilight sparkle
2288330.png,https://derpicdn.net/img/view/2020/3/2/2288330.png,0,0.993506908,1119,200,2277,1358,1158,1158,twilight sparkle
2290510.jpg,https://derpicdn.net/img/view/2020/3/5/2290510.jpg,0,0.998724401,337,0,933,576,596,576,twilight sparkle
2290970.jpg,https://derpicdn.net/img/view/2020/3/6/2290970.jpg,0,0.996469796,170,44,656,530,486,486,twilight sparkle
2291174.png,https://derpicdn.net/img/view/2020/3/6/2291174.png,0,0.989889503,0,0,357,387,357,387,twilight sparkle
2292509.jpg,https://derpicdn.net/img/view/2020/3/8/2292509.jpg,0,0.999046266,808,183,1262,637,454,454,twilight sparkle
2292509.jpg,https://derpicdn.net/img/view/2020/3/8/2292509.jpg,1,0.996976972,336,123,736,523,400,400,twilight sparkle
2292509.jpg,https://derpicdn.net/img/view/2020/3/8/2292509.jpg,0,0.999046266,808,183,1262,637,454,454,twilight sparkle
2292509.jpg,https://derpicdn.net/img/view/2020/3/8/2292509.jpg,1,0.996976972,336,123,736,523,400,400,twilight sparkle
2292701.jpg,https://derpicdn.net/img/view/2020/3/8/2292701.jpg,0,0.983461976,325,553,583,811,258,258,twilight sparkle
2292829.jpg,https://derpicdn.net/img/view/2020/3/8/2292829.jpg,0,0.992363572,314,0,1424,1069,1110,1069,twilight sparkle
2296532.jpg,https://derpicdn.net/img/view/2020/3/13/2296532.jpg,0,0.999289036,358,0,846,448,488,448,twilight sparkle
229832.png,https://derpicdn.net/img/view/2013/2/1/229832.png,0,0.950529039,144,18,354,228,210,210,twilight sparkle
2299659.png,https://derpicdn.net/img/view/2020/3/17/2299659.png,0,0.996411979,0,0,3077,3089,3077,3089,twilight sparkle
2301203.png,https://derpicdn.net/img/view/2020/3/19/2301203.png,0,0.996079206,680,0,1222,469,542,469,twilight sparkle
2301203.png,https://derpicdn.net/img/view/2020/3/19/2301203.png,1,0.983532786,6,2,626,622,620,620,twilight sparkle
2301476.png,https://derpicdn.net/img/view/2020/3/19/2301476.png,0,0.973387837,475,662,899,1086,424,424,twilight sparkle
2301522.png,https://derpicdn.net/img/view/2020/3/20/2301522.png,0,0.92236042,119,210,1023,1114,904,904,twilight sparkle
2301529.jpg,https://derpicdn.net/img/view/2020/3/20/2301529.jpg,0,0.985086203,0,0,554,616,554,616,twilight sparkle
2301752.jpg,https://derpicdn.net/img/view/2020/3/20/2301752.jpg,0,0.992139876,0,1065,578,1743,578,678,twilight sparkle
2301752.jpg,https://derpicdn.net/img/view/2020/3/20/2301752.jpg,1,0.991392612,0,0,1190,1122,1190,1122,twilight sparkle
23025.jpg,https://derpicdn.net/img/view/2012/6/27/23025.jpg,0,0.98937124,15,0,577,503,562,503,twilight sparkle
2302736.png,https://derpicdn.net/img/view/2020/3/21/2302736.png,0,0.983045518,314,0,3786,3305,3472,3305,twilight sparkle
2302831.png,https://derpicdn.net/img/view/2020/3/21/2302831.png,0,0.987097144,714,0,1290,468,576,468,twilight sparkle
2303763.jpg,https://derpicdn.net/img/view/2020/3/22/2303763.jpg,0,0.988957524,67,2,415,350,348,348,twilight sparkle
2307383.png,https://derpicdn.net/img/view/2020/3/27/2307383.png,0,0.984930694,1105,64,2083,1042,978,978,twilight sparkle
2307383.png,https://derpicdn.net/img/view/2020/3/27/2307383.png,1,0.930856884,515,219,1407,1111,892,892,twilight sparkle
2311966.png,https://derpicdn.net/img/view/2020/4/2/2311966.png,0,0.996289074,531,330,1895,1694,1364,1364,twilight sparkle
2311967.png,https://derpicdn.net/img/view/2020/4/2/2311967.png,0,0.999015093,560,375,1886,1701,1326,1326,twilight sparkle
2311967.png,https://derpicdn.net/img/view/2020/4/2/2311967.png,0,0.999015093,560,375,1886,1701,1326,1326,twilight sparkle
2312471.jpg,https://derpicdn.net/img/view/2020/4/2/2312471.jpg,0,0.992988348,1195,96,1945,846,750,750,twilight sparkle
2313183.png,https://derpicdn.net/img/view/2020/4/3/2313183.png,0,0.999201536,659,92,1207,640,548,548,twilight sparkle
2313183.png,https://derpicdn.net/img/view/2020/4/3/2313183.png,0,0.999201536,659,92,1207,640,548,548,twilight sparkle
2313640.png,https://derpicdn.net/img/view/2020/4/4/2313640.png,0,0.989705622,18,12,1159,1172,1141,1160,twilight sparkle
2313640.png,https://derpicdn.net/img/view/2020/4/4/2313640.png,0,0.989705622,18,12,1159,1172,1141,1160,twilight sparkle
2313966.jpg,https://derpicdn.net/img/view/2020/4/4/2313966.jpg,0,0.998664856,342,0,914,553,572,553,twilight sparkle
2316694.jpg,https://derpicdn.net/img/view/2020/4/7/2316694.jpg,0,0.950775266,143,301,991,1149,848,848,twilight sparkle
2317318.jpg,https://derpicdn.net/img/view/2020/4/8/2317318.jpg,0,0.994424164,70,0,1176,1081,1106,1081,twilight sparkle
2320113.jpg,https://derpicdn.net/img/view/2020/4/12/2320113.jpg,0,0.989091933,559,0,995,395,436,395,twilight sparkle
2320414.png,https://derpicdn.net/img/view/2020/4/12/2320414.png,0,0.963271022,0,0,612,556,612,556,twilight sparkle
2320617.png,https://derpicdn.net/img/view/2020/4/12/2320617.png,0,0.951597691,216,0,2842,2615,2626,2615,twilight sparkle
2320730.png,https://derpicdn.net/img/view/2020/4/12/2320730.png,0,0.996260643,541,1003,3155,3617,2614,2614,twilight sparkle
2323441.jpg,https://derpicdn.net/img/view/2020/4/15/2323441.jpg,0,0.992418528,63,116,955,1008,892,892,twilight sparkle
2326851.png,https://derpicdn.net/img/view/2020/4/20/2326851.png,0,0.9950068,2645,129,3691,1175,1046,1046,twilight sparkle
2327001.jpg,https://derpicdn.net/img/view/2020/4/20/2327001.jpg,0,0.998215973,563,919,1239,1595,676,676,twilight sparkle
2328143.png,https://derpicdn.net/img/view/2020/4/21/2328143.png,0,0.906263113,579,378,1515,1314,936,936,twilight sparkle
2332385.png,https://derpicdn.net/img/view/2020/4/26/2332385.png,0,0.990669012,849,512,1487,1150,638,638,twilight sparkle
2332405.jpg,https://derpicdn.net/img/view/2020/4/26/2332405.jpg,0,0.995062709,360,94,642,376,282,282,twilight sparkle
2332546.png,https://derpicdn.net/img/view/2020/4/26/2332546.png,0,0.98405993,311,182,685,556,374,374,twilight sparkle
2332717.jpg,https://derpicdn.net/img/view/2020/4/27/2332717.jpg,0,0.975255132,1159,176,1791,808,632,632,twilight sparkle
2333979.png,https://derpicdn.net/img/view/2020/4/28/2333979.png,0,0.996079683,775,427,3015,2667,2240,2240,twilight sparkle
2334484.jpg,https://derpicdn.net/img/view/2020/4/29/2334484.jpg,0,0.984228313,0,38,1529,1584,1529,1546,twilight sparkle
2334499.jpg,https://derpicdn.net/img/view/2020/4/29/2334499.jpg,0,0.996043622,0,0,1368,1490,1368,1490,twilight sparkle
2334644.png,https://derpicdn.net/img/view/2020/4/29/2334644.png,0,0.909855545,0,660,4881,6290,4881,5630,twilight sparkle
2335534.png,https://derpicdn.net/img/view/2020/4/30/2335534.png,0,0.96374619,2636,724,7710,5798,5074,5074,twilight sparkle
2336782.png,https://derpicdn.net/img/view/2020/5/1/2336782.png,0,0.998531938,36,44,680,688,644,644,twilight sparkle
2338961.png,https://derpicdn.net/img/view/2020/5/4/2338961.png,0,0.933354795,99,210,753,864,654,654,twilight sparkle
2339109.png,https://derpicdn.net/img/view/2020/5/4/2339109.png,0,0.965918958,338,0,1530,1274,1192,1274,twilight sparkle
2339774.png,https://derpicdn.net/img/view/2020/5/5/2339774.png,0,0.990304172,39,0,831,757,792,757,twilight sparkle
2341524.png,https://derpicdn.net/img/view/2020/5/7/2341524.png,0,0.967701137,47,0,383,290,336,290,twilight sparkle
2341524.png,https://derpicdn.net/img/view/2020/5/7/2341524.png,1,0.948522329,0,47,268,307,268,260,twilight sparkle
2342113.png,https://derpicdn.net/img/view/2020/5/7/2342113.png,0,0.968242407,121,470,4325,4674,4204,4204,twilight sparkle
2342912.png,https://derpicdn.net/img/view/2020/5/8/2342912.png,0,0.993631124,280,28,870,618,590,590,twilight sparkle
2344183.jpg,https://derpicdn.net/img/view/2020/5/10/2344183.jpg,0,0.964322567,0,0,3250,3288,3250,3288,twilight sparkle
2346565.png,https://derpicdn.net/img/view/2020/5/12/2346565.png,0,0.982414305,329,57,1595,1323,1266,1266,twilight sparkle
23489.png,https://derpicdn.net/img/view/2012/6/28/23489.png,0,0.998412967,485,1,900,435,415,434,twilight sparkle
2349014.png,https://derpicdn.net/img/view/2020/5/15/2349014.png,0,0.966495931,128,1,466,339,338,338,twilight sparkle
2349015.png,https://derpicdn.net/img/view/2020/5/15/2349015.png,0,0.988292456,118,48,422,352,304,304,twilight sparkle
2349015.png,https://derpicdn.net/img/view/2020/5/15/2349015.png,1,0.940774441,0,69,334,412,334,343,twilight sparkle
2349843.png,https://derpicdn.net/img/view/2020/5/16/2349843.png,0,0.97724092,25,7,427,409,402,402,twilight sparkle
2350198.png,https://derpicdn.net/img/view/2020/5/16/2350198.png,0,0.97903347,2093,436,3817,2160,1724,1724,twilight sparkle
2350198.png,https://derpicdn.net/img/view/2020/5/16/2350198.png,0,0.97903347,2093,436,3817,2160,1724,1724,twilight sparkle
2350255.png,https://derpicdn.net/img/view/2020/5/16/2350255.png,0,0.993913412,1935,308,3857,2230,1922,1922,twilight sparkle
2350255.png,https://derpicdn.net/img/view/2020/5/16/2350255.png,0,0.993913412,1935,308,3857,2230,1922,1922,twilight sparkle
2350434.png,https://derpicdn.net/img/view/2020/5/16/2350434.png,0,0.992099762,0,24,836,870,836,846,twilight sparkle
2350870.jpg,https://derpicdn.net/img/view/2020/5/17/2350870.jpg,0,0.995707333,51,0,777,617,726,617,twilight sparkle
2353133.png,https://derpicdn.net/img/view/2020/5/20/2353133.png,0,0.960764289,136,23,600,509,464,486,twilight sparkle
235375.png,https://derpicdn.net/img/view/2013/2/6/235375.png,0,0.985950589,67,17,911,861,844,844,twilight sparkle
235375.png,https://derpicdn.net/img/view/2013/2/6/235375.png,0,0.985950589,67,17,911,861,844,844,twilight sparkle
2354886.png,https://derpicdn.net/img/view/2020/5/22/2354886.png,0,0.97904408,2481,5,4641,2165,2160,2160,twilight sparkle
241821.png,https://derpicdn.net/img/view/2013/2/13/241821.png,0,0.947425067,74,0,640,529,566,529,twilight sparkle
245753.png,https://derpicdn.net/img/view/2013/2/16/245753.png,0,0.953208983,327,26,1097,796,770,770,twilight sparkle
247205.png,https://derpicdn.net/img/view/2013/2/18/247205.png,0,0.990917861,133,0,497,336,364,336,twilight sparkle
248092.png,https://derpicdn.net/img/view/2013/2/18/248092.png,0,0.956351519,156,0,988,719,832,719,twilight sparkle
249160.png,https://derpicdn.net/img/view/2013/2/19/249160.png,0,0.992690921,783,278,1953,1448,1170,1170,twilight sparkle
249375.png,https://derpicdn.net/img/view/2013/2/19/249375.png,0,0.998346031,595,234,937,576,342,342,twilight sparkle
249375.png,https://derpicdn.net/img/view/2013/2/19/249375.png,1,0.946666896,0,259,383,691,383,432,twilight sparkle
251243.png,https://derpicdn.net/img/view/2013/2/21/251243.png,0,0.994747579,506,0,1150,641,644,641,twilight sparkle
251368.png,https://derpicdn.net/img/view/2013/2/22/251368.png,0,0.950081706,0,123,2097,2263,2097,2140,twilight sparkle
2523.png,https://derpicdn.net/img/view/2012/1/28/2523.png,0,0.998847961,38,0,470,413,432,413,twilight sparkle
252830.png,https://derpicdn.net/img/view/2013/2/23/252830.png,0,0.978525698,893,151,1197,455,304,304,twilight sparkle
255185.png,https://derpicdn.net/img/view/2013/2/25/255185.png,0,0.927418232,138,25,360,247,222,222,twilight sparkle
258946.png,https://derpicdn.net/img/view/2013/3/1/258946.png,0,0.985264659,68,192,220,344,152,152,twilight sparkle
260216.png,https://derpicdn.net/img/view/2013/3/2/260216.png,0,0.999761403,233,0,703,468,470,468,twilight sparkle
2606.jpg,https://derpicdn.net/img/view/2012/1/29/2606.jpg,0,0.998295367,1188,164,1824,800,636,636,twilight sparkle
262005.png,https://derpicdn.net/img/view/2013/3/4/262005.png,0,0.997356832,280,84,1032,836,752,752,twilight sparkle
262659.png,https://derpicdn.net/img/view/2013/3/4/262659.png,0,0.944140434,0,548,1416,2176,1416,1628,twilight sparkle
262659.png,https://derpicdn.net/img/view/2013/3/4/262659.png,0,0.944140434,0,548,1416,2176,1416,1628,twilight sparkle
264060.png,https://derpicdn.net/img/view/2013/3/6/264060.png,0,0.976105452,352,0,632,273,280,273,twilight sparkle
26567.jpg,https://derpicdn.net/img/view/2012/6/30/26567.jpg,0,0.987928629,289,220,655,586,366,366,twilight sparkle
266279.png,https://derpicdn.net/img/view/2013/3/9/266279.png,0,0.982723296,0,1,156,199,156,198,twilight sparkle
268021.png,https://derpicdn.net/img/view/2013/3/11/268021.png,0,0.961688876,656,20,1988,1352,1332,1332,twilight sparkle
27417.png,https://derpicdn.net/img/view/2012/7/1/27417.png,0,0.992170751,307,0,781,455,474,455,twilight sparkle
276890.png,https://derpicdn.net/img/view/2013/3/22/276890.png,0,0.998308182,144,347,1228,1431,1084,1084,twilight sparkle
277664.jpg,https://derpicdn.net/img/view/2013/3/23/277664.jpg,0,0.981251955,699,17,1497,815,798,798,twilight sparkle
281081.jpg,https://derpicdn.net/img/view/2013/3/27/281081.jpg,0,0.990685105,51,0,871,770,820,770,twilight sparkle
281628.png,https://derpicdn.net/img/view/2013/3/28/281628.png,0,0.996009827,244,0,2544,2226,2300,2226,twilight sparkle
290683.png,https://derpicdn.net/img/view/2013/4/7/290683.png,0,0.983892739,294,0,1308,1006,1014,1006,twilight sparkle
291604.png,https://derpicdn.net/img/view/2013/4/8/291604.png,0,0.990326405,1831,839,3443,2451,1612,1612,twilight sparkle
2961.png,https://derpicdn.net/img/view/2012/2/9/2961.png,0,0.999292016,312,0,1122,736,810,736,twilight sparkle
300117.png,https://derpicdn.net/img/view/2013/4/16/300117.png,0,0.969348133,116,0,604,468,488,468,twilight sparkle
301718.png,https://derpicdn.net/img/view/2013/4/18/301718.png,0,0.991227746,205,0,3325,3025,3120,3025,twilight sparkle
308769.jpg,https://derpicdn.net/img/view/2013/4/26/308769.jpg,0,0.99662292,116,170,562,616,446,446,twilight sparkle
31013.png,https://derpicdn.net/img/view/2012/7/4/31013.png,0,0.968093872,621,108,1083,570,462,462,twilight sparkle
31134.jpg,https://derpicdn.net/img/view/2012/7/4/31134.jpg,0,0.927790284,91,0,617,478,526,478,twilight sparkle
311685.png,https://derpicdn.net/img/view/2013/4/29/311685.png,0,0.992085218,442,8,1042,608,600,600,twilight sparkle
313470.png,https://derpicdn.net/img/view/2013/5/1/313470.png,0,0.980879843,542,33,972,463,430,430,twilight sparkle
314997.jpg,https://derpicdn.net/img/view/2013/5/3/314997.jpg,0,0.998462617,586,429,1496,1339,910,910,twilight sparkle
319404.png,https://derpicdn.net/img/view/2013/5/8/319404.png,0,0.957448184,303,92,789,578,486,486,twilight sparkle
324246.png,https://derpicdn.net/img/view/2013/5/13/324246.png,0,0.996734142,279,418,621,760,342,342,twilight sparkle
324246.png,https://derpicdn.net/img/view/2013/5/13/324246.png,1,0.974251688,312,57,490,235,178,178,twilight sparkle
324246.png,https://derpicdn.net/img/view/2013/5/13/324246.png,2,0.936649144,755,416,965,626,210,210,twilight sparkle
325575.jpg,https://derpicdn.net/img/view/2013/5/15/325575.jpg,0,0.985318184,316,82,764,530,448,448,twilight sparkle
326086.png,https://derpicdn.net/img/view/2013/5/16/326086.png,0,0.993245304,186,0,686,499,500,499,twilight sparkle
328189.png,https://derpicdn.net/img/view/2013/5/18/328189.png,0,0.999648809,1137,422,1727,1012,590,590,twilight sparkle
330222.jpg,https://derpicdn.net/img/view/2013/5/21/330222.jpg,0,0.998945236,296,0,766,421,470,421,twilight sparkle
330222.jpg,https://derpicdn.net/img/view/2013/5/21/330222.jpg,0,0.998945236,296,0,766,421,470,421,twilight sparkle
331783.png,https://derpicdn.net/img/view/2013/5/23/331783.png,0,0.997481167,146,0,864,718,718,718,twilight sparkle
332616.png,https://derpicdn.net/img/view/2013/5/24/332616.png,0,0.996233702,483,105,863,485,380,380,twilight sparkle
332616.png,https://derpicdn.net/img/view/2013/5/24/332616.png,0,0.996233702,483,105,863,485,380,380,twilight sparkle
344910.png,https://derpicdn.net/img/view/2013/6/10/344910.png,0,0.975959539,20,0,500,583,480,583,twilight sparkle
345412.png,https://derpicdn.net/img/view/2013/6/10/345412.png,0,0.986769795,380,360,796,776,416,416,twilight sparkle
346452.png,https://derpicdn.net/img/view/2013/6/12/346452.png,0,0.976216674,207,0,498,279,291,279,twilight sparkle
347290.png,https://derpicdn.net/img/view/2013/6/13/347290.png,0,0.974319398,1463,99,3891,2527,2428,2428,twilight sparkle
349371.png,https://derpicdn.net/img/view/2013/6/15/349371.png,0,0.987258971,6,0,496,425,490,425,twilight sparkle
351676.png,https://derpicdn.net/img/view/2013/6/18/351676.png,0,0.994253635,421,89,713,381,292,292,twilight sparkle
354513.png,https://derpicdn.net/img/view/2013/6/22/354513.png,0,0.98590523,0,0,548,600,548,600,twilight sparkle
354513.png,https://derpicdn.net/img/view/2013/6/22/354513.png,1,0.957396924,0,0,604,739,604,739,twilight sparkle
355805.png,https://derpicdn.net/img/view/2013/6/24/355805.png,0,0.987513423,74,0,800,711,726,711,twilight sparkle
358721.png,https://derpicdn.net/img/view/2013/6/27/358721.png,0,0.996356905,83,0,549,463,466,463,twilight sparkle
361607.png,https://derpicdn.net/img/view/2013/7/1/361607.png,0,0.99617362,3045,0,5500,2599,2455,2599,twilight sparkle
362800.jpg,https://derpicdn.net/img/view/2013/7/2/362800.jpg,0,0.982438803,2265,348,3201,1284,936,936,twilight sparkle
3654.png,https://derpicdn.net/img/view/2012/2/29/3654.png,0,0.990962625,206,113,430,337,224,224,twilight sparkle
3654.png,https://derpicdn.net/img/view/2012/2/29/3654.png,1,0.942734838,451,128,665,342,214,214,twilight sparkle
365657.png,https://derpicdn.net/img/view/2013/7/6/365657.png,0,0.993228674,0,0,614,609,614,609,twilight sparkle
365657.png,https://derpicdn.net/img/view/2013/7/6/365657.png,1,0.916620672,167,0,800,636,633,636,twilight sparkle
368258.png,https://derpicdn.net/img/view/2013/7/9/368258.png,0,0.921290874,277,34,2581,2338,2304,2304,twilight sparkle
373646.png,https://derpicdn.net/img/view/2013/7/14/373646.png,0,0.994917154,817,0,1261,431,444,431,twilight sparkle
373740.png,https://derpicdn.net/img/view/2013/7/14/373740.png,0,0.980362952,7,2,473,468,466,466,twilight sparkle
375542.png,https://derpicdn.net/img/view/2013/7/16/375542.png,0,0.942866683,133,0,705,549,572,549,twilight sparkle
377745.png,https://derpicdn.net/img/view/2013/7/18/377745.png,0,0.982998192,274,0,1048,689,774,689,twilight sparkle
382676.png,https://derpicdn.net/img/view/2013/7/24/382676.png,0,0.9926911,261,0,1769,1353,1508,1353,twilight sparkle
383857.png,https://derpicdn.net/img/view/2013/7/29/383857.png,0,0.908014059,233,157,2341,2265,2108,2108,twilight sparkle
387589.png,https://derpicdn.net/img/view/2013/7/31/387589.png,0,0.982479692,380,0,1066,680,686,680,twilight sparkle
389411.png,https://derpicdn.net/img/view/2013/8/2/389411.png,0,0.993127942,93,45,1099,1051,1006,1006,twilight sparkle
390067.png,https://derpicdn.net/img/view/2013/8/3/390067.png,0,0.987311959,672,0,1468,687,796,687,twilight sparkle
391012.png,https://derpicdn.net/img/view/2013/8/4/391012.png,0,0.99822557,331,34,631,334,300,300,twilight sparkle
39234.png,https://derpicdn.net/img/view/2012/7/10/39234.png,0,0.996532619,134,0,586,411,452,411,twilight sparkle
395218.png,https://derpicdn.net/img/view/2013/8/9/395218.png,0,0.983623624,125,6,351,232,226,226,twilight sparkle
400169.png,https://derpicdn.net/img/view/2013/8/14/400169.png,0,0.927838147,190,67,440,317,250,250,twilight sparkle
400711.png,https://derpicdn.net/img/view/2013/8/15/400711.png,0,0.988238335,238,0,838,564,600,564,twilight sparkle
401353.png,https://derpicdn.net/img/view/2013/8/15/401353.png,0,0.993536949,676,178,1352,854,676,676,twilight sparkle
401475.png,https://derpicdn.net/img/view/2013/8/16/401475.png,0,0.966841757,562,4,914,356,352,352,twilight sparkle
401791.png,https://derpicdn.net/img/view/2013/8/16/401791.png,0,0.999470532,741,32,939,230,198,198,twilight sparkle
401826.png,https://derpicdn.net/img/view/2013/8/16/401826.png,0,0.968634307,300,0,720,359,420,359,twilight sparkle
402338.png,https://derpicdn.net/img/view/2013/8/17/402338.png,0,0.995158255,184,42,500,374,316,332,twilight sparkle
404550.jpg,https://derpicdn.net/img/view/2013/8/19/404550.jpg,0,0.997662306,309,38,895,624,586,586,twilight sparkle
406919.png,https://derpicdn.net/img/view/2013/8/22/406919.png,0,0.947540283,389,24,753,388,364,364,twilight sparkle
407139.png,https://derpicdn.net/img/view/2013/8/22/407139.png,0,0.998117149,248,351,754,857,506,506,twilight sparkle
407419.jpg,https://derpicdn.net/img/view/2013/8/22/407419.jpg,0,0.986316741,25,0,385,346,360,346,twilight sparkle
4097.jpg,https://derpicdn.net/img/view/2012/5/27/4097.jpg,0,0.998502791,540,0,886,343,346,343,twilight sparkle
4099.jpg,https://derpicdn.net/img/view/2012/5/27/4099.jpg,0,0.999043047,0,0,406,406,406,406,twilight sparkle
410796.png,https://derpicdn.net/img/view/2013/8/26/410796.png,0,0.994853139,509,26,991,508,482,482,twilight sparkle
41359.png,https://derpicdn.net/img/view/2012/7/12/41359.png,0,0.99529618,637,436,1365,1164,728,728,twilight sparkle
414434.png,https://derpicdn.net/img/view/2013/8/30/414434.png,0,0.976716697,276,0,720,399,444,399,twilight sparkle
415322.png,https://derpicdn.net/img/view/2013/8/31/415322.png,0,0.997450173,1484,422,2590,1528,1106,1106,twilight sparkle
416806.png,https://derpicdn.net/img/view/2013/9/2/416806.png,0,0.987074494,5,1,405,401,400,400,twilight sparkle
416888.png,https://derpicdn.net/img/view/2013/9/2/416888.png,0,0.978348196,435,163,1025,753,590,590,twilight sparkle
421718.jpg,https://derpicdn.net/img/view/2013/9/7/421718.jpg,0,0.987741768,1253,0,2635,1338,1382,1338,twilight sparkle
4218.jpg,https://derpicdn.net/img/view/2012/6/3/4218.jpg,0,0.996642292,15,9,483,477,468,468,twilight sparkle
425977.png,https://derpicdn.net/img/view/2013/9/12/425977.png,1,0.99728024,40,4,424,388,384,384,twilight sparkle
427565.png,https://derpicdn.net/img/view/2013/9/14/427565.png,0,0.976704895,412,31,946,565,534,534,twilight sparkle
430637.png,https://derpicdn.net/img/view/2013/9/19/430637.png,0,0.958616912,215,96,785,666,570,570,twilight sparkle
431749.png,https://derpicdn.net/img/view/2013/9/21/431749.png,0,0.992592394,535,477,1087,1029,552,552,twilight sparkle
431876.png,https://derpicdn.net/img/view/2013/9/21/431876.png,0,0.997785211,506,45,1654,1193,1148,1148,twilight sparkle
432058.png,https://derpicdn.net/img/view/2013/9/21/432058.png,0,0.986467004,282,0,616,320,334,320,twilight sparkle
432870.jpg,https://derpicdn.net/img/view/2013/9/22/432870.jpg,0,0.990493953,121,0,1115,961,994,961,twilight sparkle
434146.png,https://derpicdn.net/img/view/2013/9/24/434146.png,0,0.997050762,501,56,931,486,430,430,twilight sparkle
434146.png,https://derpicdn.net/img/view/2013/9/24/434146.png,0,0.997050762,501,56,931,486,430,430,twilight sparkle
434625.png,https://derpicdn.net/img/view/2013/9/25/434625.png,0,0.965371132,431,49,2487,2105,2056,2056,twilight sparkle
435248.png,https://derpicdn.net/img/view/2013/9/26/435248.png,0,0.9956218,270,0,808,529,538,529,twilight sparkle
441428.jpg,https://derpicdn.net/img/view/2013/10/4/441428.jpg,0,0.998330534,498,0,1032,511,534,511,twilight sparkle
441444.png,https://derpicdn.net/img/view/2013/10/4/441444.png,0,0.996311963,233,0,631,393,398,393,twilight sparkle
441714.png,https://derpicdn.net/img/view/2013/10/4/441714.png,0,0.982439876,231,0,975,689,744,689,twilight sparkle
444333.jpg,https://derpicdn.net/img/view/2013/10/8/444333.jpg,0,0.991386831,0,32,201,250,201,218,twilight sparkle
444333.jpg,https://derpicdn.net/img/view/2013/10/8/444333.jpg,1,0.937576056,35,28,227,248,192,220,twilight sparkle
446363.jpg,https://derpicdn.net/img/view/2013/10/11/446363.jpg,0,0.992897689,110,238,562,690,452,452,twilight sparkle
446363.jpg,https://derpicdn.net/img/view/2013/10/11/446363.jpg,1,0.986549258,615,422,1000,848,385,426,twilight sparkle
448267.png,https://derpicdn.net/img/view/2013/10/13/448267.png,0,0.998508036,992,198,2094,1300,1102,1102,twilight sparkle
455246.png,https://derpicdn.net/img/view/2013/10/24/455246.png,0,0.928262174,991,559,4000,3390,3009,2831,twilight sparkle
456845.png,https://derpicdn.net/img/view/2013/10/26/456845.png,0,0.987987816,611,244,919,552,308,308,twilight sparkle
456845.png,https://derpicdn.net/img/view/2013/10/26/456845.png,0,0.987987816,611,244,919,552,308,308,twilight sparkle
459894.png,https://derpicdn.net/img/view/2013/10/30/459894.png,0,0.986071944,92,0,792,681,700,681,twilight sparkle
460562.png,https://derpicdn.net/img/view/2013/10/30/460562.png,0,0.989189625,207,0,1045,696,838,696,twilight sparkle
461463.png,https://derpicdn.net/img/view/2013/10/31/461463.png,0,0.979632914,68,0,372,292,304,292,twilight sparkle
463767.png,https://derpicdn.net/img/view/2013/11/3/463767.png,0,0.991515636,424,145,2206,1927,1782,1782,twilight sparkle
465891.png,https://derpicdn.net/img/view/2013/11/6/465891.png,0,0.943214715,716,121,2406,1811,1690,1690,twilight sparkle
479178.png,https://derpicdn.net/img/view/2013/11/23/479178.png,0,0.959505141,361,68,763,470,402,402,twilight sparkle
479327.png,https://derpicdn.net/img/view/2013/11/23/479327.png,0,0.983418643,0,0,202,191,202,191,twilight sparkle
480689.png,https://derpicdn.net/img/view/2013/11/24/480689.png,0,0.990319669,857,211,2911,2265,2054,2054,twilight sparkle
480719.png,https://derpicdn.net/img/view/2013/11/24/480719.png,0,0.927104414,32,0,854,798,822,798,twilight sparkle
483514.png,https://derpicdn.net/img/view/2013/11/27/483514.png,0,0.969277322,2071,43,3889,1861,1818,1818,twilight sparkle
485278.png,https://derpicdn.net/img/view/2013/11/29/485278.png,0,0.983159661,254,51,416,213,162,162,twilight sparkle
485314.jpg,https://derpicdn.net/img/view/2013/11/29/485314.jpg,0,0.989926398,282,359,524,601,242,242,twilight sparkle
485977.png,https://derpicdn.net/img/view/2013/11/30/485977.png,0,0.900034249,589,167,1119,697,530,530,twilight sparkle
485977.png,https://derpicdn.net/img/view/2013/11/30/485977.png,0,0.900034249,589,167,1119,697,530,530,twilight sparkle
486337.png,https://derpicdn.net/img/view/2013/11/30/486337.png,0,0.97282052,201,115,800,775,599,660,twilight sparkle
486547.png,https://derpicdn.net/img/view/2013/11/30/486547.png,0,0.998049617,3348,806,6000,3744,2652,2938,twilight sparkle
486968.png,https://derpicdn.net/img/view/2013/12/1/486968.png,0,0.996586978,930,49,1882,1001,952,952,twilight sparkle
487191.png,https://derpicdn.net/img/view/2013/12/1/487191.png,0,0.901306868,148,322,684,858,536,536,twilight sparkle
487191.png,https://derpicdn.net/img/view/2013/12/1/487191.png,0,0.901306868,148,322,684,858,536,536,twilight sparkle
487532.png,https://derpicdn.net/img/view/2013/12/2/487532.png,0,0.938646734,100,52,550,514,450,462,twilight sparkle
493202.png,https://derpicdn.net/img/view/2013/12/8/493202.png,0,0.998534918,130,0,786,632,656,632,twilight sparkle
493708.png,https://derpicdn.net/img/view/2013/12/9/493708.png,0,0.987183154,0,0,275,244,275,244,twilight sparkle
494201.png,https://derpicdn.net/img/view/2013/12/10/494201.png,0,0.989142418,1557,152,2971,1566,1414,1414,twilight sparkle
499828.png,https://derpicdn.net/img/view/2013/12/18/499828.png,0,0.999609947,0,0,814,820,814,820,twilight sparkle
501946.jpg,https://derpicdn.net/img/view/2013/12/20/501946.jpg,0,0.970437109,75,0,245,155,170,155,twilight sparkle
504105.png,https://derpicdn.net/img/view/2013/12/22/504105.png,0,0.903210998,25,0,901,873,876,873,twilight sparkle
504567.png,https://derpicdn.net/img/view/2013/12/23/504567.png,0,0.927373767,49,967,1003,1921,954,954,twilight sparkle
504567.png,https://derpicdn.net/img/view/2013/12/23/504567.png,0,0.927373767,49,967,1003,1921,954,954,twilight sparkle
508141.png,https://derpicdn.net/img/view/2013/12/28/508141.png,0,0.939820051,45,61,307,323,262,262,twilight sparkle
508923.png,https://derpicdn.net/img/view/2013/12/29/508923.png,0,0.99380666,485,21,777,313,292,292,twilight sparkle
509003.png,https://derpicdn.net/img/view/2013/12/29/509003.png,0,0.915048361,1656,119,3240,1703,1584,1584,twilight sparkle
511599.png,https://derpicdn.net/img/view/2014/1/1/511599.png,0,0.924597681,247,238,779,770,532,532,twilight sparkle
520121.png,https://derpicdn.net/img/view/2014/1/10/520121.png,0,0.978765547,330,0,858,496,528,496,twilight sparkle
523991.png,https://derpicdn.net/img/view/2014/1/14/523991.png,0,0.942639709,605,515,1159,1069,554,554,twilight sparkle
526210.png,https://derpicdn.net/img/view/2014/1/17/526210.png,0,0.973211765,4,0,182,171,178,171,twilight sparkle
527335.jpg,https://derpicdn.net/img/view/2014/1/18/527335.jpg,0,0.936236084,390,490,768,868,378,378,twilight sparkle
527606.jpg,https://derpicdn.net/img/view/2014/1/18/527606.jpg,0,0.958668232,1288,17,1698,427,410,410,twilight sparkle
528059.png,https://derpicdn.net/img/view/2014/1/18/528059.png,0,0.969795585,425,239,1487,1301,1062,1062,twilight sparkle
530338.png,https://derpicdn.net/img/view/2014/1/21/530338.png,0,0.996100724,356,138,846,628,490,490,twilight sparkle
534816.png,https://derpicdn.net/img/view/2014/1/26/534816.png,0,0.976534843,3239,134,5905,2800,2666,2666,twilight sparkle
534825.png,https://derpicdn.net/img/view/2014/1/26/534825.png,0,0.959112346,0,0,1162,1013,1162,1013,twilight sparkle
535259.jpg,https://derpicdn.net/img/view/2014/1/26/535259.jpg,0,0.996302664,0,25,440,509,440,484,twilight sparkle
535980.png,https://derpicdn.net/img/view/2014/1/27/535980.png,0,0.977319181,1433,125,3804,2645,2371,2520,twilight sparkle
536099.png,https://derpicdn.net/img/view/2014/1/27/536099.png,0,0.901520073,214,22,566,374,352,352,twilight sparkle
537766.png,https://derpicdn.net/img/view/2014/1/29/537766.png,0,0.992248476,0,2,719,736,719,734,twilight sparkle
542494.png,https://derpicdn.net/img/view/2014/2/3/542494.png,0,0.991766334,395,0,865,464,470,464,twilight sparkle
547472.png,https://derpicdn.net/img/view/2014/2/9/547472.png,0,0.996004164,113,0,637,514,524,514,twilight sparkle
549704.png,https://derpicdn.net/img/view/2014/2/12/549704.png,0,0.979607761,124,0,1404,1114,1280,1114,twilight sparkle
550316.png,https://derpicdn.net/img/view/2014/2/12/550316.png,0,0.936508119,359,0,879,456,520,456,twilight sparkle
551209.png,https://derpicdn.net/img/view/2014/2/14/551209.png,0,0.978656352,0,0,1089,1037,1089,1037,twilight sparkle
554644.png,https://derpicdn.net/img/view/2014/2/17/554644.png,0,0.935560226,745,0,1719,794,974,794,twilight sparkle
555375.png,https://derpicdn.net/img/view/2014/2/18/555375.png,0,0.973328829,292,111,1130,949,838,838,twilight sparkle
559070.png,https://derpicdn.net/img/view/2014/2/22/559070.png,0,0.992850542,262,101,620,459,358,358,twilight sparkle
559225.png,https://derpicdn.net/img/view/2014/2/22/559225.png,0,0.945242047,105,2,435,332,330,330,twilight sparkle
559330.png,https://derpicdn.net/img/view/2014/2/22/559330.png,0,0.988662124,807,138,1165,496,358,358,twilight sparkle
559567.png,https://derpicdn.net/img/view/2014/2/23/559567.png,0,0.977007568,122,0,534,396,412,396,twilight sparkle
561586.png,https://derpicdn.net/img/view/2014/2/26/561586.png,0,0.980887055,0,0,743,676,743,676,twilight sparkle
563179.png,https://derpicdn.net/img/view/2014/2/28/563179.png,0,0.902810633,222,316,442,536,220,220,twilight sparkle
564144.png,https://derpicdn.net/img/view/2014/3/1/564144.png,0,0.996534646,876,155,1756,1035,880,880,twilight sparkle
564864.png,https://derpicdn.net/img/view/2014/3/2/564864.png,0,0.998205781,0,0,924,915,924,915,twilight sparkle
565954.png,https://derpicdn.net/img/view/2014/3/3/565954.png,0,0.988065958,0,0,789,800,789,800,twilight sparkle
566575.png,https://derpicdn.net/img/view/2014/3/4/566575.png,0,0.995851278,47,0,411,328,364,328,twilight sparkle
567774.png,https://derpicdn.net/img/view/2014/3/6/567774.png,0,0.924779892,2679,220,5799,3340,3120,3120,twilight sparkle
569462.png,https://derpicdn.net/img/view/2014/3/8/569462.png,0,0.991803706,0,0,674,637,674,637,twilight sparkle
569462.png,https://derpicdn.net/img/view/2014/3/8/569462.png,0,0.991803706,0,0,674,637,674,637,twilight sparkle
570903.png,https://derpicdn.net/img/view/2014/3/9/570903.png,0,0.9964149,288,270,742,724,454,454,twilight sparkle
571273.png,https://derpicdn.net/img/view/2014/3/10/571273.png,0,0.959954977,19,0,561,453,542,453,twilight sparkle
573122.jpg,https://derpicdn.net/img/view/2014/3/12/573122.jpg,0,0.913421392,13,0,477,448,464,448,twilight sparkle
574438.png,https://derpicdn.net/img/view/2014/3/14/574438.png,0,0.989774764,214,0,1132,857,918,857,twilight sparkle
577995.png,https://derpicdn.net/img/view/2014/3/17/577995.png,0,0.931622922,78,173,488,583,410,410,twilight sparkle
579192.png,https://derpicdn.net/img/view/2014/3/18/579192.png,0,0.986305654,56,0,558,471,502,471,twilight sparkle
57960.jpg,https://derpicdn.net/img/view/2012/7/26/57960.jpg,0,0.98309958,0,0,2538,2500,2538,2500,twilight sparkle
580790.jpg,https://derpicdn.net/img/view/2014/3/21/580790.jpg,0,0.916249335,300,118,486,304,186,186,twilight sparkle
580790.jpg,https://derpicdn.net/img/view/2014/3/21/580790.jpg,0,0.916249335,300,118,486,304,186,186,twilight sparkle
580974.png,https://derpicdn.net/img/view/2014/3/21/580974.png,0,0.964979589,69,163,1078,1219,1009,1056,twilight sparkle
584869.png,https://derpicdn.net/img/view/2014/3/25/584869.png,0,0.922373176,529,156,813,440,284,284,twilight sparkle
591063.png,https://derpicdn.net/img/view/2014/4/2/591063.png,0,0.929640055,792,139,1226,573,434,434,twilight sparkle
591730.png,https://derpicdn.net/img/view/2014/4/3/591730.png,0,0.994272053,231,9,819,597,588,588,twilight sparkle
592000.png,https://derpicdn.net/img/view/2014/4/3/592000.png,0,0.966182113,239,0,531,281,292,281,twilight sparkle
593315.png,https://derpicdn.net/img/view/2014/4/5/593315.png,0,0.95358181,0,17,976,1007,976,990,twilight sparkle
595938.png,https://derpicdn.net/img/view/2014/4/8/595938.png,0,0.993951976,384,14,742,372,358,358,twilight sparkle
596196.png,https://derpicdn.net/img/view/2014/4/9/596196.png,0,0.999249399,203,0,609,390,406,390,twilight sparkle
596893.png,https://derpicdn.net/img/view/2014/4/10/596893.png,0,0.995103776,192,31,538,377,346,346,twilight sparkle
597841.png,https://derpicdn.net/img/view/2014/4/11/597841.png,0,0.906090438,1920,682,2850,1612,930,930,twilight sparkle
597845.jpg,https://derpicdn.net/img/view/2014/4/11/597845.jpg,0,0.974415481,239,43,629,433,390,390,twilight sparkle
598866.png,https://derpicdn.net/img/view/2014/4/12/598866.png,0,0.966749012,12,0,650,594,638,594,twilight sparkle
604517.png,https://derpicdn.net/img/view/2014/4/19/604517.png,0,0.998889148,607,22,903,318,296,296,twilight sparkle
604517.png,https://derpicdn.net/img/view/2014/4/19/604517.png,1,0.998071432,80,0,426,334,346,334,twilight sparkle
604517.png,https://derpicdn.net/img/view/2014/4/19/604517.png,2,0.989614427,21,753,435,1167,414,414,twilight sparkle
604517.png,https://derpicdn.net/img/view/2014/4/19/604517.png,3,0.968599916,593,811,929,1147,336,336,twilight sparkle
606356.png,https://derpicdn.net/img/view/2014/4/21/606356.png,0,0.939651489,199,40,423,264,224,224,twilight sparkle
607645.png,https://derpicdn.net/img/view/2014/4/23/607645.png,0,0.987882733,112,29,796,713,684,684,twilight sparkle
608793.png,https://derpicdn.net/img/view/2014/4/24/608793.png,0,0.921418726,2560,361,4412,2213,1852,1852,twilight sparkle
609038.png,https://derpicdn.net/img/view/2014/4/25/609038.png,0,0.986007869,96,0,340,235,244,235,twilight sparkle
610163.jpg,https://derpicdn.net/img/view/2014/4/26/610163.jpg,0,0.912556469,287,107,591,411,304,304,twilight sparkle
610851.png,https://derpicdn.net/img/view/2014/4/26/610851.png,0,0.947134197,22,0,382,357,360,357,twilight sparkle
610998.png,https://derpicdn.net/img/view/2014/4/27/610998.png,0,0.997703195,5,0,1495,1358,1490,1358,twilight sparkle
611396.png,https://derpicdn.net/img/view/2014/4/27/611396.png,0,0.952859163,53,0,647,580,594,580,twilight sparkle
612683.png,https://derpicdn.net/img/view/2014/4/29/612683.png,0,0.98708427,454,48,758,352,304,304,twilight sparkle
612780.png,https://derpicdn.net/img/view/2014/4/29/612780.png,0,0.903635979,125,1,991,867,866,866,twilight sparkle
616022.png,https://derpicdn.net/img/view/2014/5/3/616022.png,0,0.999584973,586,136,1376,926,790,790,twilight sparkle
617293.png,https://derpicdn.net/img/view/2014/5/4/617293.png,0,0.979536831,353,0,1075,718,722,718,twilight sparkle
617326.png,https://derpicdn.net/img/view/2014/5/4/617326.png,0,0.996150434,1143,134,1825,816,682,682,twilight sparkle
619981.png,https://derpicdn.net/img/view/2014/5/7/619981.png,0,0.988663375,19,0,363,329,344,329,twilight sparkle
621538.jpg,https://derpicdn.net/img/view/2014/5/9/621538.jpg,0,0.981518149,308,21,794,507,486,486,twilight sparkle
623539.png,https://derpicdn.net/img/view/2014/5/11/623539.png,0,0.987560928,264,1256,532,1524,268,268,twilight sparkle
623981.png,https://derpicdn.net/img/view/2014/5/11/623981.png,0,0.992464125,76,0,366,245,290,245,twilight sparkle
624086.jpg,https://derpicdn.net/img/view/2014/5/11/624086.jpg,0,0.974928796,337,43,685,391,348,348,twilight sparkle
624473.png,https://derpicdn.net/img/view/2014/5/12/624473.png,0,0.966370463,659,14,1117,472,458,458,twilight sparkle
625467.jpg,https://derpicdn.net/img/view/2014/5/13/625467.jpg,0,0.970441818,71,110,1279,1318,1208,1208,twilight sparkle
627051.png,https://derpicdn.net/img/view/2014/5/15/627051.png,0,0.99962759,333,139,627,433,294,294,twilight sparkle
627470.png,https://derpicdn.net/img/view/2014/5/15/627470.png,0,0.993144274,775,216,1111,552,336,336,twilight sparkle
627515.png,https://derpicdn.net/img/view/2014/5/15/627515.png,0,0.997790813,35,0,409,371,374,371,twilight sparkle
629210.png,https://derpicdn.net/img/view/2014/5/17/629210.png,0,0.964769065,115,139,359,383,244,244,twilight sparkle
630878.png,https://derpicdn.net/img/view/2014/5/19/630878.png,0,0.994231343,243,271,2731,2759,2488,2488,twilight sparkle
633590.png,https://derpicdn.net/img/view/2014/5/22/633590.png,0,0.958237767,365,17,713,365,348,348,twilight sparkle
633987.png,https://derpicdn.net/img/view/2014/5/23/633987.png,0,0.998066545,182,20,776,614,594,594,twilight sparkle
634301.png,https://derpicdn.net/img/view/2014/5/23/634301.png,0,0.965938926,0,7,734,765,734,758,twilight sparkle
634301.png,https://derpicdn.net/img/view/2014/5/23/634301.png,0,0.965938926,0,7,734,765,734,758,twilight sparkle
635266.jpg,https://derpicdn.net/img/view/2014/5/24/635266.jpg,0,0.994455695,378,153,906,681,528,528,twilight sparkle
635543.png,https://derpicdn.net/img/view/2014/5/24/635543.png,0,0.938175201,0,5,1500,1915,1500,1910,twilight sparkle
637719.png,https://derpicdn.net/img/view/2014/5/27/637719.png,0,0.994349062,296,93,766,563,470,470,twilight sparkle
639405.png,https://derpicdn.net/img/view/2014/5/28/639405.png,0,0.983461618,628,0,1248,551,620,551,twilight sparkle
642127.png,https://derpicdn.net/img/view/2014/6/1/642127.png,0,0.997626007,225,0,743,500,518,500,twilight sparkle
64260.png,https://derpicdn.net/img/view/2012/8/1/64260.png,0,0.974198282,0,0,518,529,518,529,twilight sparkle
647922.png,https://derpicdn.net/img/view/2014/6/8/647922.png,0,0.99378556,178,181,486,489,308,308,twilight sparkle
656434.png,https://derpicdn.net/img/view/2014/6/18/656434.png,0,0.989324868,727,139,1280,701,553,562,twilight sparkle
657833.png,https://derpicdn.net/img/view/2014/6/20/657833.png,0,0.990637243,750,87,1196,533,446,446,twilight sparkle
658876.png,https://derpicdn.net/img/view/2014/6/22/658876.png,0,0.951858044,0,0,617,576,617,576,twilight sparkle
659518.png,https://derpicdn.net/img/view/2014/6/23/659518.png,0,0.986445367,635,15,2705,2085,2070,2070,twilight sparkle
659602.png,https://derpicdn.net/img/view/2014/6/23/659602.png,0,0.9947052,475,0,819,330,344,330,twilight sparkle
659848.png,https://derpicdn.net/img/view/2014/6/23/659848.png,0,0.971631646,0,0,435,438,435,438,twilight sparkle
661896.png,https://derpicdn.net/img/view/2014/6/26/661896.png,0,0.963031173,286,42,1194,950,908,908,twilight sparkle
662572.png,https://derpicdn.net/img/view/2014/6/27/662572.png,0,0.977487326,251,0,3213,2783,2962,2783,twilight sparkle
663906.jpg,https://derpicdn.net/img/view/2014/6/29/663906.jpg,0,0.978053033,83,35,367,319,284,284,twilight sparkle
665188.png,https://derpicdn.net/img/view/2014/7/1/665188.png,0,0.992798924,19,0,505,445,486,445,twilight sparkle
665989.jpg,https://derpicdn.net/img/view/2014/7/2/665989.jpg,0,0.92466253,726,492,1884,1650,1158,1158,twilight sparkle
668320.png,https://derpicdn.net/img/view/2014/7/5/668320.png,0,0.993430912,1229,0,2823,1547,1594,1547,twilight sparkle
669304.png,https://derpicdn.net/img/view/2014/7/7/669304.png,0,0.996871531,236,0,1256,1016,1020,1016,twilight sparkle
673631.png,https://derpicdn.net/img/view/2014/7/12/673631.png,0,0.940217674,1723,39,3515,1831,1792,1792,twilight sparkle
674823.png,https://derpicdn.net/img/view/2014/7/14/674823.png,0,0.955868304,441,154,1217,930,776,776,twilight sparkle
685487.png,https://derpicdn.net/img/view/2014/7/28/685487.png,0,0.972009718,0,50,1280,1392,1280,1342,twilight sparkle
688485.png,https://derpicdn.net/img/view/2014/8/1/688485.png,0,0.993137479,132,11,814,693,682,682,twilight sparkle
688485.png,https://derpicdn.net/img/view/2014/8/1/688485.png,0,0.993137479,132,11,814,693,682,682,twilight sparkle
688558.png,https://derpicdn.net/img/view/2014/8/1/688558.png,0,0.936574161,248,56,1076,884,828,828,twilight sparkle
689666.png,https://derpicdn.net/img/view/2014/8/2/689666.png,0,0.986556351,676,644,1328,1296,652,652,twilight sparkle
692094.png,https://derpicdn.net/img/view/2014/8/5/692094.png,0,0.998987377,132,17,448,333,316,316,twilight sparkle
692547.png,https://derpicdn.net/img/view/2014/8/6/692547.png,0,0.977503538,537,0,1875,1303,1338,1303,twilight sparkle
696452.png,https://derpicdn.net/img/view/2014/8/10/696452.png,0,0.966397882,61,26,585,550,524,524,twilight sparkle
697878.jpg,https://derpicdn.net/img/view/2014/8/12/697878.jpg,0,0.938793957,138,6,434,302,296,296,twilight sparkle
697981.png,https://derpicdn.net/img/view/2014/8/12/697981.png,0,0.986451745,41,6,433,398,392,392,twilight sparkle
698512.png,https://derpicdn.net/img/view/2014/8/13/698512.png,0,0.999316335,1055,141,1821,907,766,766,twilight sparkle
700156.png,https://derpicdn.net/img/view/2014/8/15/700156.png,0,0.999235034,57,306,405,654,348,348,twilight sparkle
700156.png,https://derpicdn.net/img/view/2014/8/15/700156.png,1,0.989818037,477,316,815,654,338,338,twilight sparkle
701372.png,https://derpicdn.net/img/view/2014/8/16/701372.png,0,0.939006984,177,0,659,436,482,436,twilight sparkle
701372.png,https://derpicdn.net/img/view/2014/8/16/701372.png,0,0.939006984,177,0,659,436,482,436,twilight sparkle
70166.png,https://derpicdn.net/img/view/2012/8/9/70166.png,0,0.998314321,667,0,1293,588,626,588,twilight sparkle
702152.png,https://derpicdn.net/img/view/2014/8/17/702152.png,0,0.931810975,1434,219,2696,1481,1262,1262,twilight sparkle
702809.png,https://derpicdn.net/img/view/2014/8/18/702809.png,0,0.994479716,367,52,767,452,400,400,twilight sparkle
702840.png,https://derpicdn.net/img/view/2014/8/18/702840.png,0,0.98488003,475,25,927,477,452,452,twilight sparkle
703112.png,https://derpicdn.net/img/view/2014/8/19/703112.png,0,0.970726669,14,0,254,224,240,224,twilight sparkle
705142.png,https://derpicdn.net/img/view/2014/8/22/705142.png,0,0.953780115,227,481,547,801,320,320,twilight sparkle
705499.png,https://derpicdn.net/img/view/2014/8/22/705499.png,0,0.998852313,274,0,936,603,662,603,twilight sparkle
708691.png,https://derpicdn.net/img/view/2014/8/26/708691.png,0,0.996125579,2933,415,3475,957,542,542,twilight sparkle
709503.png,https://derpicdn.net/img/view/2014/8/27/709503.png,0,0.989850819,251,28,955,732,704,704,twilight sparkle
710932.png,https://derpicdn.net/img/view/2014/8/30/710932.png,0,0.988705695,103,424,467,788,364,364,twilight sparkle
712007.png,https://derpicdn.net/img/view/2014/8/31/712007.png,0,0.987200677,2439,2008,3057,2626,618,618,twilight sparkle
713781.png,https://derpicdn.net/img/view/2014/9/2/713781.png,0,0.989082992,54,95,889,991,835,896,twilight sparkle
713850.png,https://derpicdn.net/img/view/2014/9/3/713850.png,0,0.967749119,0,52,720,1178,720,1126,twilight sparkle
713918.png,https://derpicdn.net/img/view/2014/9/3/713918.png,0,0.905851722,441,131,1475,1165,1034,1034,twilight sparkle
714453.png,https://derpicdn.net/img/view/2014/9/4/714453.png,0,0.979664624,351,209,1051,909,700,700,twilight sparkle
714453.png,https://derpicdn.net/img/view/2014/9/4/714453.png,0,0.979664624,351,209,1051,909,700,700,twilight sparkle
714944.jpg,https://derpicdn.net/img/view/2014/9/4/714944.jpg,0,0.906939685,339,0,649,292,310,292,twilight sparkle
717298.png,https://derpicdn.net/img/view/2014/9/7/717298.png,0,0.963251412,0,0,752,753,752,753,twilight sparkle
717298.png,https://derpicdn.net/img/view/2014/9/7/717298.png,0,0.963251412,0,0,752,753,752,753,twilight sparkle
717783.jpg,https://derpicdn.net/img/view/2014/9/8/717783.jpg,0,0.962687194,348,422,620,694,272,272,twilight sparkle
717905.png,https://derpicdn.net/img/view/2014/9/8/717905.png,0,0.995139539,525,0,965,430,440,430,twilight sparkle
718449.png,https://derpicdn.net/img/view/2014/9/9/718449.png,0,0.984933496,272,108,606,442,334,334,twilight sparkle
718637.png,https://derpicdn.net/img/view/2014/9/9/718637.png,0,0.999249935,150,4,474,328,324,324,twilight sparkle
721347.jpg,https://derpicdn.net/img/view/2014/9/13/721347.jpg,0,0.979526043,316,0,702,381,386,381,twilight sparkle
721507.png,https://derpicdn.net/img/view/2014/9/13/721507.png,0,0.917410314,373,10,913,550,540,540,twilight sparkle
725519.jpg,https://derpicdn.net/img/view/2014/9/19/725519.jpg,0,0.997335911,314,0,922,568,608,568,twilight sparkle
730750.png,https://derpicdn.net/img/view/2014/9/27/730750.png,1,0.995037794,228,9,470,251,242,242,twilight sparkle
730762.png,https://derpicdn.net/img/view/2014/9/27/730762.png,0,0.999503911,202,23,614,435,412,412,twilight sparkle
731976.png,https://derpicdn.net/img/view/2014/9/29/731976.png,0,0.98893702,0,0,1575,1509,1575,1509,twilight sparkle
733776.png,https://derpicdn.net/img/view/2014/10/1/733776.png,0,0.993882,5,3,207,205,202,202,twilight sparkle
735350.png,https://derpicdn.net/img/view/2014/10/4/735350.png,0,0.977282524,319,0,1081,678,762,678,twilight sparkle
736419.png,https://derpicdn.net/img/view/2014/10/5/736419.png,0,0.948417902,284,100,680,496,396,396,twilight sparkle
742859.png,https://derpicdn.net/img/view/2014/10/14/742859.png,0,0.97264725,76,15,568,507,492,492,twilight sparkle
743732.jpg,https://derpicdn.net/img/view/2014/10/15/743732.jpg,0,0.991899192,483,165,1515,1197,1032,1032,twilight sparkle
746356.png,https://derpicdn.net/img/view/2014/10/19/746356.png,0,0.976828873,372,0,1280,946,908,946,twilight sparkle
746778.png,https://derpicdn.net/img/view/2014/10/20/746778.png,0,0.913924575,798,64,1296,562,498,498,twilight sparkle
746893.png,https://derpicdn.net/img/view/2014/10/20/746893.png,0,0.996404827,46,0,398,340,352,340,twilight sparkle
752568.jpg,https://derpicdn.net/img/view/2014/10/28/752568.jpg,0,0.932632089,165,0,751,483,586,483,twilight sparkle
754659.png,https://derpicdn.net/img/view/2014/10/31/754659.png,0,0.993141592,178,0,770,579,592,579,twilight sparkle
756046.png,https://derpicdn.net/img/view/2014/11/2/756046.png,0,0.95467788,202,0,786,558,584,558,twilight sparkle
757765.png,https://derpicdn.net/img/view/2014/11/4/757765.png,0,0.99379468,311,0,713,396,402,396,twilight sparkle
76117.png,https://derpicdn.net/img/view/2012/8/16/76117.png,0,0.946715772,329,629,985,1285,656,656,twilight sparkle
762331.png,https://derpicdn.net/img/view/2014/11/11/762331.png,0,0.915994048,42,2648,1024,3630,982,982,twilight sparkle
767016.jpg,https://derpicdn.net/img/view/2014/11/18/767016.jpg,0,0.998622298,28,7,420,399,392,392,twilight sparkle
767193.png,https://derpicdn.net/img/view/2014/11/18/767193.png,0,0.981365085,183,2,637,456,454,454,twilight sparkle
768768.jpg,https://derpicdn.net/img/view/2014/11/21/768768.jpg,0,0.994292021,447,106,1283,942,836,836,twilight sparkle
770619.png,https://derpicdn.net/img/view/2014/11/23/770619.png,0,0.998068154,66,0,520,434,454,434,twilight sparkle
772646.png,https://derpicdn.net/img/view/2014/11/27/772646.png,0,0.911073804,360,307,762,709,402,402,twilight sparkle
775190.jpg,https://derpicdn.net/img/view/2014/11/30/775190.jpg,0,0.986454308,172,0,1350,1007,1178,1007,twilight sparkle
778203.png,https://derpicdn.net/img/view/2014/12/5/778203.png,0,0.997515738,129,0,737,560,608,560,twilight sparkle
778584.png,https://derpicdn.net/img/view/2014/12/5/778584.png,0,0.996836007,1222,0,2144,869,922,869,twilight sparkle
784551.jpg,https://derpicdn.net/img/view/2014/12/14/784551.jpg,0,0.992417634,255,0,753,486,498,486,twilight sparkle
786282.png,https://derpicdn.net/img/view/2014/12/16/786282.png,0,0.997390449,0,0,1014,970,1014,970,twilight sparkle
786548.png,https://derpicdn.net/img/view/2014/12/17/786548.png,0,0.949492335,0,251,956,1311,956,1060,twilight sparkle
787552.png,https://derpicdn.net/img/view/2014/12/18/787552.png,0,0.985342681,508,214,836,542,328,328,twilight sparkle
788774.jpg,https://derpicdn.net/img/view/2014/12/20/788774.jpg,0,0.990756094,1835,501,2655,1321,820,820,twilight sparkle
788774.jpg,https://derpicdn.net/img/view/2014/12/20/788774.jpg,1,0.980177283,172,221,1456,1505,1284,1284,twilight sparkle
788774.jpg,https://derpicdn.net/img/view/2014/12/20/788774.jpg,2,0.929205596,910,1253,1734,2000,824,747,twilight sparkle
789292.png,https://derpicdn.net/img/view/2014/12/21/789292.png,0,0.990454495,126,0,632,466,506,466,twilight sparkle
791068.png,https://derpicdn.net/img/view/2014/12/23/791068.png,0,0.974601984,1163,70,1817,724,654,654,twilight sparkle
795340.png,https://derpicdn.net/img/view/2014/12/29/795340.png,0,0.947785199,0,0,526,507,526,507,twilight sparkle
795345.png,https://derpicdn.net/img/view/2014/12/29/795345.png,0,0.994253457,137,0,717,572,580,572,twilight sparkle
7955.png,https://derpicdn.net/img/view/2012/6/18/7955.png,0,0.996987045,1682,0,3256,1449,1574,1449,twilight sparkle
797561.jpg,https://derpicdn.net/img/view/2015/1/1/797561.jpg,0,0.982618868,298,0,838,537,540,537,twilight sparkle
797706.jpg,https://derpicdn.net/img/view/2015/1/2/797706.jpg,0,0.907553136,416,122,938,644,522,522,twilight sparkle
798237.png,https://derpicdn.net/img/view/2015/1/2/798237.png,0,0.97587657,23,0,553,527,530,527,twilight sparkle
799888.png,https://derpicdn.net/img/view/2015/1/5/799888.png,0,0.968598723,114,0,516,355,402,355,twilight sparkle
800418.png,https://derpicdn.net/img/view/2015/1/6/800418.png,0,0.999310732,157,13,847,703,690,690,twilight sparkle
800420.png,https://derpicdn.net/img/view/2015/1/6/800420.png,0,0.999519527,140,0,846,702,706,702,twilight sparkle
800422.png,https://derpicdn.net/img/view/2015/1/6/800422.png,0,0.997434497,143,18,851,726,708,708,twilight sparkle
801400.jpg,https://derpicdn.net/img/view/2015/1/7/801400.jpg,0,0.991077781,988,310,1526,848,538,538,twilight sparkle
801834.png,https://derpicdn.net/img/view/2015/1/8/801834.png,0,0.996082842,85,7,437,359,352,352,twilight sparkle
802185.png,https://derpicdn.net/img/view/2015/1/8/802185.png,0,0.985206246,504,733,5000,4761,4496,4028,twilight sparkle
802358.png,https://derpicdn.net/img/view/2015/1/9/802358.png,0,0.997839987,0,0,4192,4801,4192,4801,twilight sparkle
805557.png,https://derpicdn.net/img/view/2015/1/13/805557.png,0,0.985208094,308,71,1486,1249,1178,1178,twilight sparkle
806994.png,https://derpicdn.net/img/view/2015/1/15/806994.png,0,0.993459284,72,44,224,196,152,152,twilight sparkle
807394.png,https://derpicdn.net/img/view/2015/1/15/807394.png,0,0.994217932,1134,165,1892,923,758,758,twilight sparkle
810464.png,https://derpicdn.net/img/view/2015/1/20/810464.png,0,0.971095026,51,38,937,924,886,886,twilight sparkle
810564.png,https://derpicdn.net/img/view/2015/1/20/810564.png,0,0.999174893,2201,0,4287,1990,2086,1990,twilight sparkle
810564.png,https://derpicdn.net/img/view/2015/1/20/810564.png,0,0.999174893,2201,0,4287,1990,2086,1990,twilight sparkle
814635.png,https://derpicdn.net/img/view/2015/1/25/814635.png,0,0.958200037,23,0,439,403,416,403,twilight sparkle
816948.jpg,https://derpicdn.net/img/view/2015/1/29/816948.jpg,0,0.997210801,67,0,505,421,438,421,twilight sparkle
817776.png,https://derpicdn.net/img/view/2015/1/30/817776.png,0,0.972153187,6,29,963,999,957,970,twilight sparkle
818231.png,https://derpicdn.net/img/view/2015/1/31/818231.png,0,0.997876704,99,0,3413,3225,3314,3225,twilight sparkle
818331.png,https://derpicdn.net/img/view/2015/1/31/818331.png,0,0.989290357,358,0,814,440,456,440,twilight sparkle
824446.png,https://derpicdn.net/img/view/2015/2/8/824446.png,0,0.978765011,72,6,600,534,528,528,twilight sparkle
825286.png,https://derpicdn.net/img/view/2015/2/10/825286.png,0,0.990701675,24,0,900,996,876,996,twilight sparkle
827668.png,https://derpicdn.net/img/view/2015/2/13/827668.png,0,0.996468723,311,103,559,351,248,248,twilight sparkle
828978.png,https://derpicdn.net/img/view/2015/2/15/828978.png,0,0.912322223,267,364,1087,1184,820,820,twilight sparkle
830898.png,https://derpicdn.net/img/view/2015/2/17/830898.png,0,0.98765552,44,51,1178,1185,1134,1134,twilight sparkle
83093.jpg,https://derpicdn.net/img/view/2012/8/26/83093.jpg,1,0.912056684,0,46,928,1018,928,972,twilight sparkle
831670.png,https://derpicdn.net/img/view/2015/2/18/831670.png,0,0.983694553,470,130,858,518,388,388,twilight sparkle
832314.png,https://derpicdn.net/img/view/2015/2/19/832314.png,0,0.982800186,234,119,626,511,392,392,twilight sparkle
832755.png,https://derpicdn.net/img/view/2015/2/19/832755.png,0,0.995526969,614,700,2108,2194,1494,1494,twilight sparkle
833535.png,https://derpicdn.net/img/view/2015/2/20/833535.png,0,0.93166703,256,80,538,362,282,282,twilight sparkle
833535.png,https://derpicdn.net/img/view/2015/2/20/833535.png,0,0.93166703,256,80,538,362,282,282,twilight sparkle
838420.png,https://derpicdn.net/img/view/2015/2/27/838420.png,0,0.992800057,2886,322,4374,1810,1488,1488,twilight sparkle
841291.png,https://derpicdn.net/img/view/2015/3/3/841291.png,0,0.982418537,744,72,1398,726,654,654,twilight sparkle
842522.jpg,https://derpicdn.net/img/view/2015/3/5/842522.jpg,0,0.925073087,0,0,600,628,600,628,twilight sparkle
842850.png,https://derpicdn.net/img/view/2015/3/5/842850.png,0,0.99873817,160,0,710,533,550,533,twilight sparkle
843061.png,https://derpicdn.net/img/view/2015/3/5/843061.png,0,0.998412013,301,67,589,355,288,288,twilight sparkle
847803.png,https://derpicdn.net/img/view/2015/3/12/847803.png,0,0.949421108,60,185,480,640,420,455,twilight sparkle
847906.jpg,https://derpicdn.net/img/view/2015/3/12/847906.jpg,0,0.954226792,1660,0,2376,681,716,681,twilight sparkle
848526.jpg,https://derpicdn.net/img/view/2015/3/13/848526.jpg,0,0.96038413,112,3,460,351,348,348,twilight sparkle
848702.png,https://derpicdn.net/img/view/2015/3/13/848702.png,0,0.902669668,288,181,838,731,550,550,twilight sparkle
848702.png,https://derpicdn.net/img/view/2015/3/13/848702.png,0,0.902669668,288,181,838,731,550,550,twilight sparkle
849837.png,https://derpicdn.net/img/view/2015/3/15/849837.png,0,0.993316472,586,95,1108,617,522,522,twilight sparkle
849837.png,https://derpicdn.net/img/view/2015/3/15/849837.png,1,0.974045753,254,252,668,666,414,414,twilight sparkle
851745.jpg,https://derpicdn.net/img/view/2015/3/17/851745.jpg,0,0.976046085,197,35,497,335,300,300,twilight sparkle
852494.jpg,https://derpicdn.net/img/view/2015/3/18/852494.jpg,0,0.964942694,464,0,1098,613,634,613,twilight sparkle
854261.png,https://derpicdn.net/img/view/2015/3/21/854261.png,0,0.994119346,0,0,640,588,640,588,twilight sparkle
85662.png,https://derpicdn.net/img/view/2012/8/29/85662.png,0,0.995963395,7,0,259,217,252,217,twilight sparkle
857665.png,https://derpicdn.net/img/view/2015/3/26/857665.png,0,0.987189114,1242,0,2662,1307,1420,1307,twilight sparkle
857713.jpg,https://derpicdn.net/img/view/2015/3/26/857713.jpg,0,0.991646171,114,35,402,323,288,288,twilight sparkle
858455.png,https://derpicdn.net/img/view/2015/3/27/858455.png,0,0.992907345,679,164,1295,780,616,616,twilight sparkle
859923.png,https://derpicdn.net/img/view/2015/3/29/859923.png,0,0.958451331,623,0,923,296,300,296,twilight sparkle
862058.png,https://derpicdn.net/img/view/2015/4/1/862058.png,0,0.990364373,133,38,411,316,278,278,twilight sparkle
862058.png,https://derpicdn.net/img/view/2015/4/1/862058.png,0,0.990364373,133,38,411,316,278,278,twilight sparkle
864012.png,https://derpicdn.net/img/view/2015/4/3/864012.png,0,0.998932898,405,0,1007,618,602,618,twilight sparkle
864954.png,https://derpicdn.net/img/view/2015/4/4/864954.png,0,0.991393089,1131,0,3825,2789,2694,2789,twilight sparkle
865279.png,https://derpicdn.net/img/view/2015/4/5/865279.png,0,0.974334359,0,0,948,957,948,957,twilight sparkle
866913.png,https://derpicdn.net/img/view/2015/4/6/866913.png,0,0.999284983,0,0,1776,1839,1776,1839,twilight sparkle
867168.png,https://derpicdn.net/img/view/2015/4/6/867168.png,0,0.973297596,3023,0,7378,4483,4355,4483,twilight sparkle
867598.png,https://derpicdn.net/img/view/2015/4/7/867598.png,0,0.962669551,0,0,1409,1832,1409,1832,twilight sparkle
867992.png,https://derpicdn.net/img/view/2015/4/7/867992.png,0,0.997032821,2765,19,5777,3031,3012,3012,twilight sparkle
869308.png,https://derpicdn.net/img/view/2015/4/9/869308.png,0,0.98633343,2324,0,6163,3880,3839,3880,twilight sparkle
869792.png,https://derpicdn.net/img/view/2015/4/9/869792.png,0,0.95271641,47,0,867,603,820,603,twilight sparkle
871999.png,https://derpicdn.net/img/view/2015/4/12/871999.png,0,0.972093761,323,0,1311,926,988,926,twilight sparkle
872244.jpg,https://derpicdn.net/img/view/2015/4/12/872244.jpg,0,0.970340073,145,0,741,450,596,450,twilight sparkle
872357.png,https://derpicdn.net/img/view/2015/4/12/872357.png,0,0.918253899,12,84,404,476,392,392,twilight sparkle
872465.png,https://derpicdn.net/img/view/2015/4/12/872465.png,0,0.989216566,149,0,493,330,344,330,twilight sparkle
872582.png,https://derpicdn.net/img/view/2015/4/12/872582.png,0,0.930954874,2119,0,4015,1824,1896,1824,twilight sparkle
872726.png,https://derpicdn.net/img/view/2015/4/12/872726.png,0,0.995448232,234,85,806,657,572,572,twilight sparkle
872839.png,https://derpicdn.net/img/view/2015/4/13/872839.png,0,0.956714928,299,1067,4473,5241,4174,4174,twilight sparkle
873117.png,https://derpicdn.net/img/view/2015/4/13/873117.png,0,0.979143322,208,4,1164,960,956,956,twilight sparkle
873562.png,https://derpicdn.net/img/view/2015/4/14/873562.png,0,0.991260946,2406,924,3458,1976,1052,1052,twilight sparkle
873562.png,https://derpicdn.net/img/view/2015/4/14/873562.png,1,0.939340949,0,21,2529,2543,2529,2522,twilight sparkle
873607.png,https://derpicdn.net/img/view/2015/4/14/873607.png,0,0.979773402,15,0,577,539,562,539,twilight sparkle
874153.png,https://derpicdn.net/img/view/2015/4/14/874153.png,0,0.990120888,321,0,1699,1254,1378,1254,twilight sparkle
874423.png,https://derpicdn.net/img/view/2015/4/15/874423.png,0,0.995498896,3171,0,5840,2757,2669,2757,twilight sparkle
875168.png,https://derpicdn.net/img/view/2015/4/16/875168.png,0,0.961926162,61,0,385,323,324,323,twilight sparkle
876002.png,https://derpicdn.net/img/view/2015/4/17/876002.png,0,0.997652888,379,14,801,436,422,422,twilight sparkle
876107.png,https://derpicdn.net/img/view/2015/4/17/876107.png,0,0.973753095,21,88,1883,1950,1862,1862,twilight sparkle
876295.png,https://derpicdn.net/img/view/2015/4/17/876295.png,0,0.968096495,101,58,851,808,750,750,twilight sparkle
876296.png,https://derpicdn.net/img/view/2015/4/17/876296.png,0,0.957616985,98,0,796,470,698,470,twilight sparkle
876361.png,https://derpicdn.net/img/view/2015/4/17/876361.png,0,0.995848417,1068,54,1955,968,887,914,twilight sparkle
876758.png,https://derpicdn.net/img/view/2015/4/18/876758.png,0,0.987323701,88,20,832,764,744,744,twilight sparkle
877400.png,https://derpicdn.net/img/view/2015/4/18/877400.png,0,0.990816712,1973,392,4986,3530,3013,3138,twilight sparkle
878806.jpg,https://derpicdn.net/img/view/2015/4/20/878806.jpg,0,0.950060487,78,304,314,540,236,236,twilight sparkle
878974.png,https://derpicdn.net/img/view/2015/4/20/878974.png,0,0.993765831,45,19,257,231,212,212,twilight sparkle
879368.png,https://derpicdn.net/img/view/2015/4/21/879368.png,0,0.997363567,317,31,797,511,480,480,twilight sparkle
879597.png,https://derpicdn.net/img/view/2015/4/21/879597.png,0,0.935980201,36,0,502,420,466,420,twilight sparkle
880171.png,https://derpicdn.net/img/view/2015/4/22/880171.png,0,0.98749131,42,0,934,849,892,849,twilight sparkle
880245.png,https://derpicdn.net/img/view/2015/4/22/880245.png,0,0.991550267,257,171,1797,1711,1540,1540,twilight sparkle
882722.png,https://derpicdn.net/img/view/2015/4/25/882722.png,0,0.995049,483,295,891,703,408,408,twilight sparkle
883295.png,https://derpicdn.net/img/view/2015/4/26/883295.png,0,0.946880996,18,0,356,332,338,332,twilight sparkle
883612.png,https://derpicdn.net/img/view/2015/4/26/883612.png,0,0.998921275,254,0,502,240,248,240,twilight sparkle
884184.png,https://derpicdn.net/img/view/2015/4/27/884184.png,0,0.981833637,469,153,1615,1299,1146,1146,twilight sparkle
884538.png,https://derpicdn.net/img/view/2015/4/28/884538.png,0,0.98909831,17,0,1233,1136,1216,1136,twilight sparkle
885519.png,https://derpicdn.net/img/view/2015/4/29/885519.png,0,0.960875392,0,0,800,867,800,867,twilight sparkle
888564.png,https://derpicdn.net/img/view/2015/5/4/888564.png,0,0.987325013,312,734,1142,1564,830,830,twilight sparkle
890212.png,https://derpicdn.net/img/view/2015/5/6/890212.png,0,0.99287498,352,126,676,450,324,324,twilight sparkle
891965.png,https://derpicdn.net/img/view/2015/5/9/891965.png,0,0.995177984,177,208,1007,1038,830,830,twilight sparkle
896323.png,https://derpicdn.net/img/view/2015/5/15/896323.png,0,0.927265108,71,44,1183,1156,1112,1112,twilight sparkle
896475.png,https://derpicdn.net/img/view/2015/5/15/896475.png,0,0.919781744,450,188,1028,766,578,578,twilight sparkle
898439.jpg,https://derpicdn.net/img/view/2015/5/17/898439.jpg,0,0.961037815,4,0,661,814,657,814,twilight sparkle
899060.png,https://derpicdn.net/img/view/2015/5/18/899060.png,0,0.98262006,53,0,1277,1113,1224,1113,twilight sparkle
904509.png,https://derpicdn.net/img/view/2015/5/26/904509.png,0,0.943041325,42,0,398,318,356,318,twilight sparkle
904510.png,https://derpicdn.net/img/view/2015/5/26/904510.png,0,0.942466736,40,0,400,318,360,318,twilight sparkle
904511.png,https://derpicdn.net/img/view/2015/5/26/904511.png,0,0.950957894,45,0,397,314,352,314,twilight sparkle
905427.png,https://derpicdn.net/img/view/2015/5/28/905427.png,0,0.914489567,16,0,230,205,214,205,twilight sparkle
905769.png,https://derpicdn.net/img/view/2015/5/28/905769.png,0,0.998175204,24,39,432,447,408,408,twilight sparkle
905769.png,https://derpicdn.net/img/view/2015/5/28/905769.png,0,0.998175204,24,39,432,447,408,408,twilight sparkle
908055.png,https://derpicdn.net/img/view/2015/6/1/908055.png,0,0.975607634,956,0,1978,1037,1022,1037,twilight sparkle
908179.png,https://derpicdn.net/img/view/2015/6/1/908179.png,0,0.97816515,123,0,745,609,622,609,twilight sparkle
910824.png,https://derpicdn.net/img/view/2015/6/5/910824.png,0,0.987820327,1554,560,2748,1754,1194,1194,twilight sparkle
911083.png,https://derpicdn.net/img/view/2015/6/6/911083.png,0,0.990088522,736,25,2924,2213,2188,2188,twilight sparkle
911833.png,https://derpicdn.net/img/view/2015/6/6/911833.png,0,0.999330699,292,0,1864,1537,1572,1537,twilight sparkle
912772.png,https://derpicdn.net/img/view/2015/6/8/912772.png,0,0.923146188,516,0,828,297,312,297,twilight sparkle
914772.png,https://derpicdn.net/img/view/2015/6/11/914772.png,0,0.986139119,174,0,808,623,634,623,twilight sparkle
915190.png,https://derpicdn.net/img/view/2015/6/12/915190.png,0,0.995965421,195,75,563,443,368,368,twilight sparkle
916996.png,https://derpicdn.net/img/view/2015/6/14/916996.png,0,0.977729917,132,1294,1454,2616,1322,1322,twilight sparkle
917511.png,https://derpicdn.net/img/view/2015/6/15/917511.png,0,0.996506572,462,16,970,524,508,508,twilight sparkle
919799.png,https://derpicdn.net/img/view/2015/6/19/919799.png,0,0.94916302,59,77,775,793,716,716,twilight sparkle
921144.png,https://derpicdn.net/img/view/2015/6/21/921144.png,0,0.945498228,812,240,1892,1320,1080,1080,twilight sparkle
924026.png,https://derpicdn.net/img/view/2015/6/26/924026.png,0,0.998289347,1447,118,3000,1752,1553,1634,twilight sparkle
924869.png,https://derpicdn.net/img/view/2015/6/27/924869.png,0,0.982731581,335,120,799,584,464,464,twilight sparkle
926848.png,https://derpicdn.net/img/view/2015/6/30/926848.png,0,0.976719737,0,59,4109,4593,4109,4534,twilight sparkle
929542.png,https://derpicdn.net/img/view/2015/7/4/929542.png,0,0.958542943,73,0,671,565,598,565,twilight sparkle
929887.jpg,https://derpicdn.net/img/view/2015/7/4/929887.jpg,0,0.994350255,0,0,461,422,461,422,twilight sparkle
931278.png,https://derpicdn.net/img/view/2015/7/6/931278.png,0,0.904765725,3380,314,6000,3058,2620,2744,twilight sparkle
933171.png,https://derpicdn.net/img/view/2015/7/9/933171.png,0,0.962532759,667,271,1047,651,380,380,twilight sparkle
933418.png,https://derpicdn.net/img/view/2015/7/9/933418.png,0,0.913295269,2020,0,3200,1165,1180,1165,twilight sparkle
934249.png,https://derpicdn.net/img/view/2015/7/10/934249.png,0,0.995933652,830,163,1480,813,650,650,twilight sparkle
934379.png,https://derpicdn.net/img/view/2015/7/10/934379.png,0,0.940260828,1058,0,2254,1144,1196,1144,twilight sparkle
935372.png,https://derpicdn.net/img/view/2015/7/12/935372.png,0,0.912052095,3335,298,6000,3090,2665,2792,twilight sparkle
937096.png,https://derpicdn.net/img/view/2015/7/14/937096.png,0,0.998745918,0,0,482,480,482,480,twilight sparkle
937398.png,https://derpicdn.net/img/view/2015/7/15/937398.png,0,0.98799783,56,64,468,476,412,412,twilight sparkle
9376.jpg,https://derpicdn.net/img/view/2012/6/19/9376.jpg,0,0.995470047,56,344,878,1166,822,822,twilight sparkle
940432.png,https://derpicdn.net/img/view/2015/7/20/940432.png,0,0.990240693,906,819,5722,5807,4816,4988,twilight sparkle
941416.png,https://derpicdn.net/img/view/2015/7/22/941416.png,0,0.989180088,75,0,331,255,256,255,twilight sparkle
945022.jpg,https://derpicdn.net/img/view/2015/7/27/945022.jpg,0,0.927304506,1263,1102,2151,1990,888,888,twilight sparkle
947055.png,https://derpicdn.net/img/view/2015/7/30/947055.png,0,0.998384416,838,198,1642,1002,804,804,twilight sparkle
947437.png,https://derpicdn.net/img/view/2015/7/30/947437.png,0,0.916968405,567,41,1721,1195,1154,1154,twilight sparkle
948182.png,https://derpicdn.net/img/view/2015/8/1/948182.png,0,0.948608518,200,58,820,678,620,620,twilight sparkle
952527.png,https://derpicdn.net/img/view/2015/8/6/952527.png,0,0.929540992,73,0,477,395,404,395,twilight sparkle
953607.png,https://derpicdn.net/img/view/2015/8/8/953607.png,0,0.982207239,53,0,567,505,514,505,twilight sparkle
954255.png,https://derpicdn.net/img/view/2015/8/9/954255.png,0,0.923230827,728,0,1280,471,552,471,twilight sparkle
954371.jpg,https://derpicdn.net/img/view/2015/8/9/954371.jpg,0,0.990444779,475,154,1405,1084,930,930,twilight sparkle
961068.png,https://derpicdn.net/img/view/2015/8/19/961068.png,0,0.967549026,0,147,888,1100,888,953,twilight sparkle
961817.jpg,https://derpicdn.net/img/view/2015/8/20/961817.jpg,0,0.993314385,1083,46,1869,832,786,786,twilight sparkle
965319.png,https://derpicdn.net/img/view/2015/8/25/965319.png,0,0.986020505,139,25,477,363,338,338,twilight sparkle
966728.png,https://derpicdn.net/img/view/2015/8/27/966728.png,0,0.915434301,134,0,310,175,176,175,twilight sparkle
968310.png,https://derpicdn.net/img/view/2015/8/29/968310.png,0,0.964733601,556,26,1024,508,468,482,twilight sparkle
969056.png,https://derpicdn.net/img/view/2015/8/30/969056.png,0,0.993248701,499,0,2439,1867,1940,1867,twilight sparkle
969088.png,https://derpicdn.net/img/view/2015/8/30/969088.png,0,0.970439196,187,0,685,495,498,495,twilight sparkle
969197.png,https://derpicdn.net/img/view/2015/8/30/969197.png,0,0.993068874,1258,0,3000,1722,1742,1722,twilight sparkle
972568.png,https://derpicdn.net/img/view/2015/9/4/972568.png,0,0.995255888,394,0,748,345,354,345,twilight sparkle
973065.jpg,https://derpicdn.net/img/view/2015/9/5/973065.jpg,0,0.931333542,64,54,398,388,334,334,twilight sparkle
974315.jpg,https://derpicdn.net/img/view/2015/9/7/974315.jpg,0,0.999334395,0,29,1130,1323,1130,1294,twilight sparkle
975430.png,https://derpicdn.net/img/view/2015/9/8/975430.png,0,0.976657808,290,0,776,468,486,468,twilight sparkle
975640.png,https://derpicdn.net/img/view/2015/9/8/975640.png,0,0.996340752,178,0,672,485,494,485,twilight sparkle
978434.png,https://derpicdn.net/img/view/2015/9/12/978434.png,0,0.991330922,595,382,915,702,320,320,twilight sparkle
980538.png,https://derpicdn.net/img/view/2015/9/15/980538.png,0,0.97327733,323,272,3143,3134,2820,2862,twilight sparkle
983885.png,https://derpicdn.net/img/view/2015/9/20/983885.png,0,0.977970958,634,45,3688,3395,3054,3350,twilight sparkle
986130.png,https://derpicdn.net/img/view/2015/9/23/986130.png,0,0.997881413,0,0,351,339,351,339,twilight sparkle
986153.jpg,https://derpicdn.net/img/view/2015/9/23/986153.jpg,0,0.994795144,557,0,1531,960,974,960,twilight sparkle
987800.jpg,https://derpicdn.net/img/view/2015/9/26/987800.jpg,0,0.964508593,733,2,1383,652,650,650,twilight sparkle
990005.png,https://derpicdn.net/img/view/2015/9/28/990005.png,0,0.993226707,2058,87,5302,3331,3244,3244,twilight sparkle
994146.jpg,https://derpicdn.net/img/view/2015/10/4/994146.jpg,0,0.966022015,0,0,493,360,493,360,twilight sparkle
996236.png,https://derpicdn.net/img/view/2015/10/7/996236.png,0,0.991620958,111,59,841,789,730,730,twilight sparkle
996393.png,https://derpicdn.net/img/view/2015/10/7/996393.png,0,0.994922638,825,144,1585,904,760,760,twilight sparkle
998029.png,https://derpicdn.net/img/view/2015/10/9/998029.png,0,0.941589832,237,0,1731,1080,1494,1080,twilight sparkle
999412.png,https://derpicdn.net/img/view/2015/10/11/999412.png,0,0.997202575,533,379,1477,1323,944,944,twilight sparkle
1000018.jpg,https://derpicdn.net/img/view/2015/10/11/1000018.jpg,0,0.993063867,0,0,777,860,777,860,twilight sparkle
1000275.jpg,https://derpicdn.net/img/view/2015/10/12/1000275.jpg,0,0.96708709,350,0,1110,738,760,738,twilight sparkle
1005034.png,https://derpicdn.net/img/view/2015/10/18/1005034.png,0,0.911069334,245,0,729,478,484,478,twilight sparkle
1006488.png,https://derpicdn.net/img/view/2015/10/20/1006488.png,0,0.975149274,0,4,394,420,394,416,twilight sparkle
1006730.png,https://derpicdn.net/img/view/2015/10/21/1006730.png,0,0.997999549,281,0,2567,2185,2286,2185,twilight sparkle
1008148.png,https://derpicdn.net/img/view/2015/10/23/1008148.png,0,0.905822992,2597,39,5389,3005,2792,2966,twilight sparkle
1008925.png,https://derpicdn.net/img/view/2015/10/24/1008925.png,0,0.969347417,0,0,668,649,668,649,twilight sparkle
1009163.png,https://derpicdn.net/img/view/2015/10/24/1009163.png,0,0.988130629,646,191,1252,797,606,606,twilight sparkle
1011958.png,https://derpicdn.net/img/view/2015/10/29/1011958.png,0,0.921211958,1554,113,3998,2557,2444,2444,twilight sparkle
1013050.png,https://derpicdn.net/img/view/2015/10/31/1013050.png,0,0.999615908,220,7,478,265,258,258,twilight sparkle
1014023.png,https://derpicdn.net/img/view/2015/11/1/1014023.png,0,0.981149673,522,107,1126,771,604,664,twilight sparkle
1017382.png,https://derpicdn.net/img/view/2015/11/6/1017382.png,0,0.994396329,0,0,903,944,903,944,twilight sparkle
1017387.png,https://derpicdn.net/img/view/2015/11/6/1017387.png,0,0.967033327,18,11,932,925,914,914,twilight sparkle
1017461.png,https://derpicdn.net/img/view/2015/11/6/1017461.png,0,0.990415275,453,349,945,841,492,492,twilight sparkle
1018944.png,https://derpicdn.net/img/view/2015/11/8/1018944.png,0,0.999486685,2261,0,4249,2043,1988,2043,twilight sparkle
1019012.png,https://derpicdn.net/img/view/2015/11/8/1019012.png,0,0.931576669,0,0,697,664,697,664,twilight sparkle
1019035.png,https://derpicdn.net/img/view/2015/11/8/1019035.png,0,0.988318801,973,0,3527,2545,2554,2545,twilight sparkle
1019643.png,https://derpicdn.net/img/view/2015/11/9/1019643.png,0,0.913694322,1823,44,1975,226,152,182,twilight sparkle
1020934.png,https://derpicdn.net/img/view/2015/11/11/1020934.png,0,0.962394238,661,1945,2725,4009,2064,2064,twilight sparkle
1021021.png,https://derpicdn.net/img/view/2015/11/11/1021021.png,0,0.996018469,2447,0,5081,2702,2634,2702,twilight sparkle
1022283.png,https://derpicdn.net/img/view/2015/11/13/1022283.png,0,0.993446052,1759,608,2719,1568,960,960,twilight sparkle
1023025.png,https://derpicdn.net/img/view/2015/11/15/1023025.png,0,0.968274474,13,2,540,530,527,528,twilight sparkle
1027199.png,https://derpicdn.net/img/view/2015/11/21/1027199.png,0,0.999129415,443,65,1177,799,734,734,twilight sparkle
1028908.png,https://derpicdn.net/img/view/2015/11/23/1028908.png,0,0.998245239,885,0,1805,920,920,920,twilight sparkle
1029728.png,https://derpicdn.net/img/view/2015/11/25/1029728.png,0,0.989689946,3597,0,7903,4181,4306,4181,twilight sparkle
1029821.png,https://derpicdn.net/img/view/2015/11/25/1029821.png,0,0.942765594,18,0,392,358,374,358,twilight sparkle
1030324.png,https://derpicdn.net/img/view/2015/11/26/1030324.png,0,0.951812863,1949,2013,2495,2559,546,546,twilight sparkle
1030574.png,https://derpicdn.net/img/view/2015/11/26/1030574.png,0,0.927874863,459,251,893,685,434,434,twilight sparkle
1033843.png,https://derpicdn.net/img/view/2015/11/30/1033843.png,0,0.988857567,522,82,998,558,476,476,twilight sparkle
1035099.png,https://derpicdn.net/img/view/2015/12/2/1035099.png,0,0.966852784,95,11,571,487,476,476,twilight sparkle
1035270.png,https://derpicdn.net/img/view/2015/12/2/1035270.png,0,0.970636308,0,0,589,676,589,676,twilight sparkle
1035846.png,https://derpicdn.net/img/view/2015/12/3/1035846.png,0,0.982460797,280,0,1904,1576,1624,1576,twilight sparkle
1036427.png,https://derpicdn.net/img/view/2015/12/4/1036427.png,0,0.989720345,151,17,841,707,690,690,twilight sparkle
1036806.png,https://derpicdn.net/img/view/2015/12/4/1036806.png,0,0.954495907,536,545,6206,6373,5670,5828,twilight sparkle
1039755.png,https://derpicdn.net/img/view/2015/12/8/1039755.png,0,0.920238733,69,47,539,517,470,470,twilight sparkle
1040394.png,https://derpicdn.net/img/view/2015/12/9/1040394.png,0,0.992428184,418,53,958,593,540,540,twilight sparkle
1043126.png,https://derpicdn.net/img/view/2015/12/13/1043126.png,0,0.975558281,1346,1334,2540,2528,1194,1194,twilight sparkle
1043443.png,https://derpicdn.net/img/view/2015/12/13/1043443.png,0,0.999183476,950,702,1870,1622,920,920,twilight sparkle
1047366.png,https://derpicdn.net/img/view/2015/12/19/1047366.png,0,0.997499824,100,0,776,637,676,637,twilight sparkle
1049208.png,https://derpicdn.net/img/view/2015/12/20/1049208.png,0,0.994670391,434,108,1084,758,650,650,twilight sparkle
1049941.png,https://derpicdn.net/img/view/2015/12/21/1049941.png,0,0.992986083,146,18,822,694,676,676,twilight sparkle
1053025.png,https://derpicdn.net/img/view/2015/12/26/1053025.png,0,0.999498367,3066,0,5868,2772,2802,2772,twilight sparkle
1053068.png,https://derpicdn.net/img/view/2015/12/26/1053068.png,0,0.996963859,729,0,2155,1317,1426,1317,twilight sparkle
1053140.png,https://derpicdn.net/img/view/2015/12/26/1053140.png,0,0.997679651,163,25,1113,975,950,950,twilight sparkle
1054638.png,https://derpicdn.net/img/view/2015/12/28/1054638.png,0,0.994053423,1223,1380,2395,2552,1172,1172,twilight sparkle
1056060.png,https://derpicdn.net/img/view/2015/12/30/1056060.png,2,0.984296441,1260,497,1730,967,470,470,twilight sparkle
1057692.png,https://derpicdn.net/img/view/2016/1/2/1057692.png,0,0.98292619,0,0,353,351,353,351,twilight sparkle
1060359.png,https://derpicdn.net/img/view/2016/1/5/1060359.png,0,0.998412967,912,0,2142,1095,1230,1095,twilight sparkle
1060934.png,https://derpicdn.net/img/view/2016/1/6/1060934.png,0,0.985459685,0,0,308,303,308,303,twilight sparkle
1062854.png,https://derpicdn.net/img/view/2016/1/9/1062854.png,0,0.969403923,519,2,925,408,406,406,twilight sparkle
1065602.png,https://derpicdn.net/img/view/2016/1/13/1065602.png,0,0.989076555,22,58,346,382,324,324,twilight sparkle
1065878.png,https://derpicdn.net/img/view/2016/1/13/1065878.png,0,0.994693875,96,58,506,468,410,410,twilight sparkle
1067046.png,https://derpicdn.net/img/view/2016/1/15/1067046.png,0,0.984591722,0,0,382,382,382,382,twilight sparkle
1067421.jpg,https://derpicdn.net/img/view/2016/1/16/1067421.jpg,0,0.980872631,5,0,583,539,578,539,twilight sparkle
1067748.png,https://derpicdn.net/img/view/2016/1/16/1067748.png,0,0.976871967,667,248,1123,704,456,456,twilight sparkle
1068034.png,https://derpicdn.net/img/view/2016/1/17/1068034.png,0,0.986462235,446,0,1012,565,566,565,twilight sparkle
1070415.png,https://derpicdn.net/img/view/2016/1/20/1070415.png,0,0.978635907,182,0,1240,1042,1058,1042,twilight sparkle
1076322.png,https://derpicdn.net/img/view/2016/1/30/1076322.png,0,0.938080788,182,91,746,655,564,564,twilight sparkle
1078628.png,https://derpicdn.net/img/view/2016/2/2/1078628.png,0,0.986096978,1249,248,2825,1824,1576,1576,twilight sparkle
1079386.jpg,https://derpicdn.net/img/view/2016/2/3/1079386.jpg,0,0.997677088,25,0,289,246,264,246,twilight sparkle
1080983.png,https://derpicdn.net/img/view/2016/2/5/1080983.png,0,0.996620536,0,0,694,701,694,701,twilight sparkle
1081411.jpg,https://derpicdn.net/img/view/2016/2/6/1081411.jpg,0,0.956366122,106,36,1063,1004,957,968,twilight sparkle
1081659.png,https://derpicdn.net/img/view/2016/2/6/1081659.png,0,0.999524534,278,0,736,418,458,418,twilight sparkle
1084272.png,https://derpicdn.net/img/view/2016/2/10/1084272.png,0,0.997675598,51,0,699,637,648,637,twilight sparkle
1085701.png,https://derpicdn.net/img/view/2016/2/11/1085701.png,0,0.998361051,450,286,1560,1396,1110,1110,twilight sparkle
1087084.png,https://derpicdn.net/img/view/2016/2/13/1087084.png,0,0.964033306,0,48,545,622,545,574,twilight sparkle
1090612.png,https://derpicdn.net/img/view/2016/2/17/1090612.png,0,0.951904297,1652,102,5151,3782,3499,3680,twilight sparkle
1098120.png,https://derpicdn.net/img/view/2016/2/27/1098120.png,0,0.995435238,312,69,628,385,316,316,twilight sparkle
1099402.png,https://derpicdn.net/img/view/2016/2/29/1099402.png,0,0.986052573,279,0,569,289,290,289,twilight sparkle
1099755.png,https://derpicdn.net/img/view/2016/3/1/1099755.png,0,0.946748912,833,0,1846,1110,1013,1110,twilight sparkle
1100872.jpg,https://derpicdn.net/img/view/2016/3/3/1100872.jpg,0,0.950185537,63,51,605,593,542,542,twilight sparkle
1103889.jpg,https://derpicdn.net/img/view/2016/3/7/1103889.jpg,0,0.924387097,1007,229,1599,821,592,592,twilight sparkle
1105004.png,https://derpicdn.net/img/view/2016/3/8/1105004.png,0,0.954383135,241,137,2383,2279,2142,2142,twilight sparkle
1109252.png,https://derpicdn.net/img/view/2016/3/15/1109252.png,0,0.995174646,289,105,589,405,300,300,twilight sparkle
1109545.png,https://derpicdn.net/img/view/2016/3/15/1109545.png,0,0.949881375,1248,0,4199,3666,2951,3666,twilight sparkle
1111362.png,https://derpicdn.net/img/view/2016/3/18/1111362.png,0,0.996028244,3576,0,5858,2179,2282,2179,twilight sparkle
1111895.png,https://derpicdn.net/img/view/2016/3/18/1111895.png,0,0.985709131,949,493,1329,873,380,380,twilight sparkle
1112070.png,https://derpicdn.net/img/view/2016/3/19/1112070.png,0,0.992423236,0,0,262,264,262,264,twilight sparkle
111689.png,https://derpicdn.net/img/view/2012/10/2/111689.png,0,0.998479843,442,340,1014,912,572,572,twilight sparkle
1120540.jpg,https://derpicdn.net/img/view/2016/3/30/1120540.jpg,0,0.949415505,1457,60,2963,1566,1506,1506,twilight sparkle
1120620.png,https://derpicdn.net/img/view/2016/3/30/1120620.png,0,0.97482115,559,33,771,245,212,212,twilight sparkle
1122281.png,https://derpicdn.net/img/view/2016/4/2/1122281.png,0,0.987094879,0,0,182,167,182,167,twilight sparkle
1124251.jpg,https://derpicdn.net/img/view/2016/4/4/1124251.jpg,0,0.991384268,30,0,592,535,562,535,twilight sparkle
1126823.png,https://derpicdn.net/img/view/2016/4/7/1126823.png,0,0.97980237,306,24,1420,1138,1114,1114,twilight sparkle
1129589.png,https://derpicdn.net/img/view/2016/4/11/1129589.png,0,0.999489307,0,106,2409,2850,2409,2744,twilight sparkle
1132044.png,https://derpicdn.net/img/view/2016/4/14/1132044.png,0,0.994490623,1046,0,1978,904,932,904,twilight sparkle
1132560.jpg,https://derpicdn.net/img/view/2016/4/15/1132560.jpg,0,0.941278398,69,23,943,897,874,874,twilight sparkle
113378.png,https://derpicdn.net/img/view/2012/10/4/113378.png,0,0.941622972,234,123,614,503,380,380,twilight sparkle
1134105.png,https://derpicdn.net/img/view/2016/4/17/1134105.png,0,0.992936075,222,106,1092,976,870,870,twilight sparkle
1138280.png,https://derpicdn.net/img/view/2016/4/23/1138280.png,0,0.96946907,1459,0,6000,4790,4541,4790,twilight sparkle
1138738.png,https://derpicdn.net/img/view/2016/4/23/1138738.png,0,0.93874532,24,0,1472,1386,1448,1386,twilight sparkle
1141208.png,https://derpicdn.net/img/view/2016/4/27/1141208.png,0,0.973989606,303,25,751,473,448,448,twilight sparkle
1143180.png,https://derpicdn.net/img/view/2016/4/30/1143180.png,0,0.912686467,584,0,1536,910,952,910,twilight sparkle
1144.png,https://derpicdn.net/img/view/2012/1/22/1144.png,0,0.989111423,959,354,1591,986,632,632,twilight sparkle
1145191.png,https://derpicdn.net/img/view/2016/5/2/1145191.png,0,0.997348726,2414,0,5372,2903,2958,2903,twilight sparkle
1146582.png,https://derpicdn.net/img/view/2016/5/4/1146582.png,0,0.996483386,379,203,2785,2609,2406,2406,twilight sparkle
1149834.png,https://derpicdn.net/img/view/2016/5/9/1149834.png,0,0.925230324,1013,0,2929,1832,1916,1832,twilight sparkle
1150091.png,https://derpicdn.net/img/view/2016/5/9/1150091.png,0,0.996846974,552,0,970,387,418,387,twilight sparkle
1150091.png,https://derpicdn.net/img/view/2016/5/9/1150091.png,1,0.995903611,0,23,437,473,437,450,twilight sparkle
1150604.png,https://derpicdn.net/img/view/2016/5/10/1150604.png,0,0.984994829,0,0,5292,5623,5292,5623,twilight sparkle
1150792.png,https://derpicdn.net/img/view/2016/5/10/1150792.png,1,0.978659034,0,586,364,952,364,366,twilight sparkle
1151762.jpg,https://derpicdn.net/img/view/2016/5/11/1151762.jpg,0,0.99155122,380,0,1584,1204,1204,1204,twilight sparkle
1157344.png,https://derpicdn.net/img/view/2016/5/18/1157344.png,0,0.975086927,0,212,1994,2500,1994,2288,twilight sparkle
1158406.png,https://derpicdn.net/img/view/2016/5/20/1158406.png,0,0.957534432,721,0,1920,1189,1199,1189,twilight sparkle
1160043.png,https://derpicdn.net/img/view/2016/5/22/1160043.png,0,0.940052927,575,11,1043,479,468,468,twilight sparkle
1160609.png,https://derpicdn.net/img/view/2016/5/22/1160609.png,0,0.999376655,784,0,1776,823,992,823,twilight sparkle
1161976.jpg,https://derpicdn.net/img/view/2016/5/24/1161976.jpg,0,0.907697916,17,41,293,317,276,276,twilight sparkle
1163349.png,https://derpicdn.net/img/view/2016/5/26/1163349.png,0,0.977640569,285,5,1778,1645,1493,1640,twilight sparkle
1163397.jpg,https://derpicdn.net/img/view/2016/5/26/1163397.jpg,0,0.996234596,290,70,888,668,598,598,twilight sparkle
1167067.png,https://derpicdn.net/img/view/2016/5/31/1167067.png,0,0.976193607,2979,2898,5231,5150,2252,2252,twilight sparkle
1167092.png,https://derpicdn.net/img/view/2016/5/31/1167092.png,0,0.937252283,0,859,6055,7315,6055,6456,twilight sparkle
1169689.png,https://derpicdn.net/img/view/2016/6/4/1169689.png,0,0.994019508,42,8,470,436,428,428,twilight sparkle
1170389.png,https://derpicdn.net/img/view/2016/6/4/1170389.png,0,0.981476068,31,61,357,383,326,322,twilight sparkle
1172844.png,https://derpicdn.net/img/view/2016/6/7/1172844.png,0,0.978782535,53,0,627,566,574,566,twilight sparkle
1172848.png,https://derpicdn.net/img/view/2016/6/7/1172848.png,0,0.980129957,212,0,784,528,572,528,twilight sparkle
1177378.png,https://derpicdn.net/img/view/2016/6/13/1177378.png,0,0.983845234,166,117,1822,1773,1656,1656,twilight sparkle
11780.png,https://derpicdn.net/img/view/2012/6/20/11780.png,0,0.987773836,2470,0,4730,2173,2260,2173,twilight sparkle
1186204.png,https://derpicdn.net/img/view/2016/6/25/1186204.png,0,0.956894815,1078,113,1638,673,560,560,twilight sparkle
1191714.png,https://derpicdn.net/img/view/2016/7/2/1191714.png,0,0.984905541,132,57,936,861,804,804,twilight sparkle
1192202.png,https://derpicdn.net/img/view/2016/7/3/1192202.png,0,0.983522654,720,0,1024,274,304,274,twilight sparkle
1194650.png,https://derpicdn.net/img/view/2016/7/6/1194650.png,0,0.998799443,2234,676,3316,1758,1082,1082,twilight sparkle
1195035.png,https://derpicdn.net/img/view/2016/7/6/1195035.png,0,0.91773814,3530,188,7000,3678,3470,3490,twilight sparkle
1195279.png,https://derpicdn.net/img/view/2016/7/7/1195279.png,0,0.999073267,375,66,863,554,488,488,twilight sparkle
1195913.png,https://derpicdn.net/img/view/2016/7/8/1195913.png,0,0.966726601,459,9,3361,2997,2902,2988,twilight sparkle
1196473.png,https://derpicdn.net/img/view/2016/7/8/1196473.png,0,0.969040215,685,419,2480,2441,1795,2022,twilight sparkle
1198479.png,https://derpicdn.net/img/view/2016/7/11/1198479.png,0,0.969378889,355,111,919,675,564,564,twilight sparkle
1199362.png,https://derpicdn.net/img/view/2016/7/12/1199362.png,0,0.98896867,429,0,1191,683,762,683,twilight sparkle
1205470.png,https://derpicdn.net/img/view/2016/7/20/1205470.png,0,0.989813805,180,52,434,306,254,254,twilight sparkle
1206038.png,https://derpicdn.net/img/view/2016/7/21/1206038.png,0,0.960726142,0,0,2697,3021,2697,3021,twilight sparkle
1209218.png,https://derpicdn.net/img/view/2016/7/25/1209218.png,0,0.990491211,24,0,608,543,584,543,twilight sparkle
1211179.png,https://derpicdn.net/img/view/2016/7/28/1211179.png,0,0.997631431,956,0,2000,1046,1044,1046,twilight sparkle
1221974.png,https://derpicdn.net/img/view/2016/8/10/1221974.png,0,0.91331327,1279,194,3753,2668,2474,2474,twilight sparkle
1222538.png,https://derpicdn.net/img/view/2016/8/11/1222538.png,0,0.983718753,0,17,974,1091,974,1074,twilight sparkle
1223733.png,https://derpicdn.net/img/view/2016/8/13/1223733.png,0,0.974277735,0,0,630,615,630,615,twilight sparkle
1224176.png,https://derpicdn.net/img/view/2016/8/13/1224176.png,0,0.995075285,181,56,1021,896,840,840,twilight sparkle
1226243.png,https://derpicdn.net/img/view/2016/8/16/1226243.png,0,0.961548209,61,0,695,616,634,616,twilight sparkle
1226837.png,https://derpicdn.net/img/view/2016/8/16/1226837.png,0,0.965496242,328,159,680,511,352,352,twilight sparkle
1228515.png,https://derpicdn.net/img/view/2016/8/19/1228515.png,0,0.972497463,1,0,441,430,440,430,twilight sparkle
1229752.png,https://derpicdn.net/img/view/2016/8/20/1229752.png,0,0.979496062,42,0,498,459,456,459,twilight sparkle
1230274.png,https://derpicdn.net/img/view/2016/8/21/1230274.png,0,0.960783064,0,915,5209,6180,5209,5265,twilight sparkle
1233313.png,https://derpicdn.net/img/view/2016/8/25/1233313.png,0,0.987238109,0,0,635,651,635,651,twilight sparkle
1235866.png,https://derpicdn.net/img/view/2016/8/28/1235866.png,0,0.988281906,0,0,913,906,913,906,twilight sparkle
1236001.png,https://derpicdn.net/img/view/2016/8/28/1236001.png,0,0.910907984,923,34,1805,916,882,882,twilight sparkle
123680.png,https://derpicdn.net/img/view/2012/10/15/123680.png,0,0.991124034,0,0,228,236,228,236,twilight sparkle
1239227.png,https://derpicdn.net/img/view/2016/9/1/1239227.png,0,0.985422134,0,63,1442,1741,1442,1678,twilight sparkle
1242866.png,https://derpicdn.net/img/view/2016/9/6/1242866.png,0,0.98947084,179,0,819,633,640,633,twilight sparkle
1243218.png,https://derpicdn.net/img/view/2016/9/6/1243218.png,0,0.947954297,0,0,8763,11507,8763,11507,twilight sparkle
1244811.png,https://derpicdn.net/img/view/2016/9/8/1244811.png,0,0.996397078,493,0,3095,2584,2602,2584,twilight sparkle
1246030.png,https://derpicdn.net/img/view/2016/9/10/1246030.png,0,0.997406602,139,15,439,315,300,300,twilight sparkle
1249439.png,https://derpicdn.net/img/view/2016/9/14/1249439.png,0,0.985449135,731,24,1155,448,424,424,twilight sparkle
1249439.png,https://derpicdn.net/img/view/2016/9/14/1249439.png,1,0.979186952,0,176,386,578,386,402,twilight sparkle
1252849.png,https://derpicdn.net/img/view/2016/9/19/1252849.png,0,0.937176883,417,0,787,304,370,304,twilight sparkle
1255808.png,https://derpicdn.net/img/view/2016/9/22/1255808.png,0,0.998761356,49,36,615,602,566,566,twilight sparkle
1257210.png,https://derpicdn.net/img/view/2016/9/24/1257210.png,0,0.975004315,0,0,673,628,673,628,twilight sparkle
1257413.png,https://derpicdn.net/img/view/2016/9/24/1257413.png,0,0.928790569,424,278,6006,5860,5582,5582,twilight sparkle
1258078.png,https://derpicdn.net/img/view/2016/9/25/1258078.png,0,0.993840218,100,20,1332,1252,1232,1232,twilight sparkle
1262098.png,https://derpicdn.net/img/view/2016/10/1/1262098.png,0,0.998183489,1414,11,2260,857,846,846,twilight sparkle
1264293.png,https://derpicdn.net/img/view/2016/10/3/1264293.png,0,0.977835596,994,173,1992,1171,998,998,twilight sparkle
1264501.png,https://derpicdn.net/img/view/2016/10/4/1264501.png,1,0.991121888,1081,2001,2217,3137,1136,1136,twilight sparkle
1264501.png,https://derpicdn.net/img/view/2016/10/4/1264501.png,2,0.962923765,247,2222,1115,3090,868,868,twilight sparkle
1265324.png,https://derpicdn.net/img/view/2016/10/5/1265324.png,0,0.98551482,1130,0,2516,1464,1386,1464,twilight sparkle
1265640.png,https://derpicdn.net/img/view/2016/10/5/1265640.png,0,0.974537492,0,6,614,698,614,692,twilight sparkle
1266174.png,https://derpicdn.net/img/view/2016/10/6/1266174.png,0,0.991833568,0,90,1469,1576,1469,1486,twilight sparkle
1267176.png,https://derpicdn.net/img/view/2016/10/7/1267176.png,0,0.986239135,400,312,1642,1554,1242,1242,twilight sparkle
1275726.png,https://derpicdn.net/img/view/2016/10/18/1275726.png,0,0.998512805,2559,0,5247,2566,2688,2566,twilight sparkle
1277377.png,https://derpicdn.net/img/view/2016/10/20/1277377.png,0,0.968219757,708,118,3376,2786,2668,2668,twilight sparkle
1277488.png,https://derpicdn.net/img/view/2016/10/20/1277488.png,0,0.976060867,93,509,3369,3825,3276,3316,twilight sparkle
1278112.png,https://derpicdn.net/img/view/2016/10/21/1278112.png,0,0.974833131,1654,106,3916,2418,2262,2312,twilight sparkle
1281419.png,https://derpicdn.net/img/view/2016/10/25/1281419.png,0,0.984187007,0,297,160,471,160,174,twilight sparkle
1282038.png,https://derpicdn.net/img/view/2016/10/26/1282038.png,0,0.925348461,208,52,740,584,532,532,twilight sparkle
1285996.png,https://derpicdn.net/img/view/2016/11/1/1285996.png,0,0.991317749,137,0,403,257,266,257,twilight sparkle
1288472.png,https://derpicdn.net/img/view/2016/11/4/1288472.png,0,0.988588572,228,0,3050,2695,2822,2695,twilight sparkle
1288923.png,https://derpicdn.net/img/view/2016/11/5/1288923.png,0,0.987947643,41,0,389,337,348,337,twilight sparkle
1289665.png,https://derpicdn.net/img/view/2016/11/6/1289665.png,0,0.961222172,221,667,3459,4000,3238,3333,twilight sparkle
1290935.png,https://derpicdn.net/img/view/2016/11/7/1290935.png,0,0.957404673,366,777,1122,1533,756,756,twilight sparkle
1293559.png,https://derpicdn.net/img/view/2016/11/11/1293559.png,0,0.940427482,152,43,826,717,674,674,twilight sparkle
1295458.png,https://derpicdn.net/img/view/2016/11/14/1295458.png,0,0.998661458,777,9,1667,981,890,972,twilight sparkle
129952.png,https://derpicdn.net/img/view/2012/10/22/129952.png,0,0.976025462,249,13,415,179,166,166,twilight sparkle
1301818.png,https://derpicdn.net/img/view/2016/11/23/1301818.png,0,0.9970963,540,0,3536,2857,2996,2857,twilight sparkle
1302569.png,https://derpicdn.net/img/view/2016/11/24/1302569.png,0,0.997337878,1008,30,1658,680,650,650,twilight sparkle
1303001.png,https://derpicdn.net/img/view/2016/11/25/1303001.png,0,0.980093122,50,31,480,461,430,430,twilight sparkle
1303027.png,https://derpicdn.net/img/view/2016/11/25/1303027.png,0,0.932355225,178,0,1236,851,1058,851,twilight sparkle
1303304.png,https://derpicdn.net/img/view/2016/11/25/1303304.png,0,0.998230577,138,199,706,767,568,568,twilight sparkle
1303451.png,https://derpicdn.net/img/view/2016/11/25/1303451.png,0,0.918254614,0,0,5081,5123,5081,5123,twilight sparkle
1304341.png,https://derpicdn.net/img/view/2016/11/27/1304341.png,0,0.993899941,2008,287,3398,1677,1390,1390,twilight sparkle
1306142.png,https://derpicdn.net/img/view/2016/11/29/1306142.png,0,0.967077136,144,32,748,636,604,604,twilight sparkle
1306272.png,https://derpicdn.net/img/view/2016/11/29/1306272.png,0,0.980881631,0,0,612,595,612,595,twilight sparkle
1307311.png,https://derpicdn.net/img/view/2016/12/1/1307311.png,0,0.989665627,288,35,766,513,478,478,twilight sparkle
1308733.png,https://derpicdn.net/img/view/2016/12/3/1308733.png,0,0.973049998,452,0,798,338,346,338,twilight sparkle
1310990.png,https://derpicdn.net/img/view/2016/12/6/1310990.png,0,0.974660754,0,18,800,936,800,918,twilight sparkle
1312145.png,https://derpicdn.net/img/view/2016/12/7/1312145.png,0,0.913726807,208,20,1112,924,904,904,twilight sparkle
1315531.png,https://derpicdn.net/img/view/2016/12/12/1315531.png,0,0.996032357,187,0,485,287,298,287,twilight sparkle
1321943.png,https://derpicdn.net/img/view/2016/12/21/1321943.png,0,0.992398083,110,123,914,927,804,804,twilight sparkle
1322044.png,https://derpicdn.net/img/view/2016/12/21/1322044.png,0,0.980609357,29,0,607,550,578,550,twilight sparkle
1322183.png,https://derpicdn.net/img/view/2016/12/21/1322183.png,0,0.926507354,133,9,393,269,260,260,twilight sparkle
1326672.png,https://derpicdn.net/img/view/2016/12/28/1326672.png,0,0.981804729,0,22,1300,1366,1300,1344,twilight sparkle
1329092.png,https://derpicdn.net/img/view/2016/12/31/1329092.png,0,0.973501503,568,126,886,444,318,318,twilight sparkle
1332049.png,https://derpicdn.net/img/view/2017/1/4/1332049.png,0,0.980669796,77,0,675,590,598,590,twilight sparkle
1333205.png,https://derpicdn.net/img/view/2017/1/6/1333205.png,0,0.966718554,0,274,10052,11476,10052,11202,twilight sparkle
1333483.png,https://derpicdn.net/img/view/2017/1/6/1333483.png,0,0.904348791,551,287,849,585,298,298,twilight sparkle
1338168.png,https://derpicdn.net/img/view/2017/1/12/1338168.png,0,0.994659603,482,0,1400,806,918,806,twilight sparkle
1339229.png,https://derpicdn.net/img/view/2017/1/14/1339229.png,0,0.99468106,6,0,682,645,676,645,twilight sparkle
1339976.png,https://derpicdn.net/img/view/2017/1/15/1339976.png,0,0.983487368,0,72,2786,2800,2786,2728,twilight sparkle
1345589.png,https://derpicdn.net/img/view/2017/1/22/1345589.png,0,0.985485673,150,0,1530,1283,1380,1283,twilight sparkle
1346812.png,https://derpicdn.net/img/view/2017/1/24/1346812.png,0,0.973856807,431,19,613,201,182,182,twilight sparkle
1347608.png,https://derpicdn.net/img/view/2017/1/25/1347608.png,0,0.999195695,89,82,569,562,480,480,twilight sparkle
1348827.png,https://derpicdn.net/img/view/2017/1/27/1348827.png,0,0.960524321,0,7,469,513,469,506,twilight sparkle
1348842.png,https://derpicdn.net/img/view/2017/1/27/1348842.png,0,0.994700253,446,0,974,521,528,521,twilight sparkle
1350314.png,https://derpicdn.net/img/view/2017/1/29/1350314.png,0,0.996942341,2282,0,4900,2522,2618,2522,twilight sparkle
1350809.png,https://derpicdn.net/img/view/2017/1/29/1350809.png,0,0.99788636,85,0,421,334,336,334,twilight sparkle
1354252.png,https://derpicdn.net/img/view/2017/2/3/1354252.png,0,0.980209231,102,5,654,557,552,552,twilight sparkle
1355393.png,https://derpicdn.net/img/view/2017/2/5/1355393.png,0,0.996656299,97,0,1391,1286,1294,1286,twilight sparkle
1356883.png,https://derpicdn.net/img/view/2017/2/6/1356883.png,0,0.982567012,0,0,909,1175,909,1175,twilight sparkle
1357757.png,https://derpicdn.net/img/view/2017/2/8/1357757.png,1,0.990497947,373,0,683,266,310,266,twilight sparkle
1366733.png,https://derpicdn.net/img/view/2017/2/18/1366733.png,0,0.997968853,729,0,2909,2089,2180,2089,twilight sparkle
1367796.png,https://derpicdn.net/img/view/2017/2/19/1367796.png,0,0.999160945,608,0,2064,1427,1456,1427,twilight sparkle
1369001.png,https://derpicdn.net/img/view/2017/2/21/1369001.png,0,0.992797256,4394,0,5816,1378,1422,1378,twilight sparkle
1371293.png,https://derpicdn.net/img/view/2017/2/23/1371293.png,0,0.901118815,331,167,531,367,200,200,twilight sparkle
1375771.png,https://derpicdn.net/img/view/2017/2/28/1375771.png,0,0.988600969,656,39,3100,2599,2444,2560,twilight sparkle
1377466.png,https://derpicdn.net/img/view/2017/3/2/1377466.png,0,0.992083788,21,150,353,482,332,332,twilight sparkle
1377466.png,https://derpicdn.net/img/view/2017/3/2/1377466.png,1,0.975106657,555,68,1037,550,482,482,twilight sparkle
1384274.png,https://derpicdn.net/img/view/2017/3/11/1384274.png,0,0.987940073,47,0,2487,2330,2440,2330,twilight sparkle
1389617.png,https://derpicdn.net/img/view/2017/3/17/1389617.png,0,0.956832111,326,0,1000,688,674,688,twilight sparkle
1390257.png,https://derpicdn.net/img/view/2017/3/18/1390257.png,0,0.934434652,214,0,700,483,486,483,twilight sparkle
1391127.png,https://derpicdn.net/img/view/2017/3/19/1391127.png,0,0.995391965,126,23,564,461,438,438,twilight sparkle
1392018.png,https://derpicdn.net/img/view/2017/3/20/1392018.png,0,0.998789668,261,19,627,385,366,366,twilight sparkle
1395719.png,https://derpicdn.net/img/view/2017/3/25/1395719.png,0,0.99851501,65,0,575,507,510,507,twilight sparkle
1395780.png,https://derpicdn.net/img/view/2017/3/25/1395780.png,0,0.994522274,77,0,699,599,622,599,twilight sparkle
1397405.png,https://derpicdn.net/img/view/2017/3/27/1397405.png,1,0.985318482,1814,70,2540,796,726,726,twilight sparkle
1397509.png,https://derpicdn.net/img/view/2017/3/27/1397509.png,0,0.975814939,169,19,575,425,406,406,twilight sparkle
1399445.png,https://derpicdn.net/img/view/2017/3/30/1399445.png,0,0.973394692,0,291,3519,3906,3519,3615,twilight sparkle
1399495.png,https://derpicdn.net/img/view/2017/3/30/1399495.png,0,0.988141596,187,0,1031,841,844,841,twilight sparkle
1403428.png,https://derpicdn.net/img/view/2017/4/3/1403428.png,0,0.998682737,2720,0,6174,3414,3454,3414,twilight sparkle
1404589.png,https://derpicdn.net/img/view/2017/4/5/1404589.png,0,0.982918441,2875,0,6555,3513,3680,3513,twilight sparkle
1407492.png,https://derpicdn.net/img/view/2017/4/9/1407492.png,0,0.992294669,273,387,1237,1351,964,964,twilight sparkle
1407492.png,https://derpicdn.net/img/view/2017/4/9/1407492.png,1,0.983100414,1924,67,2720,863,796,796,twilight sparkle
1409025.png,https://derpicdn.net/img/view/2017/4/11/1409025.png,0,0.997912467,700,0,2890,1971,2190,1971,twilight sparkle
1410555.png,https://derpicdn.net/img/view/2017/4/13/1410555.png,0,0.933508396,181,53,815,687,634,634,twilight sparkle
1411667.png,https://derpicdn.net/img/view/2017/4/15/1411667.png,0,0.995611072,1712,0,4972,3043,3260,3043,twilight sparkle
1414245.png,https://derpicdn.net/img/view/2017/4/17/1414245.png,0,0.991737306,382,660,3508,3786,3126,3126,twilight sparkle
1416256.png,https://derpicdn.net/img/view/2017/4/19/1416256.png,0,0.969097137,128,0,1130,859,1002,859,twilight sparkle
1417065.png,https://derpicdn.net/img/view/2017/4/20/1417065.png,0,0.979876518,46,15,1112,987,1066,972,twilight sparkle
1419781.png,https://derpicdn.net/img/view/2017/4/23/1419781.png,0,0.994279563,0,0,1375,1347,1375,1347,twilight sparkle
1429347.png,https://derpicdn.net/img/view/2017/5/5/1429347.png,0,0.99808377,175,0,481,299,306,299,twilight sparkle
1429764.png,https://derpicdn.net/img/view/2017/5/6/1429764.png,0,0.993011892,443,19,1339,915,896,896,twilight sparkle
1430213.png,https://derpicdn.net/img/view/2017/5/6/1430213.png,0,0.954778671,0,180,1213,1446,1213,1266,twilight sparkle
1434492.png,https://derpicdn.net/img/view/2017/5/12/1434492.png,0,0.910452187,145,24,613,492,468,468,twilight sparkle
1435757.png,https://derpicdn.net/img/view/2017/5/13/1435757.png,0,0.999745786,95,94,1069,1068,974,974,twilight sparkle
1436089.png,https://derpicdn.net/img/view/2017/5/14/1436089.png,0,0.998242438,1519,360,6431,5272,4912,4912,twilight sparkle
1437661.png,https://derpicdn.net/img/view/2017/5/15/1437661.png,0,0.982815206,60,0,902,824,842,824,twilight sparkle
1441191.png,https://derpicdn.net/img/view/2017/5/20/1441191.png,0,0.924218237,294,0,1844,1080,1550,1080,twilight sparkle
1451880.png,https://derpicdn.net/img/view/2017/6/2/1451880.png,0,0.99235338,0,25,825,869,825,844,twilight sparkle
1456400.png,https://derpicdn.net/img/view/2017/6/7/1456400.png,0,0.994455099,1118,20,5676,4578,4558,4558,twilight sparkle
1463610.png,https://derpicdn.net/img/view/2017/6/17/1463610.png,0,0.994428098,135,125,2021,2011,1886,1886,twilight sparkle
1468672.png,https://derpicdn.net/img/view/2017/6/22/1468672.png,0,0.974303126,16,32,698,714,682,682,twilight sparkle
1470329.png,https://derpicdn.net/img/view/2017/6/24/1470329.png,0,0.973177552,162,26,1702,1566,1540,1540,twilight sparkle
1471699.png,https://derpicdn.net/img/view/2017/6/25/1471699.png,0,0.997444928,280,211,1030,961,750,750,twilight sparkle
1473885.png,https://derpicdn.net/img/view/2017/6/29/1473885.png,0,0.988713026,423,347,709,633,286,286,twilight sparkle
1473885.png,https://derpicdn.net/img/view/2017/6/29/1473885.png,1,0.909981251,66,538,248,720,182,182,twilight sparkle
1473885.png,https://derpicdn.net/img/view/2017/6/29/1473885.png,2,0.908227205,1669,386,1920,672,251,286,twilight sparkle
1475946.png,https://derpicdn.net/img/view/2017/7/1/1475946.png,0,0.919483066,424,0,1074,614,650,614,twilight sparkle
1477047.png,https://derpicdn.net/img/view/2017/7/2/1477047.png,0,0.998431981,33,247,429,643,396,396,twilight sparkle
1477047.png,https://derpicdn.net/img/view/2017/7/2/1477047.png,1,0.997567952,573,159,899,485,326,326,twilight sparkle
1478007.png,https://derpicdn.net/img/view/2017/7/4/1478007.png,0,0.972346187,58,0,812,572,754,572,twilight sparkle
1480196.png,https://derpicdn.net/img/view/2017/7/6/1480196.png,0,0.914037764,2428,130,4562,2264,2134,2134,twilight sparkle
1485690.png,https://derpicdn.net/img/view/2017/7/13/1485690.png,0,0.987936735,1227,438,1883,1094,656,656,twilight sparkle
1487426.png,https://derpicdn.net/img/view/2017/7/16/1487426.png,0,0.997029901,4715,2432,6655,4372,1940,1940,twilight sparkle
1487426.png,https://derpicdn.net/img/view/2017/7/16/1487426.png,1,0.990384042,0,1327,2102,3459,2102,2132,twilight sparkle
1487426.png,https://derpicdn.net/img/view/2017/7/16/1487426.png,2,0.958103478,2830,1277,4478,2925,1648,1648,twilight sparkle
1492834.png,https://derpicdn.net/img/view/2017/7/23/1492834.png,0,0.992465258,69,27,467,425,398,398,twilight sparkle
1494548.png,https://derpicdn.net/img/view/2017/7/25/1494548.png,0,0.979347646,63,37,445,476,382,439,twilight sparkle
1496150.png,https://derpicdn.net/img/view/2017/7/27/1496150.png,0,0.997201741,4731,0,10819,5826,6088,5826,twilight sparkle
1501473.png,https://derpicdn.net/img/view/2017/8/3/1501473.png,0,0.997291744,261,4,989,732,728,728,twilight sparkle
1501669.png,https://derpicdn.net/img/view/2017/8/3/1501669.png,0,0.975331366,0,0,208,228,208,228,twilight sparkle
1502608.png,https://derpicdn.net/img/view/2017/8/4/1502608.png,0,0.990840137,1056,0,1986,912,930,912,twilight sparkle
150589.jpg,https://derpicdn.net/img/view/2012/11/13/150589.jpg,0,0.975487888,81,65,1683,1667,1602,1602,twilight sparkle
1505918.png,https://derpicdn.net/img/view/2017/8/8/1505918.png,0,0.984013021,18,40,454,476,436,436,twilight sparkle
1507135.png,https://derpicdn.net/img/view/2017/8/10/1507135.png,0,0.999324501,117,0,455,329,338,329,twilight sparkle
1508188.png,https://derpicdn.net/img/view/2017/8/11/1508188.png,0,0.998467565,837,182,1909,1254,1072,1072,twilight sparkle
1509537.png,https://derpicdn.net/img/view/2017/8/13/1509537.png,0,0.994804382,532,0,1880,1111,1348,1111,twilight sparkle
1510376.png,https://derpicdn.net/img/view/2017/8/14/1510376.png,0,0.96743983,0,222,3062,3284,3062,3062,twilight sparkle
1511908.png,https://derpicdn.net/img/view/2017/8/16/1511908.png,0,0.960859537,1488,55,3674,2241,2186,2186,twilight sparkle
1512417.png,https://derpicdn.net/img/view/2017/8/16/1512417.png,0,0.995060861,2174,42,4452,2388,2278,2346,twilight sparkle
1512768.png,https://derpicdn.net/img/view/2017/8/17/1512768.png,0,0.981530845,0,0,926,893,926,893,twilight sparkle
1515411.png,https://derpicdn.net/img/view/2017/8/20/1515411.png,0,0.999344528,217,494,559,836,342,342,twilight sparkle
1516175.png,https://derpicdn.net/img/view/2017/8/21/1516175.png,0,0.997466743,901,67,2550,1755,1649,1688,twilight sparkle
1517289.png,https://derpicdn.net/img/view/2017/8/22/1517289.png,0,0.99777323,1066,0,3290,2207,2224,2207,twilight sparkle
1518566.png,https://derpicdn.net/img/view/2017/8/24/1518566.png,0,0.980688572,344,76,848,580,504,504,twilight sparkle
1518985.png,https://derpicdn.net/img/view/2017/8/24/1518985.png,0,0.976240098,583,0,3303,2664,2720,2664,twilight sparkle
1519234.png,https://derpicdn.net/img/view/2017/8/25/1519234.png,0,0.980809212,24,0,1158,1107,1134,1107,twilight sparkle
1523586.png,https://derpicdn.net/img/view/2017/8/30/1523586.png,0,0.955822408,649,0,1587,849,938,849,twilight sparkle
1524158.png,https://derpicdn.net/img/view/2017/8/31/1524158.png,0,0.996729851,1169,360,2591,1782,1422,1422,twilight sparkle
1524456.png,https://derpicdn.net/img/view/2017/8/31/1524456.png,0,0.996704519,1073,160,2565,1652,1492,1492,twilight sparkle
1525409.png,https://derpicdn.net/img/view/2017/9/1/1525409.png,0,0.957396269,0,0,1674,1713,1674,1713,twilight sparkle
1530582.png,https://derpicdn.net/img/view/2017/9/8/1530582.png,0,0.993049502,302,40,642,380,340,340,twilight sparkle
1535895.png,https://derpicdn.net/img/view/2017/9/15/1535895.png,0,0.943384588,137,72,419,354,282,282,twilight sparkle
1538787.png,https://derpicdn.net/img/view/2017/9/18/1538787.png,0,0.917244494,790,0,7752,6484,6962,6484,twilight sparkle
1538988.png,https://derpicdn.net/img/view/2017/9/18/1538988.png,0,0.972144544,429,28,973,572,544,544,twilight sparkle
1539857.png,https://derpicdn.net/img/view/2017/9/20/1539857.png,0,0.934077144,430,46,1594,1210,1164,1164,twilight sparkle
1540755.png,https://derpicdn.net/img/view/2017/9/21/1540755.png,0,0.949645936,1005,891,1869,1755,864,864,twilight sparkle
1542845.png,https://derpicdn.net/img/view/2017/9/23/1542845.png,0,0.977830291,0,0,374,423,374,423,twilight sparkle
1544212.png,https://derpicdn.net/img/view/2017/9/25/1544212.png,0,0.957048476,0,279,2524,2897,2524,2618,twilight sparkle
1544765.png,https://derpicdn.net/img/view/2017/9/25/1544765.png,0,0.990164816,369,18,3111,2760,2742,2742,twilight sparkle
1545092.png,https://derpicdn.net/img/view/2017/9/26/1545092.png,0,0.942665458,733,19,1175,461,442,442,twilight sparkle
1546509.png,https://derpicdn.net/img/view/2017/9/28/1546509.png,0,0.966504872,488,0,1084,570,596,570,twilight sparkle
1547084.png,https://derpicdn.net/img/view/2017/9/28/1547084.png,0,0.995196462,802,357,3328,2883,2526,2526,twilight sparkle
1550269.png,https://derpicdn.net/img/view/2017/10/2/1550269.png,0,0.989994049,1858,0,3492,1627,1634,1627,twilight sparkle
1552156.png,https://derpicdn.net/img/view/2017/10/4/1552156.png,0,0.979437709,170,0,798,606,628,606,twilight sparkle
1554296.png,https://derpicdn.net/img/view/2017/10/7/1554296.png,0,0.998856962,586,0,1418,710,832,710,twilight sparkle
1555552.png,https://derpicdn.net/img/view/2017/10/8/1555552.png,0,0.989964664,212,0,796,572,584,572,twilight sparkle
1555630.png,https://derpicdn.net/img/view/2017/10/8/1555630.png,0,0.975619912,0,1058,3103,4130,3103,3072,twilight sparkle
1557973.png,https://derpicdn.net/img/view/2017/10/11/1557973.png,0,0.994641304,778,200,1220,642,442,442,twilight sparkle
1558322.png,https://derpicdn.net/img/view/2017/10/11/1558322.png,0,0.986902356,0,0,586,579,586,579,twilight sparkle
1560478.png,https://derpicdn.net/img/view/2017/10/14/1560478.png,0,0.983589888,458,49,812,403,354,354,twilight sparkle
1561253.png,https://derpicdn.net/img/view/2017/10/14/1561253.png,0,0.924819052,0,7,807,945,807,938,twilight sparkle
1562143.png,https://derpicdn.net/img/view/2017/10/15/1562143.png,0,0.98382777,241,44,587,390,346,346,twilight sparkle
156463.png,https://derpicdn.net/img/view/2012/11/18/156463.png,0,0.996037662,213,23,509,319,296,296,twilight sparkle
1567818.png,https://derpicdn.net/img/view/2017/10/22/1567818.png,0,0.991694152,15,0,1117,1057,1102,1057,twilight sparkle
1567859.png,https://derpicdn.net/img/view/2017/10/22/1567859.png,0,0.970507503,2160,1367,3508,2715,1348,1348,twilight sparkle
1568568.png,https://derpicdn.net/img/view/2017/10/23/1568568.png,0,0.964404523,202,62,1694,1554,1492,1492,twilight sparkle
1570976.png,https://derpicdn.net/img/view/2017/10/27/1570976.png,0,0.941023946,335,51,1269,985,934,934,twilight sparkle
1571968.png,https://derpicdn.net/img/view/2017/10/28/1571968.png,0,0.936921418,0,0,1416,1455,1416,1455,twilight sparkle
1574511.png,https://derpicdn.net/img/view/2017/10/31/1574511.png,0,0.988463044,163,92,405,334,242,242,twilight sparkle
1577256.png,https://derpicdn.net/img/view/2017/11/3/1577256.png,0,0.987837613,7,0,687,414,680,414,twilight sparkle
1577516.png,https://derpicdn.net/img/view/2017/11/4/1577516.png,0,0.985393524,153,74,497,418,344,344,twilight sparkle
1578534.png,https://derpicdn.net/img/view/2017/11/5/1578534.png,0,0.999693155,596,273,1350,1027,754,754,twilight sparkle
1589275.png,https://derpicdn.net/img/view/2017/11/18/1589275.png,0,0.980435371,94,20,610,536,516,516,twilight sparkle
1589536.png,https://derpicdn.net/img/view/2017/11/19/1589536.png,0,0.924945354,822,280,1618,1076,796,796,twilight sparkle
1589794.png,https://derpicdn.net/img/view/2017/11/19/1589794.png,0,0.974816084,62,0,1000,993,938,993,twilight sparkle
1589799.png,https://derpicdn.net/img/view/2017/11/19/1589799.png,0,0.936074138,38,7,694,663,656,656,twilight sparkle
1590111.png,https://derpicdn.net/img/view/2017/11/19/1590111.png,0,0.968941987,141,0,945,719,804,719,twilight sparkle
1604257.png,https://derpicdn.net/img/view/2017/12/10/1604257.png,0,0.920481861,0,39,451,565,451,526,twilight sparkle
1604404.png,https://derpicdn.net/img/view/2017/12/10/1604404.png,0,0.97592628,0,0,829,826,829,826,twilight sparkle
1605129.png,https://derpicdn.net/img/view/2017/12/11/1605129.png,0,0.900384307,848,121,3974,3247,3126,3126,twilight sparkle
1605484.png,https://derpicdn.net/img/view/2017/12/11/1605484.png,0,0.998628259,240,11,744,515,504,504,twilight sparkle
1605882.png,https://derpicdn.net/img/view/2017/12/12/1605882.png,0,0.99768877,100,695,1730,2325,1630,1630,twilight sparkle
1619325.png,https://derpicdn.net/img/view/2017/12/29/1619325.png,0,0.98758471,243,575,639,971,396,396,twilight sparkle
1619534.png,https://derpicdn.net/img/view/2017/12/30/1619534.png,0,0.995711088,202,11,972,781,770,770,twilight sparkle
1619973.png,https://derpicdn.net/img/view/2017/12/30/1619973.png,0,0.96733582,43,4,787,748,744,744,twilight sparkle
1620083.png,https://derpicdn.net/img/view/2017/12/30/1620083.png,0,0.997489929,299,0,1063,744,764,744,twilight sparkle
1620107.png,https://derpicdn.net/img/view/2017/12/30/1620107.png,0,0.938615799,409,674,739,1004,330,330,twilight sparkle
1622158.png,https://derpicdn.net/img/view/2018/1/2/1622158.png,0,0.959316373,153,122,4972,5630,4819,5508,twilight sparkle
1626443.png,https://derpicdn.net/img/view/2018/1/7/1626443.png,0,0.929748535,315,0,1819,1080,1504,1080,twilight sparkle
1631554.png,https://derpicdn.net/img/view/2018/1/13/1631554.png,0,0.973916411,820,0,1900,1080,1080,1080,twilight sparkle
1632296.png,https://derpicdn.net/img/view/2018/1/14/1632296.png,0,0.998586535,116,0,618,495,502,495,twilight sparkle
1632774.png,https://derpicdn.net/img/view/2018/1/15/1632774.png,0,0.98373729,345,0,1853,1504,1508,1504,twilight sparkle
1633601.png,https://derpicdn.net/img/view/2018/1/16/1633601.png,0,0.954507768,64,0,536,432,472,432,twilight sparkle
1645440.png,https://derpicdn.net/img/view/2018/1/31/1645440.png,0,0.993192494,905,278,1777,1150,872,872,twilight sparkle
1647489.png,https://derpicdn.net/img/view/2018/2/3/1647489.png,0,0.997714698,0,56,443,534,443,478,twilight sparkle
1650147.png,https://derpicdn.net/img/view/2018/2/7/1650147.png,0,0.935286701,100,169,524,593,424,424,twilight sparkle
1651510.png,https://derpicdn.net/img/view/2018/2/9/1651510.png,0,0.908379018,341,101,763,523,422,422,twilight sparkle
1655132.png,https://derpicdn.net/img/view/2018/2/13/1655132.png,0,0.995605648,34,346,468,780,434,434,twilight sparkle
1661317.png,https://derpicdn.net/img/view/2018/2/20/1661317.png,0,0.964995027,179,0,807,566,628,566,twilight sparkle
1661366.png,https://derpicdn.net/img/view/2018/2/20/1661366.png,0,0.999248624,735,0,2391,1582,1656,1582,twilight sparkle
1664219.png,https://derpicdn.net/img/view/2018/2/24/1664219.png,0,0.98844254,253,452,863,1062,610,610,twilight sparkle
1664557.png,https://derpicdn.net/img/view/2018/2/24/1664557.png,0,0.999528825,186,528,900,1242,714,714,twilight sparkle
1668741.png,https://derpicdn.net/img/view/2018/3/1/1668741.png,0,0.998841405,426,72,850,496,424,424,twilight sparkle
1669308.png,https://derpicdn.net/img/view/2018/3/1/1669308.png,0,0.999085307,475,18,1359,902,884,884,twilight sparkle
1670515.png,https://derpicdn.net/img/view/2018/3/3/1670515.png,0,0.959228516,852,441,1240,829,388,388,twilight sparkle
1673550.png,https://derpicdn.net/img/view/2018/3/6/1673550.png,0,0.998703718,2046,65,3660,1679,1614,1614,twilight sparkle
1673880.png,https://derpicdn.net/img/view/2018/3/7/1673880.png,0,0.999153316,1133,65,2273,1205,1140,1140,twilight sparkle
1674490.png,https://derpicdn.net/img/view/2018/3/8/1674490.png,0,0.993131697,61,98,411,448,350,350,twilight sparkle
1674551.png,https://derpicdn.net/img/view/2018/3/8/1674551.png,0,0.975941181,137,0,645,491,508,491,twilight sparkle
1676544.png,https://derpicdn.net/img/view/2018/3/10/1676544.png,0,0.995427787,468,0,838,360,370,360,twilight sparkle
1679491.png,https://derpicdn.net/img/view/2018/3/14/1679491.png,0,0.990310907,495,85,1215,805,720,720,twilight sparkle
1687084.png,https://derpicdn.net/img/view/2018/3/22/1687084.png,0,0.980624259,1035,0,2906,1957,1871,1957,twilight sparkle
1687297.png,https://derpicdn.net/img/view/2018/3/22/1687297.png,0,0.92941159,550,1170,870,1490,320,320,twilight sparkle
1688187.png,https://derpicdn.net/img/view/2018/3/23/1688187.png,0,0.981268466,996,5,2004,1013,1008,1008,twilight sparkle
1689549.png,https://derpicdn.net/img/view/2018/3/24/1689549.png,0,0.939035118,76,97,829,929,753,832,twilight sparkle
1690330.png,https://derpicdn.net/img/view/2018/3/25/1690330.png,0,0.979008853,296,122,770,596,474,474,twilight sparkle
1692011.png,https://derpicdn.net/img/view/2018/3/27/1692011.png,0,0.981703639,398,0,2692,1943,2294,1943,twilight sparkle
1692352.png,https://derpicdn.net/img/view/2018/3/27/1692352.png,0,0.985227823,644,81,1230,667,586,586,twilight sparkle
1693342.png,https://derpicdn.net/img/view/2018/3/28/1693342.png,0,0.999488473,1562,0,3094,1469,1532,1469,twilight sparkle
1697445.png,https://derpicdn.net/img/view/2018/4/2/1697445.png,0,0.999254048,460,0,1118,640,658,640,twilight sparkle
1700442.png,https://derpicdn.net/img/view/2018/4/6/1700442.png,0,0.954838276,163,7,495,339,332,332,twilight sparkle
1702673.png,https://derpicdn.net/img/view/2018/4/8/1702673.png,0,0.992182195,4,0,424,391,420,391,twilight sparkle
1703054.png,https://derpicdn.net/img/view/2018/4/9/1703054.png,0,0.997968793,0,0,397,373,397,373,twilight sparkle
1705174.png,https://derpicdn.net/img/view/2018/4/11/1705174.png,0,0.968541324,11,0,343,332,332,332,twilight sparkle
1706565.png,https://derpicdn.net/img/view/2018/4/13/1706565.png,0,0.999206364,59,36,659,636,600,600,twilight sparkle
1711500.png,https://derpicdn.net/img/view/2018/4/19/1711500.png,0,0.986480594,1875,0,3475,1550,1600,1550,twilight sparkle
1711510.png,https://derpicdn.net/img/view/2018/4/19/1711510.png,0,0.995806873,144,15,1258,1129,1114,1114,twilight sparkle
1711516.png,https://derpicdn.net/img/view/2018/4/19/1711516.png,0,0.931066394,56,0,1570,1420,1514,1420,twilight sparkle
1712728.png,https://derpicdn.net/img/view/2018/4/20/1712728.png,0,0.96330893,549,0,1280,721,731,721,twilight sparkle
1714263.png,https://derpicdn.net/img/view/2018/4/22/1714263.png,0,0.965800822,0,91,249,351,249,260,twilight sparkle
1717368.png,https://derpicdn.net/img/view/2018/4/26/1717368.png,0,0.979201198,0,0,2589,2814,2589,2814,twilight sparkle
1717671.png,https://derpicdn.net/img/view/2018/4/26/1717671.png,0,0.969734371,0,92,2715,3240,2715,3148,twilight sparkle
1717911.png,https://derpicdn.net/img/view/2018/4/27/1717911.png,0,0.980959892,0,0,2526,2964,2526,2964,twilight sparkle
1718554.png,https://derpicdn.net/img/view/2018/4/27/1718554.png,0,0.975651562,0,0,955,978,955,978,twilight sparkle
1719247.png,https://derpicdn.net/img/view/2018/4/28/1719247.png,0,0.94611752,63,0,459,393,396,393,twilight sparkle
1719652.png,https://derpicdn.net/img/view/2018/4/29/1719652.png,0,0.993418694,608,0,1536,829,928,829,twilight sparkle
1720089.png,https://derpicdn.net/img/view/2018/4/29/1720089.png,0,0.995372355,0,1385,3674,5093,3674,3708,twilight sparkle
1720898.png,https://derpicdn.net/img/view/2018/4/30/1720898.png,0,0.994473934,0,0,599,616,599,616,twilight sparkle
1721281.png,https://derpicdn.net/img/view/2018/5/1/1721281.png,1,0.996215343,768,387,1084,703,316,316,twilight sparkle
1722838.png,https://derpicdn.net/img/view/2018/5/3/1722838.png,0,0.97326386,0,402,2637,3190,2637,2788,twilight sparkle
1722915.png,https://derpicdn.net/img/view/2018/5/3/1722915.png,0,0.951691508,261,0,1459,1158,1198,1158,twilight sparkle
1723406.png,https://derpicdn.net/img/view/2018/5/3/1723406.png,0,0.982114494,70,0,2568,2252,2498,2252,twilight sparkle
1724411.png,https://derpicdn.net/img/view/2018/5/5/1724411.png,0,0.959891677,124,0,846,697,722,697,twilight sparkle
1729854.png,https://derpicdn.net/img/view/2018/5/11/1729854.png,0,0.917722344,0,139,387,540,387,401,twilight sparkle
1730214.png,https://derpicdn.net/img/view/2018/5/11/1730214.png,0,0.961603999,417,0,1179,745,762,745,twilight sparkle
1730717.png,https://derpicdn.net/img/view/2018/5/12/1730717.png,0,0.987251461,346,5,728,387,382,382,twilight sparkle
1731541.png,https://derpicdn.net/img/view/2018/5/13/1731541.png,0,0.995769441,357,0,1491,1016,1134,1016,twilight sparkle
173243.jpg,https://derpicdn.net/img/view/2012/12/5/173243.jpg,0,0.989645422,0,18,566,606,566,588,twilight sparkle
1734736.png,https://derpicdn.net/img/view/2018/5/17/1734736.png,0,0.968195021,3463,0,6507,2378,3044,2378,twilight sparkle
1740964.png,https://derpicdn.net/img/view/2018/5/25/1740964.png,0,0.93641907,441,129,1271,959,830,830,twilight sparkle
1741074.png,https://derpicdn.net/img/view/2018/5/25/1741074.png,0,0.982758641,385,5,823,443,438,438,twilight sparkle
1741483.png,https://derpicdn.net/img/view/2018/5/26/1741483.png,0,0.953155935,63,223,1379,1500,1316,1277,twilight sparkle
1741483.png,https://derpicdn.net/img/view/2018/5/26/1741483.png,1,0.922014534,315,0,1500,1234,1185,1234,twilight sparkle
1741899.png,https://derpicdn.net/img/view/2018/5/26/1741899.png,0,0.977769434,78,0,910,740,832,740,twilight sparkle
1744991.png,https://derpicdn.net/img/view/2018/5/30/1744991.png,0,0.976707101,42,0,374,332,332,332,twilight sparkle
1749806.png,https://derpicdn.net/img/view/2018/6/4/1749806.png,0,0.973712862,86,74,1446,1434,1360,1360,twilight sparkle
1750815.png,https://derpicdn.net/img/view/2018/6/6/1750815.png,0,0.993582308,534,170,1694,1330,1160,1160,twilight sparkle
1751014.png,https://derpicdn.net/img/view/2018/6/6/1751014.png,0,0.996118486,94,41,530,477,436,436,twilight sparkle
1752361.png,https://derpicdn.net/img/view/2018/6/8/1752361.png,0,0.979531169,82,4,730,652,648,648,twilight sparkle
1753569.png,https://derpicdn.net/img/view/2018/6/9/1753569.png,0,0.969571948,37,0,1649,1080,1612,1080,twilight sparkle
1753948.png,https://derpicdn.net/img/view/2018/6/9/1753948.png,0,0.995923638,1112,127,3416,2431,2304,2304,twilight sparkle
1757920.png,https://derpicdn.net/img/view/2018/6/15/1757920.png,0,0.992875755,61,0,867,798,806,798,twilight sparkle
1758018.png,https://derpicdn.net/img/view/2018/6/15/1758018.png,0,0.952053785,149,0,765,586,616,586,twilight sparkle
1759064.png,https://derpicdn.net/img/view/2018/6/16/1759064.png,0,0.980266154,350,19,1188,857,838,838,twilight sparkle
1760295.png,https://derpicdn.net/img/view/2018/6/18/1760295.png,0,0.992469072,863,505,1221,863,358,358,twilight sparkle
1760295.png,https://derpicdn.net/img/view/2018/6/18/1760295.png,1,0.984093428,230,7,504,281,274,274,twilight sparkle
1761828.png,https://derpicdn.net/img/view/2018/6/20/1761828.png,0,0.997260332,658,0,1396,733,738,733,twilight sparkle
1762251.png,https://derpicdn.net/img/view/2018/6/20/1762251.png,0,0.98716706,167,0,599,422,432,422,twilight sparkle
1766487.png,https://derpicdn.net/img/view/2018/6/26/1766487.png,0,0.997505724,1383,0,2835,1368,1452,1368,twilight sparkle
1766858.png,https://derpicdn.net/img/view/2018/6/27/1766858.png,0,0.948581338,321,30,2039,1838,1718,1808,twilight sparkle
1767807.png,https://derpicdn.net/img/view/2018/6/28/1767807.png,0,0.991983056,64,0,752,675,688,675,twilight sparkle
1768589.png,https://derpicdn.net/img/view/2018/6/29/1768589.png,0,0.99580282,145,54,1049,958,904,904,twilight sparkle
1770131.png,https://derpicdn.net/img/view/2018/7/1/1770131.png,0,0.985286951,352,29,1410,1087,1058,1058,twilight sparkle
1772010.png,https://derpicdn.net/img/view/2018/7/3/1772010.png,0,0.980410516,0,0,546,554,546,554,twilight sparkle
1772346.png,https://derpicdn.net/img/view/2018/7/3/1772346.png,0,0.929434001,416,200,2122,1906,1706,1706,twilight sparkle
1772960.png,https://derpicdn.net/img/view/2018/7/4/1772960.png,0,0.983722925,310,165,894,749,584,584,twilight sparkle
1774268.png,https://derpicdn.net/img/view/2018/7/6/1774268.png,0,0.989726484,479,87,800,445,321,358,twilight sparkle
1775439.png,https://derpicdn.net/img/view/2018/7/7/1775439.png,0,0.992922604,276,28,1984,1736,1708,1708,twilight sparkle
1782581.png,https://derpicdn.net/img/view/2018/7/16/1782581.png,0,0.984398484,0,115,3782,4079,3782,3964,twilight sparkle
1783032.png,https://derpicdn.net/img/view/2018/7/17/1783032.png,0,0.967004001,1088,193,1690,795,602,602,twilight sparkle
1783032.png,https://derpicdn.net/img/view/2018/7/17/1783032.png,1,0.903187573,761,208,1321,768,560,560,twilight sparkle
1783686.png,https://derpicdn.net/img/view/2018/7/18/1783686.png,0,0.992390752,0,5,663,739,663,734,twilight sparkle
1784981.png,https://derpicdn.net/img/view/2018/7/19/1784981.png,0,0.979453325,2401,1319,3693,2611,1292,1292,twilight sparkle
1784981.png,https://derpicdn.net/img/view/2018/7/19/1784981.png,1,0.956501126,1090,560,2652,2122,1562,1562,twilight sparkle
1785036.png,https://derpicdn.net/img/view/2018/7/19/1785036.png,0,0.97300595,263,0,905,618,642,618,twilight sparkle
1786267.png,https://derpicdn.net/img/view/2018/7/21/1786267.png,0,0.931751788,6,33,802,801,796,768,twilight sparkle
179129.png,https://derpicdn.net/img/view/2012/12/11/179129.png,0,0.940710604,0,0,759,711,759,711,twilight sparkle
1794124.png,https://derpicdn.net/img/view/2018/7/31/1794124.png,0,0.931761682,0,0,219,218,219,218,twilight sparkle
1794179.png,https://derpicdn.net/img/view/2018/7/31/1794179.png,0,0.997956455,151,82,691,622,540,540,twilight sparkle
1797726.png,https://derpicdn.net/img/view/2018/8/4/1797726.png,0,0.993394136,115,45,809,739,694,694,twilight sparkle
1800438.png,https://derpicdn.net/img/view/2018/8/7/1800438.png,0,0.96337676,297,283,2013,1999,1716,1716,twilight sparkle
1802735.png,https://derpicdn.net/img/view/2018/8/9/1802735.png,0,0.906878531,775,0,1677,854,902,854,twilight sparkle
1802757.png,https://derpicdn.net/img/view/2018/8/9/1802757.png,0,0.990599215,0,73,2715,3127,2715,3054,twilight sparkle
1804744.png,https://derpicdn.net/img/view/2018/8/12/1804744.png,0,0.987422347,198,226,748,776,550,550,twilight sparkle
1807422.png,https://derpicdn.net/img/view/2018/8/15/1807422.png,0,0.998708189,139,209,385,455,246,246,twilight sparkle
1807422.png,https://derpicdn.net/img/view/2018/8/15/1807422.png,1,0.99632138,318,95,612,389,294,294,twilight sparkle
1807572.png,https://derpicdn.net/img/view/2018/8/15/1807572.png,0,0.999047935,467,554,999,1086,532,532,twilight sparkle
1807572.png,https://derpicdn.net/img/view/2018/8/15/1807572.png,1,0.926446378,979,491,1537,1049,558,558,twilight sparkle
1813177.png,https://derpicdn.net/img/view/2018/8/22/1813177.png,0,0.99776274,414,423,838,847,424,424,twilight sparkle
1817116.png,https://derpicdn.net/img/view/2018/8/26/1817116.png,0,0.920969427,714,0,1550,873,836,873,twilight sparkle
1819106.png,https://derpicdn.net/img/view/2018/8/29/1819106.png,0,0.995253146,2539,169,4441,2071,1902,1902,twilight sparkle
1819854.png,https://derpicdn.net/img/view/2018/8/29/1819854.png,0,0.954976916,0,58,2498,2750,2498,2692,twilight sparkle
1821158.png,https://derpicdn.net/img/view/2018/8/31/1821158.png,0,0.959163547,718,1501,4762,5287,4044,3786,twilight sparkle
1823807.png,https://derpicdn.net/img/view/2018/9/3/1823807.png,0,0.99836123,36,0,2041,1942,2005,1942,twilight sparkle
1824007.png,https://derpicdn.net/img/view/2018/9/3/1824007.png,0,0.944562256,151,0,1413,975,1262,975,twilight sparkle
1832102.png,https://derpicdn.net/img/view/2018/9/13/1832102.png,0,0.962769032,62,50,448,436,386,386,twilight sparkle
1841408.png,https://derpicdn.net/img/view/2018/9/26/1841408.png,0,0.982276022,3222,0,8056,5002,4834,5002,twilight sparkle
1843349.png,https://derpicdn.net/img/view/2018/9/28/1843349.png,0,0.957962871,135,0,1683,1080,1548,1080,twilight sparkle
1844834.png,https://derpicdn.net/img/view/2018/9/30/1844834.png,0,0.999286294,62,0,2298,2207,2236,2207,twilight sparkle
1854891.png,https://derpicdn.net/img/view/2018/10/12/1854891.png,0,0.936805069,847,279,5104,4701,4257,4422,twilight sparkle
1855608.png,https://derpicdn.net/img/view/2018/10/13/1855608.png,0,0.927803516,375,1,833,459,458,458,twilight sparkle
1859452.png,https://derpicdn.net/img/view/2018/10/18/1859452.png,0,0.989919782,80,9,524,453,444,444,twilight sparkle
1861608.png,https://derpicdn.net/img/view/2018/10/20/1861608.png,0,0.989975333,465,408,939,882,474,474,twilight sparkle
1862763.png,https://derpicdn.net/img/view/2018/10/22/1862763.png,0,0.978252649,1963,188,4940,3232,2977,3044,twilight sparkle
186440.png,https://derpicdn.net/img/view/2012/12/18/186440.png,0,0.995025456,287,9,1375,1097,1088,1088,twilight sparkle
1864954.png,https://derpicdn.net/img/view/2018/10/24/1864954.png,0,0.972757697,725,105,2119,1499,1394,1394,twilight sparkle
1867821.png,https://derpicdn.net/img/view/2018/10/27/1867821.png,1,0.9128865,442,301,3550,3631,3108,3330,twilight sparkle
1868567.png,https://derpicdn.net/img/view/2018/10/28/1868567.png,0,0.947299898,227,489,2500,2817,2273,2328,twilight sparkle
1869056.png,https://derpicdn.net/img/view/2018/10/29/1869056.png,0,0.996410072,1684,136,6256,4708,4572,4572,twilight sparkle
1872529.png,https://derpicdn.net/img/view/2018/11/1/1872529.png,0,0.963188469,1493,463,6833,5803,5340,5340,twilight sparkle
1872755.png,https://derpicdn.net/img/view/2018/11/1/1872755.png,0,0.998941481,235,285,511,561,276,276,twilight sparkle
1872755.png,https://derpicdn.net/img/view/2018/11/1/1872755.png,1,0.920221448,484,189,756,461,272,272,twilight sparkle
1875979.png,https://derpicdn.net/img/view/2018/11/5/1875979.png,0,0.966902912,0,0,963,877,963,877,twilight sparkle
1876106.png,https://derpicdn.net/img/view/2018/11/6/1876106.png,0,0.997288942,502,0,1146,631,644,631,twilight sparkle
1878847.png,https://derpicdn.net/img/view/2018/11/10/1878847.png,0,0.985600173,18,3,300,285,282,282,twilight sparkle
1880031.png,https://derpicdn.net/img/view/2018/11/11/1880031.png,0,0.999529362,0,16,304,326,304,310,twilight sparkle
1882041.png,https://derpicdn.net/img/view/2018/11/14/1882041.png,0,0.985872328,382,275,1094,987,712,712,twilight sparkle
1884039.png,https://derpicdn.net/img/view/2018/11/17/1884039.png,0,0.996975422,221,0,851,626,630,626,twilight sparkle
1884878.png,https://derpicdn.net/img/view/2018/11/18/1884878.png,0,0.981638134,2,88,260,346,258,258,twilight sparkle
1884878.png,https://derpicdn.net/img/view/2018/11/18/1884878.png,1,0.959997177,239,0,631,361,392,361,twilight sparkle
1885460.png,https://derpicdn.net/img/view/2018/11/18/1885460.png,0,0.98630625,341,38,1723,1420,1382,1382,twilight sparkle
1887313.png,https://derpicdn.net/img/view/2018/11/21/1887313.png,0,0.999045193,424,284,1026,886,602,602,twilight sparkle
1888134.png,https://derpicdn.net/img/view/2018/11/22/1888134.png,0,0.990935862,13,127,595,651,582,524,twilight sparkle
1893178.png,https://derpicdn.net/img/view/2018/11/28/1893178.png,0,0.986625135,798,94,1214,510,416,416,twilight sparkle
1894765.png,https://derpicdn.net/img/view/2018/11/30/1894765.png,0,0.978815019,248,0,1571,1260,1323,1260,twilight sparkle
1894772.png,https://derpicdn.net/img/view/2018/11/30/1894772.png,0,0.990766644,652,127,934,409,282,282,twilight sparkle
1895046.png,https://derpicdn.net/img/view/2018/12/1/1895046.png,0,0.996102691,264,0,630,361,366,361,twilight sparkle
1896481.png,https://derpicdn.net/img/view/2018/12/2/1896481.png,0,0.954978347,235,50,815,630,580,580,twilight sparkle
1898760.png,https://derpicdn.net/img/view/2018/12/5/1898760.png,0,0.979902565,50,0,1674,1541,1624,1541,twilight sparkle
1898760.png,https://derpicdn.net/img/view/2018/12/5/1898760.png,1,0.919901431,165,363,1800,2139,1635,1776,twilight sparkle
1900705.png,https://derpicdn.net/img/view/2018/12/7/1900705.png,0,0.930222988,344,132,976,764,632,632,twilight sparkle
1900860.png,https://derpicdn.net/img/view/2018/12/7/1900860.png,0,0.95453757,0,0,4365,4785,4365,4785,twilight sparkle
1902944.png,https://derpicdn.net/img/view/2018/12/8/1902944.png,0,0.998942792,779,0,1853,1019,1074,1019,twilight sparkle
19073.png,https://derpicdn.net/img/view/2012/6/24/19073.png,0,0.962362289,18,284,294,560,276,276,twilight sparkle
1909571.png,https://derpicdn.net/img/view/2018/12/16/1909571.png,0,0.992428124,229,0,725,478,496,478,twilight sparkle
191.png,https://derpicdn.net/img/view/2012/1/12/191.png,0,0.997289658,2784,29,4740,1985,1956,1956,twilight sparkle
1910795.png,https://derpicdn.net/img/view/2018/12/17/1910795.png,0,0.998059273,422,8,920,506,498,498,twilight sparkle
1911162.png,https://derpicdn.net/img/view/2018/12/17/1911162.png,0,0.999625564,952,0,1492,536,540,536,twilight sparkle
1911813.png,https://derpicdn.net/img/view/2018/12/18/1911813.png,4,0.977077603,696,1832,1570,2706,874,874,twilight sparkle
191363.jpg,https://derpicdn.net/img/view/2012/12/23/191363.jpg,0,0.998434603,1561,21,2599,1059,1038,1038,twilight sparkle
1913981.png,https://derpicdn.net/img/view/2018/12/20/1913981.png,0,0.970079482,729,0,1707,865,978,865,twilight sparkle
1915428.png,https://derpicdn.net/img/view/2018/12/22/1915428.png,0,0.992809713,99,0,651,537,552,537,twilight sparkle
1915512.png,https://derpicdn.net/img/view/2018/12/22/1915512.png,0,0.99742943,58,84,434,460,376,376,twilight sparkle
1915924.png,https://derpicdn.net/img/view/2018/12/22/1915924.png,0,0.978947282,260,218,1646,1604,1386,1386,twilight sparkle
1921041.png,https://derpicdn.net/img/view/2018/12/28/1921041.png,0,0.900223076,1439,0,4153,2648,2714,2648,twilight sparkle
1921827.png,https://derpicdn.net/img/view/2018/12/30/1921827.png,0,0.991481364,407,22,793,408,386,386,twilight sparkle
1924337.png,https://derpicdn.net/img/view/2019/1/1/1924337.png,0,0.979749262,1939,0,3441,1357,1502,1357,twilight sparkle
1927974.png,https://derpicdn.net/img/view/2019/1/6/1927974.png,0,0.952489793,22,0,644,586,622,586,twilight sparkle
192813.png,https://derpicdn.net/img/view/2012/12/25/192813.png,0,0.977352023,0,1,208,235,208,234,twilight sparkle
1929551.png,https://derpicdn.net/img/view/2019/1/8/1929551.png,0,0.992197335,23,0,559,498,536,498,twilight sparkle
1931490.png,https://derpicdn.net/img/view/2019/1/10/1931490.png,0,0.916765928,104,376,5000,5300,4896,4924,twilight sparkle
1934213.png,https://derpicdn.net/img/view/2019/1/13/1934213.png,0,0.998470247,514,0,1894,1262,1380,1262,twilight sparkle
1934794.png,https://derpicdn.net/img/view/2019/1/14/1934794.png,0,0.943413615,0,51,532,683,532,632,twilight sparkle
1939271.png,https://derpicdn.net/img/view/2019/1/19/1939271.png,0,0.916042447,669,70,2011,1412,1342,1342,twilight sparkle
1939924.png,https://derpicdn.net/img/view/2019/1/20/1939924.png,0,0.983035505,0,0,1171,1170,1171,1170,twilight sparkle
1940753.png,https://derpicdn.net/img/view/2019/1/21/1940753.png,0,0.999020576,405,219,693,507,288,288,twilight sparkle
1943784.png,https://derpicdn.net/img/view/2019/1/25/1943784.png,0,0.987579346,1072,30,1410,368,338,338,twilight sparkle
1945727.png,https://derpicdn.net/img/view/2019/1/27/1945727.png,0,0.99711287,130,0,618,478,488,478,twilight sparkle
1946527.png,https://derpicdn.net/img/view/2019/1/28/1946527.png,0,0.952877045,69,15,813,759,744,744,twilight sparkle
1946927.png,https://derpicdn.net/img/view/2019/1/28/1946927.png,0,0.99834758,510,0,1458,884,948,884,twilight sparkle
1947638.png,https://derpicdn.net/img/view/2019/1/29/1947638.png,0,0.999057591,0,0,297,295,297,295,twilight sparkle
1947644.png,https://derpicdn.net/img/view/2019/1/29/1947644.png,0,0.982201159,15,25,449,459,434,434,twilight sparkle
1952130.png,https://derpicdn.net/img/view/2019/2/3/1952130.png,0,0.994865298,1011,0,2961,1906,1950,1906,twilight sparkle
1953266.png,https://derpicdn.net/img/view/2019/2/4/1953266.png,0,0.983557105,175,0,830,721,655,721,twilight sparkle
1953592.png,https://derpicdn.net/img/view/2019/2/4/1953592.png,0,0.986138523,54,121,1638,1674,1584,1553,twilight sparkle
1954706.png,https://derpicdn.net/img/view/2019/2/6/1954706.png,0,0.96618402,176,4,624,452,448,448,twilight sparkle
1955499.png,https://derpicdn.net/img/view/2019/2/7/1955499.png,0,0.965684414,392,4,704,316,312,312,twilight sparkle
1956355.png,https://derpicdn.net/img/view/2019/2/8/1956355.png,0,0.976688504,0,17,2214,2285,2214,2268,twilight sparkle
1957615.png,https://derpicdn.net/img/view/2019/2/9/1957615.png,0,0.999750555,2784,0,5496,2589,2712,2589,twilight sparkle
1960619.png,https://derpicdn.net/img/view/2019/2/13/1960619.png,0,0.974681795,0,0,868,852,868,852,twilight sparkle
1963058.png,https://derpicdn.net/img/view/2019/2/15/1963058.png,0,0.977951109,121,80,845,804,724,724,twilight sparkle
1963060.png,https://derpicdn.net/img/view/2019/2/15/1963060.png,0,0.920978367,99,56,881,838,782,782,twilight sparkle
1963061.png,https://derpicdn.net/img/view/2019/2/15/1963061.png,0,0.930872202,116,108,848,840,732,732,twilight sparkle
1963273.png,https://derpicdn.net/img/view/2019/2/16/1963273.png,0,0.995441139,1668,0,4872,3089,3204,3089,twilight sparkle
1963510.png,https://derpicdn.net/img/view/2019/2/16/1963510.png,0,0.983592272,2849,0,5700,2579,2851,2579,twilight sparkle
1965803.png,https://derpicdn.net/img/view/2019/2/19/1965803.png,0,0.995844603,0,73,315,403,315,330,twilight sparkle
1966145.png,https://derpicdn.net/img/view/2019/2/19/1966145.png,0,0.909987152,77,0,1243,720,1166,720,twilight sparkle
1966556.png,https://derpicdn.net/img/view/2019/2/19/1966556.png,0,0.943047106,276,68,812,604,536,536,twilight sparkle
1968402.png,https://derpicdn.net/img/view/2019/2/22/1968402.png,0,0.931944191,68,52,693,734,625,682,twilight sparkle
1968723.png,https://derpicdn.net/img/view/2019/2/22/1968723.png,0,0.999570429,75,102,453,480,378,378,twilight sparkle
1971144.png,https://derpicdn.net/img/view/2019/2/25/1971144.png,0,0.95147121,962,59,1358,455,396,396,twilight sparkle
1971144.png,https://derpicdn.net/img/view/2019/2/25/1971144.png,1,0.936075747,411,356,821,766,410,410,twilight sparkle
1978517.png,https://derpicdn.net/img/view/2019/3/6/1978517.png,0,0.966365874,453,0,1315,727,862,727,twilight sparkle
1978521.png,https://derpicdn.net/img/view/2019/3/6/1978521.png,0,0.981615305,233,0,1159,904,926,904,twilight sparkle
1978522.png,https://derpicdn.net/img/view/2019/3/6/1978522.png,0,0.991501093,63,67,747,751,684,684,twilight sparkle
197902.png,https://derpicdn.net/img/view/2012/12/30/197902.png,0,0.972198248,666,6,946,286,280,280,twilight sparkle
1979446.png,https://derpicdn.net/img/view/2019/3/7/1979446.png,0,0.988871336,5,24,551,570,546,546,twilight sparkle
1980099.png,https://derpicdn.net/img/view/2019/3/8/1980099.png,0,0.970403016,252,0,596,312,344,312,twilight sparkle
1981226.png,https://derpicdn.net/img/view/2019/3/9/1981226.png,0,0.992890596,363,55,1091,783,728,728,twilight sparkle
1982719.png,https://derpicdn.net/img/view/2019/3/11/1982719.png,0,0.997367501,0,0,304,306,304,306,twilight sparkle
1988107.png,https://derpicdn.net/img/view/2019/3/17/1988107.png,0,0.999477088,887,0,1481,547,594,547,twilight sparkle
1991439.png,https://derpicdn.net/img/view/2019/3/21/1991439.png,0,0.997306764,681,34,2617,1970,1936,1936,twilight sparkle
1992510.png,https://derpicdn.net/img/view/2019/3/23/1992510.png,0,0.97143352,0,0,2830,2743,2830,2743,twilight sparkle
1994610.png,https://derpicdn.net/img/view/2019/3/25/1994610.png,0,0.983083963,305,0,1691,1356,1386,1356,twilight sparkle
1994610.png,https://derpicdn.net/img/view/2019/3/25/1994610.png,1,0.953026891,247,1444,1545,2742,1298,1298,twilight sparkle
1995373.png,https://derpicdn.net/img/view/2019/3/26/1995373.png,0,0.979857922,0,42,2878,3382,2878,3340,twilight sparkle
1997351.png,https://derpicdn.net/img/view/2019/3/29/1997351.png,0,0.92128855,0,104,4750,5246,4750,5142,twilight sparkle
1997511.png,https://derpicdn.net/img/view/2019/3/29/1997511.png,0,0.986025751,0,212,4748,5966,4748,5754,twilight sparkle
1997849.png,https://derpicdn.net/img/view/2019/3/29/1997849.png,0,0.966712892,791,14,6115,5338,5324,5324,twilight sparkle
1998192.png,https://derpicdn.net/img/view/2019/3/30/1998192.png,0,0.998605549,0,0,597,573,597,573,twilight sparkle
1999858.png,https://derpicdn.net/img/view/2019/4/1/1999858.png,0,0.982403398,58,0,754,704,696,704,twilight sparkle
1999860.png,https://derpicdn.net/img/view/2019/4/1/1999860.png,0,0.945307732,41,0,749,677,708,677,twilight sparkle
1999865.png,https://derpicdn.net/img/view/2019/4/1/1999865.png,0,0.977786362,407,0,999,550,592,550,twilight sparkle
2000611.png,https://derpicdn.net/img/view/2019/4/2/2000611.png,0,0.967002273,467,216,2057,1806,1590,1590,twilight sparkle
2009886.png,https://derpicdn.net/img/view/2019/4/12/2009886.png,0,0.979873955,101,137,1475,1511,1374,1374,twilight sparkle
2011569.png,https://derpicdn.net/img/view/2019/4/14/2011569.png,0,0.987344861,672,0,1450,746,778,746,twilight sparkle
2013669.png,https://derpicdn.net/img/view/2019/4/15/2013669.png,0,0.998491704,3463,43,5860,2443,2397,2400,twilight sparkle
2014314.png,https://derpicdn.net/img/view/2019/4/16/2014314.png,0,0.978265226,883,0,2287,1359,1404,1359,twilight sparkle
2014839.png,https://derpicdn.net/img/view/2019/4/17/2014839.png,0,0.960192442,357,0,903,496,546,496,twilight sparkle
2019705.png,https://derpicdn.net/img/view/2019/4/22/2019705.png,0,0.938183665,92,220,3002,3130,2910,2910,twilight sparkle
2020619.png,https://derpicdn.net/img/view/2019/4/23/2020619.png,0,0.969572723,26,52,934,960,908,908,twilight sparkle
2024290.png,https://derpicdn.net/img/view/2019/4/27/2024290.png,0,0.985182047,50,23,476,449,426,426,twilight sparkle
2025782.png,https://derpicdn.net/img/view/2019/4/28/2025782.png,0,0.999491334,1359,0,2027,537,668,537,twilight sparkle
2025782.png,https://derpicdn.net/img/view/2019/4/28/2025782.png,1,0.999347627,767,0,1425,589,658,589,twilight sparkle
2026014.png,https://derpicdn.net/img/view/2019/4/28/2026014.png,0,0.98614639,758,0,1920,986,1162,986,twilight sparkle
2026117.png,https://derpicdn.net/img/view/2019/4/29/2026117.png,0,0.99813056,0,35,625,679,625,644,twilight sparkle
2027114.png,https://derpicdn.net/img/view/2019/4/30/2027114.png,0,0.960869968,1137,95,3000,2047,1863,1952,twilight sparkle
2028077.png,https://derpicdn.net/img/view/2019/5/1/2028077.png,0,0.992274463,229,197,515,483,286,286,twilight sparkle
2028094.png,https://derpicdn.net/img/view/2019/5/1/2028094.png,0,0.958799958,0,0,3000,3282,3000,3282,twilight sparkle
2028618.png,https://derpicdn.net/img/view/2019/5/1/2028618.png,0,0.995560288,1205,63,3299,2157,2094,2094,twilight sparkle
2028848.png,https://derpicdn.net/img/view/2019/5/2/2028848.png,0,0.998132586,13,36,1037,1060,1024,1024,twilight sparkle
2032474.png,https://derpicdn.net/img/view/2019/5/6/2032474.png,0,0.963076234,24,72,564,612,540,540,twilight sparkle
2034386.png,https://derpicdn.net/img/view/2019/5/9/2034386.png,0,0.998523355,0,0,304,301,304,301,twilight sparkle
2035967.png,https://derpicdn.net/img/view/2019/5/11/2035967.png,0,0.998444915,100,869,710,1479,610,610,twilight sparkle
2039124.png,https://derpicdn.net/img/view/2019/5/15/2039124.png,0,0.981260836,33,32,277,276,244,244,twilight sparkle
2039665.png,https://derpicdn.net/img/view/2019/5/15/2039665.png,0,0.986871541,0,0,2123,2082,2123,2082,twilight sparkle
2044385.png,https://derpicdn.net/img/view/2019/5/20/2044385.png,0,0.925893009,662,617,1948,1903,1286,1286,twilight sparkle
2044571.png,https://derpicdn.net/img/view/2019/5/20/2044571.png,0,0.938452303,188,0,1926,1360,1738,1360,twilight sparkle
2047024.png,https://derpicdn.net/img/view/2019/5/23/2047024.png,0,0.998483002,155,12,573,430,418,418,twilight sparkle
2051419.png,https://derpicdn.net/img/view/2019/5/28/2051419.png,0,0.989113092,726,0,1478,734,752,734,twilight sparkle
2051673.png,https://derpicdn.net/img/view/2019/5/28/2051673.png,0,0.980033875,51,34,497,488,446,454,twilight sparkle
2053894.png,https://derpicdn.net/img/view/2019/5/31/2053894.png,0,0.939994752,0,29,441,563,441,534,twilight sparkle
2054620.png,https://derpicdn.net/img/view/2019/5/31/2054620.png,0,0.997169375,476,49,1148,721,672,672,twilight sparkle
2054620.png,https://derpicdn.net/img/view/2019/5/31/2054620.png,1,0.9969998,81,0,599,485,518,485,twilight sparkle
2058950.png,https://derpicdn.net/img/view/2019/6/6/2058950.png,0,0.989336848,0,0,3768,3476,3768,3476,twilight sparkle
2060216.png,https://derpicdn.net/img/view/2019/6/7/2060216.png,0,0.994286478,0,0,365,341,365,341,twilight sparkle
2061021.png,https://derpicdn.net/img/view/2019/6/8/2061021.png,0,0.996781647,138,24,1104,990,966,966,twilight sparkle
2063640.png,https://derpicdn.net/img/view/2019/6/12/2063640.png,0,0.941392958,19,0,277,223,258,223,twilight sparkle
2064130.png,https://derpicdn.net/img/view/2019/6/13/2064130.png,0,0.981536388,3616,0,7000,3210,3384,3210,twilight sparkle
2068097.png,https://derpicdn.net/img/view/2019/6/17/2068097.png,0,0.918284357,7,136,683,812,676,676,twilight sparkle
2071073.png,https://derpicdn.net/img/view/2019/6/21/2071073.png,0,0.999722779,1478,523,2194,1239,716,716,twilight sparkle
2073872.png,https://derpicdn.net/img/view/2019/6/24/2073872.png,0,0.945419669,160,47,1000,905,840,858,twilight sparkle
2074267.png,https://derpicdn.net/img/view/2019/6/24/2074267.png,0,0.98086983,50,25,826,801,776,776,twilight sparkle
2074446.png,https://derpicdn.net/img/view/2019/6/24/2074446.png,0,0.988569498,97,1199,349,1451,252,252,twilight sparkle
2074446.png,https://derpicdn.net/img/view/2019/6/24/2074446.png,1,0.978860795,402,375,670,643,268,268,twilight sparkle
2074446.png,https://derpicdn.net/img/view/2019/6/24/2074446.png,2,0.964388311,347,1069,800,1579,453,510,twilight sparkle
2075593.png,https://derpicdn.net/img/view/2019/6/26/2075593.png,0,0.981917322,640,295,1520,1175,880,880,twilight sparkle
2076816.png,https://derpicdn.net/img/view/2019/6/27/2076816.png,0,0.949144661,1590,183,3144,1737,1554,1554,twilight sparkle
2078401.png,https://derpicdn.net/img/view/2019/6/29/2078401.png,0,0.999556839,0,0,1135,1058,1135,1058,twilight sparkle
2078401.png,https://derpicdn.net/img/view/2019/6/29/2078401.png,1,0.991742253,1573,484,2511,1422,938,938,twilight sparkle
2080042.png,https://derpicdn.net/img/view/2019/7/1/2080042.png,0,0.991567075,1010,441,1496,927,486,486,twilight sparkle
2081236.png,https://derpicdn.net/img/view/2019/7/2/2081236.png,0,0.935417414,159,0,387,227,228,227,twilight sparkle
2087375.png,https://derpicdn.net/img/view/2019/7/9/2087375.png,0,0.997554958,0,25,1199,1227,1199,1202,twilight sparkle
2091864.png,https://derpicdn.net/img/view/2019/7/14/2091864.png,0,0.976215005,229,44,1485,1300,1256,1256,twilight sparkle
2095313.png,https://derpicdn.net/img/view/2019/7/18/2095313.png,0,0.998912215,473,0,1157,607,684,607,twilight sparkle
2097243.png,https://derpicdn.net/img/view/2019/7/21/2097243.png,0,0.968836486,344,38,678,372,334,334,twilight sparkle
2097888.png,https://derpicdn.net/img/view/2019/7/21/2097888.png,0,0.910438955,154,97,656,599,502,502,twilight sparkle
2098358.png,https://derpicdn.net/img/view/2019/7/22/2098358.png,0,0.955300272,211,0,2489,2221,2278,2221,twilight sparkle
2098781.png,https://derpicdn.net/img/view/2019/7/22/2098781.png,0,0.980524182,0,42,1829,2088,1829,2046,twilight sparkle
2108296.png,https://derpicdn.net/img/view/2019/8/3/2108296.png,0,0.999236941,61,120,1305,1364,1244,1244,twilight sparkle
2108308.png,https://derpicdn.net/img/view/2019/8/3/2108308.png,0,0.974002242,1475,432,2275,1232,800,800,twilight sparkle
2108443.png,https://derpicdn.net/img/view/2019/8/4/2108443.png,0,0.998157144,199,0,757,553,558,553,twilight sparkle
2108671.png,https://derpicdn.net/img/view/2019/8/4/2108671.png,0,0.974743187,34,3,519,509,485,506,twilight sparkle
2108940.png,https://derpicdn.net/img/view/2019/8/4/2108940.png,0,0.988529384,560,0,1608,992,1048,992,twilight sparkle
2109420.png,https://derpicdn.net/img/view/2019/8/5/2109420.png,0,0.986382961,0,0,2294,2338,2294,2338,twilight sparkle
2114905.png,https://derpicdn.net/img/view/2019/8/11/2114905.png,0,0.993275702,249,455,1327,1533,1078,1078,twilight sparkle
2115832.png,https://derpicdn.net/img/view/2019/8/12/2115832.png,0,0.99131602,207,246,915,954,708,708,twilight sparkle
2116431.png,https://derpicdn.net/img/view/2019/8/12/2116431.png,0,0.979948699,131,13,731,613,600,600,twilight sparkle
2117354.png,https://derpicdn.net/img/view/2019/8/13/2117354.png,0,0.988623679,26,48,622,644,596,596,twilight sparkle
2119389.png,https://derpicdn.net/img/view/2019/8/16/2119389.png,0,0.997936785,1542,3,3226,1687,1684,1684,twilight sparkle
2122201.png,https://derpicdn.net/img/view/2019/8/19/2122201.png,0,0.955506623,132,53,370,291,238,238,twilight sparkle
2123417.png,https://derpicdn.net/img/view/2019/8/20/2123417.png,0,0.9746629,0,175,3603,4307,3603,4132,twilight sparkle
2123773.png,https://derpicdn.net/img/view/2019/8/21/2123773.png,0,0.947677195,0,36,2419,2654,2419,2618,twilight sparkle
2124580.png,https://derpicdn.net/img/view/2019/8/22/2124580.png,0,0.984801829,959,913,1639,1593,680,680,twilight sparkle
2124580.png,https://derpicdn.net/img/view/2019/8/22/2124580.png,1,0.927155495,1016,75,1642,701,626,626,twilight sparkle
2125094.png,https://derpicdn.net/img/view/2019/8/23/2125094.png,0,0.967967093,88,0,586,588,498,588,twilight sparkle
2126662.png,https://derpicdn.net/img/view/2019/8/24/2126662.png,0,0.97098273,104,60,414,370,310,310,twilight sparkle
2126733.png,https://derpicdn.net/img/view/2019/8/24/2126733.png,0,0.965350926,124,0,1154,923,1030,923,twilight sparkle
2129454.png,https://derpicdn.net/img/view/2019/8/27/2129454.png,0,0.987133145,356,74,4694,4412,4338,4338,twilight sparkle
2132059.png,https://derpicdn.net/img/view/2019/8/31/2132059.png,0,0.98037535,1109,1325,1929,2145,820,820,twilight sparkle
2135356.png,https://derpicdn.net/img/view/2019/9/3/2135356.png,0,0.998937368,25,0,317,280,292,280,twilight sparkle
2135356.png,https://derpicdn.net/img/view/2019/9/3/2135356.png,1,0.994671941,793,0,1065,267,272,267,twilight sparkle
2135356.png,https://derpicdn.net/img/view/2019/9/3/2135356.png,2,0.992681503,401,0,667,260,266,260,twilight sparkle
2135356.png,https://derpicdn.net/img/view/2019/9/3/2135356.png,3,0.988565922,410,680,696,966,286,286,twilight sparkle
2135356.png,https://derpicdn.net/img/view/2019/9/3/2135356.png,4,0.958386123,35,718,295,978,260,260,twilight sparkle
2135356.png,https://derpicdn.net/img/view/2019/9/3/2135356.png,5,0.955262601,824,691,1108,975,284,284,twilight sparkle
2136861.png,https://derpicdn.net/img/view/2019/9/5/2136861.png,0,0.957530081,0,1,4819,5183,4819,5182,twilight sparkle
2138016.png,https://derpicdn.net/img/view/2019/9/6/2138016.png,0,0.995809197,496,0,3424,2880,2928,2880,twilight sparkle
2138019.png,https://derpicdn.net/img/view/2019/9/6/2138019.png,0,0.990307927,10,0,332,404,322,404,twilight sparkle
2138550.png,https://derpicdn.net/img/view/2019/9/7/2138550.png,0,0.971612573,1745,94,2819,1168,1074,1074,twilight sparkle
2138705.png,https://derpicdn.net/img/view/2019/9/7/2138705.png,0,0.988909602,0,0,2708,2620,2708,2620,twilight sparkle
2138845.png,https://derpicdn.net/img/view/2019/9/7/2138845.png,0,0.997587323,569,0,973,392,404,392,twilight sparkle
2139476.png,https://derpicdn.net/img/view/2019/9/8/2139476.png,0,0.996300399,933,0,1725,789,792,789,twilight sparkle
2149749.png,https://derpicdn.net/img/view/2019/9/21/2149749.png,0,0.997321248,0,388,337,734,337,346,twilight sparkle
2149749.png,https://derpicdn.net/img/view/2019/9/21/2149749.png,1,0.949028671,318,1,598,281,280,280,twilight sparkle
215060.png,https://derpicdn.net/img/view/2013/1/17/215060.png,0,0.999015689,62,10,446,394,384,384,twilight sparkle
2152181.png,https://derpicdn.net/img/view/2019/9/24/2152181.png,0,0.997760057,783,0,3197,2414,2414,2414,twilight sparkle
2153112.png,https://derpicdn.net/img/view/2019/9/25/2153112.png,0,0.98236239,170,0,808,539,638,539,twilight sparkle
2154676.png,https://derpicdn.net/img/view/2019/9/28/2154676.png,0,0.985959053,36,0,402,358,366,358,twilight sparkle
2155752.png,https://derpicdn.net/img/view/2019/9/29/2155752.png,0,0.968468487,0,0,534,534,534,534,twilight sparkle
215634.png,https://derpicdn.net/img/view/2013/1/17/215634.png,0,0.986546636,460,376,968,884,508,508,twilight sparkle
2157281.png,https://derpicdn.net/img/view/2019/10/1/2157281.png,0,0.996820986,404,0,618,211,214,211,twilight sparkle
2158444.png,https://derpicdn.net/img/view/2019/10/2/2158444.png,0,0.994246185,91,0,749,646,658,646,twilight sparkle
2158604.png,https://derpicdn.net/img/view/2019/10/2/2158604.png,0,0.983557701,0,408,2664,3288,2664,2880,twilight sparkle
2165864.png,https://derpicdn.net/img/view/2019/10/11/2165864.png,0,0.988927722,0,0,1342,1353,1342,1353,twilight sparkle
2165865.png,https://derpicdn.net/img/view/2019/10/11/2165865.png,0,0.98763895,0,0,1340,1353,1340,1353,twilight sparkle
2167231.png,https://derpicdn.net/img/view/2019/10/13/2167231.png,0,0.99590838,30,0,552,521,522,521,twilight sparkle
2168808.png,https://derpicdn.net/img/view/2019/10/14/2168808.png,0,0.965448022,324,39,612,327,288,288,twilight sparkle
2169001.png,https://derpicdn.net/img/view/2019/10/14/2169001.png,0,0.957954884,359,81,773,495,414,414,twilight sparkle
2169122.png,https://derpicdn.net/img/view/2019/10/15/2169122.png,0,0.995800853,126,0,386,248,260,248,twilight sparkle
2169207.png,https://derpicdn.net/img/view/2019/10/15/2169207.png,0,0.989345431,24,67,926,939,902,872,twilight sparkle
2169940.png,https://derpicdn.net/img/view/2019/10/15/2169940.png,0,0.969979405,0,6,491,714,491,708,twilight sparkle
2172923.png,https://derpicdn.net/img/view/2019/10/18/2172923.png,0,0.936165154,79,0,431,384,352,384,twilight sparkle
2173119.png,https://derpicdn.net/img/view/2019/10/18/2173119.png,0,0.986784339,636,35,1116,515,480,480,twilight sparkle
2174845.png,https://derpicdn.net/img/view/2019/10/20/2174845.png,0,0.998570919,34,0,498,450,464,450,twilight sparkle
2176181.png,https://derpicdn.net/img/view/2019/10/22/2176181.png,0,0.997379959,270,0,1400,1091,1130,1091,twilight sparkle
2178196.png,https://derpicdn.net/img/view/2019/10/25/2178196.png,0,0.999154985,1668,0,4250,2590,2582,2590,twilight sparkle
2180805.png,https://derpicdn.net/img/view/2019/10/28/2180805.png,0,0.998015404,90,0,512,399,422,399,twilight sparkle
2182574.png,https://derpicdn.net/img/view/2019/10/30/2182574.png,0,0.997138202,0,132,1720,1870,1720,1738,twilight sparkle
2185021.png,https://derpicdn.net/img/view/2019/11/1/2185021.png,0,0.907004416,285,0,659,367,374,367,twilight sparkle
218731.png,https://derpicdn.net/img/view/2013/1/20/218731.png,0,0.917956114,139,440,327,628,188,188,twilight sparkle
2187651.png,https://derpicdn.net/img/view/2019/11/4/2187651.png,0,0.996919453,359,26,893,560,534,534,twilight sparkle
2189795.png,https://derpicdn.net/img/view/2019/11/7/2189795.png,1,0.926141202,387,111,853,577,466,466,twilight sparkle
2196083.png,https://derpicdn.net/img/view/2019/11/14/2196083.png,0,0.985106766,858,503,1276,921,418,418,twilight sparkle
2196083.png,https://derpicdn.net/img/view/2019/11/14/2196083.png,3,0.966385961,1366,215,1640,489,274,274,twilight sparkle
2196919.png,https://derpicdn.net/img/view/2019/11/15/2196919.png,0,0.999028385,62,0,402,334,340,334,twilight sparkle
2198803.png,https://derpicdn.net/img/view/2019/11/17/2198803.png,0,0.984840631,434,36,1058,660,624,624,twilight sparkle
2199449.png,https://derpicdn.net/img/view/2019/11/18/2199449.png,0,0.997947574,818,78,1880,1140,1062,1062,twilight sparkle
2200529.png,https://derpicdn.net/img/view/2019/11/20/2200529.png,0,0.994852602,0,0,2332,2462,2332,2462,twilight sparkle
2202886.png,https://derpicdn.net/img/view/2019/11/22/2202886.png,0,0.978517234,0,8,430,468,430,460,twilight sparkle
2202887.png,https://derpicdn.net/img/view/2019/11/22/2202887.png,0,0.928715765,116,0,500,382,384,382,twilight sparkle
2204417.png,https://derpicdn.net/img/view/2019/11/24/2204417.png,0,0.998944163,563,0,1345,765,782,765,twilight sparkle
2205568.png,https://derpicdn.net/img/view/2019/11/25/2205568.png,0,0.934157252,1152,245,1808,901,656,656,twilight sparkle
2212000.png,https://derpicdn.net/img/view/2019/12/4/2212000.png,0,0.958535552,0,0,314,390,314,390,twilight sparkle
2213661.png,https://derpicdn.net/img/view/2019/12/6/2213661.png,0,0.984923899,334,0,912,534,578,534,twilight sparkle
2215184.png,https://derpicdn.net/img/view/2019/12/7/2215184.png,0,0.922283649,169,72,1021,924,852,852,twilight sparkle
2215288.png,https://derpicdn.net/img/view/2019/12/7/2215288.png,0,0.984466195,45,130,893,978,848,848,twilight sparkle
2216.jpg,https://derpicdn.net/img/view/2012/1/24/2216.jpg,0,0.997720659,435,174,769,508,334,334,twilight sparkle
2218037.png,https://derpicdn.net/img/view/2019/12/11/2218037.png,0,0.985268474,390,0,758,334,368,334,twilight sparkle
2219406.png,https://derpicdn.net/img/view/2019/12/13/2219406.png,0,0.978326321,494,126,960,592,466,466,twilight sparkle
2220668.png,https://derpicdn.net/img/view/2019/12/14/2220668.png,0,0.99936223,379,0,1549,1043,1170,1043,twilight sparkle
2222199.png,https://derpicdn.net/img/view/2019/12/16/2222199.png,0,0.952095509,5769,2168,10097,6496,4328,4328,twilight sparkle
2224033.jpg,https://derpicdn.net/img/view/2019/12/18/2224033.jpg,0,0.990113199,295,40,759,504,464,464,twilight sparkle
2225476.jpg,https://derpicdn.net/img/view/2019/12/20/2225476.jpg,0,0.996884108,284,11,1074,801,790,790,twilight sparkle
2226875.png,https://derpicdn.net/img/view/2019/12/22/2226875.png,0,0.987533629,238,0,1042,800,804,800,twilight sparkle
2226896.png,https://derpicdn.net/img/view/2019/12/22/2226896.png,0,0.982698739,189,0,1179,863,990,863,twilight sparkle
2229565.png,https://derpicdn.net/img/view/2019/12/25/2229565.png,0,0.99407059,180,25,808,653,628,628,twilight sparkle
2230085.png,https://derpicdn.net/img/view/2019/12/25/2230085.png,0,0.91025579,0,85,1012,1127,1012,1042,twilight sparkle
2234500.png,https://derpicdn.net/img/view/2019/12/31/2234500.png,0,0.999516487,431,772,879,1220,448,448,twilight sparkle
2237139.png,https://derpicdn.net/img/view/2020/1/3/2237139.png,0,0.958863676,0,0,427,475,427,475,twilight sparkle
2237141.png,https://derpicdn.net/img/view/2020/1/3/2237141.png,0,0.987267673,2,11,432,441,430,430,twilight sparkle
2237205.png,https://derpicdn.net/img/view/2020/1/3/2237205.png,0,0.994570017,1605,0,2775,1026,1170,1026,twilight sparkle
2237888.png,https://derpicdn.net/img/view/2020/1/3/2237888.png,0,0.961312711,0,53,1255,1321,1255,1268,twilight sparkle
2239010.png,https://derpicdn.net/img/view/2020/1/5/2239010.png,0,0.990354478,0,0,1459,1286,1459,1286,twilight sparkle
2239905.png,https://derpicdn.net/img/view/2020/1/6/2239905.png,0,0.995286107,732,79,1814,1161,1082,1082,twilight sparkle
2240821.png,https://derpicdn.net/img/view/2020/1/7/2240821.png,0,0.900291502,2213,552,3571,1910,1358,1358,twilight sparkle
2241182.png,https://derpicdn.net/img/view/2020/1/7/2241182.png,0,0.986408353,582,7,1188,613,606,606,twilight sparkle
2241735.jpg,https://derpicdn.net/img/view/2020/1/8/2241735.jpg,0,0.971675456,189,162,483,456,294,294,twilight sparkle
2242434.png,https://derpicdn.net/img/view/2020/1/9/2242434.png,0,0.99759984,2891,1266,4685,3060,1794,1794,twilight sparkle
2242434.png,https://derpicdn.net/img/view/2020/1/9/2242434.png,1,0.990256667,3065,44,4487,1466,1422,1422,twilight sparkle
2242434.png,https://derpicdn.net/img/view/2020/1/9/2242434.png,2,0.98615706,1436,319,3562,2445,2126,2126,twilight sparkle
2244857.jpg,https://derpicdn.net/img/view/2020/1/11/2244857.jpg,0,0.993580699,277,0,1151,849,874,849,twilight sparkle
2245911.jpg,https://derpicdn.net/img/view/2020/1/13/2245911.jpg,0,0.973649263,475,0,1053,575,578,575,twilight sparkle
2248328.png,https://derpicdn.net/img/view/2020/1/15/2248328.png,0,0.998893499,136,3,638,505,502,502,twilight sparkle
2249236.png,https://derpicdn.net/img/view/2020/1/16/2249236.png,0,0.991111219,49,0,689,605,640,605,twilight sparkle
2252614.png,https://derpicdn.net/img/view/2020/1/20/2252614.png,0,0.936794162,208,8,986,786,778,778,twilight sparkle
2253172.png,https://derpicdn.net/img/view/2020/1/21/2253172.png,0,0.988445044,491,273,1009,791,518,518,twilight sparkle
2256026.png,https://derpicdn.net/img/view/2020/1/24/2256026.png,0,0.978266418,458,0,1108,621,650,621,twilight sparkle
2257779.jpg,https://derpicdn.net/img/view/2020/1/26/2257779.jpg,0,0.990760028,381,92,859,570,478,478,twilight sparkle
225818.png,https://derpicdn.net/img/view/2013/1/27/225818.png,0,0.970066667,0,0,210,219,210,219,twilight sparkle
2258259.png,https://derpicdn.net/img/view/2020/1/27/2258259.png,0,0.993074596,8,42,608,642,600,600,twilight sparkle
2262011.jpg,https://derpicdn.net/img/view/2020/1/31/2262011.jpg,0,0.988137603,158,0,1280,1150,1122,1150,twilight sparkle
2263462.png,https://derpicdn.net/img/view/2020/2/2/2263462.png,0,0.973158896,685,0,5873,3780,5188,3780,twilight sparkle
2266342.png,https://derpicdn.net/img/view/2020/2/5/2266342.png,0,0.998708725,680,27,1920,1267,1240,1240,twilight sparkle
2267492.jpg,https://derpicdn.net/img/view/2020/2/7/2267492.jpg,0,0.981205285,28,17,894,883,866,866,twilight sparkle
2270186.png,https://derpicdn.net/img/view/2020/2/10/2270186.png,0,0.941956103,0,15,361,558,361,543,twilight sparkle
2271138.png,https://derpicdn.net/img/view/2020/2/11/2271138.png,0,0.999152899,845,52,1381,588,536,536,twilight sparkle
2274107.png,https://derpicdn.net/img/view/2020/2/14/2274107.png,0,0.985800147,53,0,779,481,726,481,twilight sparkle
2275667.png,https://derpicdn.net/img/view/2020/2/16/2275667.png,0,0.989366412,479,0,911,431,432,431,twilight sparkle
227601.jpg,https://derpicdn.net/img/view/2013/1/29/227601.jpg,0,0.993609071,0,0,298,290,298,290,twilight sparkle
2276315.png,https://derpicdn.net/img/view/2020/2/16/2276315.png,0,0.995792627,1061,144,1579,662,518,518,twilight sparkle
2276315.png,https://derpicdn.net/img/view/2020/2/16/2276315.png,1,0.985487282,417,176,875,634,458,458,twilight sparkle
2278333.jpg,https://derpicdn.net/img/view/2020/2/19/2278333.jpg,0,0.964538813,224,0,1302,1073,1078,1073,twilight sparkle
2279534.png,https://derpicdn.net/img/view/2020/2/20/2279534.png,0,0.998335421,1230,0,2332,988,1102,988,twilight sparkle
2281184.png,https://derpicdn.net/img/view/2020/2/22/2281184.png,0,0.989848673,0,0,668,605,668,605,twilight sparkle
2281187.jpg,https://derpicdn.net/img/view/2020/2/22/2281187.jpg,0,0.987248898,472,0,924,443,452,443,twilight sparkle
2283200.png,https://derpicdn.net/img/view/2020/2/25/2283200.png,0,0.989806652,51,5,725,679,674,674,twilight sparkle
2284573.jpg,https://derpicdn.net/img/view/2020/2/27/2284573.jpg,0,0.963832796,526,23,1148,645,622,622,twilight sparkle
228564.png,https://derpicdn.net/img/view/2013/1/30/228564.png,0,0.994502008,1114,245,2174,1305,1060,1060,twilight sparkle
2286240.png,https://derpicdn.net/img/view/2020/2/29/2286240.png,0,0.972201049,877,0,1969,1026,1092,1026,twilight sparkle
2286299.png,https://derpicdn.net/img/view/2020/2/29/2286299.png,0,0.915410578,223,34,1813,1624,1590,1590,twilight sparkle
2292205.png,https://derpicdn.net/img/view/2020/3/7/2292205.png,0,0.965830982,2799,656,4845,2702,2046,2046,twilight sparkle
2293646.png,https://derpicdn.net/img/view/2020/3/9/2293646.png,0,0.990985692,207,109,1413,1315,1206,1206,twilight sparkle
2293660.png,https://derpicdn.net/img/view/2020/3/9/2293660.png,0,0.998256922,66,25,704,663,638,638,twilight sparkle
2295543.png,https://derpicdn.net/img/view/2020/3/12/2295543.png,0,0.924427629,470,138,1076,744,606,606,twilight sparkle
2297.png,https://derpicdn.net/img/view/2012/1/25/2297.png,0,0.911581933,0,55,495,609,495,554,twilight sparkle
2297061.png,https://derpicdn.net/img/view/2020/3/14/2297061.png,0,0.996734977,259,32,481,254,222,222,twilight sparkle
2298563.png,https://derpicdn.net/img/view/2020/3/16/2298563.png,0,0.999425709,858,208,1428,778,570,570,twilight sparkle
2301261.jpg,https://derpicdn.net/img/view/2020/3/19/2301261.jpg,0,0.993209422,509,0,2075,1334,1566,1334,twilight sparkle
2301497.png,https://derpicdn.net/img/view/2020/3/20/2301497.png,0,0.996770918,677,7,1207,537,530,530,twilight sparkle
2301703.png,https://derpicdn.net/img/view/2020/3/20/2301703.png,0,0.985318065,107,15,461,369,354,354,twilight sparkle
2302112.png,https://derpicdn.net/img/view/2020/3/20/2302112.png,0,0.911146402,80,0,1238,1157,1158,1157,twilight sparkle
2302729.png,https://derpicdn.net/img/view/2020/3/21/2302729.png,0,0.992477655,29,0,629,560,600,560,twilight sparkle
2303610.png,https://derpicdn.net/img/view/2020/3/22/2303610.png,0,0.931886435,861,0,2281,1312,1420,1312,twilight sparkle
230421.jpg,https://derpicdn.net/img/view/2013/2/1/230421.jpg,0,0.941697955,311,67,487,243,176,176,twilight sparkle
2304236.jpg,https://derpicdn.net/img/view/2020/3/23/2304236.jpg,0,0.949399531,172,435,868,1131,696,696,twilight sparkle
2309210.png,https://derpicdn.net/img/view/2020/3/29/2309210.png,0,0.948367417,0,0,651,672,651,672,twilight sparkle
2309602.png,https://derpicdn.net/img/view/2020/3/30/2309602.png,0,0.980041802,658,0,4075,2869,3417,2869,twilight sparkle
2311502.jpg,https://derpicdn.net/img/view/2020/4/1/2311502.jpg,0,0.908171952,552,0,1000,413,448,413,twilight sparkle
2311516.png,https://derpicdn.net/img/view/2020/4/1/2311516.png,0,0.981624603,0,52,592,742,592,690,twilight sparkle
2312755.jpg,https://derpicdn.net/img/view/2020/4/3/2312755.jpg,0,0.961178899,530,17,1400,887,870,870,twilight sparkle
2319421.png,https://derpicdn.net/img/view/2020/4/11/2319421.png,0,0.995394826,83,0,913,822,830,822,twilight sparkle
2320544.jpg,https://derpicdn.net/img/view/2020/4/12/2320544.jpg,0,0.975887179,1056,164,1558,666,502,502,twilight sparkle
2321137.png,https://derpicdn.net/img/view/2020/4/13/2321137.png,0,0.975497544,199,0,555,344,356,344,twilight sparkle
2321230.jpg,https://derpicdn.net/img/view/2020/4/13/2321230.jpg,0,0.946867526,256,0,2415,2169,2159,2169,twilight sparkle
2323334.png,https://derpicdn.net/img/view/2020/4/15/2323334.png,0,0.993168175,170,0,1388,1144,1218,1144,twilight sparkle
2324874.jpg,https://derpicdn.net/img/view/2020/4/17/2324874.jpg,0,0.998232186,1621,1313,2437,2129,816,816,twilight sparkle
2324874.jpg,https://derpicdn.net/img/view/2020/4/17/2324874.jpg,1,0.993425071,893,1884,1477,2468,584,584,twilight sparkle
2324874.jpg,https://derpicdn.net/img/view/2020/4/17/2324874.jpg,2,0.992660761,1292,249,2086,1043,794,794,twilight sparkle
2324874.jpg,https://derpicdn.net/img/view/2020/4/17/2324874.jpg,3,0.972482085,1,145,1249,1393,1248,1248,twilight sparkle
2325341.png,https://derpicdn.net/img/view/2020/4/18/2325341.png,0,0.974550903,0,139,836,976,836,837,twilight sparkle
2325665.jpg,https://derpicdn.net/img/view/2020/4/18/2325665.jpg,1,0.960905552,1995,1794,2363,2162,368,368,twilight sparkle
232683.png,https://derpicdn.net/img/view/2013/2/3/232683.png,0,0.982940555,0,1030,2243,3362,2243,2332,twilight sparkle
2330993.jpg,https://derpicdn.net/img/view/2020/4/25/2330993.jpg,0,0.997394145,266,0,1166,936,900,936,twilight sparkle
2331690.png,https://derpicdn.net/img/view/2020/4/25/2331690.png,0,0.996946633,369,0,991,614,622,614,twilight sparkle
2332296.png,https://derpicdn.net/img/view/2020/4/26/2332296.png,0,0.908339262,14,2,966,954,952,952,twilight sparkle
2332619.png,https://derpicdn.net/img/view/2020/4/26/2332619.png,0,0.910087764,84,0,1036,720,952,720,twilight sparkle
2338914.jpg,https://derpicdn.net/img/view/2020/5/4/2338914.jpg,0,0.940307677,680,631,984,935,304,304,twilight sparkle
2339222.jpg,https://derpicdn.net/img/view/2020/5/4/2339222.jpg,0,0.994564831,58,56,852,850,794,794,twilight sparkle
2340107.png,https://derpicdn.net/img/view/2020/5/5/2340107.png,0,0.994531095,298,27,724,453,426,426,twilight sparkle
2340387.jpg,https://derpicdn.net/img/view/2020/5/5/2340387.jpg,0,0.995991766,459,2,1225,768,766,766,twilight sparkle
2341484.png,https://derpicdn.net/img/view/2020/5/7/2341484.png,0,0.970170617,225,0,2245,1440,2020,1440,twilight sparkle
2344474.jpg,https://derpicdn.net/img/view/2020/5/10/2344474.jpg,0,0.968430877,1381,8,1931,558,550,550,twilight sparkle
2344474.jpg,https://derpicdn.net/img/view/2020/5/10/2344474.jpg,1,0.938659012,130,387,708,965,578,578,twilight sparkle
2345787.jpg,https://derpicdn.net/img/view/2020/5/11/2345787.jpg,0,0.962154627,90,95,450,455,360,360,twilight sparkle
2346215.jpg,https://derpicdn.net/img/view/2020/5/12/2346215.jpg,0,0.996250153,486,79,1006,599,520,520,twilight sparkle
2346437.png,https://derpicdn.net/img/view/2020/5/12/2346437.png,0,0.961022377,292,0,3042,2695,2750,2695,twilight sparkle
2348614.png,https://derpicdn.net/img/view/2020/5/14/2348614.png,0,0.978630424,933,455,3153,2675,2220,2220,twilight sparkle
2349012.png,https://derpicdn.net/img/view/2020/5/15/2349012.png,0,0.965374351,0,0,507,533,507,533,twilight sparkle
2349366.png,https://derpicdn.net/img/view/2020/5/15/2349366.png,0,0.960407495,1068,0,2416,1319,1348,1319,twilight sparkle
2349831.png,https://derpicdn.net/img/view/2020/5/16/2349831.png,0,0.993100882,77,0,793,704,716,704,twilight sparkle
2351749.png,https://derpicdn.net/img/view/2020/5/18/2351749.png,0,0.965839088,122,0,888,659,766,659,twilight sparkle
2353109.png,https://derpicdn.net/img/view/2020/5/20/2353109.png,0,0.973775983,171,50,481,360,310,310,twilight sparkle
2353538.png,https://derpicdn.net/img/view/2020/5/20/2353538.png,0,0.990913391,1468,676,2182,1390,714,714,twilight sparkle
2355575.png,https://derpicdn.net/img/view/2020/5/22/2355575.png,0,0.9813115,629,774,2119,2264,1490,1490,twilight sparkle
2356125.jpg,https://derpicdn.net/img/view/2020/5/23/2356125.jpg,0,0.977979898,174,0,1260,1038,1086,1038,twilight sparkle
2356431.png,https://derpicdn.net/img/view/2020/5/24/2356431.png,0,0.995747268,363,41,1147,825,784,784,twilight sparkle
239009.png,https://derpicdn.net/img/view/2013/2/10/239009.png,0,0.990303934,61,162,419,520,358,358,twilight sparkle
241884.png,https://derpicdn.net/img/view/2013/2/13/241884.png,0,0.955102921,379,0,859,477,480,477,twilight sparkle
24564.png,https://derpicdn.net/img/view/2012/6/29/24564.png,0,0.935962915,286,0,688,380,402,380,twilight sparkle
245657.png,https://derpicdn.net/img/view/2013/2/16/245657.png,0,0.967106819,263,243,589,569,326,326,twilight sparkle
246423.png,https://derpicdn.net/img/view/2013/2/17/246423.png,0,0.914971709,634,255,1504,1125,870,870,twilight sparkle
248158.jpg,https://derpicdn.net/img/view/2013/2/18/248158.jpg,0,0.993166208,327,0,725,396,398,396,twilight sparkle
249558.png,https://derpicdn.net/img/view/2013/2/20/249558.png,0,0.995734096,208,0,674,432,466,432,twilight sparkle
251176.png,https://derpicdn.net/img/view/2013/2/21/251176.png,0,0.985505819,307,54,513,260,206,206,twilight sparkle
251466.png,https://derpicdn.net/img/view/2013/2/22/251466.png,0,0.977868557,22,163,838,979,816,816,twilight sparkle
255241.png,https://derpicdn.net/img/view/2013/2/25/255241.png,0,0.967319787,377,0,755,356,378,356,twilight sparkle
25647.png,https://derpicdn.net/img/view/2012/6/29/25647.png,0,0.997741103,335,346,659,670,324,324,twilight sparkle
25647.png,https://derpicdn.net/img/view/2012/6/29/25647.png,1,0.988352537,1148,299,1500,651,352,352,twilight sparkle
25647.png,https://derpicdn.net/img/view/2012/6/29/25647.png,2,0.961119652,869,303,1245,679,376,376,twilight sparkle
256935.png,https://derpicdn.net/img/view/2013/2/27/256935.png,0,0.993906438,825,166,2719,2060,1894,1894,twilight sparkle
26163.jpg,https://derpicdn.net/img/view/2012/6/30/26163.jpg,0,0.98231107,242,92,634,484,392,392,twilight sparkle
26353.png,https://derpicdn.net/img/view/2012/6/30/26353.png,0,0.925259113,206,37,928,759,722,722,twilight sparkle
264778.png,https://derpicdn.net/img/view/2013/3/7/264778.png,0,0.980728686,339,0,1373,934,1034,934,twilight sparkle
271517.png,https://derpicdn.net/img/view/2013/3/15/271517.png,0,0.910706282,110,43,590,523,480,480,twilight sparkle
272673.png,https://derpicdn.net/img/view/2013/3/17/272673.png,0,0.944088995,78,0,666,568,588,568,twilight sparkle
277514.png,https://derpicdn.net/img/view/2013/3/23/277514.png,0,0.95738399,516,417,860,761,344,344,twilight sparkle
281941.png,https://derpicdn.net/img/view/2013/3/28/281941.png,0,0.996588171,194,0,730,524,536,524,twilight sparkle
284869.png,https://derpicdn.net/img/view/2013/4/1/284869.png,0,0.964389384,36,0,616,477,580,477,twilight sparkle
287289.jpg,https://derpicdn.net/img/view/2013/4/3/287289.jpg,0,0.93976742,28,84,584,640,556,556,twilight sparkle
287421.png,https://derpicdn.net/img/view/2013/4/3/287421.png,0,0.967357576,0,0,1048,1029,1048,1029,twilight sparkle
290055.png,https://derpicdn.net/img/view/2013/4/6/290055.png,0,0.985497296,488,934,4968,4824,4480,3890,twilight sparkle
292584.jpg,https://derpicdn.net/img/view/2013/4/9/292584.jpg,0,0.966407061,289,0,769,464,480,464,twilight sparkle
294088.png,https://derpicdn.net/img/view/2013/4/10/294088.png,0,0.997707307,100,124,1118,1142,1018,1018,twilight sparkle
296822.png,https://derpicdn.net/img/view/2013/4/13/296822.png,0,0.993854702,32,17,418,403,386,386,twilight sparkle
300714.png,https://derpicdn.net/img/view/2013/4/17/300714.png,0,0.904261112,109,99,407,397,298,298,twilight sparkle
306792.png,https://derpicdn.net/img/view/2013/4/24/306792.png,0,0.952155828,577,563,1145,1131,568,568,twilight sparkle
309373.jpg,https://derpicdn.net/img/view/2013/4/27/309373.jpg,0,0.913055599,0,0,805,740,805,740,twilight sparkle
310075.jpg,https://derpicdn.net/img/view/2013/4/27/310075.jpg,0,0.955099285,447,83,913,549,466,466,twilight sparkle
312799.jpg,https://derpicdn.net/img/view/2013/4/30/312799.jpg,0,0.994087756,254,0,720,566,466,566,twilight sparkle
321600.png,https://derpicdn.net/img/view/2013/5/10/321600.png,0,0.982397199,90,128,630,668,540,540,twilight sparkle
32466.png,https://derpicdn.net/img/view/2012/7/5/32466.png,0,0.971110582,0,21,223,248,223,227,twilight sparkle
324802.jpg,https://derpicdn.net/img/view/2013/5/14/324802.jpg,0,0.980259955,87,73,297,283,210,210,twilight sparkle
326110.png,https://derpicdn.net/img/view/2013/5/16/326110.png,0,0.95581913,67,190,389,512,322,322,twilight sparkle
326745.png,https://derpicdn.net/img/view/2013/5/16/326745.png,0,0.999293089,184,2,432,250,248,248,twilight sparkle
327949.png,https://derpicdn.net/img/view/2013/5/18/327949.png,0,0.950968266,46,17,370,341,324,324,twilight sparkle
33148.png,https://derpicdn.net/img/view/2012/7/5/33148.png,0,0.957439899,0,26,2482,2604,2482,2578,twilight sparkle
334256.png,https://derpicdn.net/img/view/2013/5/26/334256.png,0,0.999132395,518,51,812,345,294,294,twilight sparkle
336358.png,https://derpicdn.net/img/view/2013/5/29/336358.png,0,0.986338317,118,84,558,524,440,440,twilight sparkle
337639.png,https://derpicdn.net/img/view/2013/5/31/337639.png,0,0.949986279,394,342,1106,1054,712,712,twilight sparkle
338533.png,https://derpicdn.net/img/view/2013/6/1/338533.png,0,0.942942202,177,0,943,707,766,707,twilight sparkle
341213.png,https://derpicdn.net/img/view/2013/6/5/341213.png,0,0.984438777,8,21,346,359,338,338,twilight sparkle
348452.png,https://derpicdn.net/img/view/2013/6/14/348452.png,0,0.992582977,68,121,730,783,662,662,twilight sparkle
349855.jpg,https://derpicdn.net/img/view/2013/6/16/349855.jpg,0,0.975776672,17,0,625,574,608,574,twilight sparkle
353388.png,https://derpicdn.net/img/view/2013/6/21/353388.png,0,0.974369287,2245,341,3285,1381,1040,1040,twilight sparkle
356100.png,https://derpicdn.net/img/view/2013/6/24/356100.png,0,0.900135458,49,0,511,376,462,376,twilight sparkle
358496.png,https://derpicdn.net/img/view/2013/6/27/358496.png,0,0.992972314,0,65,558,641,558,576,twilight sparkle
3615.png,https://derpicdn.net/img/view/2012/2/28/3615.png,0,0.930129051,409,0,900,503,491,503,twilight sparkle
367724.png,https://derpicdn.net/img/view/2013/7/8/367724.png,0,0.993222475,122,3,684,565,562,562,twilight sparkle
370235.png,https://derpicdn.net/img/view/2013/7/11/370235.png,0,0.980338454,441,283,1523,1365,1082,1082,twilight sparkle
376779.png,https://derpicdn.net/img/view/2013/7/17/376779.png,0,0.991308272,325,26,759,460,434,434,twilight sparkle
379768.png,https://derpicdn.net/img/view/2013/7/20/379768.png,0,0.946489573,691,14,1280,648,589,634,twilight sparkle
380364.png,https://derpicdn.net/img/view/2013/7/21/380364.png,0,0.918995976,423,464,1039,1080,616,616,twilight sparkle
380913.png,https://derpicdn.net/img/view/2013/7/22/380913.png,0,0.956906497,40,0,518,458,478,458,twilight sparkle
38134.jpg,https://derpicdn.net/img/view/2012/7/9/38134.jpg,0,0.997005224,84,10,498,424,414,414,twilight sparkle
384048.png,https://derpicdn.net/img/view/2013/7/29/384048.png,0,0.936975062,416,576,760,942,344,366,twilight sparkle
384048.png,https://derpicdn.net/img/view/2013/7/29/384048.png,1,0.917616129,109,0,677,545,568,545,twilight sparkle
384746.png,https://derpicdn.net/img/view/2013/7/29/384746.png,0,0.940119028,203,122,609,528,406,406,twilight sparkle
387376.png,https://derpicdn.net/img/view/2013/7/31/387376.png,0,0.989386559,170,0,670,493,500,493,twilight sparkle
390008.png,https://derpicdn.net/img/view/2013/8/3/390008.png,0,0.999220252,301,0,677,366,376,366,twilight sparkle
39178.jpg,https://derpicdn.net/img/view/2012/7/10/39178.jpg,0,0.981064618,512,4,900,422,388,418,twilight sparkle
39691.png,https://derpicdn.net/img/view/2012/7/10/39691.png,0,0.98428297,30,0,492,424,462,424,twilight sparkle
39715.jpg,https://derpicdn.net/img/view/2012/7/10/39715.jpg,0,0.984617889,281,0,695,395,414,395,twilight sparkle
39716.jpg,https://derpicdn.net/img/view/2012/7/10/39716.jpg,0,0.998669684,238,6,580,348,342,342,twilight sparkle
397179.png,https://derpicdn.net/img/view/2013/8/11/397179.png,0,0.99741888,215,110,1319,1214,1104,1104,twilight sparkle
398618.png,https://derpicdn.net/img/view/2013/8/12/398618.png,0,0.997950912,318,16,2840,2538,2522,2522,twilight sparkle
399472.png,https://derpicdn.net/img/view/2013/8/13/399472.png,0,0.998139799,500,0,1838,1295,1338,1295,twilight sparkle
399974.png,https://derpicdn.net/img/view/2013/8/14/399974.png,0,0.988387823,62,5,546,489,484,484,twilight sparkle
400001.png,https://derpicdn.net/img/view/2013/8/14/400001.png,0,0.994175911,43,0,313,250,270,250,twilight sparkle
401211.png,https://derpicdn.net/img/view/2013/8/15/401211.png,0,0.988273382,341,395,2645,2699,2304,2304,twilight sparkle
402640.jpg,https://derpicdn.net/img/view/2013/8/17/402640.jpg,0,0.989382267,0,0,363,317,363,317,twilight sparkle
402773.jpg,https://derpicdn.net/img/view/2013/8/17/402773.jpg,0,0.99052453,676,70,1040,434,364,364,twilight sparkle
402773.jpg,https://derpicdn.net/img/view/2013/8/17/402773.jpg,1,0.95784694,112,0,500,354,388,354,twilight sparkle
405139.jpg,https://derpicdn.net/img/view/2013/8/20/405139.jpg,0,0.902782798,651,70,1515,934,864,864,twilight sparkle
407136.jpg,https://derpicdn.net/img/view/2013/8/22/407136.jpg,0,0.987852991,588,0,1178,573,590,573,twilight sparkle
407137.png,https://derpicdn.net/img/view/2013/8/22/407137.png,0,0.999684513,258,0,838,559,580,559,twilight sparkle
407416.jpg,https://derpicdn.net/img/view/2013/8/22/407416.jpg,0,0.967259586,68,0,430,328,362,328,twilight sparkle
410320.png,https://derpicdn.net/img/view/2013/8/25/410320.png,0,0.985029399,300,7,754,461,454,454,twilight sparkle
414454.png,https://derpicdn.net/img/view/2013/8/30/414454.png,0,0.935789883,274,95,542,363,268,268,twilight sparkle
417332.jpg,https://derpicdn.net/img/view/2013/9/2/417332.jpg,0,0.994522154,0,85,936,1149,936,1064,twilight sparkle
418753.png,https://derpicdn.net/img/view/2013/9/4/418753.png,0,0.952903807,94,21,468,395,374,374,twilight sparkle
420319.png,https://derpicdn.net/img/view/2013/9/6/420319.png,0,0.991422713,51,0,345,268,294,268,twilight sparkle
424205.png,https://derpicdn.net/img/view/2013/9/10/424205.png,0,0.974178851,258,24,702,468,444,444,twilight sparkle
424829.png,https://derpicdn.net/img/view/2013/9/11/424829.png,0,0.992731035,464,2951,1262,3749,798,798,twilight sparkle
42519.png,https://derpicdn.net/img/view/2012/7/13/42519.png,0,0.979511678,219,236,421,438,202,202,twilight sparkle
430386.png,https://derpicdn.net/img/view/2013/9/18/430386.png,0,0.907539189,228,0,1642,1371,1414,1371,twilight sparkle
434514.png,https://derpicdn.net/img/view/2013/9/25/434514.png,0,0.996057093,256,63,536,343,280,280,twilight sparkle
451528.jpg,https://derpicdn.net/img/view/2013/10/18/451528.jpg,0,0.998465121,16,123,396,503,380,380,twilight sparkle
455217.jpg,https://derpicdn.net/img/view/2013/10/24/455217.jpg,0,0.999431312,281,0,1419,1138,1138,1138,twilight sparkle
459452.png,https://derpicdn.net/img/view/2013/10/29/459452.png,0,0.998458862,0,0,196,190,196,190,twilight sparkle
463530.jpg,https://derpicdn.net/img/view/2013/11/3/463530.jpg,0,0.981407583,2,59,489,590,487,531,twilight sparkle
464418.png,https://derpicdn.net/img/view/2013/11/4/464418.png,0,0.995271504,467,0,659,188,192,188,twilight sparkle
464418.png,https://derpicdn.net/img/view/2013/11/4/464418.png,1,0.990877569,82,254,260,432,178,178,twilight sparkle
464876.png,https://derpicdn.net/img/view/2013/11/5/464876.png,0,0.999513686,488,0,936,429,448,429,twilight sparkle
466527.png,https://derpicdn.net/img/view/2013/11/7/466527.png,0,0.938212395,245,88,659,502,414,414,twilight sparkle
4685.png,https://derpicdn.net/img/view/2012/6/17/4685.png,0,0.976651013,633,0,993,279,360,279,twilight sparkle
470527.png,https://derpicdn.net/img/view/2013/11/11/470527.png,0,0.973270893,0,193,1052,1337,1052,1144,twilight sparkle
470548.png,https://derpicdn.net/img/view/2013/11/12/470548.png,0,0.988327205,206,0,880,624,674,624,twilight sparkle
47180.jpg,https://derpicdn.net/img/view/2012/7/17/47180.jpg,0,0.984185517,0,0,604,633,604,633,twilight sparkle
479005.jpg,https://derpicdn.net/img/view/2013/11/23/479005.jpg,0,0.980904102,122,12,648,538,526,526,twilight sparkle
480052.png,https://derpicdn.net/img/view/2013/11/24/480052.png,0,0.99201107,180,0,647,474,467,474,twilight sparkle
481143.jpg,https://derpicdn.net/img/view/2013/11/25/481143.jpg,0,0.968583107,41,0,1175,720,1134,720,twilight sparkle
481213.png,https://derpicdn.net/img/view/2013/11/25/481213.png,0,0.987393379,724,409,2660,2345,1936,1936,twilight sparkle
482258.png,https://derpicdn.net/img/view/2013/11/26/482258.png,0,0.922398627,70,0,666,584,596,584,twilight sparkle
483403.png,https://derpicdn.net/img/view/2013/11/27/483403.png,0,0.998856544,0,0,2262,2306,2262,2306,twilight sparkle
483608.png,https://derpicdn.net/img/view/2013/11/27/483608.png,0,0.983500779,133,0,939,770,806,770,twilight sparkle
484958.png,https://derpicdn.net/img/view/2013/11/29/484958.png,0,0.9200086,820,103,1586,869,766,766,twilight sparkle
485111.png,https://derpicdn.net/img/view/2013/11/29/485111.png,0,0.997683942,186,33,558,405,372,372,twilight sparkle
485547.png,https://derpicdn.net/img/view/2013/11/29/485547.png,0,0.97808814,78,0,796,669,718,669,twilight sparkle
486144.png,https://derpicdn.net/img/view/2013/11/30/486144.png,0,0.96615696,197,0,543,344,346,344,twilight sparkle
486714.png,https://derpicdn.net/img/view/2013/12/1/486714.png,0,0.961435497,142,0,1650,1506,1508,1506,twilight sparkle
488778.png,https://derpicdn.net/img/view/2013/12/3/488778.png,0,0.998084486,202,36,684,518,482,482,twilight sparkle
489722.png,https://derpicdn.net/img/view/2013/12/5/489722.png,0,0.928555429,91,0,539,384,448,384,twilight sparkle
498084.png,https://derpicdn.net/img/view/2013/12/15/498084.png,0,0.979539633,2681,1569,4987,3875,2306,2306,twilight sparkle
498822.png,https://derpicdn.net/img/view/2013/12/16/498822.png,0,0.97844857,3499,131,4627,1259,1128,1128,twilight sparkle
500186.png,https://derpicdn.net/img/view/2013/12/18/500186.png,0,0.989595473,246,218,604,576,358,358,twilight sparkle
501698.png,https://derpicdn.net/img/view/2013/12/20/501698.png,0,0.991571009,61,0,1573,1423,1512,1423,twilight sparkle
502889.png,https://derpicdn.net/img/view/2013/12/21/502889.png,0,0.953601301,59,52,831,824,772,772,twilight sparkle
503548.png,https://derpicdn.net/img/view/2013/12/22/503548.png,0,0.996942341,611,44,889,322,278,278,twilight sparkle
503740.png,https://derpicdn.net/img/view/2013/12/22/503740.png,0,0.982260108,316,0,886,512,570,512,twilight sparkle
503750.jpg,https://derpicdn.net/img/view/2013/12/22/503750.jpg,0,0.992110848,6,0,272,248,266,248,twilight sparkle
503817.png,https://derpicdn.net/img/view/2013/12/22/503817.png,0,0.919790328,429,75,1271,917,842,842,twilight sparkle
503915.png,https://derpicdn.net/img/view/2013/12/22/503915.png,0,0.985504389,35,0,581,528,546,528,twilight sparkle
504342.png,https://derpicdn.net/img/view/2013/12/23/504342.png,0,0.997131646,1683,383,2267,967,584,584,twilight sparkle
504342.png,https://derpicdn.net/img/view/2013/12/23/504342.png,1,0.973801017,546,427,1208,1089,662,662,twilight sparkle
507367.png,https://derpicdn.net/img/view/2013/12/27/507367.png,0,0.937059104,608,446,1144,982,536,536,twilight sparkle
509291.png,https://derpicdn.net/img/view/2013/12/29/509291.png,0,0.929767489,1525,649,2999,2123,1474,1474,twilight sparkle
510.png,https://derpicdn.net/img/view/2012/1/16/510.png,0,0.983494163,196,0,4360,4056,4164,4056,twilight sparkle
511549.png,https://derpicdn.net/img/view/2014/1/1/511549.png,0,0.977401555,599,170,1103,674,504,504,twilight sparkle
512641.png,https://derpicdn.net/img/view/2014/1/2/512641.png,0,0.902480185,1880,101,3180,1401,1300,1300,twilight sparkle
51294.png,https://derpicdn.net/img/view/2012/7/21/51294.png,0,0.999448836,228,3,552,327,324,324,twilight sparkle
514719.png,https://derpicdn.net/img/view/2014/1/4/514719.png,0,0.997053862,141,158,661,678,520,520,twilight sparkle
516543.png,https://derpicdn.net/img/view/2014/1/6/516543.png,0,0.916060984,1020,347,3354,2681,2334,2334,twilight sparkle
517276.png,https://derpicdn.net/img/view/2014/1/6/517276.png,0,0.948711872,1065,294,1917,1146,852,852,twilight sparkle
519597.png,https://derpicdn.net/img/view/2014/1/9/519597.png,0,0.990984619,103,8,431,336,328,328,twilight sparkle
525893.jpg,https://derpicdn.net/img/view/2014/1/16/525893.jpg,0,0.99155283,92,0,588,483,496,483,twilight sparkle
529619.png,https://derpicdn.net/img/view/2014/1/20/529619.png,0,0.909643114,21,34,269,282,248,248,twilight sparkle
53392.jpg,https://derpicdn.net/img/view/2012/7/23/53392.jpg,0,0.945488274,854,254,1280,688,426,434,twilight sparkle
539183.png,https://derpicdn.net/img/view/2014/1/31/539183.png,0,0.961846948,57,0,304,258,247,258,twilight sparkle
541935.jpg,https://derpicdn.net/img/view/2014/2/3/541935.jpg,0,0.965875983,6,0,526,494,520,494,twilight sparkle
543330.png,https://derpicdn.net/img/view/2014/2/4/543330.png,0,0.973259389,86,0,692,492,606,492,twilight sparkle
544904.png,https://derpicdn.net/img/view/2014/2/6/544904.png,0,0.949041247,199,33,631,465,432,432,twilight sparkle
544912.png,https://derpicdn.net/img/view/2014/2/6/544912.png,0,0.911763966,134,0,622,483,488,483,twilight sparkle
548558.png,https://derpicdn.net/img/view/2014/2/10/548558.png,0,0.965063095,221,245,953,977,732,732,twilight sparkle
551376.png,https://derpicdn.net/img/view/2014/2/14/551376.png,0,0.971454024,366,80,674,388,308,308,twilight sparkle
551700.jpg,https://derpicdn.net/img/view/2014/2/14/551700.jpg,0,0.9983235,303,21,1067,785,764,764,twilight sparkle
552053.png,https://derpicdn.net/img/view/2014/2/14/552053.png,0,0.980479002,1492,52,2788,1348,1296,1296,twilight sparkle
554536.png,https://derpicdn.net/img/view/2014/2/17/554536.png,0,0.971081376,143,43,961,861,818,818,twilight sparkle
556317.png,https://derpicdn.net/img/view/2014/2/19/556317.png,0,0.994602025,144,0,516,368,372,368,twilight sparkle
558172.png,https://derpicdn.net/img/view/2014/2/21/558172.png,0,0.999765813,523,0,1183,638,660,638,twilight sparkle
558819.png,https://derpicdn.net/img/view/2014/2/22/558819.png,0,0.982719839,72,17,766,711,694,694,twilight sparkle
562443.png,https://derpicdn.net/img/view/2014/2/27/562443.png,0,0.992002726,0,0,613,406,613,406,twilight sparkle
563995.png,https://derpicdn.net/img/view/2014/3/1/563995.png,0,0.973329008,279,0,1395,1066,1116,1066,twilight sparkle
564858.png,https://derpicdn.net/img/view/2014/3/2/564858.png,0,0.965182424,1390,342,2026,978,636,636,twilight sparkle
565396.png,https://derpicdn.net/img/view/2014/3/2/565396.png,0,0.942940593,232,54,740,562,508,508,twilight sparkle
565603.png,https://derpicdn.net/img/view/2014/3/3/565603.png,0,0.989909053,179,138,619,578,440,440,twilight sparkle
566403.png,https://derpicdn.net/img/view/2014/3/4/566403.png,0,0.979586482,1059,247,1591,779,532,532,twilight sparkle
567695.png,https://derpicdn.net/img/view/2014/3/6/567695.png,0,0.998691499,1478,1378,1976,1876,498,498,twilight sparkle
567695.png,https://derpicdn.net/img/view/2014/3/6/567695.png,1,0.976619542,453,0,2000,1545,1547,1545,twilight sparkle
571807.png,https://derpicdn.net/img/view/2014/3/11/571807.png,0,0.985236585,538,0,788,198,250,198,twilight sparkle
576988.png,https://derpicdn.net/img/view/2014/3/16/576988.png,0,0.986850619,1790,2,3900,2272,2110,2270,twilight sparkle
578210.png,https://derpicdn.net/img/view/2014/3/17/578210.png,0,0.932479978,0,56,321,392,321,336,twilight sparkle
578210.png,https://derpicdn.net/img/view/2014/3/17/578210.png,1,0.908363998,370,63,575,313,205,250,twilight sparkle
578706.png,https://derpicdn.net/img/view/2014/3/18/578706.png,0,0.957740426,0,272,722,1044,722,772,twilight sparkle
578923.png,https://derpicdn.net/img/view/2014/3/18/578923.png,0,0.985656381,616,0,1304,667,688,667,twilight sparkle
579243.jpg,https://derpicdn.net/img/view/2014/3/19/579243.jpg,0,0.945772648,0,0,500,666,500,666,twilight sparkle
579767.png,https://derpicdn.net/img/view/2014/3/19/579767.png,0,0.993887424,297,0,693,384,396,384,twilight sparkle
580111.jpg,https://derpicdn.net/img/view/2014/3/20/580111.jpg,0,0.984743178,222,0,728,498,506,498,twilight sparkle
580601.png,https://derpicdn.net/img/view/2014/3/20/580601.png,0,0.977028489,60,0,592,502,532,502,twilight sparkle
584034.jpg,https://derpicdn.net/img/view/2014/3/24/584034.jpg,0,0.997072935,480,0,1140,561,660,561,twilight sparkle
585454.png,https://derpicdn.net/img/view/2014/3/26/585454.png,0,0.950321078,349,0,641,274,292,274,twilight sparkle
586252.png,https://derpicdn.net/img/view/2014/3/27/586252.png,0,0.909150839,362,0,1048,676,686,676,twilight sparkle
586337.png,https://derpicdn.net/img/view/2014/3/27/586337.png,0,0.994841397,196,0,1006,775,810,775,twilight sparkle
587616.png,https://derpicdn.net/img/view/2014/3/29/587616.png,0,0.98934418,445,56,1141,752,696,696,twilight sparkle
588007.png,https://derpicdn.net/img/view/2014/3/29/588007.png,0,0.952432752,2308,120,3202,1014,894,894,twilight sparkle
589619.png,https://derpicdn.net/img/view/2014/3/31/589619.png,0,0.900220156,2301,172,2725,596,424,424,twilight sparkle
589890.png,https://derpicdn.net/img/view/2014/3/31/589890.png,0,0.998598874,2075,743,3665,2333,1590,1590,twilight sparkle
591001.png,https://derpicdn.net/img/view/2014/4/2/591001.png,0,0.992024362,1487,0,2793,1234,1306,1234,twilight sparkle
592498.jpg,https://derpicdn.net/img/view/2014/4/4/592498.jpg,0,0.999441803,166,15,690,539,524,524,twilight sparkle
593365.png,https://derpicdn.net/img/view/2014/4/5/593365.png,0,0.944025993,68,31,721,658,653,627,twilight sparkle
597856.png,https://derpicdn.net/img/view/2014/4/11/597856.png,0,0.97275573,324,38,1018,732,694,694,twilight sparkle
598216.png,https://derpicdn.net/img/view/2014/4/11/598216.png,0,0.995223045,49,285,765,1001,716,716,twilight sparkle
598485.png,https://derpicdn.net/img/view/2014/4/12/598485.png,0,0.946967006,89,0,1339,1218,1250,1218,twilight sparkle
604616.png,https://derpicdn.net/img/view/2014/4/19/604616.png,0,0.957565546,637,166,1366,930,729,764,twilight sparkle
608958.png,https://derpicdn.net/img/view/2014/4/24/608958.png,0,0.963425875,227,412,2419,2620,2192,2208,twilight sparkle
609471.png,https://derpicdn.net/img/view/2014/4/25/609471.png,0,0.993111312,951,330,1403,782,452,452,twilight sparkle
609471.png,https://derpicdn.net/img/view/2014/4/25/609471.png,2,0.959247828,584,91,1070,577,486,486,twilight sparkle
609529.png,https://derpicdn.net/img/view/2014/4/25/609529.png,0,0.994403541,180,424,3866,4110,3686,3686,twilight sparkle
610368.jpg,https://derpicdn.net/img/view/2014/4/26/610368.jpg,0,0.933240771,162,0,446,294,284,294,twilight sparkle
619331.png,https://derpicdn.net/img/view/2014/5/6/619331.png,0,0.998026252,0,35,3839,3957,3839,3922,twilight sparkle
620741.png,https://derpicdn.net/img/view/2014/5/8/620741.png,0,0.980193257,1414,0,3114,1670,1700,1670,twilight sparkle
621398.png,https://derpicdn.net/img/view/2014/5/9/621398.png,0,0.942374051,316,0,846,495,530,495,twilight sparkle
621772.png,https://derpicdn.net/img/view/2014/5/9/621772.png,0,0.922670841,2329,135,6000,4483,3671,4348,twilight sparkle
622400.png,https://derpicdn.net/img/view/2014/5/10/622400.png,0,0.964569986,610,11,1142,573,532,562,twilight sparkle
622420.png,https://derpicdn.net/img/view/2014/5/10/622420.png,0,0.998962998,5568,0,9594,3868,4026,3868,twilight sparkle
624610.png,https://derpicdn.net/img/view/2014/5/12/624610.png,0,0.978217602,0,200,271,474,271,274,twilight sparkle
624663.png,https://derpicdn.net/img/view/2014/5/12/624663.png,0,0.988640964,276,49,772,545,496,496,twilight sparkle
625299.png,https://derpicdn.net/img/view/2014/5/13/625299.png,0,0.925258577,14,0,460,439,446,439,twilight sparkle
628316.png,https://derpicdn.net/img/view/2014/5/16/628316.png,0,0.993877828,1585,67,3075,1557,1490,1490,twilight sparkle
629382.png,https://derpicdn.net/img/view/2014/5/17/629382.png,0,0.991735518,1840,0,3081,1376,1241,1376,twilight sparkle
6318.png,https://derpicdn.net/img/view/2012/6/18/6318.png,0,0.904655278,0,27,750,811,750,784,twilight sparkle
631868.jpg,https://derpicdn.net/img/view/2014/5/20/631868.jpg,0,0.987407506,20,0,830,761,810,761,twilight sparkle
63191.png,https://derpicdn.net/img/view/2012/7/31/63191.png,0,0.901669443,310,125,797,596,487,471,twilight sparkle
644352.png,https://derpicdn.net/img/view/2014/6/4/644352.png,0,0.990715206,484,1,836,353,352,352,twilight sparkle
649811.png,https://derpicdn.net/img/view/2014/6/10/649811.png,0,0.958463848,158,10,360,212,202,202,twilight sparkle
650522.png,https://derpicdn.net/img/view/2014/6/11/650522.png,0,0.989753664,8,112,524,628,516,516,twilight sparkle
650591.png,https://derpicdn.net/img/view/2014/6/11/650591.png,0,0.90514487,319,131,749,561,430,430,twilight sparkle
651746.png,https://derpicdn.net/img/view/2014/6/13/651746.png,0,0.902703345,20,10,342,332,322,322,twilight sparkle
656183.jpg,https://derpicdn.net/img/view/2014/6/18/656183.jpg,0,0.957189918,194,0,724,480,530,480,twilight sparkle
657562.jpg,https://derpicdn.net/img/view/2014/6/20/657562.jpg,0,0.987108648,391,0,997,593,606,593,twilight sparkle
657913.png,https://derpicdn.net/img/view/2014/6/20/657913.png,0,0.987404823,79,20,457,398,378,378,twilight sparkle
661662.png,https://derpicdn.net/img/view/2014/6/26/661662.png,0,0.984835684,0,0,725,751,725,751,twilight sparkle
662528.png,https://derpicdn.net/img/view/2014/6/27/662528.png,0,0.991817236,901,0,2389,1378,1488,1378,twilight sparkle
662713.png,https://derpicdn.net/img/view/2014/6/27/662713.png,0,0.930882156,195,210,1127,1142,932,932,twilight sparkle
664955.png,https://derpicdn.net/img/view/2014/6/30/664955.png,0,0.97673279,215,0,1555,1305,1340,1305,twilight sparkle
665508.png,https://derpicdn.net/img/view/2014/7/1/665508.png,0,0.999647856,619,68,1055,504,436,436,twilight sparkle
668192.jpg,https://derpicdn.net/img/view/2014/7/5/668192.jpg,0,0.959926188,1004,0,1980,943,976,943,twilight sparkle
669971.png,https://derpicdn.net/img/view/2014/7/8/669971.png,0,0.976230443,450,0,992,504,542,504,twilight sparkle
673352.png,https://derpicdn.net/img/view/2014/7/12/673352.png,0,0.997007728,0,55,340,437,340,382,twilight sparkle
679944.png,https://derpicdn.net/img/view/2014/7/21/679944.png,0,0.997399569,92,185,3048,3141,2956,2956,twilight sparkle
684735.png,https://derpicdn.net/img/view/2014/7/27/684735.png,0,0.997634292,349,73,771,495,422,422,twilight sparkle
688422.png,https://derpicdn.net/img/view/2014/8/1/688422.png,0,0.997135401,362,62,670,370,308,308,twilight sparkle
69236.png,https://derpicdn.net/img/view/2012/8/7/69236.png,0,0.939025164,1613,517,3549,2453,1936,1936,twilight sparkle
694434.png,https://derpicdn.net/img/view/2014/8/8/694434.png,0,0.915364742,0,12,1674,1994,1674,1982,twilight sparkle
696047.png,https://derpicdn.net/img/view/2014/8/10/696047.png,0,0.989375949,110,21,1006,917,896,896,twilight sparkle
701943.png,https://derpicdn.net/img/view/2014/8/17/701943.png,0,0.990278721,440,24,952,536,512,512,twilight sparkle
705083.png,https://derpicdn.net/img/view/2014/8/21/705083.png,0,0.984362125,0,0,847,543,847,543,twilight sparkle
705460.jpg,https://derpicdn.net/img/view/2014/8/22/705460.jpg,0,0.948008478,303,40,811,548,508,508,twilight sparkle
707176.png,https://derpicdn.net/img/view/2014/8/24/707176.png,0,0.98245585,76,99,1080,1103,1004,1004,twilight sparkle
708369.png,https://derpicdn.net/img/view/2014/8/26/708369.png,0,0.978071153,80,128,538,586,458,458,twilight sparkle
708411.png,https://derpicdn.net/img/view/2014/8/26/708411.png,0,0.993489802,198,0,816,602,618,602,twilight sparkle
708913.png,https://derpicdn.net/img/view/2014/8/27/708913.png,0,0.993645847,93,58,515,480,422,422,twilight sparkle
710080.png,https://derpicdn.net/img/view/2014/8/28/710080.png,0,0.984485865,185,193,367,375,182,182,twilight sparkle
710763.jpg,https://derpicdn.net/img/view/2014/8/30/710763.jpg,0,0.917211413,472,187,974,689,502,502,twilight sparkle
711802.jpg,https://derpicdn.net/img/view/2014/8/31/711802.jpg,0,0.989270627,170,0,646,475,476,475,twilight sparkle
714130.png,https://derpicdn.net/img/view/2014/9/3/714130.png,0,0.997368217,74,0,808,601,734,601,twilight sparkle
714171.png,https://derpicdn.net/img/view/2014/9/3/714171.png,0,0.994081259,0,0,1902,1950,1902,1950,twilight sparkle
71757.png,https://derpicdn.net/img/view/2012/8/11/71757.png,0,0.915718675,471,0,1187,688,716,688,twilight sparkle
718382.png,https://derpicdn.net/img/view/2014/9/9/718382.png,0,0.963167369,1198,995,3430,3227,2232,2232,twilight sparkle
719919.png,https://derpicdn.net/img/view/2014/9/11/719919.png,0,0.994700134,336,0,912,576,576,576,twilight sparkle
719955.png,https://derpicdn.net/img/view/2014/9/11/719955.png,0,0.987527847,213,0,574,284,361,284,twilight sparkle
722783.png,https://derpicdn.net/img/view/2014/9/15/722783.png,0,0.994708836,478,473,956,951,478,478,twilight sparkle
724039.png,https://derpicdn.net/img/view/2014/9/17/724039.png,0,0.997339547,273,0,677,401,404,401,twilight sparkle
724960.jpg,https://derpicdn.net/img/view/2014/9/18/724960.jpg,0,0.993555546,324,19,676,371,352,352,twilight sparkle
727096.jpg,https://derpicdn.net/img/view/2014/9/22/727096.jpg,0,0.982419431,725,43,1016,335,291,292,twilight sparkle
730065.png,https://derpicdn.net/img/view/2014/9/26/730065.png,0,0.925058961,0,0,389,373,389,373,twilight sparkle
734412.png,https://derpicdn.net/img/view/2014/10/3/734412.png,0,0.999444723,612,0,1180,551,568,551,twilight sparkle
73941.png,https://derpicdn.net/img/view/2012/8/13/73941.png,0,0.927457988,184,54,810,680,626,626,twilight sparkle
74057.png,https://derpicdn.net/img/view/2012/8/13/74057.png,0,0.987098157,355,65,957,667,602,602,twilight sparkle
741718.png,https://derpicdn.net/img/view/2014/10/12/741718.png,0,0.999413431,1085,15,1662,615,577,600,twilight sparkle
742897.png,https://derpicdn.net/img/view/2014/10/14/742897.png,0,0.99527359,5,0,305,285,300,285,twilight sparkle
748064.jpg,https://derpicdn.net/img/view/2014/10/22/748064.jpg,0,0.985898197,174,43,500,369,326,326,twilight sparkle
74863.png,https://derpicdn.net/img/view/2012/8/15/74863.png,0,0.924950361,122,12,370,260,248,248,twilight sparkle
757210.png,https://derpicdn.net/img/view/2014/11/3/757210.png,0,0.993386805,1240,27,4156,2943,2916,2916,twilight sparkle
761614.png,https://derpicdn.net/img/view/2014/11/10/761614.png,1,0.998908281,722,624,1239,1150,517,526,twilight sparkle
761614.png,https://derpicdn.net/img/view/2014/11/10/761614.png,2,0.998403251,776,0,1096,305,320,305,twilight sparkle
761614.png,https://derpicdn.net/img/view/2014/11/10/761614.png,3,0.97920984,133,0,579,438,446,438,twilight sparkle
762949.png,https://derpicdn.net/img/view/2014/11/12/762949.png,0,0.994143426,29,0,861,781,832,781,twilight sparkle
763651.png,https://derpicdn.net/img/view/2014/11/13/763651.png,0,0.996402502,26,0,392,355,366,355,twilight sparkle
769473.png,https://derpicdn.net/img/view/2014/11/22/769473.png,0,0.98799181,214,13,762,561,548,548,twilight sparkle
771792.png,https://derpicdn.net/img/view/2014/11/25/771792.png,0,0.947881997,406,191,1708,1493,1302,1302,twilight sparkle
771912.png,https://derpicdn.net/img/view/2014/11/25/771912.png,0,0.990899265,262,3,478,219,216,216,twilight sparkle
774636.png,https://derpicdn.net/img/view/2014/11/30/774636.png,0,0.974846661,99,0,755,652,656,652,twilight sparkle
776095.png,https://derpicdn.net/img/view/2014/12/1/776095.png,0,0.994188249,708,139,1954,1385,1246,1246,twilight sparkle
776681.jpg,https://derpicdn.net/img/view/2014/12/2/776681.jpg,0,0.939347565,456,42,842,428,386,386,twilight sparkle
7801.jpg,https://derpicdn.net/img/view/2012/6/18/7801.jpg,0,0.999088168,0,343,356,713,356,370,twilight sparkle
782288.jpg,https://derpicdn.net/img/view/2014/12/10/782288.jpg,0,0.985555649,0,0,539,549,539,549,twilight sparkle
78460.png,https://derpicdn.net/img/view/2012/8/20/78460.png,0,0.9887501,212,138,720,646,508,508,twilight sparkle
787134.png,https://derpicdn.net/img/view/2014/12/18/787134.png,0,0.998882234,182,673,508,999,326,326,twilight sparkle
787353.png,https://derpicdn.net/img/view/2014/12/18/787353.png,0,0.985903382,58,0,248,187,190,187,twilight sparkle
787900.png,https://derpicdn.net/img/view/2014/12/19/787900.png,0,0.940998733,0,127,1024,1193,1024,1066,twilight sparkle
791873.png,https://derpicdn.net/img/view/2014/12/24/791873.png,0,0.907016814,629,30,813,214,184,184,twilight sparkle
793124.png,https://derpicdn.net/img/view/2014/12/26/793124.png,0,0.992198586,263,291,601,629,338,338,twilight sparkle
795349.png,https://derpicdn.net/img/view/2014/12/29/795349.png,0,0.948459148,101,0,600,529,499,529,twilight sparkle
797159.png,https://derpicdn.net/img/view/2015/1/1/797159.png,0,0.969139874,2169,730,5203,3764,3034,3034,twilight sparkle
79882.jpg,https://derpicdn.net/img/view/2012/8/22/79882.jpg,0,0.910807252,265,184,543,462,278,278,twilight sparkle
801277.png,https://derpicdn.net/img/view/2015/1/7/801277.png,0,0.998053074,257,33,593,369,336,336,twilight sparkle
801787.png,https://derpicdn.net/img/view/2015/1/8/801787.png,0,0.92782259,228,0,594,347,366,347,twilight sparkle
802116.png,https://derpicdn.net/img/view/2015/1/8/802116.png,0,0.944285214,127,9,501,383,374,374,twilight sparkle
803738.png,https://derpicdn.net/img/view/2015/1/11/803738.png,0,0.948792279,9,0,463,448,454,448,twilight sparkle
803916.png,https://derpicdn.net/img/view/2015/1/11/803916.png,0,0.997620642,0,0,244,241,244,241,twilight sparkle
805586.png,https://derpicdn.net/img/view/2015/1/13/805586.png,0,0.947687685,73,18,559,504,486,486,twilight sparkle
808116.png,https://derpicdn.net/img/view/2015/1/16/808116.png,0,0.999350131,735,0,1079,332,344,332,twilight sparkle
80813.png,https://derpicdn.net/img/view/2012/8/23/80813.png,0,0.963487923,119,0,471,332,352,332,twilight sparkle
808383.png,https://derpicdn.net/img/view/2015/1/17/808383.png,0,0.97702527,14,0,634,572,620,572,twilight sparkle
808800.png,https://derpicdn.net/img/view/2015/1/17/808800.png,0,0.996475935,2347,0,5000,2734,2653,2734,twilight sparkle
809201.jpg,https://derpicdn.net/img/view/2015/1/18/809201.jpg,0,0.997789383,1098,0,2270,975,1172,975,twilight sparkle
809413.jpg,https://derpicdn.net/img/view/2015/1/18/809413.jpg,0,0.997299075,2973,0,5277,2257,2304,2257,twilight sparkle
811218.png,https://derpicdn.net/img/view/2015/1/21/811218.png,0,0.991671979,525,35,2217,1727,1692,1692,twilight sparkle
812189.png,https://derpicdn.net/img/view/2015/1/22/812189.png,0,0.945352614,2371,565,3891,2085,1520,1520,twilight sparkle
812920.png,https://derpicdn.net/img/view/2015/1/23/812920.png,0,0.999453187,83,0,1763,1626,1680,1626,twilight sparkle
813652.png,https://derpicdn.net/img/view/2015/1/24/813652.png,0,0.991809666,429,326,585,482,156,156,twilight sparkle
814812.png,https://derpicdn.net/img/view/2015/1/26/814812.png,0,0.996519566,103,112,415,424,312,312,twilight sparkle
815453.jpg,https://derpicdn.net/img/view/2015/1/27/815453.jpg,0,0.98048079,1134,489,1566,921,432,432,twilight sparkle
815599.jpg,https://derpicdn.net/img/view/2015/1/27/815599.jpg,0,0.91995281,410,164,716,470,306,306,twilight sparkle
824765.jpg,https://derpicdn.net/img/view/2015/2/9/824765.jpg,0,0.98824209,0,37,424,525,424,488,twilight sparkle
825860.png,https://derpicdn.net/img/view/2015/2/11/825860.png,0,0.989327967,65,124,495,554,430,430,twilight sparkle
826694.jpg,https://derpicdn.net/img/view/2015/2/12/826694.jpg,0,0.996758759,725,161,1159,595,434,434,twilight sparkle
829609.png,https://derpicdn.net/img/view/2015/2/15/829609.png,0,0.98809588,178,84,1106,1012,928,928,twilight sparkle
829790.png,https://derpicdn.net/img/view/2015/2/16/829790.png,0,0.991317689,0,0,230,264,230,264,twilight sparkle
829790.png,https://derpicdn.net/img/view/2015/2/16/829790.png,1,0.939775825,0,0,246,287,246,287,twilight sparkle
837167.png,https://derpicdn.net/img/view/2015/2/25/837167.png,0,0.996253848,220,50,584,414,364,364,twilight sparkle
838813.png,https://derpicdn.net/img/view/2015/2/28/838813.png,0,0.967088461,634,323,1078,767,444,444,twilight sparkle
838968.png,https://derpicdn.net/img/view/2015/2/28/838968.png,0,0.961535811,117,0,1319,1148,1202,1148,twilight sparkle
839349.png,https://derpicdn.net/img/view/2015/2/28/839349.png,0,0.999035716,72,112,536,576,464,464,twilight sparkle
840166.png,https://derpicdn.net/img/view/2015/3/1/840166.png,0,0.960400999,0,0,5000,5337,5000,5337,twilight sparkle
842560.png,https://derpicdn.net/img/view/2015/3/5/842560.png,0,0.998904824,175,0,829,566,654,566,twilight sparkle
845775.jpg,https://derpicdn.net/img/view/2015/3/9/845775.jpg,0,0.974432051,0,127,580,875,580,748,twilight sparkle
846555.png,https://derpicdn.net/img/view/2015/3/10/846555.png,0,0.979564965,38,22,900,954,862,932,twilight sparkle
848439.jpg,https://derpicdn.net/img/view/2015/3/13/848439.jpg,0,0.992664099,525,76,769,320,244,244,twilight sparkle
848439.jpg,https://derpicdn.net/img/view/2015/3/13/848439.jpg,3,0.986437678,1427,23,1695,291,268,268,twilight sparkle
851185.png,https://derpicdn.net/img/view/2015/3/17/851185.png,0,0.984622896,290,68,544,322,254,254,twilight sparkle
85648.png,https://derpicdn.net/img/view/2012/8/29/85648.png,0,0.997794807,456,0,3148,2375,2692,2375,twilight sparkle
856717.jpg,https://derpicdn.net/img/view/2015/3/25/856717.jpg,0,0.990310788,44,0,766,645,722,645,twilight sparkle
857316.png,https://derpicdn.net/img/view/2015/3/26/857316.png,0,0.997623742,869,0,1861,967,992,967,twilight sparkle
860321.png,https://derpicdn.net/img/view/2015/3/30/860321.png,0,0.97367245,8,0,250,234,242,234,twilight sparkle
862597.png,https://derpicdn.net/img/view/2015/4/1/862597.png,0,0.996984959,91,93,1507,1509,1416,1416,twilight sparkle
863733.png,https://derpicdn.net/img/view/2015/4/3/863733.png,0,0.991628289,955,0,1871,887,916,887,twilight sparkle
864956.png,https://derpicdn.net/img/view/2015/4/4/864956.png,0,0.964213789,1202,12,3825,2752,2623,2740,twilight sparkle
870342.png,https://derpicdn.net/img/view/2015/4/10/870342.png,0,0.942700565,974,118,2300,1444,1326,1326,twilight sparkle
872062.png,https://derpicdn.net/img/view/2015/4/12/872062.png,0,0.993304312,25,22,709,706,684,684,twilight sparkle
872488.png,https://derpicdn.net/img/view/2015/4/12/872488.png,0,0.98645395,875,0,1563,652,688,652,twilight sparkle
872639.png,https://derpicdn.net/img/view/2015/4/12/872639.png,0,0.908552468,28,46,308,326,280,280,twilight sparkle
872754.png,https://derpicdn.net/img/view/2015/4/12/872754.png,0,0.994921863,104,0,610,465,506,465,twilight sparkle
875040.png,https://derpicdn.net/img/view/2015/4/16/875040.png,0,0.977306902,124,0,1022,851,898,851,twilight sparkle
875315.png,https://derpicdn.net/img/view/2015/4/16/875315.png,0,0.977707028,18,6,730,718,712,712,twilight sparkle
875406.png,https://derpicdn.net/img/view/2015/4/16/875406.png,0,0.983382463,300,26,762,488,462,462,twilight sparkle
878134.png,https://derpicdn.net/img/view/2015/4/19/878134.png,0,0.982867002,1029,1209,2235,2415,1206,1206,twilight sparkle
879443.png,https://derpicdn.net/img/view/2015/4/21/879443.png,0,0.919983745,0,0,552,420,552,420,twilight sparkle
880111.png,https://derpicdn.net/img/view/2015/4/22/880111.png,0,0.999578774,497,50,849,402,352,352,twilight sparkle
880238.png,https://derpicdn.net/img/view/2015/4/22/880238.png,0,0.973117352,709,283,1165,739,456,456,twilight sparkle
881864.png,https://derpicdn.net/img/view/2015/4/25/881864.png,0,0.983006537,84,0,378,292,294,292,twilight sparkle
884014.png,https://derpicdn.net/img/view/2015/4/27/884014.png,0,0.996058106,455,6,861,412,406,406,twilight sparkle
884502.png,https://derpicdn.net/img/view/2015/4/28/884502.png,0,0.966867566,2245,123,3538,1423,1293,1300,twilight sparkle
884504.png,https://derpicdn.net/img/view/2015/4/28/884504.png,0,0.919160187,2048,32,3571,1628,1523,1596,twilight sparkle
885344.png,https://derpicdn.net/img/view/2015/4/29/885344.png,0,0.942390501,84,228,780,924,696,696,twilight sparkle
887192.png,https://derpicdn.net/img/view/2015/5/2/887192.png,0,0.997146606,201,7,905,711,704,704,twilight sparkle
888255.png,https://derpicdn.net/img/view/2015/5/3/888255.png,0,0.992175996,599,0,1289,664,690,664,twilight sparkle
888848.png,https://derpicdn.net/img/view/2015/5/4/888848.png,0,0.955311656,482,0,1452,975,970,975,twilight sparkle
891142.png,https://derpicdn.net/img/view/2015/5/7/891142.png,0,0.998793066,15,16,491,492,476,476,twilight sparkle
893193.png,https://derpicdn.net/img/view/2015/5/10/893193.png,0,0.977436006,161,0,697,528,536,528,twilight sparkle
893263.png,https://derpicdn.net/img/view/2015/5/10/893263.png,0,0.991470754,303,662,1123,1482,820,820,twilight sparkle
893520.png,https://derpicdn.net/img/view/2015/5/10/893520.png,0,0.991807103,333,430,979,1076,646,646,twilight sparkle
898365.png,https://derpicdn.net/img/view/2015/5/17/898365.png,0,0.924616039,128,546,2540,2958,2412,2412,twilight sparkle
899861.png,https://derpicdn.net/img/view/2015/5/19/899861.png,0,0.985978842,73,21,1131,1079,1058,1058,twilight sparkle
901861.png,https://derpicdn.net/img/view/2015/5/22/901861.png,0,0.990243554,481,0,1265,698,784,698,twilight sparkle
902151.jpg,https://derpicdn.net/img/view/2015/5/23/902151.jpg,0,0.998924196,339,0,773,419,434,419,twilight sparkle
903153.png,https://derpicdn.net/img/view/2015/5/24/903153.png,0,0.944722891,785,0,1883,1004,1098,1004,twilight sparkle
903626.png,https://derpicdn.net/img/view/2015/5/25/903626.png,0,0.997054875,125,0,523,385,398,385,twilight sparkle
904042.png,https://derpicdn.net/img/view/2015/5/25/904042.png,0,0.993069589,1316,0,2744,1220,1428,1220,twilight sparkle
906596.png,https://derpicdn.net/img/view/2015/5/30/906596.png,0,0.985337555,2178,252,4000,2184,1822,1932,twilight sparkle
910773.png,https://derpicdn.net/img/view/2015/6/5/910773.png,0,0.995815217,1598,36,3086,1524,1488,1488,twilight sparkle
912988.png,https://derpicdn.net/img/view/2015/6/8/912988.png,0,0.996459424,321,0,765,422,444,422,twilight sparkle
913134.png,https://derpicdn.net/img/view/2015/6/8/913134.png,0,0.998343647,0,0,1140,1089,1140,1089,twilight sparkle
915695.png,https://derpicdn.net/img/view/2015/6/13/915695.png,0,0.996435583,659,0,1069,401,410,401,twilight sparkle
91590.jpg,https://derpicdn.net/img/view/2012/9/6/91590.jpg,0,0.991281092,355,42,559,246,204,204,twilight sparkle
91590.jpg,https://derpicdn.net/img/view/2012/9/6/91590.jpg,1,0.990950108,82,20,302,240,220,220,twilight sparkle
915974.png,https://derpicdn.net/img/view/2015/6/13/915974.png,0,0.959563255,68,0,900,819,832,819,twilight sparkle
919039.png,https://derpicdn.net/img/view/2015/6/18/919039.png,0,0.998672783,811,0,1815,887,1004,887,twilight sparkle
923174.png,https://derpicdn.net/img/view/2015/6/24/923174.png,0,0.995186627,550,0,1430,874,880,874,twilight sparkle
923963.png,https://derpicdn.net/img/view/2015/6/26/923963.png,0,0.997906685,1406,59,2848,1501,1442,1442,twilight sparkle
925936.png,https://derpicdn.net/img/view/2015/6/29/925936.png,0,0.997882843,1090,0,2509,1482,1419,1482,twilight sparkle
926986.png,https://derpicdn.net/img/view/2015/6/30/926986.png,0,0.970647871,18,0,476,423,458,423,twilight sparkle
927398.png,https://derpicdn.net/img/view/2015/7/1/927398.png,0,0.994642854,55,0,277,216,222,216,twilight sparkle
927398.png,https://derpicdn.net/img/view/2015/7/1/927398.png,1,0.980221748,498,19,878,399,380,380,twilight sparkle
930666.png,https://derpicdn.net/img/view/2015/7/5/930666.png,0,0.995402694,453,71,1007,625,554,554,twilight sparkle
932388.jpg,https://derpicdn.net/img/view/2015/7/8/932388.jpg,0,0.903259575,442,176,788,522,346,346,twilight sparkle
933049.png,https://derpicdn.net/img/view/2015/7/9/933049.png,0,0.949163377,636,903,1248,1515,612,612,twilight sparkle
934733.png,https://derpicdn.net/img/view/2015/7/11/934733.png,0,0.914891422,2012,0,3200,1160,1188,1160,twilight sparkle
935806.png,https://derpicdn.net/img/view/2015/7/12/935806.png,0,0.985508502,158,158,1870,1870,1712,1712,twilight sparkle
939814.jpg,https://derpicdn.net/img/view/2015/7/19/939814.jpg,0,0.980399191,683,0,1651,968,968,968,twilight sparkle
940698.png,https://derpicdn.net/img/view/2015/7/20/940698.png,0,0.973848283,26,56,504,534,478,478,twilight sparkle
941303.png,https://derpicdn.net/img/view/2015/7/21/941303.png,0,0.997268736,1263,0,2311,879,1048,879,twilight sparkle
941303.png,https://derpicdn.net/img/view/2015/7/21/941303.png,1,0.987132132,383,0,1531,1043,1148,1043,twilight sparkle
942923.png,https://derpicdn.net/img/view/2015/7/24/942923.png,0,0.985396206,0,70,954,1068,954,998,twilight sparkle
942952.png,https://derpicdn.net/img/view/2015/7/24/942952.png,0,0.933621347,3362,152,3882,672,520,520,twilight sparkle
945128.png,https://derpicdn.net/img/view/2015/7/27/945128.png,0,0.962071955,3381,1395,3777,1791,396,396,twilight sparkle
945128.png,https://derpicdn.net/img/view/2015/7/27/945128.png,1,0.949998736,2039,425,2663,1049,624,624,twilight sparkle
945128.png,https://derpicdn.net/img/view/2015/7/27/945128.png,2,0.942094743,935,584,1507,1156,572,572,twilight sparkle
947523.png,https://derpicdn.net/img/view/2015/7/30/947523.png,0,0.993620574,415,52,1155,792,740,740,twilight sparkle
947925.png,https://derpicdn.net/img/view/2015/7/31/947925.png,0,0.996754229,138,0,844,599,706,599,twilight sparkle
949207.png,https://derpicdn.net/img/view/2015/8/2/949207.png,0,0.906315148,80,5,622,547,542,542,twilight sparkle
949712.png,https://derpicdn.net/img/view/2015/8/3/949712.png,0,0.999343336,419,6,891,478,472,472,twilight sparkle
953736.png,https://derpicdn.net/img/view/2015/8/8/953736.png,0,0.905873418,635,0,5473,4619,4838,4619,twilight sparkle
953888.png,https://derpicdn.net/img/view/2015/8/8/953888.png,0,0.970042825,283,113,597,427,314,314,twilight sparkle
954870.png,https://derpicdn.net/img/view/2015/8/10/954870.png,0,0.997885346,11,3,463,455,452,452,twilight sparkle
957155.png,https://derpicdn.net/img/view/2015/8/13/957155.png,0,0.956156671,44,0,650,592,606,592,twilight sparkle
960339.png,https://derpicdn.net/img/view/2015/8/18/960339.png,0,0.999189496,656,0,1112,450,456,450,twilight sparkle
961355.png,https://derpicdn.net/img/view/2015/8/19/961355.png,0,0.999527037,18,0,414,363,396,363,twilight sparkle
961389.png,https://derpicdn.net/img/view/2015/8/20/961389.png,0,0.987175703,0,0,2210,2429,2210,2429,twilight sparkle
964485.png,https://derpicdn.net/img/view/2015/8/24/964485.png,0,0.992619336,2746,0,8628,5780,5882,5780,twilight sparkle
968073.png,https://derpicdn.net/img/view/2015/8/29/968073.png,0,0.988525927,0,0,2782,2856,2782,2856,twilight sparkle
970311.png,https://derpicdn.net/img/view/2015/9/1/970311.png,0,0.971473098,0,77,755,855,755,778,twilight sparkle
971516.png,https://derpicdn.net/img/view/2015/9/2/971516.png,0,0.997309029,0,0,149,134,149,134,twilight sparkle
973707.png,https://derpicdn.net/img/view/2015/9/6/973707.png,0,0.986347377,367,246,753,632,386,386,twilight sparkle
975737.png,https://derpicdn.net/img/view/2015/9/9/975737.png,0,0.998794794,287,0,695,408,408,408,twilight sparkle
978459.png,https://derpicdn.net/img/view/2015/9/12/978459.png,1,0.944096744,2559,392,3149,982,590,590,twilight sparkle
981328.png,https://derpicdn.net/img/view/2015/9/16/981328.png,0,0.991800666,65,85,787,807,722,722,twilight sparkle
981893.png,https://derpicdn.net/img/view/2015/9/17/981893.png,0,0.94907856,253,375,675,797,422,422,twilight sparkle
981965.png,https://derpicdn.net/img/view/2015/9/17/981965.png,0,0.999660969,2860,0,5540,2645,2680,2645,twilight sparkle
982452.png,https://derpicdn.net/img/view/2015/9/18/982452.png,0,0.999605834,133,0,439,287,306,287,twilight sparkle
983790.jpg,https://derpicdn.net/img/view/2015/9/20/983790.jpg,0,0.964962959,880,227,1234,581,354,354,twilight sparkle
985390.png,https://derpicdn.net/img/view/2015/9/22/985390.png,0,0.991402209,895,71,1613,789,718,718,twilight sparkle
985682.png,https://derpicdn.net/img/view/2015/9/22/985682.png,0,0.993167758,120,20,540,440,420,420,twilight sparkle
986398.png,https://derpicdn.net/img/view/2015/9/23/986398.png,0,0.992851794,428,3,852,427,424,424,twilight sparkle
986884.png,https://derpicdn.net/img/view/2015/9/24/986884.png,0,0.999072552,1805,0,3522,1519,1717,1519,twilight sparkle
987792.jpg,https://derpicdn.net/img/view/2015/9/25/987792.jpg,1,0.931234062,2778,336,3454,1012,676,676,twilight sparkle
989356.jpg,https://derpicdn.net/img/view/2015/9/27/989356.jpg,0,0.908412099,253,227,853,827,600,600,twilight sparkle
991360.jpg,https://derpicdn.net/img/view/2015/9/30/991360.jpg,0,0.971444488,0,26,683,854,683,828,twilight sparkle
992624.png,https://derpicdn.net/img/view/2015/10/2/992624.png,0,0.970530272,203,0,607,301,404,301,twilight sparkle
994348.png,https://derpicdn.net/img/view/2015/10/4/994348.png,0,0.98526293,536,288,846,598,310,310,twilight sparkle
994407.jpg,https://derpicdn.net/img/view/2015/10/4/994407.jpg,0,0.992360055,132,127,886,881,754,754,twilight sparkle
997113.png,https://derpicdn.net/img/view/2015/10/8/997113.png,0,0.996571839,396,251,742,597,346,346,twilight sparkle
997452.png,https://derpicdn.net/img/view/2015/10/8/997452.png,0,0.961112022,30,0,668,624,638,624,twilight sparkle
1000108.png,https://derpicdn.net/img/view/2015/10/11/1000108.png,0,0.994602203,4,0,286,263,282,263,twilight sparkle
1000535.png,https://derpicdn.net/img/view/2015/10/12/1000535.png,0,0.995227993,0,0,682,664,682,664,twilight sparkle
1008103.png,https://derpicdn.net/img/view/2015/10/23/1008103.png,0,0.988567948,3289,0,7903,4563,4614,4563,twilight sparkle
1008189.png,https://derpicdn.net/img/view/2015/10/23/1008189.png,0,0.999472141,20,0,470,438,450,438,twilight sparkle
1008604.jpg,https://derpicdn.net/img/view/2015/10/24/1008604.jpg,0,0.991350353,263,254,1223,1214,960,960,twilight sparkle
1009234.png,https://derpicdn.net/img/view/2015/10/24/1009234.png,0,0.996752739,198,10,634,446,436,436,twilight sparkle
1010780.png,https://derpicdn.net/img/view/2015/10/28/1010780.png,0,0.965221465,53,0,917,851,864,851,twilight sparkle
1012088.png,https://derpicdn.net/img/view/2015/10/29/1012088.png,0,0.991710544,924,356,1276,708,352,352,twilight sparkle
1012351.png,https://derpicdn.net/img/view/2015/10/30/1012351.png,0,0.996400952,834,13,1760,939,926,926,twilight sparkle
1012414.png,https://derpicdn.net/img/view/2015/10/30/1012414.png,0,0.948242188,1417,130,4981,3000,3564,2870,twilight sparkle
1013052.png,https://derpicdn.net/img/view/2015/10/31/1013052.png,0,0.999685049,222,7,480,265,258,258,twilight sparkle
1014683.png,https://derpicdn.net/img/view/2015/11/2/1014683.png,0,0.99523145,819,0,1569,722,750,722,twilight sparkle
1021014.png,https://derpicdn.net/img/view/2015/11/11/1021014.png,0,0.995200813,314,68,918,672,604,604,twilight sparkle
1021700.png,https://derpicdn.net/img/view/2015/11/12/1021700.png,0,0.946272492,106,0,306,198,200,198,twilight sparkle
1022994.png,https://derpicdn.net/img/view/2015/11/15/1022994.png,0,0.950354397,0,0,360,411,360,411,twilight sparkle
1024739.png,https://derpicdn.net/img/view/2015/11/17/1024739.png,0,0.99906373,449,163,761,475,312,312,twilight sparkle
1029522.png,https://derpicdn.net/img/view/2015/11/24/1029522.png,0,0.904012561,69,79,417,427,348,348,twilight sparkle
1030936.png,https://derpicdn.net/img/view/2015/11/27/1030936.png,0,0.980548799,455,0,947,487,492,487,twilight sparkle
1031546.png,https://derpicdn.net/img/view/2015/11/28/1031546.png,0,0.964487135,0,29,241,309,241,280,twilight sparkle
1031546.png,https://derpicdn.net/img/view/2015/11/28/1031546.png,1,0.907902122,25,5,249,229,224,224,twilight sparkle
1033001.png,https://derpicdn.net/img/view/2015/11/29/1033001.png,0,0.989034534,1139,351,2197,1409,1058,1058,twilight sparkle
1040780.png,https://derpicdn.net/img/view/2015/12/10/1040780.png,0,0.990529776,583,190,867,474,284,284,twilight sparkle
1040780.png,https://derpicdn.net/img/view/2015/12/10/1040780.png,1,0.958397329,191,136,575,520,384,384,twilight sparkle
1041103.png,https://derpicdn.net/img/view/2015/12/10/1041103.png,0,0.985962749,101,5,757,661,656,656,twilight sparkle
1043133.png,https://derpicdn.net/img/view/2015/12/13/1043133.png,0,0.985401273,0,336,2992,3528,2992,3192,twilight sparkle
1049654.png,https://derpicdn.net/img/view/2015/12/21/1049654.png,0,0.909911811,156,149,2136,2129,1980,1980,twilight sparkle
1052381.png,https://derpicdn.net/img/view/2015/12/25/1052381.png,0,0.980173528,337,257,623,543,286,286,twilight sparkle
1052381.png,https://derpicdn.net/img/view/2015/12/25/1052381.png,1,0.976938725,74,179,426,531,352,352,twilight sparkle
1053762.png,https://derpicdn.net/img/view/2015/12/27/1053762.png,0,0.981673717,213,0,773,466,560,466,twilight sparkle
1053993.png,https://derpicdn.net/img/view/2015/12/27/1053993.png,0,0.959897816,48,0,392,342,344,342,twilight sparkle
1055466.png,https://derpicdn.net/img/view/2015/12/30/1055466.png,0,0.954382002,161,3,589,431,428,428,twilight sparkle
1056239.png,https://derpicdn.net/img/view/2015/12/31/1056239.png,0,0.974366009,899,403,1489,993,590,590,twilight sparkle
105736.png,https://derpicdn.net/img/view/2012/9/24/105736.png,0,0.987136304,428,100,764,436,336,336,twilight sparkle
1059106.png,https://derpicdn.net/img/view/2016/1/3/1059106.png,0,0.917827129,1666,354,4088,3070,2422,2716,twilight sparkle
1059107.png,https://derpicdn.net/img/view/2016/1/3/1059107.png,0,0.983071029,67,0,687,593,620,593,twilight sparkle
1059538.png,https://derpicdn.net/img/view/2016/1/4/1059538.png,0,0.99825418,75,0,2079,1979,2004,1979,twilight sparkle
1061562.png,https://derpicdn.net/img/view/2016/1/7/1061562.png,0,0.998715103,38,6,292,260,254,254,twilight sparkle
1064055.png,https://derpicdn.net/img/view/2016/1/11/1064055.png,0,0.998051345,338,41,1196,899,858,858,twilight sparkle
106536.png,https://derpicdn.net/img/view/2012/9/25/106536.png,0,0.992021203,512,0,794,272,282,272,twilight sparkle
106536.png,https://derpicdn.net/img/view/2012/9/25/106536.png,1,0.988767684,85,0,379,274,294,274,twilight sparkle
1067743.png,https://derpicdn.net/img/view/2016/1/16/1067743.png,0,0.984493494,234,788,3922,4476,3688,3688,twilight sparkle
1069696.png,https://derpicdn.net/img/view/2016/1/19/1069696.png,0,0.971034586,151,15,453,317,302,302,twilight sparkle
1069696.png,https://derpicdn.net/img/view/2016/1/19/1069696.png,1,0.953239679,589,35,989,435,400,400,twilight sparkle
107010.png,https://derpicdn.net/img/view/2012/9/26/107010.png,0,0.936312616,80,0,520,431,440,431,twilight sparkle
1072915.png,https://derpicdn.net/img/view/2016/1/24/1072915.png,0,0.98334527,357,0,1705,1413,1348,1413,twilight sparkle
1073768.png,https://derpicdn.net/img/view/2016/1/25/1073768.png,0,0.998730898,234,0,722,429,488,429,twilight sparkle
1074729.png,https://derpicdn.net/img/view/2016/1/27/1074729.png,0,0.995437622,0,0,2621,2457,2621,2457,twilight sparkle
1076448.png,https://derpicdn.net/img/view/2016/1/30/1076448.png,0,0.964469016,0,104,1449,1818,1449,1714,twilight sparkle
1076962.png,https://derpicdn.net/img/view/2016/1/30/1076962.png,0,0.909969091,216,318,652,754,436,436,twilight sparkle
1082483.png,https://derpicdn.net/img/view/2016/2/7/1082483.png,0,0.935696244,996,40,1728,772,732,732,twilight sparkle
1082576.png,https://derpicdn.net/img/view/2016/2/7/1082576.png,0,0.960968971,81,500,301,720,220,220,twilight sparkle
1083613.png,https://derpicdn.net/img/view/2016/2/9/1083613.png,0,0.966815829,1024,0,2782,1637,1758,1637,twilight sparkle
1085082.png,https://derpicdn.net/img/view/2016/2/11/1085082.png,0,0.96638751,55,10,421,376,366,366,twilight sparkle
1085617.png,https://derpicdn.net/img/view/2016/2/11/1085617.png,0,0.963153899,0,41,950,1035,950,994,twilight sparkle
1087440.png,https://derpicdn.net/img/view/2016/2/14/1087440.png,0,0.968787968,472,1396,1218,2142,746,746,twilight sparkle
1088160.png,https://derpicdn.net/img/view/2016/2/14/1088160.png,0,0.994262397,237,0,587,329,350,329,twilight sparkle
1088731.png,https://derpicdn.net/img/view/2016/2/15/1088731.png,0,0.999778688,230,0,708,469,478,469,twilight sparkle
1090609.png,https://derpicdn.net/img/view/2016/2/17/1090609.png,0,0.989893436,261,0,711,449,450,449,twilight sparkle
1095966.png,https://derpicdn.net/img/view/2016/2/24/1095966.png,0,0.917977393,228,29,1180,981,952,952,twilight sparkle
1096400.png,https://derpicdn.net/img/view/2016/2/25/1096400.png,0,0.950210631,48,1911,3304,5167,3256,3256,twilight sparkle
1097210.png,https://derpicdn.net/img/view/2016/2/26/1097210.png,0,0.994090915,350,91,820,561,470,470,twilight sparkle
1097421.png,https://derpicdn.net/img/view/2016/2/26/1097421.png,0,0.954396307,249,21,561,333,312,312,twilight sparkle
1098119.png,https://derpicdn.net/img/view/2016/2/27/1098119.png,0,0.992388308,214,160,590,536,376,376,twilight sparkle
1099674.png,https://derpicdn.net/img/view/2016/3/1/1099674.png,0,0.993805945,190,0,1058,853,868,853,twilight sparkle
1101690.png,https://derpicdn.net/img/view/2016/3/4/1101690.png,0,0.997320831,1090,0,2384,1204,1294,1204,twilight sparkle
1101925.png,https://derpicdn.net/img/view/2016/3/4/1101925.png,0,0.997202933,226,580,892,1246,666,666,twilight sparkle
1102101.png,https://derpicdn.net/img/view/2016/3/5/1102101.png,0,0.993422985,1172,646,1672,1146,500,500,twilight sparkle
1103421.png,https://derpicdn.net/img/view/2016/3/6/1103421.png,0,0.993479311,1578,0,3908,1992,2330,1992,twilight sparkle
1105015.png,https://derpicdn.net/img/view/2016/3/8/1105015.png,0,0.997574627,2542,129,4472,2059,1930,1930,twilight sparkle
1106072.jpg,https://derpicdn.net/img/view/2016/3/10/1106072.jpg,0,0.930254519,108,14,598,514,490,500,twilight sparkle
1106253.png,https://derpicdn.net/img/view/2016/3/10/1106253.png,0,0.987929523,0,0,1474,1535,1474,1535,twilight sparkle
1106652.jpg,https://derpicdn.net/img/view/2016/3/11/1106652.jpg,0,0.984573245,436,19,1862,1445,1426,1426,twilight sparkle
1107116.png,https://derpicdn.net/img/view/2016/3/12/1107116.png,0,0.970077872,53,109,375,431,322,322,twilight sparkle
1109842.jpg,https://derpicdn.net/img/view/2016/3/16/1109842.jpg,0,0.975923896,910,89,1650,829,740,740,twilight sparkle
1111234.png,https://derpicdn.net/img/view/2016/3/18/1111234.png,0,0.964096427,1042,420,1918,1296,876,876,twilight sparkle
1112132.png,https://derpicdn.net/img/view/2016/3/19/1112132.png,1,0.987437189,2190,161,3476,1447,1286,1286,twilight sparkle
1114477.png,https://derpicdn.net/img/view/2016/3/22/1114477.png,0,0.900912523,553,0,1011,424,458,424,twilight sparkle
1115419.jpg,https://derpicdn.net/img/view/2016/3/23/1115419.jpg,0,0.992565334,395,5,1157,767,762,762,twilight sparkle
1120829.png,https://derpicdn.net/img/view/2016/3/31/1120829.png,0,0.987336218,0,199,1641,2061,1641,1862,twilight sparkle
1122270.png,https://derpicdn.net/img/view/2016/4/2/1122270.png,0,0.993297875,154,34,430,310,276,276,twilight sparkle
1123381.png,https://derpicdn.net/img/view/2016/4/3/1123381.png,0,0.997554004,0,3,307,313,307,310,twilight sparkle
1125345.png,https://derpicdn.net/img/view/2016/4/5/1125345.png,0,0.968062997,547,3,1461,917,914,914,twilight sparkle
1125430.png,https://derpicdn.net/img/view/2016/4/5/1125430.png,0,0.906767368,71,114,1911,1954,1840,1840,twilight sparkle
1129081.png,https://derpicdn.net/img/view/2016/4/10/1129081.png,0,0.966875792,0,180,3500,5138,3500,4958,twilight sparkle
1129481.png,https://derpicdn.net/img/view/2016/4/10/1129481.png,0,0.977530539,1209,0,2553,1300,1344,1300,twilight sparkle
1130924.png,https://derpicdn.net/img/view/2016/4/13/1130924.png,0,0.966489553,264,0,1532,1066,1268,1066,twilight sparkle
1131156.png,https://derpicdn.net/img/view/2016/4/13/1131156.png,0,0.999153376,1119,333,1969,1183,850,850,twilight sparkle
1131691.png,https://derpicdn.net/img/view/2016/4/14/1131691.png,1,0.995597363,308,64,598,354,290,290,twilight sparkle
1133026.png,https://derpicdn.net/img/view/2016/4/16/1133026.png,0,0.975173295,11,0,2387,2303,2376,2303,twilight sparkle
1135587.png,https://derpicdn.net/img/view/2016/4/19/1135587.png,0,0.997437894,639,59,1755,1175,1116,1116,twilight sparkle
1138270.png,https://derpicdn.net/img/view/2016/4/23/1138270.png,0,0.975948155,1776,0,6000,4296,4224,4296,twilight sparkle
1139013.png,https://derpicdn.net/img/view/2016/4/24/1139013.png,0,0.943684459,164,0,782,598,618,598,twilight sparkle
1140678.png,https://derpicdn.net/img/view/2016/4/26/1140678.png,0,0.999043167,367,27,927,587,560,560,twilight sparkle
1146766.png,https://derpicdn.net/img/view/2016/5/5/1146766.png,1,0.996471941,1865,472,2895,1502,1030,1030,twilight sparkle
1146979.png,https://derpicdn.net/img/view/2016/5/5/1146979.png,0,0.962342262,267,83,885,701,618,618,twilight sparkle
1148010.png,https://derpicdn.net/img/view/2016/5/6/1148010.png,0,0.98834151,128,0,410,266,282,266,twilight sparkle
1149625.png,https://derpicdn.net/img/view/2016/5/8/1149625.png,0,0.990123749,412,0,1020,536,608,536,twilight sparkle
1149968.png,https://derpicdn.net/img/view/2016/5/9/1149968.png,0,0.999135375,408,11,876,479,468,468,twilight sparkle
1150611.png,https://derpicdn.net/img/view/2016/5/10/1150611.png,0,0.904879808,1781,457,5793,4469,4012,4012,twilight sparkle
1153203.png,https://derpicdn.net/img/view/2016/5/13/1153203.png,0,0.967902243,433,43,1067,677,634,634,twilight sparkle
1153416.png,https://derpicdn.net/img/view/2016/5/14/1153416.png,0,0.919841647,378,148,742,512,364,364,twilight sparkle
115371.png,https://derpicdn.net/img/view/2012/10/6/115371.png,0,0.996349633,0,0,1001,879,1001,879,twilight sparkle
1153815.png,https://derpicdn.net/img/view/2016/5/14/1153815.png,0,0.981016815,21,0,781,490,760,490,twilight sparkle
1156792.png,https://derpicdn.net/img/view/2016/5/18/1156792.png,0,0.981582224,0,55,3226,3511,3226,3456,twilight sparkle
1159051.png,https://derpicdn.net/img/view/2016/5/21/1159051.png,0,0.960108995,4527,242,8403,4118,3876,3876,twilight sparkle
1159524.png,https://derpicdn.net/img/view/2016/5/21/1159524.png,0,0.988627195,27,0,505,437,478,437,twilight sparkle
1160415.png,https://derpicdn.net/img/view/2016/5/22/1160415.png,0,0.977933288,106,37,932,863,826,826,twilight sparkle
1161308.png,https://derpicdn.net/img/view/2016/5/23/1161308.png,0,0.997845113,617,0,1571,930,954,930,twilight sparkle
1161380.png,https://derpicdn.net/img/view/2016/5/23/1161380.png,0,0.975278914,346,0,816,452,470,452,twilight sparkle
1161446.png,https://derpicdn.net/img/view/2016/5/23/1161446.png,1,0.945318699,910,415,1698,1203,788,788,twilight sparkle
1162886.jpg,https://derpicdn.net/img/view/2016/5/25/1162886.jpg,0,0.984567344,129,14,1215,1100,1086,1086,twilight sparkle
1168451.png,https://derpicdn.net/img/view/2016/6/2/1168451.png,0,0.996667564,429,1,981,553,552,552,twilight sparkle
1168592.png,https://derpicdn.net/img/view/2016/6/2/1168592.png,0,0.951990068,19,0,865,844,846,844,twilight sparkle
1169007.png,https://derpicdn.net/img/view/2016/6/3/1169007.png,0,0.995441616,298,0,928,566,630,566,twilight sparkle
1169289.png,https://derpicdn.net/img/view/2016/6/3/1169289.png,0,0.980323374,366,2,1544,1180,1178,1178,twilight sparkle
1169833.png,https://derpicdn.net/img/view/2016/6/4/1169833.png,0,0.962018907,301,5,941,645,640,640,twilight sparkle
1170667.png,https://derpicdn.net/img/view/2016/6/5/1170667.png,0,0.998928249,986,0,2590,1592,1604,1592,twilight sparkle
1172236.png,https://derpicdn.net/img/view/2016/6/7/1172236.png,0,0.995855153,67,0,617,527,550,527,twilight sparkle
1174931.png,https://derpicdn.net/img/view/2016/6/10/1174931.png,0,0.987190962,379,81,901,603,522,522,twilight sparkle
1175558.jpg,https://derpicdn.net/img/view/2016/6/11/1175558.jpg,0,0.999731243,232,127,526,421,294,294,twilight sparkle
1177331.png,https://derpicdn.net/img/view/2016/6/13/1177331.png,0,0.990746796,136,89,494,447,358,358,twilight sparkle
1180274.png,https://derpicdn.net/img/view/2016/6/17/1180274.png,0,0.989085197,2384,0,5818,3369,3434,3369,twilight sparkle
1181113.png,https://derpicdn.net/img/view/2016/6/18/1181113.png,0,0.998661697,403,35,1213,845,810,810,twilight sparkle
1181782.png,https://derpicdn.net/img/view/2016/6/19/1181782.png,0,0.999864817,315,0,655,329,340,329,twilight sparkle
1183066.jpg,https://derpicdn.net/img/view/2016/6/20/1183066.jpg,0,0.988044441,403,0,911,463,508,463,twilight sparkle
1183564.png,https://derpicdn.net/img/view/2016/6/21/1183564.png,0,0.997169554,465,94,929,558,464,464,twilight sparkle
1187237.png,https://derpicdn.net/img/view/2016/6/26/1187237.png,0,0.960555553,236,40,1106,910,870,870,twilight sparkle
1187936.png,https://derpicdn.net/img/view/2016/6/27/1187936.png,0,0.914959133,373,8,923,558,550,550,twilight sparkle
1188716.png,https://derpicdn.net/img/view/2016/6/28/1188716.png,0,0.981588423,0,0,500,498,500,498,twilight sparkle
119005.png,https://derpicdn.net/img/view/2012/10/10/119005.png,0,0.9922328,546,48,1520,1022,974,974,twilight sparkle
1193970.png,https://derpicdn.net/img/view/2016/7/5/1193970.png,0,0.922895968,1049,0,3153,1971,2104,1971,twilight sparkle
1193972.png,https://derpicdn.net/img/view/2016/7/5/1193972.png,0,0.958025634,61,158,2745,2842,2684,2684,twilight sparkle
1197636.png,https://derpicdn.net/img/view/2016/7/10/1197636.png,0,0.963749945,67,0,761,663,694,663,twilight sparkle
1204703.png,https://derpicdn.net/img/view/2016/7/19/1204703.png,0,0.980955362,426,130,690,394,264,264,twilight sparkle
1205313.png,https://derpicdn.net/img/view/2016/7/20/1205313.png,0,0.981147885,79,77,493,491,414,414,twilight sparkle
1205313.png,https://derpicdn.net/img/view/2016/7/20/1205313.png,1,0.943092942,389,0,831,438,442,438,twilight sparkle
1205424.png,https://derpicdn.net/img/view/2016/7/20/1205424.png,0,0.976533592,979,117,1649,787,670,670,twilight sparkle
1208392.png,https://derpicdn.net/img/view/2016/7/24/1208392.png,0,0.989838541,0,454,1524,2172,1524,1718,twilight sparkle
1208667.png,https://derpicdn.net/img/view/2016/7/25/1208667.png,0,0.994456708,590,65,878,353,288,288,twilight sparkle
1210270.png,https://derpicdn.net/img/view/2016/7/27/1210270.png,0,0.953965366,225,135,873,783,648,648,twilight sparkle
1211073.png,https://derpicdn.net/img/view/2016/7/28/1211073.png,0,0.994815648,433,69,1339,975,906,906,twilight sparkle
1215909.png,https://derpicdn.net/img/view/2016/8/3/1215909.png,0,0.986540735,356,0,774,417,418,417,twilight sparkle
1218100.png,https://derpicdn.net/img/view/2016/8/6/1218100.png,0,0.982272148,486,339,750,603,264,264,twilight sparkle
1225859.png,https://derpicdn.net/img/view/2016/8/15/1225859.png,0,0.999218047,1452,0,2832,1377,1380,1377,twilight sparkle
1227462.png,https://derpicdn.net/img/view/2016/8/17/1227462.png,0,0.960957468,1491,338,2581,1428,1090,1090,twilight sparkle
1228115.png,https://derpicdn.net/img/view/2016/8/18/1228115.png,0,0.99935776,2335,30,4107,1802,1772,1772,twilight sparkle
1229728.png,https://derpicdn.net/img/view/2016/8/20/1229728.png,0,0.983393788,39,0,386,351,347,351,twilight sparkle
1229778.png,https://derpicdn.net/img/view/2016/8/20/1229778.png,0,0.986818016,0,0,409,402,409,402,twilight sparkle
123012.jpg,https://derpicdn.net/img/view/2012/10/14/123012.jpg,0,0.934352756,578,38,1286,746,708,708,twilight sparkle
1230129.png,https://derpicdn.net/img/view/2016/8/21/1230129.png,0,0.98769027,4,0,808,768,804,768,twilight sparkle
1232857.png,https://derpicdn.net/img/view/2016/8/24/1232857.png,0,0.963165283,961,537,3435,3011,2474,2474,twilight sparkle
1233334.png,https://derpicdn.net/img/view/2016/8/25/1233334.png,0,0.90281266,4,0,352,305,348,305,twilight sparkle
1233384.png,https://derpicdn.net/img/view/2016/8/25/1233384.png,0,0.9397012,362,512,5130,5280,4768,4768,twilight sparkle
1235209.png,https://derpicdn.net/img/view/2016/8/27/1235209.png,0,0.978354514,319,15,2349,2045,2030,2030,twilight sparkle
1236056.png,https://derpicdn.net/img/view/2016/8/28/1236056.png,0,0.975393295,236,10,722,496,486,486,twilight sparkle
1237158.png,https://derpicdn.net/img/view/2016/8/29/1237158.png,0,0.976605594,172,0,1910,1695,1738,1695,twilight sparkle
1239154.png,https://derpicdn.net/img/view/2016/9/1/1239154.png,0,0.916574538,0,0,977,801,977,801,twilight sparkle
124489.png,https://derpicdn.net/img/view/2012/10/16/124489.png,0,0.993178129,25,0,477,450,452,450,twilight sparkle
124504.png,https://derpicdn.net/img/view/2012/10/16/124504.png,0,0.949187756,331,376,673,718,342,342,twilight sparkle
1245932.png,https://derpicdn.net/img/view/2016/9/10/1245932.png,0,0.9096331,582,0,2600,2036,2018,2036,twilight sparkle
1247820.png,https://derpicdn.net/img/view/2016/9/12/1247820.png,0,0.985365093,441,106,1003,668,562,562,twilight sparkle
1248001.png,https://derpicdn.net/img/view/2016/9/12/1248001.png,0,0.978566945,64,0,4212,3992,4148,3992,twilight sparkle
1250523.png,https://derpicdn.net/img/view/2016/9/16/1250523.png,0,0.983765602,0,0,2064,2372,2064,2372,twilight sparkle
1252245.png,https://derpicdn.net/img/view/2016/9/18/1252245.png,0,0.974442005,611,0,9201,7874,8590,7874,twilight sparkle
1253917.png,https://derpicdn.net/img/view/2016/9/20/1253917.png,0,0.947577953,89,0,412,337,323,337,twilight sparkle
1255768.png,https://derpicdn.net/img/view/2016/9/22/1255768.png,0,0.997313738,303,0,1151,804,848,804,twilight sparkle
1256934.png,https://derpicdn.net/img/view/2016/9/24/1256934.png,0,0.928607643,120,0,494,366,374,366,twilight sparkle
1258712.png,https://derpicdn.net/img/view/2016/9/26/1258712.png,0,0.999457598,0,43,903,983,903,940,twilight sparkle
1259735.png,https://derpicdn.net/img/view/2016/9/27/1259735.png,0,0.999682188,400,219,658,477,258,258,twilight sparkle
1260953.png,https://derpicdn.net/img/view/2016/9/29/1260953.png,0,0.99702394,517,28,833,344,316,316,twilight sparkle
1261011.png,https://derpicdn.net/img/view/2016/9/29/1261011.png,0,0.94606477,102,82,840,819,738,737,twilight sparkle
1262227.png,https://derpicdn.net/img/view/2016/10/1/1262227.png,0,0.96815902,2500,667,4760,2927,2260,2260,twilight sparkle
1262486.png,https://derpicdn.net/img/view/2016/10/1/1262486.png,0,0.952126205,0,0,607,688,607,688,twilight sparkle
1262559.png,https://derpicdn.net/img/view/2016/10/1/1262559.png,0,0.986997366,0,3,222,225,222,222,twilight sparkle
1262611.png,https://derpicdn.net/img/view/2016/10/1/1262611.png,0,0.90087527,276,0,1860,1080,1584,1080,twilight sparkle
1262886.png,https://derpicdn.net/img/view/2016/10/1/1262886.png,0,0.984286904,0,0,532,521,532,521,twilight sparkle
1263249.png,https://derpicdn.net/img/view/2016/10/2/1263249.png,0,0.997738957,0,13,1517,1575,1517,1562,twilight sparkle
1263890.png,https://derpicdn.net/img/view/2016/10/3/1263890.png,0,0.992581785,657,243,1791,1377,1134,1134,twilight sparkle
1263973.png,https://derpicdn.net/img/view/2016/10/3/1263973.png,0,0.951043606,2,14,1666,1678,1664,1664,twilight sparkle
126450.png,https://derpicdn.net/img/view/2012/10/19/126450.png,0,0.980961382,237,15,517,295,280,280,twilight sparkle
1266168.png,https://derpicdn.net/img/view/2016/10/6/1266168.png,0,0.974561036,0,6,614,698,614,692,twilight sparkle
1267126.png,https://derpicdn.net/img/view/2016/10/7/1267126.png,0,0.990501642,0,0,2303,2340,2303,2340,twilight sparkle
1271299.png,https://derpicdn.net/img/view/2016/10/12/1271299.png,0,0.998102248,0,0,366,372,366,372,twilight sparkle
1273091.png,https://derpicdn.net/img/view/2016/10/15/1273091.png,0,0.998907685,26,0,1136,1060,1110,1060,twilight sparkle
1273641.png,https://derpicdn.net/img/view/2016/10/15/1273641.png,0,0.992255926,3124,74,6736,3686,3612,3612,twilight sparkle
1274400.png,https://derpicdn.net/img/view/2016/10/16/1274400.png,0,0.900322914,68,47,325,321,257,274,twilight sparkle
1276247.png,https://derpicdn.net/img/view/2016/10/18/1276247.png,0,0.91942662,95,0,1765,1080,1670,1080,twilight sparkle
1278139.png,https://derpicdn.net/img/view/2016/10/21/1278139.png,3,0.960669041,402,40,1160,798,758,758,twilight sparkle
1278139.png,https://derpicdn.net/img/view/2016/10/21/1278139.png,4,0.957514584,1567,66,2231,730,664,664,twilight sparkle
1278139.png,https://derpicdn.net/img/view/2016/10/21/1278139.png,5,0.903302729,567,1469,1431,2333,864,864,twilight sparkle
1279164.png,https://derpicdn.net/img/view/2016/10/22/1279164.png,0,0.98242557,531,185,1551,1205,1020,1020,twilight sparkle
1286157.png,https://derpicdn.net/img/view/2016/11/1/1286157.png,0,0.989269853,22,19,670,667,648,648,twilight sparkle
1287216.png,https://derpicdn.net/img/view/2016/11/2/1287216.png,0,0.978502095,380,138,838,596,458,458,twilight sparkle
1287388.png,https://derpicdn.net/img/view/2016/11/2/1287388.png,0,0.950119972,661,1214,6062,6872,5401,5658,twilight sparkle
1287421.png,https://derpicdn.net/img/view/2016/11/2/1287421.png,0,0.927424431,125,330,2567,2772,2442,2442,twilight sparkle
1290621.png,https://derpicdn.net/img/view/2016/11/7/1290621.png,0,0.991618097,620,146,2778,2304,2158,2158,twilight sparkle
1291932.png,https://derpicdn.net/img/view/2016/11/9/1291932.png,0,0.956364691,74,1,512,487,438,486,twilight sparkle
1296211.png,https://derpicdn.net/img/view/2016/11/15/1296211.png,0,0.951853454,343,0,2375,1996,2032,1996,twilight sparkle
1297704.png,https://derpicdn.net/img/view/2016/11/17/1297704.png,0,0.934504688,6707,2990,9237,5520,2530,2530,twilight sparkle
1297915.png,https://derpicdn.net/img/view/2016/11/17/1297915.png,0,0.998577416,233,220,861,848,628,628,twilight sparkle
1299359.png,https://derpicdn.net/img/view/2016/11/20/1299359.png,0,0.99803555,224,327,680,783,456,456,twilight sparkle
1302869.png,https://derpicdn.net/img/view/2016/11/24/1302869.png,0,0.969586849,0,0,1937,1936,1937,1936,twilight sparkle
1302914.png,https://derpicdn.net/img/view/2016/11/24/1302914.png,0,0.946208537,976,629,1584,1237,608,608,twilight sparkle
1303266.png,https://derpicdn.net/img/view/2016/11/25/1303266.png,0,0.972019255,54,164,2030,2140,1976,1976,twilight sparkle
1305259.png,https://derpicdn.net/img/view/2016/11/28/1305259.png,0,0.952197373,233,13,1389,1169,1156,1156,twilight sparkle
1305831.png,https://derpicdn.net/img/view/2016/11/29/1305831.png,0,0.976188362,308,38,2347,2390,2039,2352,twilight sparkle
1305838.png,https://derpicdn.net/img/view/2016/11/29/1305838.png,0,0.990230501,0,18,1067,1118,1067,1100,twilight sparkle
1309156.png,https://derpicdn.net/img/view/2016/12/3/1309156.png,0,0.999122202,595,325,1159,889,564,564,twilight sparkle
1312572.png,https://derpicdn.net/img/view/2016/12/8/1312572.png,0,0.996059299,3298,0,6630,3216,3332,3216,twilight sparkle
1315864.png,https://derpicdn.net/img/view/2016/12/12/1315864.png,0,0.956339598,100,28,700,628,600,600,twilight sparkle
1318842.png,https://derpicdn.net/img/view/2016/12/16/1318842.png,0,0.987025023,82,0,1248,1145,1166,1145,twilight sparkle
1320166.png,https://derpicdn.net/img/view/2016/12/18/1320166.png,0,0.98787272,301,223,1269,1191,968,968,twilight sparkle
1320182.png,https://derpicdn.net/img/view/2016/12/18/1320182.png,0,0.960102618,744,0,2790,1669,2046,1669,twilight sparkle
1321452.png,https://derpicdn.net/img/view/2016/12/20/1321452.png,0,0.999842167,1906,0,3838,1891,1932,1891,twilight sparkle
1321577.png,https://derpicdn.net/img/view/2016/12/20/1321577.png,0,0.997255147,683,385,1213,915,530,530,twilight sparkle
1323676.png,https://derpicdn.net/img/view/2016/12/23/1323676.png,0,0.993045986,140,0,481,354,341,354,twilight sparkle
1325047.png,https://derpicdn.net/img/view/2016/12/25/1325047.png,0,0.965987027,404,454,914,964,510,510,twilight sparkle
1326967.png,https://derpicdn.net/img/view/2016/12/28/1326967.png,0,0.992709041,827,63,1739,975,912,912,twilight sparkle
1332730.png,https://derpicdn.net/img/view/2017/1/5/1332730.png,0,0.981566608,164,131,856,823,692,692,twilight sparkle
1333136.png,https://derpicdn.net/img/view/2017/1/6/1333136.png,0,0.937343419,0,0,437,436,437,436,twilight sparkle
1335278.png,https://derpicdn.net/img/view/2017/1/9/1335278.png,0,0.989975512,454,591,820,957,366,366,twilight sparkle
1338446.png,https://derpicdn.net/img/view/2017/1/13/1338446.png,0,0.999511957,476,0,1268,683,792,683,twilight sparkle
1339302.png,https://derpicdn.net/img/view/2017/1/14/1339302.png,0,0.977788329,0,0,351,396,351,396,twilight sparkle
1339531.png,https://derpicdn.net/img/view/2017/1/14/1339531.png,0,0.996330142,177,0,779,598,602,598,twilight sparkle
1339717.png,https://derpicdn.net/img/view/2017/1/15/1339717.png,0,0.999624372,1100,12,1978,966,878,954,twilight sparkle
1341798.png,https://derpicdn.net/img/view/2017/1/18/1341798.png,1,0.990589201,2172,882,3404,2114,1232,1232,twilight sparkle
1346476.png,https://derpicdn.net/img/view/2017/1/23/1346476.png,0,0.960861087,856,0,2760,1760,1904,1760,twilight sparkle
1347855.png,https://derpicdn.net/img/view/2017/1/25/1347855.png,0,0.94194901,15,0,955,905,940,905,twilight sparkle
134799.png,https://derpicdn.net/img/view/2012/10/28/134799.png,0,0.998303473,1100,844,4604,4348,3504,3504,twilight sparkle
1348122.png,https://derpicdn.net/img/view/2017/1/26/1348122.png,0,0.994480431,32,0,1096,1043,1064,1043,twilight sparkle
1350810.png,https://derpicdn.net/img/view/2017/1/29/1350810.png,0,0.983595014,14,31,752,720,738,689,twilight sparkle
1355628.png,https://derpicdn.net/img/view/2017/2/5/1355628.png,0,0.967825353,118,324,542,748,424,424,twilight sparkle
1356343.png,https://derpicdn.net/img/view/2017/2/6/1356343.png,0,0.961382866,557,332,1563,1338,1006,1006,twilight sparkle
1360893.png,https://derpicdn.net/img/view/2017/2/12/1360893.png,0,0.998179853,670,82,1572,984,902,902,twilight sparkle
1361329.png,https://derpicdn.net/img/view/2017/2/12/1361329.png,0,0.977688432,1022,120,1508,606,486,486,twilight sparkle
1362108.png,https://derpicdn.net/img/view/2017/2/13/1362108.png,0,0.991322756,139,122,1711,1694,1572,1572,twilight sparkle
1362333.png,https://derpicdn.net/img/view/2017/2/14/1362333.png,0,0.997926176,401,62,787,448,386,386,twilight sparkle
1363001.png,https://derpicdn.net/img/view/2017/2/14/1363001.png,0,0.910149276,2090,530,3120,1560,1030,1030,twilight sparkle
1363458.png,https://derpicdn.net/img/view/2017/2/15/1363458.png,0,0.937731385,312,502,4993,5476,4681,4974,twilight sparkle
1366798.png,https://derpicdn.net/img/view/2017/2/18/1366798.png,0,0.996109545,158,0,770,597,612,597,twilight sparkle
1370362.png,https://derpicdn.net/img/view/2017/2/22/1370362.png,0,0.993253827,416,128,540,266,124,138,twilight sparkle
1371177.png,https://derpicdn.net/img/view/2017/2/23/1371177.png,0,0.995266199,781,604,1259,1082,478,478,twilight sparkle
1372420.png,https://derpicdn.net/img/view/2017/2/25/1372420.png,0,0.99967593,0,14,373,388,373,374,twilight sparkle
1372684.png,https://derpicdn.net/img/view/2017/2/25/1372684.png,1,0.92402631,377,115,691,429,314,314,twilight sparkle
1378565.png,https://derpicdn.net/img/view/2017/3/4/1378565.png,0,0.932527483,0,75,857,985,857,910,twilight sparkle
1379815.png,https://derpicdn.net/img/view/2017/3/5/1379815.png,0,0.991817236,51,0,3011,2798,2960,2798,twilight sparkle
1379848.png,https://derpicdn.net/img/view/2017/3/5/1379848.png,0,0.992555439,270,185,1060,975,790,790,twilight sparkle
1382203.png,https://derpicdn.net/img/view/2017/3/8/1382203.png,0,0.998384476,403,29,1549,1175,1146,1146,twilight sparkle
1382233.png,https://derpicdn.net/img/view/2017/3/8/1382233.png,0,0.948806584,772,495,1482,1205,710,710,twilight sparkle
1382529.png,https://derpicdn.net/img/view/2017/3/8/1382529.png,0,0.981390297,0,0,899,991,899,991,twilight sparkle
1383435.png,https://derpicdn.net/img/view/2017/3/10/1383435.png,0,0.958131433,329,0,1719,1226,1390,1226,twilight sparkle
1384092.png,https://derpicdn.net/img/view/2017/3/11/1384092.png,0,0.994553566,81,65,1749,1733,1668,1668,twilight sparkle
1384272.png,https://derpicdn.net/img/view/2017/3/11/1384272.png,0,0.904431581,722,11,2058,1347,1336,1336,twilight sparkle
1384304.png,https://derpicdn.net/img/view/2017/3/11/1384304.png,0,0.916815758,258,417,804,963,546,546,twilight sparkle
1385576.png,https://derpicdn.net/img/view/2017/3/12/1385576.png,0,0.98627156,494,718,1290,1514,796,796,twilight sparkle
1388386.png,https://derpicdn.net/img/view/2017/3/16/1388386.png,0,0.97408241,81,491,2952,3276,2871,2785,twilight sparkle
1390122.png,https://derpicdn.net/img/view/2017/3/18/1390122.png,0,0.956707478,478,193,1024,739,546,546,twilight sparkle
1391202.png,https://derpicdn.net/img/view/2017/3/19/1391202.png,0,0.999750674,470,32,916,478,446,446,twilight sparkle
1391454.png,https://derpicdn.net/img/view/2017/3/19/1391454.png,0,0.975159526,863,0,2713,1721,1850,1721,twilight sparkle
139180.png,https://derpicdn.net/img/view/2012/11/2/139180.png,0,0.981062293,20,0,688,571,668,571,twilight sparkle
1394443.png,https://derpicdn.net/img/view/2017/3/23/1394443.png,0,0.916407943,109,0,425,302,316,302,twilight sparkle
1397758.png,https://derpicdn.net/img/view/2017/3/27/1397758.png,0,0.982705951,797,177,1559,939,762,762,twilight sparkle
1398125.png,https://derpicdn.net/img/view/2017/3/28/1398125.png,0,0.980032742,1021,0,1697,676,676,676,twilight sparkle
1398305.png,https://derpicdn.net/img/view/2017/3/28/1398305.png,0,0.993446946,0,0,3325,3741,3325,3741,twilight sparkle
1398668.png,https://derpicdn.net/img/view/2017/3/28/1398668.png,0,0.987497091,192,3,1026,837,834,834,twilight sparkle
1401596.png,https://derpicdn.net/img/view/2017/4/1/1401596.png,0,0.996354878,288,51,1050,813,762,762,twilight sparkle
1402601.png,https://derpicdn.net/img/view/2017/4/2/1402601.png,0,0.962195575,9,0,821,722,812,722,twilight sparkle
1404972.png,https://derpicdn.net/img/view/2017/4/5/1404972.png,0,0.919418871,18,0,1200,1239,1182,1239,twilight sparkle
1408211.png,https://derpicdn.net/img/view/2017/4/10/1408211.png,0,0.981674552,1,0,492,505,491,505,twilight sparkle
1408268.png,https://derpicdn.net/img/view/2017/4/10/1408268.png,0,0.976288438,124,180,498,554,374,374,twilight sparkle
1408977.png,https://derpicdn.net/img/view/2017/4/11/1408977.png,0,0.968411207,983,0,1635,623,652,623,twilight sparkle
141016.png,https://derpicdn.net/img/view/2012/11/3/141016.png,0,0.993540287,203,0,625,416,422,416,twilight sparkle
1412447.png,https://derpicdn.net/img/view/2017/4/15/1412447.png,0,0.996948361,845,0,3607,2644,2762,2644,twilight sparkle
1413264.png,https://derpicdn.net/img/view/2017/4/16/1413264.png,0,0.907682955,59,0,409,345,350,345,twilight sparkle
1414644.png,https://derpicdn.net/img/view/2017/4/18/1414644.png,0,0.926003635,402,591,3472,3661,3070,3070,twilight sparkle
1415548.png,https://derpicdn.net/img/view/2017/4/18/1415548.png,0,0.990976751,458,7,988,537,530,530,twilight sparkle
1416873.png,https://derpicdn.net/img/view/2017/4/20/1416873.png,0,0.99013418,59,32,347,320,288,288,twilight sparkle
1419005.png,https://derpicdn.net/img/view/2017/4/22/1419005.png,0,0.998505294,718,43,1408,733,690,690,twilight sparkle
1423001.png,https://derpicdn.net/img/view/2017/4/27/1423001.png,0,0.994375288,35,0,541,483,506,483,twilight sparkle
1424012.png,https://derpicdn.net/img/view/2017/4/29/1424012.png,0,0.94423604,809,17,2455,1440,1646,1423,twilight sparkle
1425426.png,https://derpicdn.net/img/view/2017/4/30/1425426.png,0,0.925443351,275,248,533,506,258,258,twilight sparkle
1429945.png,https://derpicdn.net/img/view/2017/5/6/1429945.png,0,0.994569063,1251,29,2831,1609,1580,1580,twilight sparkle
1430666.png,https://derpicdn.net/img/view/2017/5/7/1430666.png,0,0.999559224,329,101,979,751,650,650,twilight sparkle
1432004.png,https://derpicdn.net/img/view/2017/5/8/1432004.png,0,0.907854915,0,280,7000,9532,7000,9252,twilight sparkle
1435029.png,https://derpicdn.net/img/view/2017/5/13/1435029.png,0,0.952094078,178,86,1730,1638,1552,1552,twilight sparkle
1437015.png,https://derpicdn.net/img/view/2017/5/15/1437015.png,0,0.999334872,341,445,1169,1273,828,828,twilight sparkle
1441499.png,https://derpicdn.net/img/view/2017/5/20/1441499.png,0,0.927168787,0,0,413,497,413,497,twilight sparkle
1443505.png,https://derpicdn.net/img/view/2017/5/22/1443505.png,0,0.997652411,153,22,885,754,732,732,twilight sparkle
1446008.png,https://derpicdn.net/img/view/2017/5/25/1446008.png,0,0.947076917,568,44,1234,710,666,666,twilight sparkle
1446280.png,https://derpicdn.net/img/view/2017/5/26/1446280.png,0,0.909097731,201,19,599,417,398,398,twilight sparkle
1446466.png,https://derpicdn.net/img/view/2017/5/26/1446466.png,0,0.93742317,84,53,758,727,674,674,twilight sparkle
1449982.png,https://derpicdn.net/img/view/2017/5/30/1449982.png,0,0.953883588,257,61,1041,845,784,784,twilight sparkle
1450550.png,https://derpicdn.net/img/view/2017/5/31/1450550.png,0,0.908396006,240,0,1876,1080,1636,1080,twilight sparkle
1452135.png,https://derpicdn.net/img/view/2017/6/2/1452135.png,0,0.967129052,2528,165,5488,3125,2960,2960,twilight sparkle
1452234.png,https://derpicdn.net/img/view/2017/6/2/1452234.png,0,0.992877245,0,0,933,946,933,946,twilight sparkle
1452235.png,https://derpicdn.net/img/view/2017/6/2/1452235.png,0,0.988112748,0,0,919,936,919,936,twilight sparkle
1453056.png,https://derpicdn.net/img/view/2017/6/3/1453056.png,0,0.992078066,8,0,480,451,472,451,twilight sparkle
1453093.png,https://derpicdn.net/img/view/2017/6/3/1453093.png,0,0.955650806,3635,0,8800,4829,5165,4829,twilight sparkle
1454719.png,https://derpicdn.net/img/view/2017/6/5/1454719.png,0,0.98884052,929,251,1901,1223,972,972,twilight sparkle
1462951.png,https://derpicdn.net/img/view/2017/6/16/1462951.png,0,0.988656938,39,0,451,376,412,376,twilight sparkle
1464596.png,https://derpicdn.net/img/view/2017/6/18/1464596.png,0,0.991006315,130,0,2944,2620,2814,2620,twilight sparkle
14656.jpg,https://derpicdn.net/img/view/2012/6/21/14656.jpg,0,0.958197773,191,37,939,785,748,748,twilight sparkle
1466130.png,https://derpicdn.net/img/view/2017/6/19/1466130.png,1,0.992476761,803,342,2029,1568,1226,1226,twilight sparkle
1476188.png,https://derpicdn.net/img/view/2017/7/1/1476188.png,0,0.959422767,102,0,544,401,442,401,twilight sparkle
1480152.png,https://derpicdn.net/img/view/2017/7/6/1480152.png,0,0.991232812,362,0,984,602,622,602,twilight sparkle
1482631.png,https://derpicdn.net/img/view/2017/7/10/1482631.png,0,0.998637855,731,36,1563,868,832,832,twilight sparkle
1485835.png,https://derpicdn.net/img/view/2017/7/14/1485835.png,0,0.971928418,323,129,2400,2321,2077,2192,twilight sparkle
1485945.png,https://derpicdn.net/img/view/2017/7/14/1485945.png,0,0.902914882,191,0,697,439,506,439,twilight sparkle
1486747.png,https://derpicdn.net/img/view/2017/7/15/1486747.png,0,0.986011505,95,128,1145,1178,1050,1050,twilight sparkle
1489796.png,https://derpicdn.net/img/view/2017/7/19/1489796.png,0,0.990013659,1951,75,6563,4687,4612,4612,twilight sparkle
1491194.png,https://derpicdn.net/img/view/2017/7/21/1491194.png,0,0.965172827,1,0,313,303,312,303,twilight sparkle
1492221.png,https://derpicdn.net/img/view/2017/7/22/1492221.png,0,0.978900611,58,105,868,915,810,810,twilight sparkle
1492363.png,https://derpicdn.net/img/view/2017/7/22/1492363.png,0,0.975518405,276,4,828,556,552,552,twilight sparkle
1493654.png,https://derpicdn.net/img/view/2017/7/24/1493654.png,0,0.991615653,727,85,1209,567,482,482,twilight sparkle
1495730.png,https://derpicdn.net/img/view/2017/7/27/1495730.png,0,0.953006566,1454,0,3098,1503,1644,1503,twilight sparkle
1498715.png,https://derpicdn.net/img/view/2017/7/30/1498715.png,0,0.996088088,380,130,778,528,398,398,twilight sparkle
1499358.png,https://derpicdn.net/img/view/2017/7/31/1499358.png,0,0.990885019,1052,0,1918,856,866,856,twilight sparkle
1501305.png,https://derpicdn.net/img/view/2017/8/2/1501305.png,0,0.998703182,880,43,1566,729,686,686,twilight sparkle
1503164.png,https://derpicdn.net/img/view/2017/8/5/1503164.png,0,0.951193869,153,225,908,972,755,747,twilight sparkle
1504805.png,https://derpicdn.net/img/view/2017/8/7/1504805.png,0,0.985052764,540,339,928,727,388,388,twilight sparkle
1510178.png,https://derpicdn.net/img/view/2017/8/14/1510178.png,0,0.994715333,1254,240,2340,1326,1086,1086,twilight sparkle
1511548.png,https://derpicdn.net/img/view/2017/8/15/1511548.png,0,0.971016109,967,0,3000,2037,2033,2037,twilight sparkle
1511739.png,https://derpicdn.net/img/view/2017/8/15/1511739.png,0,0.97969079,301,73,657,429,356,356,twilight sparkle
1512454.png,https://derpicdn.net/img/view/2017/8/16/1512454.png,0,0.978186786,805,1084,2363,2642,1558,1558,twilight sparkle
1514703.png,https://derpicdn.net/img/view/2017/8/19/1514703.png,0,0.953503847,899,44,1457,602,558,558,twilight sparkle
1516173.png,https://derpicdn.net/img/view/2017/8/21/1516173.png,0,0.989767134,1275,0,4456,3352,3181,3352,twilight sparkle
1516655.png,https://derpicdn.net/img/view/2017/8/21/1516655.png,0,0.948616564,382,313,818,749,436,436,twilight sparkle
1519856.png,https://derpicdn.net/img/view/2017/8/26/1519856.png,0,0.998352349,1813,146,2727,1060,914,914,twilight sparkle
1521654.png,https://derpicdn.net/img/view/2017/8/28/1521654.png,0,0.922583818,0,0,1393,1389,1393,1389,twilight sparkle
1524240.png,https://derpicdn.net/img/view/2017/8/31/1524240.png,0,0.991698384,0,544,2385,3036,2385,2492,twilight sparkle
1524533.png,https://derpicdn.net/img/view/2017/8/31/1524533.png,0,0.992981911,1244,257,1588,601,344,344,twilight sparkle
1527382.png,https://derpicdn.net/img/view/2017/9/4/1527382.png,0,0.99388957,0,0,1168,1148,1168,1148,twilight sparkle
1528038.png,https://derpicdn.net/img/view/2017/9/4/1528038.png,0,0.990160167,295,0,705,407,410,407,twilight sparkle
1528854.png,https://derpicdn.net/img/view/2017/9/5/1528854.png,0,0.961228669,2487,1455,3976,3051,1489,1596,twilight sparkle
1534969.png,https://derpicdn.net/img/view/2017/9/14/1534969.png,0,0.972769737,26,0,254,228,228,228,twilight sparkle
1545599.png,https://derpicdn.net/img/view/2017/9/26/1545599.png,0,0.999433696,817,0,1799,1084,982,1084,twilight sparkle
1546127.png,https://derpicdn.net/img/view/2017/9/27/1546127.png,0,0.986224592,0,0,601,610,601,610,twilight sparkle
1546838.png,https://derpicdn.net/img/view/2017/9/28/1546838.png,0,0.996748745,80,10,488,418,408,408,twilight sparkle
1553343.png,https://derpicdn.net/img/view/2017/10/6/1553343.png,0,0.995114863,499,24,1173,698,674,674,twilight sparkle
1553551.png,https://derpicdn.net/img/view/2017/10/6/1553551.png,0,0.994886518,169,51,785,667,616,616,twilight sparkle
1555264.png,https://derpicdn.net/img/view/2017/10/8/1555264.png,0,0.965464115,782,325,1528,1071,746,746,twilight sparkle
1556387.png,https://derpicdn.net/img/view/2017/10/9/1556387.png,0,0.95782429,1160,51,1600,493,440,442,twilight sparkle
1557820.png,https://derpicdn.net/img/view/2017/10/10/1557820.png,0,0.994351327,808,85,1198,475,390,390,twilight sparkle
1559511.png,https://derpicdn.net/img/view/2017/10/12/1559511.png,0,0.995561242,178,262,498,582,320,320,twilight sparkle
1559715.png,https://derpicdn.net/img/view/2017/10/13/1559715.png,0,0.993473709,327,0,1849,1488,1522,1488,twilight sparkle
1559861.png,https://derpicdn.net/img/view/2017/10/13/1559861.png,0,0.99727118,1406,0,3454,1992,2048,1992,twilight sparkle
1560768.png,https://derpicdn.net/img/view/2017/10/14/1560768.png,0,0.957109451,0,375,2543,3017,2543,2642,twilight sparkle
1563853.png,https://derpicdn.net/img/view/2017/10/17/1563853.png,0,0.936946332,3252,312,6250,3514,2998,3202,twilight sparkle
1564332.png,https://derpicdn.net/img/view/2017/10/18/1564332.png,0,0.939067781,176,0,1678,1080,1502,1080,twilight sparkle
1564649.png,https://derpicdn.net/img/view/2017/10/18/1564649.png,0,0.995543122,582,534,1330,1282,748,748,twilight sparkle
1565554.png,https://derpicdn.net/img/view/2017/10/20/1565554.png,0,0.989206314,275,372,1989,2086,1714,1714,twilight sparkle
1567463.png,https://derpicdn.net/img/view/2017/10/22/1567463.png,0,0.955550492,0,0,443,459,443,459,twilight sparkle
1567728.png,https://derpicdn.net/img/view/2017/10/22/1567728.png,0,0.99262768,314,0,824,460,510,460,twilight sparkle
1568679.png,https://derpicdn.net/img/view/2017/10/23/1568679.png,0,0.986281276,55,134,1401,1459,1346,1325,twilight sparkle
1569343.png,https://derpicdn.net/img/view/2017/10/24/1569343.png,0,0.982501507,0,63,523,631,523,568,twilight sparkle
1569444.png,https://derpicdn.net/img/view/2017/10/24/1569444.png,0,0.949997544,249,68,1451,1270,1202,1202,twilight sparkle
1569815.png,https://derpicdn.net/img/view/2017/10/25/1569815.png,0,0.994584858,47,0,641,568,594,568,twilight sparkle
1574676.png,https://derpicdn.net/img/view/2017/10/31/1574676.png,0,0.973394811,2551,492,5753,3736,3202,3244,twilight sparkle
1576471.png,https://derpicdn.net/img/view/2017/11/2/1576471.png,0,0.924156129,952,306,1840,1194,888,888,twilight sparkle
1578150.png,https://derpicdn.net/img/view/2017/11/4/1578150.png,0,0.994021475,23,0,565,518,542,518,twilight sparkle
1580890.png,https://derpicdn.net/img/view/2017/11/7/1580890.png,0,0.984082818,0,0,859,829,859,829,twilight sparkle
1584338.png,https://derpicdn.net/img/view/2017/11/12/1584338.png,0,0.996941984,1243,0,3019,1771,1776,1771,twilight sparkle
1586066.png,https://derpicdn.net/img/view/2017/11/14/1586066.png,0,0.9973405,551,0,1727,1156,1176,1156,twilight sparkle
1588547.png,https://derpicdn.net/img/view/2017/11/17/1588547.png,0,0.950482368,328,0,1444,1099,1116,1099,twilight sparkle
1589807.png,https://derpicdn.net/img/view/2017/11/19/1589807.png,0,0.931281686,581,0,4769,3413,4188,3413,twilight sparkle
1589853.png,https://derpicdn.net/img/view/2017/11/19/1589853.png,0,0.968105912,184,50,620,486,436,436,twilight sparkle
1589912.png,https://derpicdn.net/img/view/2017/11/19/1589912.png,0,0.982496917,533,602,1091,1160,558,558,twilight sparkle
1592873.png,https://derpicdn.net/img/view/2017/11/23/1592873.png,0,0.997384727,568,0,1000,439,432,439,twilight sparkle
1593103.png,https://derpicdn.net/img/view/2017/11/24/1593103.png,0,0.994439662,363,79,701,417,338,338,twilight sparkle
1593303.png,https://derpicdn.net/img/view/2017/11/24/1593303.png,0,0.992021203,14,34,466,486,452,452,twilight sparkle
1595840.png,https://derpicdn.net/img/view/2017/11/27/1595840.png,0,0.990477622,0,0,576,481,576,481,twilight sparkle
1596784.png,https://derpicdn.net/img/view/2017/11/29/1596784.png,0,0.985284209,159,124,4109,4074,3950,3950,twilight sparkle
1596785.png,https://derpicdn.net/img/view/2017/11/29/1596785.png,0,0.997954845,1948,0,5536,3479,3588,3479,twilight sparkle
1598249.png,https://derpicdn.net/img/view/2017/12/1/1598249.png,0,0.981120408,56,0,1072,720,1016,720,twilight sparkle
1599871.png,https://derpicdn.net/img/view/2017/12/3/1599871.png,0,0.988310516,1930,155,2718,943,788,788,twilight sparkle
1600363.png,https://derpicdn.net/img/view/2017/12/4/1600363.png,0,0.997940302,2516,112,6318,3914,3802,3802,twilight sparkle
1606487.png,https://derpicdn.net/img/view/2017/12/13/1606487.png,0,0.993092358,451,54,861,464,410,410,twilight sparkle
1607972.png,https://derpicdn.net/img/view/2017/12/14/1607972.png,0,0.984404445,231,7,600,409,369,402,twilight sparkle
1608183.png,https://derpicdn.net/img/view/2017/12/15/1608183.png,0,0.984593689,25,0,291,245,266,245,twilight sparkle
1608209.png,https://derpicdn.net/img/view/2017/12/15/1608209.png,0,0.994585991,722,342,1772,1392,1050,1050,twilight sparkle
1609239.png,https://derpicdn.net/img/view/2017/12/16/1609239.png,0,0.903213263,205,0,1143,720,938,720,twilight sparkle
1610031.png,https://derpicdn.net/img/view/2017/12/17/1610031.png,0,0.933407128,421,13,1285,877,864,864,twilight sparkle
1610303.png,https://derpicdn.net/img/view/2017/12/18/1610303.png,0,0.987353027,207,132,681,606,474,474,twilight sparkle
1610303.png,https://derpicdn.net/img/view/2017/12/18/1610303.png,1,0.963491678,521,445,1031,955,510,510,twilight sparkle
1611495.png,https://derpicdn.net/img/view/2017/12/19/1611495.png,0,0.999558151,1741,333,2971,1563,1230,1230,twilight sparkle
1612957.png,https://derpicdn.net/img/view/2017/12/21/1612957.png,0,0.988628149,1010,791,1564,1345,554,554,twilight sparkle
1612957.png,https://derpicdn.net/img/view/2017/12/21/1612957.png,1,0.985500991,414,608,1036,1230,622,622,twilight sparkle
1613587.png,https://derpicdn.net/img/view/2017/12/22/1613587.png,0,0.976801872,443,0,800,334,357,334,twilight sparkle
1613758.png,https://derpicdn.net/img/view/2017/12/23/1613758.png,0,0.987849772,337,0,3389,2943,3052,2943,twilight sparkle
1614485.png,https://derpicdn.net/img/view/2017/12/24/1614485.png,0,0.996431351,874,338,1280,744,406,406,twilight sparkle
1614490.png,https://derpicdn.net/img/view/2017/12/24/1614490.png,0,0.996192396,117,0,783,646,666,646,twilight sparkle
1614490.png,https://derpicdn.net/img/view/2017/12/24/1614490.png,1,0.995749176,707,186,1197,676,490,490,twilight sparkle
1617056.png,https://derpicdn.net/img/view/2017/12/27/1617056.png,0,0.985761762,2349,39,3829,1519,1480,1480,twilight sparkle
1619236.png,https://derpicdn.net/img/view/2017/12/29/1619236.png,0,0.943115294,1157,0,2931,1767,1774,1767,twilight sparkle
1619785.png,https://derpicdn.net/img/view/2017/12/30/1619785.png,0,0.996717215,438,212,1430,1204,992,992,twilight sparkle
1625219.png,https://derpicdn.net/img/view/2018/1/6/1625219.png,0,0.992394924,183,147,461,425,278,278,twilight sparkle
1627711.png,https://derpicdn.net/img/view/2018/1/9/1627711.png,0,0.914591193,423,136,771,484,348,348,twilight sparkle
1629924.png,https://derpicdn.net/img/view/2018/1/11/1629924.png,0,0.963944554,0,0,907,923,907,923,twilight sparkle
1638326.png,https://derpicdn.net/img/view/2018/1/22/1638326.png,0,0.952706754,756,0,1704,847,948,847,twilight sparkle
1639715.png,https://derpicdn.net/img/view/2018/1/24/1639715.png,0,0.99782604,149,0,553,384,404,384,twilight sparkle
1639715.png,https://derpicdn.net/img/view/2018/1/24/1639715.png,1,0.953179061,1128,0,1574,394,446,394,twilight sparkle
1641695.png,https://derpicdn.net/img/view/2018/1/26/1641695.png,0,0.999430358,2,0,508,470,506,470,twilight sparkle
1643224.png,https://derpicdn.net/img/view/2018/1/28/1643224.png,0,0.942227006,695,317,1255,877,560,560,twilight sparkle
1644124.png,https://derpicdn.net/img/view/2018/1/29/1644124.png,0,0.97468555,81,20,539,478,458,458,twilight sparkle
1645428.png,https://derpicdn.net/img/view/2018/1/31/1645428.png,0,0.981003046,321,0,873,521,552,521,twilight sparkle
1645751.png,https://derpicdn.net/img/view/2018/2/1/1645751.png,0,0.998813629,271,35,873,637,602,602,twilight sparkle
1646764.png,https://derpicdn.net/img/view/2018/2/2/1646764.png,0,0.908020914,93,34,979,920,886,886,twilight sparkle
1648715.png,https://derpicdn.net/img/view/2018/2/5/1648715.png,0,0.983942807,51,46,337,332,286,286,twilight sparkle
1649740.png,https://derpicdn.net/img/view/2018/2/6/1649740.png,0,0.973822176,0,32,1949,2380,1949,2348,twilight sparkle
1650868.png,https://derpicdn.net/img/view/2018/2/8/1650868.png,0,0.964049995,140,0,2106,1939,1966,1939,twilight sparkle
1651526.png,https://derpicdn.net/img/view/2018/2/9/1651526.png,0,0.951108694,223,68,1263,1108,1040,1040,twilight sparkle
1654789.png,https://derpicdn.net/img/view/2018/2/13/1654789.png,0,0.989632487,743,582,1275,1114,532,532,twilight sparkle
1654875.png,https://derpicdn.net/img/view/2018/2/13/1654875.png,0,0.973192573,654,1512,3690,4548,3036,3036,twilight sparkle
1657802.png,https://derpicdn.net/img/view/2018/2/16/1657802.png,0,0.998867631,0,3,1375,1439,1375,1436,twilight sparkle
1658887.png,https://derpicdn.net/img/view/2018/2/18/1658887.png,0,0.990661442,316,16,756,456,440,440,twilight sparkle
1659619.png,https://derpicdn.net/img/view/2018/2/18/1659619.png,0,0.973229408,1144,55,1930,841,786,786,twilight sparkle
1661062.png,https://derpicdn.net/img/view/2018/2/20/1661062.png,0,0.994576633,1925,0,4059,2038,2134,2038,twilight sparkle
1661105.png,https://derpicdn.net/img/view/2018/2/20/1661105.png,0,0.92612195,31,201,335,505,304,304,twilight sparkle
1661580.png,https://derpicdn.net/img/view/2018/2/20/1661580.png,0,0.997225881,193,258,581,646,388,388,twilight sparkle
1663282.png,https://derpicdn.net/img/view/2018/2/23/1663282.png,0,0.984429777,1282,333,2294,1345,1012,1012,twilight sparkle
1665345.png,https://derpicdn.net/img/view/2018/2/25/1665345.png,0,0.999564946,463,177,1111,825,648,648,twilight sparkle
1665490.png,https://derpicdn.net/img/view/2018/2/25/1665490.png,0,0.904968321,254,19,1008,773,754,754,twilight sparkle
1668183.png,https://derpicdn.net/img/view/2018/2/28/1668183.png,0,0.990716696,619,170,2285,1836,1666,1666,twilight sparkle
1671325.png,https://derpicdn.net/img/view/2018/3/4/1671325.png,0,0.904585183,436,1115,7000,7957,6564,6842,twilight sparkle
1673238.png,https://derpicdn.net/img/view/2018/3/6/1673238.png,0,0.913804173,156,0,1152,720,996,720,twilight sparkle
1674022.png,https://derpicdn.net/img/view/2018/3/7/1674022.png,0,0.964327693,51,91,501,530,450,439,twilight sparkle
1674870.png,https://derpicdn.net/img/view/2018/3/9/1674870.png,0,0.987881839,1687,880,2463,1656,776,776,twilight sparkle
1675048.png,https://derpicdn.net/img/view/2018/3/9/1675048.png,0,0.979090869,0,0,661,701,661,701,twilight sparkle
1675495.png,https://derpicdn.net/img/view/2018/3/9/1675495.png,0,0.984461546,293,0,683,388,390,388,twilight sparkle
1676203.png,https://derpicdn.net/img/view/2018/3/10/1676203.png,0,0.979787111,163,14,643,494,480,480,twilight sparkle
1676994.png,https://derpicdn.net/img/view/2018/3/11/1676994.png,0,0.987218857,858,0,1676,760,818,760,twilight sparkle
1677615.png,https://derpicdn.net/img/view/2018/3/11/1677615.png,0,0.955584824,117,0,429,247,312,247,twilight sparkle
1678017.png,https://derpicdn.net/img/view/2018/3/12/1678017.png,0,0.99598819,238,40,1664,1466,1426,1426,twilight sparkle
1682925.png,https://derpicdn.net/img/view/2018/3/17/1682925.png,0,0.940026581,0,94,619,780,619,686,twilight sparkle
1684338.png,https://derpicdn.net/img/view/2018/3/18/1684338.png,0,0.990641356,2807,2014,4109,3316,1302,1302,twilight sparkle
1686965.png,https://derpicdn.net/img/view/2018/3/21/1686965.png,0,0.972498715,308,0,748,433,440,433,twilight sparkle
1692517.png,https://derpicdn.net/img/view/2018/3/27/1692517.png,0,0.9805547,812,57,2760,2005,1948,1948,twilight sparkle
1692517.png,https://derpicdn.net/img/view/2018/3/27/1692517.png,1,0.944286168,3157,191,4770,1881,1613,1690,twilight sparkle
1692771.png,https://derpicdn.net/img/view/2018/3/28/1692771.png,0,0.988505483,198,105,2602,2382,2404,2277,twilight sparkle
1694938.png,https://derpicdn.net/img/view/2018/3/31/1694938.png,0,0.972338796,0,0,2879,2848,2879,2848,twilight sparkle
1695103.png,https://derpicdn.net/img/view/2018/3/31/1695103.png,0,0.94673717,80,0,726,618,646,618,twilight sparkle
1695575.png,https://derpicdn.net/img/view/2018/3/31/1695575.png,0,0.989305913,162,0,1080,1015,918,1015,twilight sparkle
1703955.png,https://derpicdn.net/img/view/2018/4/10/1703955.png,0,0.967162728,1437,0,4675,3206,3238,3206,twilight sparkle
1708591.png,https://derpicdn.net/img/view/2018/4/15/1708591.png,0,0.90612179,0,13,431,469,431,456,twilight sparkle
1710813.png,https://derpicdn.net/img/view/2018/4/18/1710813.png,0,0.990390539,591,103,1225,737,634,634,twilight sparkle
1711937.png,https://derpicdn.net/img/view/2018/4/19/1711937.png,0,0.994280696,0,0,277,283,277,283,twilight sparkle
1712405.png,https://derpicdn.net/img/view/2018/4/20/1712405.png,0,0.989655316,261,0,1001,697,740,697,twilight sparkle
1712486.png,https://derpicdn.net/img/view/2018/4/20/1712486.png,0,0.976949275,139,53,605,519,466,466,twilight sparkle
1713472.png,https://derpicdn.net/img/view/2018/4/21/1713472.png,0,0.97576946,0,0,521,587,521,587,twilight sparkle
1715522.png,https://derpicdn.net/img/view/2018/4/23/1715522.png,0,0.984163284,196,0,782,551,586,551,twilight sparkle
1716134.png,https://derpicdn.net/img/view/2018/4/24/1716134.png,0,0.998404145,0,0,1385,1330,1385,1330,twilight sparkle
1716496.png,https://derpicdn.net/img/view/2018/4/25/1716496.png,0,0.982567012,39,0,563,500,524,500,twilight sparkle
1717248.png,https://derpicdn.net/img/view/2018/4/26/1717248.png,0,0.994863093,0,0,2933,2865,2933,2865,twilight sparkle
1721872.png,https://derpicdn.net/img/view/2018/5/1/1721872.png,0,0.99820292,46,453,644,1051,598,598,twilight sparkle
1722722.png,https://derpicdn.net/img/view/2018/5/2/1722722.png,0,0.95083946,105,95,699,689,594,594,twilight sparkle
1722796.png,https://derpicdn.net/img/view/2018/5/3/1722796.png,0,0.965662718,0,272,2851,3308,2851,3036,twilight sparkle
1723145.png,https://derpicdn.net/img/view/2018/5/3/1723145.png,0,0.998608589,2305,0,4555,2143,2250,2143,twilight sparkle
1723662.png,https://derpicdn.net/img/view/2018/5/4/1723662.png,0,0.989547133,0,0,337,388,337,388,twilight sparkle
1724821.png,https://derpicdn.net/img/view/2018/5/5/1724821.png,0,0.986228287,0,1,480,563,480,562,twilight sparkle
1730602.png,https://derpicdn.net/img/view/2018/5/12/1730602.png,0,0.971164405,0,0,1597,1713,1597,1713,twilight sparkle
1731836.png,https://derpicdn.net/img/view/2018/5/13/1731836.png,0,0.961377442,63,120,449,500,386,380,twilight sparkle
1732382.png,https://derpicdn.net/img/view/2018/5/14/1732382.png,0,0.984924734,0,8,250,438,250,430,twilight sparkle
1733006.png,https://derpicdn.net/img/view/2018/5/15/1733006.png,0,0.998976707,153,5,815,667,662,662,twilight sparkle
1734737.png,https://derpicdn.net/img/view/2018/5/17/1734737.png,0,0.974582911,3579,0,6685,2417,3106,2417,twilight sparkle
1734780.png,https://derpicdn.net/img/view/2018/5/17/1734780.png,0,0.999463022,257,544,691,978,434,434,twilight sparkle
1734780.png,https://derpicdn.net/img/view/2018/5/17/1734780.png,1,0.946727574,566,538,1034,1006,468,468,twilight sparkle
1735207.png,https://derpicdn.net/img/view/2018/5/18/1735207.png,0,0.998605788,352,21,750,419,398,398,twilight sparkle
1735893.png,https://derpicdn.net/img/view/2018/5/18/1735893.png,0,0.993421257,217,65,1043,891,826,826,twilight sparkle
1735966.png,https://derpicdn.net/img/view/2018/5/18/1735966.png,0,0.964146435,119,62,980,970,861,908,twilight sparkle
1736140.png,https://derpicdn.net/img/view/2018/5/19/1736140.png,0,0.982140481,596,77,1260,741,664,664,twilight sparkle
1739554.png,https://derpicdn.net/img/view/2018/5/23/1739554.png,0,0.998601198,933,80,1953,1100,1020,1020,twilight sparkle
1739712.png,https://derpicdn.net/img/view/2018/5/23/1739712.png,0,0.956310272,116,0,1012,872,896,872,twilight sparkle
1740229.png,https://derpicdn.net/img/view/2018/5/24/1740229.png,0,0.973545313,0,0,455,444,455,444,twilight sparkle
1743272.png,https://derpicdn.net/img/view/2018/5/27/1743272.png,0,0.996116877,210,0,1064,805,854,805,twilight sparkle
1743860.png,https://derpicdn.net/img/view/2018/5/28/1743860.png,0,0.976556182,0,0,1280,1501,1280,1501,twilight sparkle
1747479.png,https://derpicdn.net/img/view/2018/6/2/1747479.png,0,0.999044478,193,801,1081,1689,888,888,twilight sparkle
1748288.png,https://derpicdn.net/img/view/2018/6/2/1748288.png,0,0.99849093,389,0,1725,1297,1336,1297,twilight sparkle
1748296.png,https://derpicdn.net/img/view/2018/6/2/1748296.png,0,0.996936977,2036,67,4241,2341,2205,2274,twilight sparkle
1751497.png,https://derpicdn.net/img/view/2018/6/6/1751497.png,0,0.998562455,682,12,1350,680,668,668,twilight sparkle
1756313.png,https://derpicdn.net/img/view/2018/6/12/1756313.png,0,0.932543278,349,0,2479,2083,2130,2083,twilight sparkle
1756463.png,https://derpicdn.net/img/view/2018/6/13/1756463.png,0,0.996759176,58,0,1632,1195,1574,1195,twilight sparkle
1758291.png,https://derpicdn.net/img/view/2018/6/15/1758291.png,0,0.983255208,21,104,927,1010,906,906,twilight sparkle
1759034.png,https://derpicdn.net/img/view/2018/6/16/1759034.png,0,0.99835217,1540,139,2758,1357,1218,1218,twilight sparkle
1760469.png,https://derpicdn.net/img/view/2018/6/18/1760469.png,0,0.982060313,501,16,1055,570,554,554,twilight sparkle
1761814.png,https://derpicdn.net/img/view/2018/6/20/1761814.png,0,0.963522136,117,1561,2257,3701,2140,2140,twilight sparkle
1762401.png,https://derpicdn.net/img/view/2018/6/20/1762401.png,0,0.95658493,152,0,644,461,492,461,twilight sparkle
1765346.png,https://derpicdn.net/img/view/2018/6/25/1765346.png,0,0.994907498,328,205,692,569,364,364,twilight sparkle
1765914.png,https://derpicdn.net/img/view/2018/6/25/1765914.png,0,0.990631461,93,0,1357,1246,1264,1246,twilight sparkle
1768010.png,https://derpicdn.net/img/view/2018/6/28/1768010.png,0,0.932030678,86,0,1158,1035,1072,1035,twilight sparkle
1768619.png,https://derpicdn.net/img/view/2018/6/29/1768619.png,0,0.96118319,32,0,980,846,948,846,twilight sparkle
1778168.png,https://derpicdn.net/img/view/2018/7/11/1778168.png,0,0.995534062,0,0,313,313,313,313,twilight sparkle
1778785.png,https://derpicdn.net/img/view/2018/7/11/1778785.png,0,0.990258038,82,0,690,514,608,514,twilight sparkle
1780144.png,https://derpicdn.net/img/view/2018/7/13/1780144.png,0,0.993712366,0,0,997,985,997,985,twilight sparkle
1783288.png,https://derpicdn.net/img/view/2018/7/17/1783288.png,1,0.980281711,1045,38,1443,436,398,398,twilight sparkle
1783477.png,https://derpicdn.net/img/view/2018/7/17/1783477.png,0,0.992233038,0,0,454,442,454,442,twilight sparkle
1784375.png,https://derpicdn.net/img/view/2018/7/19/1784375.png,0,0.998198867,778,2,1348,572,570,570,twilight sparkle
1784905.png,https://derpicdn.net/img/view/2018/7/19/1784905.png,0,0.997399628,1201,1832,2945,3576,1744,1744,twilight sparkle
1785090.png,https://derpicdn.net/img/view/2018/7/20/1785090.png,0,0.997604251,125,151,2063,2089,1938,1938,twilight sparkle
1785288.png,https://derpicdn.net/img/view/2018/7/20/1785288.png,0,0.985277414,85,375,4789,5079,4704,4704,twilight sparkle
1785298.png,https://derpicdn.net/img/view/2018/7/20/1785298.png,0,0.959407687,425,0,1851,1080,1426,1080,twilight sparkle
1785308.png,https://derpicdn.net/img/view/2018/7/20/1785308.png,0,0.965160429,135,0,1176,1109,1041,1109,twilight sparkle
1785921.png,https://derpicdn.net/img/view/2018/7/21/1785921.png,0,0.921476305,366,121,600,355,234,234,twilight sparkle
1786074.png,https://derpicdn.net/img/view/2018/7/21/1786074.png,0,0.997286499,2763,0,6183,3299,3420,3299,twilight sparkle
1786125.png,https://derpicdn.net/img/view/2018/7/21/1786125.png,0,0.932554781,21,48,797,801,776,753,twilight sparkle
1788393.png,https://derpicdn.net/img/view/2018/7/24/1788393.png,0,0.939457953,276,96,678,498,402,402,twilight sparkle
1788810.png,https://derpicdn.net/img/view/2018/7/24/1788810.png,0,0.992225647,297,22,857,582,560,560,twilight sparkle
1789067.png,https://derpicdn.net/img/view/2018/7/25/1789067.png,0,0.992217481,0,0,2025,1996,2025,1996,twilight sparkle
1791095.png,https://derpicdn.net/img/view/2018/7/27/1791095.png,0,0.972218513,16,0,892,683,876,683,twilight sparkle
1793563.png,https://derpicdn.net/img/view/2018/7/30/1793563.png,0,0.93940407,76,43,652,619,576,576,twilight sparkle
1793906.png,https://derpicdn.net/img/view/2018/7/31/1793906.png,0,0.996169269,742,181,1102,541,360,360,twilight sparkle
1794557.png,https://derpicdn.net/img/view/2018/7/31/1794557.png,0,0.916168094,157,79,913,835,756,756,twilight sparkle
1795666.png,https://derpicdn.net/img/view/2018/8/2/1795666.png,0,0.966845632,84,0,601,566,517,566,twilight sparkle
1796406.png,https://derpicdn.net/img/view/2018/8/2/1796406.png,0,0.998504698,99,0,1295,1151,1196,1151,twilight sparkle
1797440.png,https://derpicdn.net/img/view/2018/8/4/1797440.png,0,0.995078206,494,8,934,448,440,440,twilight sparkle
1798622.png,https://derpicdn.net/img/view/2018/8/5/1798622.png,0,0.994475603,1241,12,2657,1428,1416,1416,twilight sparkle
1799212.png,https://derpicdn.net/img/view/2018/8/6/1799212.png,0,0.956721723,299,200,1679,1862,1380,1662,twilight sparkle
1800117.png,https://derpicdn.net/img/view/2018/8/6/1800117.png,0,0.993483901,272,84,708,520,436,436,twilight sparkle
1800591.png,https://derpicdn.net/img/view/2018/8/7/1800591.png,0,0.997385025,633,406,1439,1212,806,806,twilight sparkle
1801160.png,https://derpicdn.net/img/view/2018/8/8/1801160.png,0,0.990899265,70,596,272,798,202,202,twilight sparkle
1801916.png,https://derpicdn.net/img/view/2018/8/8/1801916.png,1,0.935030878,232,309,952,1029,720,720,twilight sparkle
1802768.png,https://derpicdn.net/img/view/2018/8/9/1802768.png,0,0.99883455,428,67,718,357,290,290,twilight sparkle
1802768.png,https://derpicdn.net/img/view/2018/8/9/1802768.png,1,0.9920699,142,138,386,382,244,244,twilight sparkle
1806139.png,https://derpicdn.net/img/view/2018/8/13/1806139.png,0,0.981823683,1035,173,3813,2951,2778,2778,twilight sparkle
1807233.png,https://derpicdn.net/img/view/2018/8/15/1807233.png,0,0.971705794,76,46,670,640,594,594,twilight sparkle
1808641.png,https://derpicdn.net/img/view/2018/8/16/1808641.png,0,0.986491024,278,0,964,667,686,667,twilight sparkle
1812032.png,https://derpicdn.net/img/view/2018/8/21/1812032.png,0,0.966292202,0,24,784,922,784,898,twilight sparkle
1812126.png,https://derpicdn.net/img/view/2018/8/21/1812126.png,0,0.998741806,0,0,4692,4760,4692,4760,twilight sparkle
1812707.png,https://derpicdn.net/img/view/2018/8/21/1812707.png,0,0.995211244,186,0,1998,1757,1812,1757,twilight sparkle
1813354.png,https://derpicdn.net/img/view/2018/8/22/1813354.png,0,0.981029212,1161,41,1955,835,794,794,twilight sparkle
1815082.png,https://derpicdn.net/img/view/2018/8/24/1815082.png,0,0.985470533,447,0,1705,1192,1258,1192,twilight sparkle
1815398.png,https://derpicdn.net/img/view/2018/8/25/1815398.png,0,0.909897506,0,44,760,942,760,898,twilight sparkle
1816319.png,https://derpicdn.net/img/view/2018/8/26/1816319.png,0,0.983424485,83,53,2157,2127,2074,2074,twilight sparkle
181669.png,https://derpicdn.net/img/view/2012/12/13/181669.png,0,0.999642491,0,18,391,410,391,392,twilight sparkle
181669.png,https://derpicdn.net/img/view/2012/12/13/181669.png,1,0.995553315,495,583,853,941,358,358,twilight sparkle
181669.png,https://derpicdn.net/img/view/2012/12/13/181669.png,2,0.993166447,399,0,795,384,396,384,twilight sparkle
1818235.png,https://derpicdn.net/img/view/2018/8/28/1818235.png,0,0.973764658,0,0,3576,4033,3576,4033,twilight sparkle
1818657.png,https://derpicdn.net/img/view/2018/8/28/1818657.png,0,0.993232727,447,9,1023,585,576,576,twilight sparkle
1818983.png,https://derpicdn.net/img/view/2018/8/28/1818983.png,0,0.999003232,1335,28,2051,744,716,716,twilight sparkle
1819291.png,https://derpicdn.net/img/view/2018/8/29/1819291.png,0,0.945117176,83,1,457,375,374,374,twilight sparkle
1822637.png,https://derpicdn.net/img/view/2018/9/2/1822637.png,0,0.933462024,795,46,1499,750,704,704,twilight sparkle
1822861.png,https://derpicdn.net/img/view/2018/9/2/1822861.png,0,0.93799144,188,0,886,659,698,659,twilight sparkle
1826060.png,https://derpicdn.net/img/view/2018/9/6/1826060.png,0,0.998316169,823,0,1605,775,782,775,twilight sparkle
1826520.png,https://derpicdn.net/img/view/2018/9/6/1826520.png,0,0.997893095,72,0,842,764,770,764,twilight sparkle
1826978.png,https://derpicdn.net/img/view/2018/9/7/1826978.png,0,0.985071778,83,41,745,703,662,662,twilight sparkle
1830512.png,https://derpicdn.net/img/view/2018/9/11/1830512.png,0,0.997063637,64,71,380,387,316,316,twilight sparkle
1834907.png,https://derpicdn.net/img/view/2018/9/17/1834907.png,0,0.997449577,1636,228,2288,880,652,652,twilight sparkle
1836485.png,https://derpicdn.net/img/view/2018/9/19/1836485.png,0,0.995195746,1015,545,6275,5805,5260,5260,twilight sparkle
1836739.png,https://derpicdn.net/img/view/2018/9/20/1836739.png,0,0.913123667,1288,787,1768,1267,480,480,twilight sparkle
1838430.png,https://derpicdn.net/img/view/2018/9/22/1838430.png,0,0.986377001,753,0,2333,1439,1580,1439,twilight sparkle
1838469.png,https://derpicdn.net/img/view/2018/9/22/1838469.png,0,0.943654537,426,66,1028,668,602,602,twilight sparkle
1838522.png,https://derpicdn.net/img/view/2018/9/22/1838522.png,0,0.983521402,1607,111,2917,1421,1310,1310,twilight sparkle
1843173.png,https://derpicdn.net/img/view/2018/9/28/1843173.png,0,0.980420649,88,1,348,261,260,260,twilight sparkle
1844873.png,https://derpicdn.net/img/view/2018/9/30/1844873.png,0,0.988904893,0,0,512,533,512,533,twilight sparkle
1855698.png,https://derpicdn.net/img/view/2018/10/13/1855698.png,0,0.938565433,325,0,1055,572,730,572,twilight sparkle
1855986.png,https://derpicdn.net/img/view/2018/10/14/1855986.png,0,0.994126856,1847,0,3623,1535,1776,1535,twilight sparkle
1856148.png,https://derpicdn.net/img/view/2018/10/14/1856148.png,0,0.992008686,740,206,1906,1372,1166,1166,twilight sparkle
1856215.png,https://derpicdn.net/img/view/2018/10/14/1856215.png,0,0.979500353,0,0,3533,3551,3533,3551,twilight sparkle
1859453.png,https://derpicdn.net/img/view/2018/10/18/1859453.png,0,0.979807615,44,0,232,188,188,188,twilight sparkle
1864467.png,https://derpicdn.net/img/view/2018/10/24/1864467.png,0,0.998461127,40,0,472,421,432,421,twilight sparkle
186454.png,https://derpicdn.net/img/view/2012/12/18/186454.png,0,0.997816324,215,0,603,373,388,373,twilight sparkle
1864616.png,https://derpicdn.net/img/view/2018/10/24/1864616.png,0,0.993359804,972,9,1668,705,696,696,twilight sparkle
1866188.png,https://derpicdn.net/img/view/2018/10/26/1866188.png,0,0.955415487,947,392,1933,1378,986,986,twilight sparkle
1867493.png,https://derpicdn.net/img/view/2018/10/27/1867493.png,0,0.991295934,110,325,1112,1200,1002,875,twilight sparkle
1869078.png,https://derpicdn.net/img/view/2018/10/29/1869078.png,0,0.993255734,429,0,3907,2400,3478,2400,twilight sparkle
1879429.png,https://derpicdn.net/img/view/2018/11/10/1879429.png,0,0.974953175,268,0,2558,2235,2290,2235,twilight sparkle
1879719.png,https://derpicdn.net/img/view/2018/11/11/1879719.png,0,0.937133312,610,0,3442,2160,2832,2160,twilight sparkle
1879726.png,https://derpicdn.net/img/view/2018/11/11/1879726.png,0,0.998927653,761,303,1113,655,352,352,twilight sparkle
1882574.png,https://derpicdn.net/img/view/2018/11/15/1882574.png,0,0.969725251,241,0,795,529,554,529,twilight sparkle
1884047.png,https://derpicdn.net/img/view/2018/11/17/1884047.png,0,0.990681469,542,0,1574,853,1032,853,twilight sparkle
1884405.png,https://derpicdn.net/img/view/2018/11/17/1884405.png,0,0.989914656,0,0,951,912,951,912,twilight sparkle
1884415.png,https://derpicdn.net/img/view/2018/11/17/1884415.png,0,0.996722102,380,0,606,210,226,210,twilight sparkle
1886040.png,https://derpicdn.net/img/view/2018/11/19/1886040.png,0,0.99676168,322,363,892,933,570,570,twilight sparkle
1886955.png,https://derpicdn.net/img/view/2018/11/20/1886955.png,0,0.905353665,0,0,809,806,809,806,twilight sparkle
1887650.png,https://derpicdn.net/img/view/2018/11/21/1887650.png,0,0.994468868,1692,0,3614,1817,1922,1817,twilight sparkle
1890577.png,https://derpicdn.net/img/view/2018/11/25/1890577.png,0,0.945565283,79,0,367,284,288,284,twilight sparkle
1892343.png,https://derpicdn.net/img/view/2018/11/27/1892343.png,0,0.929313183,138,0,988,822,850,822,twilight sparkle
1893351.png,https://derpicdn.net/img/view/2018/11/29/1893351.png,0,0.983986318,525,183,1165,823,640,640,twilight sparkle
1897156.png,https://derpicdn.net/img/view/2018/12/3/1897156.png,0,0.928648055,16,121,646,751,630,630,twilight sparkle
1898014.png,https://derpicdn.net/img/view/2018/12/4/1898014.png,0,0.998446703,1557,98,3269,1810,1712,1712,twilight sparkle
1899124.png,https://derpicdn.net/img/view/2018/12/5/1899124.png,0,0.958563149,138,323,2324,2509,2186,2186,twilight sparkle
1900090.png,https://derpicdn.net/img/view/2018/12/6/1900090.png,0,0.977907777,985,466,1447,928,462,462,twilight sparkle
1900699.png,https://derpicdn.net/img/view/2018/12/7/1900699.png,0,0.998668671,382,0,710,275,328,275,twilight sparkle
1901483.png,https://derpicdn.net/img/view/2018/12/7/1901483.png,0,0.974625409,0,44,263,320,263,276,twilight sparkle
1901483.png,https://derpicdn.net/img/view/2018/12/7/1901483.png,1,0.917353749,49,14,303,268,254,254,twilight sparkle
1902248.png,https://derpicdn.net/img/view/2018/12/8/1902248.png,0,0.993127346,769,0,1839,1058,1070,1058,twilight sparkle
1905190.png,https://derpicdn.net/img/view/2018/12/11/1905190.png,0,0.944876194,40,0,490,440,450,440,twilight sparkle
1905826.png,https://derpicdn.net/img/view/2018/12/11/1905826.png,0,0.999014199,0,0,3025,2802,3025,2802,twilight sparkle
1906239.png,https://derpicdn.net/img/view/2018/12/12/1906239.png,0,0.995253921,134,501,1538,1905,1404,1404,twilight sparkle
1906255.png,https://derpicdn.net/img/view/2018/12/12/1906255.png,0,0.997632861,475,69,3073,2667,2598,2598,twilight sparkle
1906452.png,https://derpicdn.net/img/view/2018/12/12/1906452.png,0,0.96267426,0,0,677,671,677,671,twilight sparkle
1911691.png,https://derpicdn.net/img/view/2018/12/18/1911691.png,0,0.995231211,647,22,1541,916,894,894,twilight sparkle
1911866.png,https://derpicdn.net/img/view/2018/12/18/1911866.png,0,0.99327594,443,0,1075,604,632,604,twilight sparkle
1917825.png,https://derpicdn.net/img/view/2018/12/24/1917825.png,0,0.998546243,102,0,472,338,370,338,twilight sparkle
1918165.png,https://derpicdn.net/img/view/2018/12/25/1918165.png,0,0.990073621,182,18,1024,868,842,850,twilight sparkle
1919142.png,https://derpicdn.net/img/view/2018/12/26/1919142.png,0,0.998229861,548,1917,1582,2951,1034,1034,twilight sparkle
1925312.png,https://derpicdn.net/img/view/2019/1/3/1925312.png,0,0.993366301,592,0,1280,704,688,704,twilight sparkle
1925488.png,https://derpicdn.net/img/view/2019/1/3/1925488.png,0,0.928592741,69,0,1153,1036,1084,1036,twilight sparkle
1928242.png,https://derpicdn.net/img/view/2019/1/6/1928242.png,0,0.997593582,244,31,524,311,280,280,twilight sparkle
1928369.png,https://derpicdn.net/img/view/2019/1/6/1928369.png,0,0.998182535,271,420,641,790,370,370,twilight sparkle
1931709.png,https://derpicdn.net/img/view/2019/1/10/1931709.png,0,0.998953819,455,0,929,462,474,462,twilight sparkle
1931957.png,https://derpicdn.net/img/view/2019/1/11/1931957.png,0,0.990716279,72,0,3154,2961,3082,2961,twilight sparkle
1932559.png,https://derpicdn.net/img/view/2019/1/11/1932559.png,0,0.98753804,106,34,630,558,524,524,twilight sparkle
1934247.png,https://derpicdn.net/img/view/2019/1/13/1934247.png,0,0.981407762,995,1236,2033,2274,1038,1038,twilight sparkle
1937625.png,https://derpicdn.net/img/view/2019/1/17/1937625.png,0,0.994625568,214,65,720,540,506,475,twilight sparkle
1938223.png,https://derpicdn.net/img/view/2019/1/18/1938223.png,0,0.946387947,108,1096,2342,3330,2234,2234,twilight sparkle
1939245.png,https://derpicdn.net/img/view/2019/1/19/1939245.png,0,0.972161114,87,344,3311,3000,3224,2656,twilight sparkle
1939245.png,https://derpicdn.net/img/view/2019/1/19/1939245.png,1,0.926608026,0,115,2537,2747,2537,2632,twilight sparkle
1940934.png,https://derpicdn.net/img/view/2019/1/21/1940934.png,0,0.981441438,23,0,575,541,552,541,twilight sparkle
1944801.png,https://derpicdn.net/img/view/2019/1/26/1944801.png,0,0.990966856,1062,462,2124,1524,1062,1062,twilight sparkle
1946413.png,https://derpicdn.net/img/view/2019/1/28/1946413.png,0,0.99575609,63,49,667,653,604,604,twilight sparkle
1946959.png,https://derpicdn.net/img/view/2019/1/28/1946959.png,0,0.983654737,72,0,1262,939,1190,939,twilight sparkle
1947284.png,https://derpicdn.net/img/view/2019/1/29/1947284.png,0,0.95246774,1141,194,1461,514,320,320,twilight sparkle
1948150.png,https://derpicdn.net/img/view/2019/1/29/1948150.png,0,0.995273888,2083,0,4685,2448,2602,2448,twilight sparkle
1948637.png,https://derpicdn.net/img/view/2019/1/30/1948637.png,0,0.999662161,631,148,1055,572,424,424,twilight sparkle
1948637.png,https://derpicdn.net/img/view/2019/1/30/1948637.png,2,0.99668324,751,1180,1061,1490,310,310,twilight sparkle
1949705.png,https://derpicdn.net/img/view/2019/1/31/1949705.png,0,0.996246934,408,0,984,514,576,514,twilight sparkle
1950481.png,https://derpicdn.net/img/view/2019/2/1/1950481.png,0,0.980947912,31,1305,815,2089,784,784,twilight sparkle
1950481.png,https://derpicdn.net/img/view/2019/2/1/1950481.png,1,0.972990751,272,2239,1060,3027,788,788,twilight sparkle
1950481.png,https://derpicdn.net/img/view/2019/2/1/1950481.png,2,0.935510457,847,2132,1497,2782,650,650,twilight sparkle
1951521.png,https://derpicdn.net/img/view/2019/2/2/1951521.png,0,0.952445805,850,0,1778,901,928,901,twilight sparkle
1953766.png,https://derpicdn.net/img/view/2019/2/4/1953766.png,0,0.983345807,43,57,991,1005,948,948,twilight sparkle
1955033.png,https://derpicdn.net/img/view/2019/2/6/1955033.png,0,0.982920766,3246,0,6638,3328,3392,3328,twilight sparkle
1955034.png,https://derpicdn.net/img/view/2019/2/6/1955034.png,0,0.909809649,3264,0,6602,3297,3338,3297,twilight sparkle
1956159.png,https://derpicdn.net/img/view/2019/2/7/1956159.png,0,0.977934122,505,0,1979,1366,1474,1366,twilight sparkle
1960346.png,https://derpicdn.net/img/view/2019/2/12/1960346.png,0,0.987028837,24,0,404,351,380,351,twilight sparkle
1965098.png,https://derpicdn.net/img/view/2019/2/18/1965098.png,0,0.99571389,0,0,619,637,619,637,twilight sparkle
1965305.png,https://derpicdn.net/img/view/2019/2/18/1965305.png,0,0.978028834,46,54,2870,2878,2824,2824,twilight sparkle
1965704.png,https://derpicdn.net/img/view/2019/2/19/1965704.png,0,0.986496389,43,0,343,287,300,287,twilight sparkle
1967061.png,https://derpicdn.net/img/view/2019/2/20/1967061.png,0,0.990063965,820,418,2656,2254,1836,1836,twilight sparkle
1967321.png,https://derpicdn.net/img/view/2019/2/20/1967321.png,0,0.988759696,318,44,868,594,550,550,twilight sparkle
1967323.png,https://derpicdn.net/img/view/2019/2/20/1967323.png,0,0.987801611,840,64,1860,1084,1020,1020,twilight sparkle
1967923.png,https://derpicdn.net/img/view/2019/2/21/1967923.png,0,0.991329849,226,0,934,702,708,702,twilight sparkle
1968232.png,https://derpicdn.net/img/view/2019/2/21/1968232.png,0,0.955290198,52,3194,280,3422,228,228,twilight sparkle
1969549.png,https://derpicdn.net/img/view/2019/2/23/1969549.png,0,0.952548265,0,75,1599,1683,1599,1608,twilight sparkle
1970537.png,https://derpicdn.net/img/view/2019/2/24/1970537.png,0,0.977668166,766,257,1418,909,652,652,twilight sparkle
1970537.png,https://derpicdn.net/img/view/2019/2/24/1970537.png,1,0.942824364,409,74,1019,684,610,610,twilight sparkle
1973095.png,https://derpicdn.net/img/view/2019/2/27/1973095.png,0,0.998951077,495,21,1607,1133,1112,1112,twilight sparkle
1973853.png,https://derpicdn.net/img/view/2019/2/28/1973853.png,0,0.983824193,242,97,903,809,661,712,twilight sparkle
1974153.png,https://derpicdn.net/img/view/2019/3/1/1974153.png,0,0.970940113,794,76,1032,314,238,238,twilight sparkle
1974153.png,https://derpicdn.net/img/view/2019/3/1/1974153.png,1,0.957172811,574,95,792,313,218,218,twilight sparkle
1975164.png,https://derpicdn.net/img/view/2019/3/2/1975164.png,0,0.999595523,1311,142,2555,1386,1244,1244,twilight sparkle
1975164.png,https://derpicdn.net/img/view/2019/3/2/1975164.png,1,0.986849189,97,352,1321,1576,1224,1224,twilight sparkle
1975164.png,https://derpicdn.net/img/view/2019/3/2/1975164.png,2,0.946614385,947,1341,1759,2153,812,812,twilight sparkle
1975476.png,https://derpicdn.net/img/view/2019/3/2/1975476.png,0,0.992942929,2034,576,3292,1834,1258,1258,twilight sparkle
1975506.png,https://derpicdn.net/img/view/2019/3/2/1975506.png,0,0.994863629,1284,0,2548,1182,1264,1182,twilight sparkle
1976208.png,https://derpicdn.net/img/view/2019/3/3/1976208.png,0,0.965664566,626,35,2200,1697,1574,1662,twilight sparkle
1976231.png,https://derpicdn.net/img/view/2019/3/3/1976231.png,0,0.956951737,310,0,1280,980,970,980,twilight sparkle
1978020.png,https://derpicdn.net/img/view/2019/3/5/1978020.png,0,0.93004477,390,0,2514,1817,2124,1817,twilight sparkle
1978518.png,https://derpicdn.net/img/view/2019/3/6/1978518.png,0,0.991635323,267,0,1668,940,1401,940,twilight sparkle
1979303.png,https://derpicdn.net/img/view/2019/3/7/1979303.png,0,0.992653847,36,0,918,797,882,797,twilight sparkle
1981172.png,https://derpicdn.net/img/view/2019/3/9/1981172.png,0,0.998529732,307,0,1027,705,720,705,twilight sparkle
1981319.png,https://derpicdn.net/img/view/2019/3/9/1981319.png,0,0.981812119,65,0,517,376,452,376,twilight sparkle
1983830.png,https://derpicdn.net/img/view/2019/3/12/1983830.png,0,0.982899427,0,4,391,510,391,506,twilight sparkle
1984123.png,https://derpicdn.net/img/view/2019/3/13/1984123.png,0,0.995147049,19,0,1377,1365,1358,1365,twilight sparkle
1985024.png,https://derpicdn.net/img/view/2019/3/14/1985024.png,0,0.951128781,271,249,793,771,522,522,twilight sparkle
1985332.png,https://derpicdn.net/img/view/2019/3/14/1985332.png,0,0.979614854,284,34,605,360,321,326,twilight sparkle
1986067.png,https://derpicdn.net/img/view/2019/3/15/1986067.png,0,0.992913127,924,224,1658,958,734,734,twilight sparkle
1986381.png,https://derpicdn.net/img/view/2019/3/15/1986381.png,0,0.998036981,679,180,1237,738,558,558,twilight sparkle
1986557.png,https://derpicdn.net/img/view/2019/3/15/1986557.png,0,0.998757839,388,0,758,369,370,369,twilight sparkle
1988874.png,https://derpicdn.net/img/view/2019/3/18/1988874.png,0,0.977757692,29,24,381,376,352,352,twilight sparkle
1989264.png,https://derpicdn.net/img/view/2019/3/18/1989264.png,0,0.980609596,22,76,756,810,734,734,twilight sparkle
1989952.png,https://derpicdn.net/img/view/2019/3/19/1989952.png,0,0.98840934,22,25,1270,1273,1248,1248,twilight sparkle
1989973.png,https://derpicdn.net/img/view/2019/3/19/1989973.png,0,0.987690687,794,0,2256,1408,1462,1408,twilight sparkle
1989997.png,https://derpicdn.net/img/view/2019/3/19/1989997.png,0,0.924623966,173,43,487,357,314,314,twilight sparkle
1990173.png,https://derpicdn.net/img/view/2019/3/19/1990173.png,0,0.98641783,27,55,737,765,710,710,twilight sparkle
1990606.png,https://derpicdn.net/img/view/2019/3/20/1990606.png,0,0.996717095,29,0,463,421,434,421,twilight sparkle
1990989.png,https://derpicdn.net/img/view/2019/3/20/1990989.png,0,0.997527063,5,0,359,336,354,336,twilight sparkle
1992879.png,https://derpicdn.net/img/view/2019/3/23/1992879.png,0,0.945408702,0,51,1375,1581,1375,1530,twilight sparkle
1993383.png,https://derpicdn.net/img/view/2019/3/24/1993383.png,0,0.991422415,462,0,1398,926,936,926,twilight sparkle
1993489.png,https://derpicdn.net/img/view/2019/3/24/1993489.png,0,0.978529871,0,73,325,451,325,378,twilight sparkle
1995682.png,https://derpicdn.net/img/view/2019/3/26/1995682.png,0,0.982617736,187,0,803,561,616,561,twilight sparkle
1995781.png,https://derpicdn.net/img/view/2019/3/27/1995781.png,0,0.983147681,320,37,2498,2215,2178,2178,twilight sparkle
1996137.png,https://derpicdn.net/img/view/2019/3/27/1996137.png,0,0.998905897,855,134,2015,1294,1160,1160,twilight sparkle
1997051.png,https://derpicdn.net/img/view/2019/3/28/1997051.png,0,0.985607862,0,0,656,722,656,722,twilight sparkle
1999030.png,https://derpicdn.net/img/view/2019/3/31/1999030.png,0,0.911347568,34,0,334,294,300,294,twilight sparkle
2002316.png,https://derpicdn.net/img/view/2019/4/4/2002316.png,0,0.996052086,504,43,1528,1067,1024,1024,twilight sparkle
2003950.png,https://derpicdn.net/img/view/2019/4/5/2003950.png,0,0.943053901,55,55,459,459,404,404,twilight sparkle
2005778.png,https://derpicdn.net/img/view/2019/4/7/2005778.png,0,0.9796924,1098,1873,1560,2335,462,462,twilight sparkle
2005778.png,https://derpicdn.net/img/view/2019/4/7/2005778.png,1,0.975203633,1426,1816,1950,2340,524,524,twilight sparkle
2005778.png,https://derpicdn.net/img/view/2019/4/7/2005778.png,2,0.910165668,2745,1901,3247,2403,502,502,twilight sparkle
2005922.png,https://derpicdn.net/img/view/2019/4/7/2005922.png,0,0.949272096,1303,0,5809,3973,4506,3973,twilight sparkle
2006967.png,https://derpicdn.net/img/view/2019/4/8/2006967.png,0,0.978568435,0,47,791,987,791,940,twilight sparkle
2008205.png,https://derpicdn.net/img/view/2019/4/10/2008205.png,0,0.998002887,105,0,721,591,616,591,twilight sparkle
2008293.png,https://derpicdn.net/img/view/2019/4/10/2008293.png,0,0.90252912,811,79,2044,1329,1233,1250,twilight sparkle
2012169.png,https://derpicdn.net/img/view/2019/4/14/2012169.png,0,0.98553133,285,33,825,573,540,540,twilight sparkle
2012362.png,https://derpicdn.net/img/view/2019/4/14/2012362.png,0,0.984371006,145,46,749,650,604,604,twilight sparkle
2012912.png,https://derpicdn.net/img/view/2019/4/15/2012912.png,0,0.955088317,310,0,1918,1427,1608,1427,twilight sparkle
2013155.png,https://derpicdn.net/img/view/2019/4/15/2013155.png,0,0.939742684,1456,338,2100,982,644,644,twilight sparkle
2014802.png,https://derpicdn.net/img/view/2019/4/17/2014802.png,0,0.999553263,199,0,903,604,704,604,twilight sparkle
2014905.png,https://derpicdn.net/img/view/2019/4/17/2014905.png,0,0.964270651,0,94,1024,1212,1024,1118,twilight sparkle
2014935.png,https://derpicdn.net/img/view/2019/4/17/2014935.png,0,0.983502567,3264,0,8999,5833,5735,5833,twilight sparkle
2014936.png,https://derpicdn.net/img/view/2019/4/17/2014936.png,0,0.96447283,0,325,7338,8879,7338,8554,twilight sparkle
2015204.png,https://derpicdn.net/img/view/2019/4/17/2015204.png,0,0.995441437,2642,0,6818,4030,4176,4030,twilight sparkle
2015225.png,https://derpicdn.net/img/view/2019/4/17/2015225.png,0,0.994603336,4020,2,7802,3784,3782,3782,twilight sparkle
2017084.png,https://derpicdn.net/img/view/2019/4/19/2017084.png,0,0.997718632,18,0,696,596,678,596,twilight sparkle
2018138.png,https://derpicdn.net/img/view/2019/4/20/2018138.png,0,0.992204487,0,0,594,642,594,642,twilight sparkle
2018776.png,https://derpicdn.net/img/view/2019/4/21/2018776.png,0,0.951072395,58,0,648,581,590,581,twilight sparkle
2019388.png,https://derpicdn.net/img/view/2019/4/22/2019388.png,0,0.927408516,83,52,1668,1698,1585,1646,twilight sparkle
2019692.png,https://derpicdn.net/img/view/2019/4/22/2019692.png,0,0.992779613,400,84,1295,1061,895,977,twilight sparkle
2020622.png,https://derpicdn.net/img/view/2019/4/23/2020622.png,0,0.979358077,57,0,683,624,626,624,twilight sparkle
2024250.png,https://derpicdn.net/img/view/2019/4/27/2024250.png,0,0.949797511,507,39,1449,981,942,942,twilight sparkle
2024519.png,https://derpicdn.net/img/view/2019/4/27/2024519.png,0,0.976444304,29,3,509,499,480,496,twilight sparkle
2025081.png,https://derpicdn.net/img/view/2019/4/28/2025081.png,0,0.958353043,92,53,643,621,551,568,twilight sparkle
2026269.png,https://derpicdn.net/img/view/2019/4/29/2026269.png,0,0.985392928,0,0,774,736,774,736,twilight sparkle
2026280.png,https://derpicdn.net/img/view/2019/4/29/2026280.png,0,0.921184659,0,15,369,467,369,452,twilight sparkle
2026477.png,https://derpicdn.net/img/view/2019/4/29/2026477.png,0,0.928210437,673,221,875,423,202,202,twilight sparkle
2026833.png,https://derpicdn.net/img/view/2019/4/29/2026833.png,0,0.975848198,0,51,792,1097,792,1046,twilight sparkle
2027740.png,https://derpicdn.net/img/view/2019/5/1/2027740.png,0,0.958535314,0,15,248,269,248,254,twilight sparkle
2027740.png,https://derpicdn.net/img/view/2019/5/1/2027740.png,1,0.905837059,58,59,300,299,242,240,twilight sparkle
2031800.png,https://derpicdn.net/img/view/2019/5/5/2031800.png,0,0.996603251,1108,78,2520,1490,1412,1412,twilight sparkle
2034235.png,https://derpicdn.net/img/view/2019/5/8/2034235.png,0,0.985363603,152,31,2616,2495,2464,2464,twilight sparkle
2038257.png,https://derpicdn.net/img/view/2019/5/13/2038257.png,0,0.959245086,969,29,3447,2507,2478,2478,twilight sparkle
203926.jpg,https://derpicdn.net/img/view/2013/1/6/203926.jpg,0,0.937892079,207,0,575,363,368,363,twilight sparkle
2039625.png,https://derpicdn.net/img/view/2019/5/15/2039625.png,0,0.9809407,106,23,784,701,678,678,twilight sparkle
2040984.png,https://derpicdn.net/img/view/2019/5/17/2040984.png,0,0.941823661,224,0,1102,878,878,878,twilight sparkle
2042719.png,https://derpicdn.net/img/view/2019/5/19/2042719.png,0,0.962489963,269,966,1067,1764,798,798,twilight sparkle
2045132.png,https://derpicdn.net/img/view/2019/5/21/2045132.png,0,0.974620819,0,0,1450,1080,1450,1080,twilight sparkle
2046.png,https://derpicdn.net/img/view/2012/1/24/2046.png,0,0.974670529,59,0,453,377,394,377,twilight sparkle
2047807.png,https://derpicdn.net/img/view/2019/5/24/2047807.png,0,0.970169127,524,0,2804,2277,2280,2277,twilight sparkle
2048400.png,https://derpicdn.net/img/view/2019/5/25/2048400.png,0,0.995493889,379,0,1145,638,766,638,twilight sparkle
2051463.png,https://derpicdn.net/img/view/2019/5/28/2051463.png,1,0.992794812,27,0,967,907,940,907,twilight sparkle
2051463.png,https://derpicdn.net/img/view/2019/5/28/2051463.png,2,0.986156523,1737,0,2965,978,1228,978,twilight sparkle
2052026.png,https://derpicdn.net/img/view/2019/5/28/2052026.png,0,0.998024285,1290,0,2038,697,748,697,twilight sparkle
2053737.png,https://derpicdn.net/img/view/2019/5/30/2053737.png,0,0.976059794,138,438,2130,2430,1992,1992,twilight sparkle
2054072.png,https://derpicdn.net/img/view/2019/5/31/2054072.png,0,0.983751357,405,0,1280,856,875,856,twilight sparkle
2054189.png,https://derpicdn.net/img/view/2019/5/31/2054189.png,0,0.989881694,158,9,540,409,382,400,twilight sparkle
2059588.png,https://derpicdn.net/img/view/2019/6/7/2059588.png,0,0.928138196,578,276,1028,726,450,450,twilight sparkle
2059669.png,https://derpicdn.net/img/view/2019/6/7/2059669.png,0,0.998730004,1118,0,2162,964,1044,964,twilight sparkle
2060377.png,https://derpicdn.net/img/view/2019/6/8/2060377.png,0,0.974421203,101,133,333,365,232,232,twilight sparkle
206056.png,https://derpicdn.net/img/view/2013/1/8/206056.png,0,0.988546252,599,110,1227,738,628,628,twilight sparkle
206056.png,https://derpicdn.net/img/view/2013/1/8/206056.png,1,0.979601562,23,0,817,722,794,722,twilight sparkle
2061036.png,https://derpicdn.net/img/view/2019/6/8/2061036.png,0,0.94706279,107,23,585,501,478,478,twilight sparkle
2061243.png,https://derpicdn.net/img/view/2019/6/9/2061243.png,0,0.990270317,73,0,583,469,510,469,twilight sparkle
2063748.png,https://derpicdn.net/img/view/2019/6/12/2063748.png,0,0.9494344,159,40,539,452,380,412,twilight sparkle
2066230.png,https://derpicdn.net/img/view/2019/6/15/2066230.png,0,0.921107888,10,0,514,561,504,561,twilight sparkle
2068121.png,https://derpicdn.net/img/view/2019/6/17/2068121.png,0,0.993385851,148,0,604,426,456,426,twilight sparkle
2071629.png,https://derpicdn.net/img/view/2019/6/21/2071629.png,0,0.971653581,3166,630,7895,5448,4729,4818,twilight sparkle
2074266.png,https://derpicdn.net/img/view/2019/6/24/2074266.png,0,0.979985058,50,0,874,853,824,853,twilight sparkle
2075265.png,https://derpicdn.net/img/view/2019/6/25/2075265.png,0,0.970075607,2804,190,5998,3384,3194,3194,twilight sparkle
2075280.png,https://derpicdn.net/img/view/2019/6/25/2075280.png,0,0.97994417,1777,642,2417,1282,640,640,twilight sparkle
2075305.png,https://derpicdn.net/img/view/2019/6/25/2075305.png,0,0.997588217,1660,0,3478,1693,1818,1693,twilight sparkle
2077668.png,https://derpicdn.net/img/view/2019/6/28/2077668.png,0,0.982216477,89,30,759,752,670,722,twilight sparkle
2077672.png,https://derpicdn.net/img/view/2019/6/28/2077672.png,0,0.940723181,410,12,1296,938,886,926,twilight sparkle
2080792.png,https://derpicdn.net/img/view/2019/7/2/2080792.png,0,0.97070539,218,0,2654,2233,2436,2233,twilight sparkle
2081083.png,https://derpicdn.net/img/view/2019/7/2/2081083.png,0,0.905842721,0,423,7000,8775,7000,8352,twilight sparkle
2083803.png,https://derpicdn.net/img/view/2019/7/5/2083803.png,0,0.992267013,269,80,843,654,574,574,twilight sparkle
2084784.png,https://derpicdn.net/img/view/2019/7/6/2084784.png,0,0.979385197,0,0,333,334,333,334,twilight sparkle
2087603.png,https://derpicdn.net/img/view/2019/7/9/2087603.png,0,0.954426169,98,0,325,230,227,230,twilight sparkle
2089232.png,https://derpicdn.net/img/view/2019/7/11/2089232.png,0,0.999401689,781,19,1687,925,906,906,twilight sparkle
2089717.png,https://derpicdn.net/img/view/2019/7/12/2089717.png,0,0.97253722,0,61,818,893,818,832,twilight sparkle
2097120.png,https://derpicdn.net/img/view/2019/7/20/2097120.png,0,0.971865296,0,64,560,626,560,562,twilight sparkle
2098563.png,https://derpicdn.net/img/view/2019/7/22/2098563.png,0,0.994077921,34,19,720,658,686,639,twilight sparkle
2103226.png,https://derpicdn.net/img/view/2019/7/28/2103226.png,0,0.996327519,602,761,2792,2951,2190,2190,twilight sparkle
2103247.png,https://derpicdn.net/img/view/2019/7/28/2103247.png,0,0.961325645,316,0,652,328,336,328,twilight sparkle
2104937.png,https://derpicdn.net/img/view/2019/7/30/2104937.png,0,0.997914195,462,0,876,400,414,400,twilight sparkle
2106018.png,https://derpicdn.net/img/view/2019/7/31/2106018.png,0,0.995862722,1406,0,2896,1483,1490,1483,twilight sparkle
2107199.png,https://derpicdn.net/img/view/2019/8/2/2107199.png,0,0.997556508,494,1,1018,531,524,530,twilight sparkle
2108294.png,https://derpicdn.net/img/view/2019/8/3/2108294.png,0,0.999246776,58,124,1302,1368,1244,1244,twilight sparkle
2111458.png,https://derpicdn.net/img/view/2019/8/7/2111458.png,0,0.996266305,60,0,1556,1483,1496,1483,twilight sparkle
2111649.png,https://derpicdn.net/img/view/2019/8/7/2111649.png,0,0.985150456,280,425,1072,1217,792,792,twilight sparkle
2112848.png,https://derpicdn.net/img/view/2019/8/9/2112848.png,0,0.995676696,19,0,595,548,576,548,twilight sparkle
2113771.png,https://derpicdn.net/img/view/2019/8/10/2113771.png,0,0.997908831,521,355,989,823,468,468,twilight sparkle
2117317.png,https://derpicdn.net/img/view/2019/8/13/2117317.png,0,0.977141976,770,0,1786,974,1016,974,twilight sparkle
2118450.png,https://derpicdn.net/img/view/2019/8/15/2118450.png,0,0.998696268,23,0,365,333,342,333,twilight sparkle
2119678.png,https://derpicdn.net/img/view/2019/8/16/2119678.png,0,0.991742551,139,0,631,427,492,427,twilight sparkle
2121519.png,https://derpicdn.net/img/view/2019/8/18/2121519.png,0,0.992822528,98,63,616,605,518,542,twilight sparkle
2124815.png,https://derpicdn.net/img/view/2019/8/22/2124815.png,0,0.977118015,1424,0,4595,3047,3171,3047,twilight sparkle
2125044.png,https://derpicdn.net/img/view/2019/8/23/2125044.png,0,0.969081461,148,0,848,669,700,669,twilight sparkle
2126312.png,https://derpicdn.net/img/view/2019/8/24/2126312.png,0,0.989794672,0,0,820,846,820,846,twilight sparkle
2126321.png,https://derpicdn.net/img/view/2019/8/24/2126321.png,0,0.993036866,9,0,845,830,836,830,twilight sparkle
2128156.png,https://derpicdn.net/img/view/2019/8/26/2128156.png,0,0.994164824,555,25,2225,1695,1670,1670,twilight sparkle
2128722.png,https://derpicdn.net/img/view/2019/8/27/2128722.png,0,0.95509392,1217,399,1471,653,254,254,twilight sparkle
2128722.png,https://derpicdn.net/img/view/2019/8/27/2128722.png,1,0.904247582,798,441,1008,651,210,210,twilight sparkle
2129031.png,https://derpicdn.net/img/view/2019/8/27/2129031.png,0,0.937277317,68,53,884,869,816,816,twilight sparkle
2130241.png,https://derpicdn.net/img/view/2019/8/28/2130241.png,0,0.984820426,4015,0,7999,3818,3984,3818,twilight sparkle
2131897.png,https://derpicdn.net/img/view/2019/8/30/2131897.png,0,0.998709559,299,0,753,409,454,409,twilight sparkle
2133581.png,https://derpicdn.net/img/view/2019/9/1/2133581.png,0,0.91975379,118,159,3240,3281,3122,3122,twilight sparkle
2133600.png,https://derpicdn.net/img/view/2019/9/1/2133600.png,0,0.961583614,1,0,1641,1770,1640,1770,twilight sparkle
2134192.png,https://derpicdn.net/img/view/2019/9/2/2134192.png,0,0.993173182,1666,678,2982,1994,1316,1316,twilight sparkle
2134487.png,https://derpicdn.net/img/view/2019/9/2/2134487.png,0,0.98627913,1069,241,1733,905,664,664,twilight sparkle
2138012.png,https://derpicdn.net/img/view/2019/9/6/2138012.png,0,0.989453375,0,0,373,371,373,371,twilight sparkle
2139108.png,https://derpicdn.net/img/view/2019/9/8/2139108.png,0,0.993242919,10,22,290,302,280,280,twilight sparkle
2144218.png,https://derpicdn.net/img/view/2019/9/14/2144218.png,0,0.997870207,203,107,649,553,446,446,twilight sparkle
2144250.png,https://derpicdn.net/img/view/2019/9/14/2144250.png,0,0.999277174,850,476,1410,1036,560,560,twilight sparkle
2144803.png,https://derpicdn.net/img/view/2019/9/15/2144803.png,0,0.966205239,448,1021,1578,2151,1130,1130,twilight sparkle
2146582.png,https://derpicdn.net/img/view/2019/9/17/2146582.png,0,0.970777452,1103,0,3305,2053,2202,2053,twilight sparkle
2148215.png,https://derpicdn.net/img/view/2019/9/20/2148215.png,0,0.960152924,117,2,599,484,482,482,twilight sparkle
2149450.png,https://derpicdn.net/img/view/2019/9/21/2149450.png,0,0.986614048,320,217,1094,991,774,774,twilight sparkle
2152674.png,https://derpicdn.net/img/view/2019/9/25/2152674.png,0,0.97597301,273,206,695,628,422,422,twilight sparkle
2153828.png,https://derpicdn.net/img/view/2019/9/26/2153828.png,0,0.925638735,387,0,1217,781,830,781,twilight sparkle
2156580.png,https://derpicdn.net/img/view/2019/9/30/2156580.png,0,0.992906153,537,234,3000,2878,2463,2644,twilight sparkle
2161593.png,https://derpicdn.net/img/view/2019/10/6/2161593.png,0,0.982582986,14,0,206,184,192,184,twilight sparkle
2161593.png,https://derpicdn.net/img/view/2019/10/6/2161593.png,1,0.938444912,11,34,209,222,198,188,twilight sparkle
2163442.png,https://derpicdn.net/img/view/2019/10/8/2163442.png,0,0.994257808,377,142,715,480,338,338,twilight sparkle
2166576.png,https://derpicdn.net/img/view/2019/10/12/2166576.png,0,0.950980604,5,137,688,828,683,691,twilight sparkle
2167837.png,https://derpicdn.net/img/view/2019/10/13/2167837.png,1,0.921752453,109,545,1203,1639,1094,1094,twilight sparkle
2168999.png,https://derpicdn.net/img/view/2019/10/14/2168999.png,0,0.978650868,219,79,573,433,354,354,twilight sparkle
2169208.png,https://derpicdn.net/img/view/2019/10/15/2169208.png,0,0.972991765,75,82,441,448,366,366,twilight sparkle
2169234.png,https://derpicdn.net/img/view/2019/10/15/2169234.png,0,0.988641381,447,40,1216,846,769,806,twilight sparkle
2170009.png,https://derpicdn.net/img/view/2019/10/15/2170009.png,0,0.95413655,2,0,322,315,320,315,twilight sparkle
2170240.png,https://derpicdn.net/img/view/2019/10/16/2170240.png,0,0.977161705,222,29,554,361,332,332,twilight sparkle
2170957.png,https://derpicdn.net/img/view/2019/10/16/2170957.png,0,0.973667383,0,0,552,503,552,503,twilight sparkle
2171981.png,https://derpicdn.net/img/view/2019/10/17/2171981.png,0,0.983166575,472,454,662,644,190,190,twilight sparkle
2171981.png,https://derpicdn.net/img/view/2019/10/17/2171981.png,1,0.973025501,615,261,953,599,338,338,twilight sparkle
2172882.png,https://derpicdn.net/img/view/2019/10/18/2172882.png,0,0.994626105,495,188,1129,822,634,634,twilight sparkle
2174062.png,https://derpicdn.net/img/view/2019/10/20/2174062.png,0,0.963472128,310,117,548,355,238,238,twilight sparkle
2175658.png,https://derpicdn.net/img/view/2019/10/21/2175658.png,0,0.996275723,86,138,428,480,342,342,twilight sparkle
2176909.png,https://derpicdn.net/img/view/2019/10/23/2176909.png,0,0.992009461,2620,0,5270,2530,2650,2530,twilight sparkle
2176910.png,https://derpicdn.net/img/view/2019/10/23/2176910.png,0,0.933772326,2821,732,5457,3368,2636,2636,twilight sparkle
2177882.png,https://derpicdn.net/img/view/2019/10/24/2177882.png,0,0.991776347,0,7,531,691,531,684,twilight sparkle
2180808.png,https://derpicdn.net/img/view/2019/10/28/2180808.png,0,0.995120943,69,20,511,462,442,442,twilight sparkle
2181943.png,https://derpicdn.net/img/view/2019/10/29/2181943.png,0,0.99365294,0,0,249,258,249,258,twilight sparkle
2181943.png,https://derpicdn.net/img/view/2019/10/29/2181943.png,1,0.91018945,30,77,338,371,308,294,twilight sparkle
2182044.png,https://derpicdn.net/img/view/2019/10/29/2182044.png,0,0.999166787,59,298,359,598,300,300,twilight sparkle
2183014.png,https://derpicdn.net/img/view/2019/10/30/2183014.png,1,0.978776455,185,0,1619,1434,1434,1434,twilight sparkle
2185610.png,https://derpicdn.net/img/view/2019/11/2/2185610.png,0,0.992298841,633,144,925,450,292,306,twilight sparkle
2185954.png,https://derpicdn.net/img/view/2019/11/2/2185954.png,0,0.904457629,39,11,237,209,198,198,twilight sparkle
2185965.png,https://derpicdn.net/img/view/2019/11/2/2185965.png,0,0.957839787,38,28,242,232,204,204,twilight sparkle
2185966.png,https://derpicdn.net/img/view/2019/11/2/2185966.png,0,0.961086214,38,28,242,232,204,204,twilight sparkle
2187589.png,https://derpicdn.net/img/view/2019/11/4/2187589.png,0,0.964984357,424,0,1020,563,596,563,twilight sparkle
2187679.png,https://derpicdn.net/img/view/2019/11/4/2187679.png,0,0.969584048,180,54,404,278,224,224,twilight sparkle
2190515.png,https://derpicdn.net/img/view/2019/11/8/2190515.png,0,0.99753499,2785,1878,4311,3404,1526,1526,twilight sparkle
2191290.png,https://derpicdn.net/img/view/2019/11/9/2191290.png,0,0.934482396,0,97,1642,1817,1642,1720,twilight sparkle
2192627.png,https://derpicdn.net/img/view/2019/11/10/2192627.png,0,0.963152409,0,0,390,381,390,381,twilight sparkle
2192640.png,https://derpicdn.net/img/view/2019/11/10/2192640.png,0,0.978802562,0,0,269,284,269,284,twilight sparkle
2193196.png,https://derpicdn.net/img/view/2019/11/11/2193196.png,0,0.999342501,268,0,886,590,618,590,twilight sparkle
2194805.png,https://derpicdn.net/img/view/2019/11/13/2194805.png,1,0.949373066,7,48,335,376,328,328,twilight sparkle
2197840.png,https://derpicdn.net/img/view/2019/11/16/2197840.png,0,0.948997617,75,101,457,483,382,382,twilight sparkle
2201092.png,https://derpicdn.net/img/view/2019/11/20/2201092.png,0,0.978858411,8,50,856,898,848,848,twilight sparkle
2203700.png,https://derpicdn.net/img/view/2019/11/23/2203700.png,0,0.979656577,411,201,643,433,232,232,twilight sparkle
2207722.png,https://derpicdn.net/img/view/2019/11/28/2207722.png,0,0.988313377,22,0,514,469,492,469,twilight sparkle
2208990.png,https://derpicdn.net/img/view/2019/11/30/2208990.png,0,0.959765196,71,4,543,476,472,472,twilight sparkle
2209150.png,https://derpicdn.net/img/view/2019/11/30/2209150.png,0,0.999429882,704,0,1888,1141,1184,1141,twilight sparkle
2209845.png,https://derpicdn.net/img/view/2019/12/1/2209845.png,0,0.997701049,677,276,1317,916,640,640,twilight sparkle
2210506.png,https://derpicdn.net/img/view/2019/12/2/2210506.png,0,0.98108393,0,0,1180,1278,1180,1278,twilight sparkle
2213918.png,https://derpicdn.net/img/view/2019/12/6/2213918.png,0,0.976702988,0,416,2919,3424,2919,3008,twilight sparkle
2214575.png,https://derpicdn.net/img/view/2019/12/7/2214575.png,0,0.971446633,314,235,850,771,536,536,twilight sparkle
2216286.png,https://derpicdn.net/img/view/2019/12/9/2216286.png,0,0.973465621,307,31,1467,1191,1160,1160,twilight sparkle
2218142.png,https://derpicdn.net/img/view/2019/12/11/2218142.png,0,0.944305599,0,37,2893,3363,2893,3326,twilight sparkle
2220227.png,https://derpicdn.net/img/view/2019/12/14/2220227.png,0,0.997412801,285,0,876,574,591,574,twilight sparkle
2221766.png,https://derpicdn.net/img/view/2019/12/16/2221766.png,0,0.987896562,0,0,796,847,796,847,twilight sparkle
2221767.png,https://derpicdn.net/img/view/2019/12/16/2221767.png,0,0.965292215,93,0,1259,938,1166,938,twilight sparkle
2224417.png,https://derpicdn.net/img/view/2019/12/19/2224417.png,0,0.988233268,501,0,1861,1240,1360,1240,twilight sparkle
2226338.jpg,https://derpicdn.net/img/view/2019/12/21/2226338.jpg,0,0.955280304,85,127,1019,1061,934,934,twilight sparkle
2226707.png,https://derpicdn.net/img/view/2019/12/22/2226707.png,0,0.986239254,15,80,643,708,628,628,twilight sparkle
2226883.png,https://derpicdn.net/img/view/2019/12/22/2226883.png,0,0.990514517,172,0,988,732,816,732,twilight sparkle
223013.png,https://derpicdn.net/img/view/2013/1/25/223013.png,0,0.979217172,84,0,484,388,400,388,twilight sparkle
2232769.png,https://derpicdn.net/img/view/2019/12/29/2232769.png,0,0.930223703,987,526,2423,1962,1436,1436,twilight sparkle
2232856.png,https://derpicdn.net/img/view/2019/12/29/2232856.png,0,0.999375224,468,70,1488,1090,1020,1020,twilight sparkle
2233677.png,https://derpicdn.net/img/view/2019/12/30/2233677.png,0,0.981643915,126,0,836,708,710,708,twilight sparkle
2235357.jpg,https://derpicdn.net/img/view/2020/1/1/2235357.jpg,0,0.983613491,0,57,673,747,673,690,twilight sparkle
2235788.jpg,https://derpicdn.net/img/view/2020/1/1/2235788.jpg,0,0.958900988,342,11,1326,995,984,984,twilight sparkle
2238132.jpg,https://derpicdn.net/img/view/2020/1/4/2238132.jpg,0,0.961269796,0,0,837,877,837,877,twilight sparkle
2238795.png,https://derpicdn.net/img/view/2020/1/4/2238795.png,0,0.995167851,245,0,989,665,744,665,twilight sparkle
2240383.png,https://derpicdn.net/img/view/2020/1/6/2240383.png,0,0.975598454,10,42,553,632,543,590,twilight sparkle
2242475.jpg,https://derpicdn.net/img/view/2020/1/9/2242475.jpg,0,0.966863632,305,35,829,559,524,524,twilight sparkle
2245764.png,https://derpicdn.net/img/view/2020/1/12/2245764.png,0,0.994685888,77,0,499,401,422,401,twilight sparkle
2245823.png,https://derpicdn.net/img/view/2020/1/12/2245823.png,0,0.976164937,178,0,778,560,600,560,twilight sparkle
224660.png,https://derpicdn.net/img/view/2013/1/26/224660.png,0,0.958719969,1469,214,1991,736,522,522,twilight sparkle
2247007.png,https://derpicdn.net/img/view/2020/1/14/2247007.png,0,0.991539598,39,0,751,682,712,682,twilight sparkle
2247686.png,https://derpicdn.net/img/view/2020/1/15/2247686.png,0,0.912887573,25,289,445,709,420,420,twilight sparkle
2247737.png,https://derpicdn.net/img/view/2020/1/15/2247737.png,0,0.931197882,58,0,570,497,512,497,twilight sparkle
2250199.png,https://derpicdn.net/img/view/2020/1/18/2250199.png,0,0.995229244,382,0,946,551,564,551,twilight sparkle
2250267.png,https://derpicdn.net/img/view/2020/1/18/2250267.png,0,0.972409248,160,218,364,422,204,204,twilight sparkle
225446.png,https://derpicdn.net/img/view/2013/1/27/225446.png,0,0.971437454,1665,143,2163,641,498,498,twilight sparkle
2256739.jpg,https://derpicdn.net/img/view/2020/1/25/2256739.jpg,0,0.974334836,394,14,682,302,288,288,twilight sparkle
2256747.jpg,https://derpicdn.net/img/view/2020/1/25/2256747.jpg,0,0.991555393,633,134,1067,568,434,434,twilight sparkle
225794.png,https://derpicdn.net/img/view/2013/1/27/225794.png,0,0.998215318,323,0,685,348,362,348,twilight sparkle
2261157.png,https://derpicdn.net/img/view/2020/1/30/2261157.png,0,0.962125719,1873,91,5037,3435,3164,3344,twilight sparkle
2261673.jpg,https://derpicdn.net/img/view/2020/1/31/2261673.jpg,0,0.988971174,324,83,570,329,246,246,twilight sparkle
2264750.jpg,https://derpicdn.net/img/view/2020/2/3/2264750.jpg,0,0.990065753,680,487,1912,1719,1232,1232,twilight sparkle
2267154.jpg,https://derpicdn.net/img/view/2020/2/6/2267154.jpg,1,0.999103367,344,13,718,387,374,374,twilight sparkle
2267154.jpg,https://derpicdn.net/img/view/2020/2/6/2267154.jpg,2,0.995253384,597,766,903,1072,306,306,twilight sparkle
2267770.png,https://derpicdn.net/img/view/2020/2/7/2267770.png,0,0.946591675,0,754,3263,4172,3263,3418,twilight sparkle
2270187.png,https://derpicdn.net/img/view/2020/2/10/2270187.png,0,0.986936748,59,32,399,372,340,340,twilight sparkle
2270188.png,https://derpicdn.net/img/view/2020/2/10/2270188.png,0,0.980099261,0,0,796,817,796,817,twilight sparkle
2271081.png,https://derpicdn.net/img/view/2020/2/11/2271081.png,0,0.977016211,27,54,535,562,508,508,twilight sparkle
2273742.png,https://derpicdn.net/img/view/2020/2/14/2273742.png,0,0.995727122,505,686,981,1162,476,476,twilight sparkle
2274060.jpg,https://derpicdn.net/img/view/2020/2/14/2274060.jpg,0,0.972056985,46,0,698,652,652,652,twilight sparkle
2275099.png,https://derpicdn.net/img/view/2020/2/15/2275099.png,0,0.981422663,898,417,2166,1685,1268,1268,twilight sparkle
227563.jpg,https://derpicdn.net/img/view/2013/1/29/227563.jpg,0,0.961061835,194,0,998,801,804,801,twilight sparkle
2277841.png,https://derpicdn.net/img/view/2020/2/18/2277841.png,0,0.967939317,197,0,650,408,453,408,twilight sparkle
227789.png,https://derpicdn.net/img/view/2013/1/30/227789.png,0,0.980167687,0,0,260,255,260,255,twilight sparkle
2278015.png,https://derpicdn.net/img/view/2020/2/19/2278015.png,1,0.982081115,268,460,768,1012,500,552,twilight sparkle
2278015.png,https://derpicdn.net/img/view/2020/2/19/2278015.png,2,0.930319667,324,4,766,446,442,442,twilight sparkle
2278389.png,https://derpicdn.net/img/view/2020/2/19/2278389.png,0,0.990936518,65,0,1557,1356,1492,1356,twilight sparkle
2281074.jpg,https://derpicdn.net/img/view/2020/2/22/2281074.jpg,0,0.996639669,382,78,840,536,458,458,twilight sparkle
2281188.jpg,https://derpicdn.net/img/view/2020/2/22/2281188.jpg,0,0.990581572,466,0,896,422,430,422,twilight sparkle
2281236.png,https://derpicdn.net/img/view/2020/2/22/2281236.png,0,0.950161695,87,21,813,747,726,726,twilight sparkle
2282818.png,https://derpicdn.net/img/view/2020/2/24/2282818.png,0,0.99476546,341,35,681,375,340,340,twilight sparkle
2282833.png,https://derpicdn.net/img/view/2020/2/24/2282833.png,0,0.993104339,333,650,891,1208,558,558,twilight sparkle
2283871.png,https://derpicdn.net/img/view/2020/2/26/2283871.png,0,0.973319948,152,0,410,256,258,256,twilight sparkle
22840.png,https://derpicdn.net/img/view/2012/6/27/22840.png,0,0.995300293,899,0,1847,855,948,855,twilight sparkle
2284302.png,https://derpicdn.net/img/view/2020/2/26/2284302.png,0,0.960591853,12,0,656,629,644,629,twilight sparkle
2284527.png,https://derpicdn.net/img/view/2020/2/27/2284527.png,0,0.978225052,0,0,644,638,644,638,twilight sparkle
2285058.jpg,https://derpicdn.net/img/view/2020/2/28/2285058.jpg,0,0.933418632,295,47,885,637,590,590,twilight sparkle
2286803.png,https://derpicdn.net/img/view/2020/3/1/2286803.png,0,0.989590585,0,0,428,461,428,461,twilight sparkle
2287650.png,https://derpicdn.net/img/view/2020/3/2/2287650.png,0,0.980378628,0,17,423,559,423,542,twilight sparkle
2287840.jpg,https://derpicdn.net/img/view/2020/3/2/2287840.jpg,0,0.997497916,146,4,854,712,708,708,twilight sparkle
2289415.jpg,https://derpicdn.net/img/view/2020/3/4/2289415.jpg,0,0.99362874,562,0,1412,831,850,831,twilight sparkle
2289823.png,https://derpicdn.net/img/view/2020/3/4/2289823.png,0,0.967327058,524,0,3271,2830,2747,2830,twilight sparkle
2290556.png,https://derpicdn.net/img/view/2020/3/5/2290556.png,0,0.985461831,0,0,3013,2961,3013,2961,twilight sparkle
2290812.jpg,https://derpicdn.net/img/view/2020/3/5/2290812.jpg,0,0.999407709,648,31,1246,629,598,598,twilight sparkle
2292678.png,https://derpicdn.net/img/view/2020/3/8/2292678.png,0,0.9886235,0,0,607,610,607,610,twilight sparkle
2293277.png,https://derpicdn.net/img/view/2020/3/9/2293277.png,0,0.96897316,384,0,1260,899,876,899,twilight sparkle
2293477.png,https://derpicdn.net/img/view/2020/3/9/2293477.png,0,0.979982555,0,18,525,548,525,530,twilight sparkle
2295220.png,https://derpicdn.net/img/view/2020/3/11/2295220.png,0,0.959771454,132,0,648,515,516,515,twilight sparkle
2295884.jpg,https://derpicdn.net/img/view/2020/3/12/2295884.jpg,0,0.999208629,459,20,1287,848,828,828,twilight sparkle
2297112.png,https://derpicdn.net/img/view/2020/3/14/2297112.png,0,0.962102294,0,27,1159,1295,1159,1268,twilight sparkle
2297159.png,https://derpicdn.net/img/view/2020/3/14/2297159.png,0,0.977199137,200,9,552,361,352,352,twilight sparkle
2298095.png,https://derpicdn.net/img/view/2020/3/15/2298095.png,0,0.991932213,12,194,422,604,410,410,twilight sparkle
2298744.png,https://derpicdn.net/img/view/2020/3/16/2298744.png,0,0.998198628,699,28,1915,1244,1216,1216,twilight sparkle
2299717.png,https://derpicdn.net/img/view/2020/3/17/2299717.png,0,0.995565116,2350,2826,4462,4938,2112,2112,twilight sparkle
2299717.png,https://derpicdn.net/img/view/2020/3/17/2299717.png,1,0.922118604,4470,580,6532,2642,2062,2062,twilight sparkle
230032.jpg,https://derpicdn.net/img/view/2013/2/1/230032.jpg,0,0.999032378,158,68,584,494,426,426,twilight sparkle
2301797.jpg,https://derpicdn.net/img/view/2020/3/20/2301797.jpg,0,0.980781078,0,38,420,458,420,420,twilight sparkle
2302361.png,https://derpicdn.net/img/view/2020/3/21/2302361.png,0,0.999474347,276,60,674,458,398,398,twilight sparkle
2303761.jpg,https://derpicdn.net/img/view/2020/3/22/2303761.jpg,0,0.981563449,0,13,1081,1129,1081,1116,twilight sparkle
2304542.png,https://derpicdn.net/img/view/2020/3/23/2304542.png,0,0.986246228,0,84,653,670,653,586,twilight sparkle
2306193.jpg,https://derpicdn.net/img/view/2020/3/26/2306193.jpg,0,0.923507929,0,295,1661,1991,1661,1696,twilight sparkle
230633.png,https://derpicdn.net/img/view/2013/2/1/230633.png,0,0.995346963,58,0,462,366,404,366,twilight sparkle
2307500.png,https://derpicdn.net/img/view/2020/3/27/2307500.png,0,0.98595047,145,3,477,335,332,332,twilight sparkle
2308035.jpg,https://derpicdn.net/img/view/2020/3/28/2308035.jpg,0,0.95095396,304,0,1054,724,750,724,twilight sparkle
2308535.png,https://derpicdn.net/img/view/2020/3/29/2308535.png,0,0.9904598,5259,177,10873,5791,5614,5614,twilight sparkle
2308967.png,https://derpicdn.net/img/view/2020/3/29/2308967.png,0,0.998574793,1501,0,4829,3203,3328,3203,twilight sparkle
2309032.png,https://derpicdn.net/img/view/2020/3/29/2309032.png,0,0.977306843,389,0,1165,608,776,608,twilight sparkle
230991.png,https://derpicdn.net/img/view/2013/2/2/230991.png,0,0.994465709,2320,1963,3844,3487,1524,1524,twilight sparkle
2311337.png,https://derpicdn.net/img/view/2020/4/1/2311337.png,0,0.981978357,1468,0,3730,2148,2262,2148,twilight sparkle
2311338.png,https://derpicdn.net/img/view/2020/4/1/2311338.png,0,0.974658906,1595,0,3691,2093,2096,2093,twilight sparkle
2311710.png,https://derpicdn.net/img/view/2020/4/1/2311710.png,0,0.991571605,209,0,607,388,398,388,twilight sparkle
2312644.png,https://derpicdn.net/img/view/2020/4/2/2312644.png,0,0.986527145,367,18,813,464,446,446,twilight sparkle
2315525.png,https://derpicdn.net/img/view/2020/4/6/2315525.png,0,0.942207277,0,10,831,908,831,898,twilight sparkle
2316956.png,https://derpicdn.net/img/view/2020/4/8/2316956.png,0,0.9610883,0,0,2163,2457,2163,2457,twilight sparkle
2317317.jpg,https://derpicdn.net/img/view/2020/4/8/2317317.jpg,0,0.979346275,393,16,707,330,314,314,twilight sparkle
2318275.png,https://derpicdn.net/img/view/2020/4/9/2318275.png,0,0.988725722,825,67,1400,659,575,592,twilight sparkle
2320909.png,https://derpicdn.net/img/view/2020/4/12/2320909.png,0,0.983435571,69,4,783,718,714,714,twilight sparkle
2322876.png,https://derpicdn.net/img/view/2020/4/15/2322876.png,0,0.987899721,1539,147,4027,2635,2488,2488,twilight sparkle
232315.png,https://derpicdn.net/img/view/2013/2/3/232315.png,0,0.949296236,394,0,784,382,390,382,twilight sparkle
2323668.png,https://derpicdn.net/img/view/2020/4/16/2323668.png,0,0.998466611,909,177,1249,517,340,340,twilight sparkle
2326498.png,https://derpicdn.net/img/view/2020/4/19/2326498.png,0,0.984199166,0,0,760,735,760,735,twilight sparkle
2326500.png,https://derpicdn.net/img/view/2020/4/19/2326500.png,0,0.976617396,0,0,315,430,315,430,twilight sparkle
2326503.png,https://derpicdn.net/img/view/2020/4/19/2326503.png,0,0.966006339,86,89,738,741,652,652,twilight sparkle
2327293.png,https://derpicdn.net/img/view/2020/4/20/2327293.png,0,0.950581193,1018,1099,1570,1651,552,552,twilight sparkle
2328010.png,https://derpicdn.net/img/view/2020/4/21/2328010.png,0,0.998697162,1680,105,2758,1183,1078,1078,twilight sparkle
2328126.jpg,https://derpicdn.net/img/view/2020/4/21/2328126.jpg,0,0.989239931,153,159,2713,2719,2560,2560,twilight sparkle
2329209.png,https://derpicdn.net/img/view/2020/4/23/2329209.png,0,0.981720865,248,228,1398,1378,1150,1150,twilight sparkle
2329374.png,https://derpicdn.net/img/view/2020/4/23/2329374.png,0,0.994844079,124,22,753,666,629,644,twilight sparkle
2329965.png,https://derpicdn.net/img/view/2020/4/23/2329965.png,0,0.999064386,96,0,384,279,288,279,twilight sparkle
2333375.png,https://derpicdn.net/img/view/2020/4/27/2333375.png,0,0.989933074,177,0,719,524,542,524,twilight sparkle
2335149.png,https://derpicdn.net/img/view/2020/4/29/2335149.png,0,0.990257442,0,0,277,340,277,340,twilight sparkle
2335274.jpg,https://derpicdn.net/img/view/2020/4/30/2335274.jpg,0,0.93542695,240,89,776,625,536,536,twilight sparkle
2336199.jpg,https://derpicdn.net/img/view/2020/5/1/2336199.jpg,0,0.998487711,991,1183,1279,1471,288,288,twilight sparkle
2337398.png,https://derpicdn.net/img/view/2020/5/2/2337398.png,0,0.989432096,120,42,500,472,380,430,twilight sparkle
2338652.jpg,https://derpicdn.net/img/view/2020/5/3/2338652.jpg,0,0.916095495,1097,397,1919,1219,822,822,twilight sparkle
2340095.jpg,https://derpicdn.net/img/view/2020/5/5/2340095.jpg,1,0.988785744,1339,247,1887,795,548,548,twilight sparkle
2340095.jpg,https://derpicdn.net/img/view/2020/5/5/2340095.jpg,2,0.934708238,855,330,1289,764,434,434,twilight sparkle
2340160.jpg,https://derpicdn.net/img/view/2020/5/5/2340160.jpg,0,0.989629865,1391,741,2105,1455,714,714,twilight sparkle
2340160.jpg,https://derpicdn.net/img/view/2020/5/5/2340160.jpg,1,0.986766517,1326,1925,2020,2619,694,694,twilight sparkle
2340160.jpg,https://derpicdn.net/img/view/2020/5/5/2340160.jpg,2,0.978120446,1845,93,2441,689,596,596,twilight sparkle
2341608.png,https://derpicdn.net/img/view/2020/5/7/2341608.png,0,0.998121321,1351,313,1651,613,300,300,twilight sparkle
2341610.png,https://derpicdn.net/img/view/2020/5/7/2341610.png,0,0.995499671,715,63,1195,543,480,480,twilight sparkle
2341610.png,https://derpicdn.net/img/view/2020/5/7/2341610.png,1,0.990959942,440,412,842,814,402,402,twilight sparkle
2341997.png,https://derpicdn.net/img/view/2020/5/7/2341997.png,0,0.975722253,395,0,747,327,352,327,twilight sparkle
2343590.png,https://derpicdn.net/img/view/2020/5/9/2343590.png,0,0.99032563,93,0,3000,3734,2907,3734,twilight sparkle
2345837.png,https://derpicdn.net/img/view/2020/5/11/2345837.png,0,0.999522865,10,0,402,359,392,359,twilight sparkle
2346144.png,https://derpicdn.net/img/view/2020/5/12/2346144.png,0,0.990484834,182,0,784,498,602,498,twilight sparkle
2347823.png,https://derpicdn.net/img/view/2020/5/13/2347823.png,0,0.982264519,2804,0,7700,5266,4896,5266,twilight sparkle
2347970.jpg,https://derpicdn.net/img/view/2020/5/14/2347970.jpg,0,0.980388582,836,302,1654,1120,818,818,twilight sparkle
2349007.png,https://derpicdn.net/img/view/2020/5/15/2349007.png,0,0.99080056,0,0,474,498,474,498,twilight sparkle
2349017.png,https://derpicdn.net/img/view/2020/5/15/2349017.png,0,0.977140188,0,0,388,439,388,439,twilight sparkle
2349827.png,https://derpicdn.net/img/view/2020/5/16/2349827.png,0,0.984912276,62,43,705,705,643,662,twilight sparkle
2349842.png,https://derpicdn.net/img/view/2020/5/16/2349842.png,0,0.98789829,48,32,288,272,240,240,twilight sparkle
2351124.jpg,https://derpicdn.net/img/view/2020/5/17/2351124.jpg,0,0.959804952,0,289,786,1079,786,790,twilight sparkle
2352052.jpg,https://derpicdn.net/img/view/2020/5/18/2352052.jpg,0,0.993186176,1642,8,2234,600,592,592,twilight sparkle
2352052.jpg,https://derpicdn.net/img/view/2020/5/18/2352052.jpg,1,0.970113873,173,145,819,791,646,646,twilight sparkle
2352531.jpg,https://derpicdn.net/img/view/2020/5/19/2352531.jpg,0,0.998549342,31,132,525,626,494,494,twilight sparkle
2353097.png,https://derpicdn.net/img/view/2020/5/20/2353097.png,0,0.941749275,0,0,585,550,585,550,twilight sparkle
2354234.png,https://derpicdn.net/img/view/2020/5/21/2354234.png,0,0.990455806,119,216,511,608,392,392,twilight sparkle
2354535.png,https://derpicdn.net/img/view/2020/5/21/2354535.png,0,0.903120756,39,133,433,527,394,394,twilight sparkle
235502.png,https://derpicdn.net/img/view/2013/2/6/235502.png,0,0.996187806,607,485,937,815,330,330,twilight sparkle
2355633.png,https://derpicdn.net/img/view/2020/5/22/2355633.png,0,0.988118887,0,0,222,228,222,228,twilight sparkle
2384.jpg,https://derpicdn.net/img/view/2012/1/25/2384.jpg,0,0.916608989,617,108,1061,552,444,444,twilight sparkle
239750.png,https://derpicdn.net/img/view/2013/2/11/239750.png,0,0.997641802,487,59,873,445,386,386,twilight sparkle
244377.jpg,https://derpicdn.net/img/view/2013/2/15/244377.jpg,0,0.955407858,30,0,474,434,444,434,twilight sparkle
245754.png,https://derpicdn.net/img/view/2013/2/16/245754.png,0,0.989559472,83,0,383,285,300,285,twilight sparkle
245780.png,https://derpicdn.net/img/view/2013/2/16/245780.png,0,0.994709671,1194,1075,1816,1697,622,622,twilight sparkle
245818.png,https://derpicdn.net/img/view/2013/2/16/245818.png,0,0.994972348,132,0,606,473,474,473,twilight sparkle
246046.png,https://derpicdn.net/img/view/2013/2/17/246046.png,0,0.925340593,0,0,287,241,287,241,twilight sparkle
246866.png,https://derpicdn.net/img/view/2013/2/17/246866.png,0,0.941018343,86,26,660,600,574,574,twilight sparkle
248717.png,https://derpicdn.net/img/view/2013/2/19/248717.png,0,0.998720288,3895,0,5749,1673,1854,1673,twilight sparkle
249466.png,https://derpicdn.net/img/view/2013/2/20/249466.png,0,0.998625219,0,0,376,387,376,387,twilight sparkle
257015.jpg,https://derpicdn.net/img/view/2013/2/27/257015.jpg,0,0.905741453,201,0,587,362,386,362,twilight sparkle
257345.png,https://derpicdn.net/img/view/2013/2/27/257345.png,0,0.994284451,1113,148,2389,1424,1276,1276,twilight sparkle
259103.png,https://derpicdn.net/img/view/2013/3/1/259103.png,0,0.994657993,89,18,815,744,726,726,twilight sparkle
25976.png,https://derpicdn.net/img/view/2012/6/30/25976.png,0,0.995550811,481,0,851,327,370,327,twilight sparkle
25976.png,https://derpicdn.net/img/view/2012/6/30/25976.png,1,0.992199242,234,320,536,622,302,302,twilight sparkle
26011.jpg,https://derpicdn.net/img/view/2012/6/30/26011.jpg,0,0.989232719,382,338,742,698,360,360,twilight sparkle
265668.png,https://derpicdn.net/img/view/2013/3/8/265668.png,0,0.96444732,377,0,875,496,498,496,twilight sparkle
267645.png,https://derpicdn.net/img/view/2013/3/10/267645.png,0,0.975716889,143,60,587,504,444,444,twilight sparkle
27310.png,https://derpicdn.net/img/view/2012/7/1/27310.png,0,0.958051562,509,39,941,471,432,432,twilight sparkle
273392.png,https://derpicdn.net/img/view/2013/3/18/273392.png,0,0.976881802,1,0,366,388,365,388,twilight sparkle
279412.jpg,https://derpicdn.net/img/view/2013/3/25/279412.jpg,0,0.929935694,145,53,345,253,200,200,twilight sparkle
284472.png,https://derpicdn.net/img/view/2013/3/31/284472.png,0,0.998439252,227,0,583,334,356,334,twilight sparkle
286808.png,https://derpicdn.net/img/view/2013/4/3/286808.png,0,0.946471155,773,33,1104,377,331,344,twilight sparkle
289328.png,https://derpicdn.net/img/view/2013/4/6/289328.png,0,0.969124794,211,92,549,430,338,338,twilight sparkle
289961.png,https://derpicdn.net/img/view/2013/4/6/289961.png,0,0.977530539,2402,23,4500,2265,2098,2242,twilight sparkle
292395.png,https://derpicdn.net/img/view/2013/4/9/292395.png,0,0.944458306,167,99,535,467,368,368,twilight sparkle
294123.png,https://derpicdn.net/img/view/2013/4/10/294123.png,0,0.983677208,0,0,274,261,274,261,twilight sparkle
299951.png,https://derpicdn.net/img/view/2013/4/16/299951.png,0,0.978662133,40,0,866,562,826,562,twilight sparkle
304500.png,https://derpicdn.net/img/view/2013/4/21/304500.png,0,0.991172552,790,0,2298,1438,1508,1438,twilight sparkle
304871.png,https://derpicdn.net/img/view/2013/4/21/304871.png,0,0.994882345,655,435,1243,1023,588,588,twilight sparkle
309743.jpg,https://derpicdn.net/img/view/2013/4/27/309743.jpg,0,0.984463096,732,102,1714,1084,982,982,twilight sparkle
311820.jpg,https://derpicdn.net/img/view/2013/4/29/311820.jpg,0,0.991279066,978,270,2612,1904,1634,1634,twilight sparkle
314234.png,https://derpicdn.net/img/view/2013/5/2/314234.png,0,0.997187495,265,0,2949,2682,2684,2682,twilight sparkle
323168.png,https://derpicdn.net/img/view/2013/5/12/323168.png,0,0.996458054,268,0,674,402,406,402,twilight sparkle
323238.png,https://derpicdn.net/img/view/2013/5/12/323238.png,0,0.994651735,158,86,320,248,162,162,twilight sparkle
323931.png,https://derpicdn.net/img/view/2013/5/13/323931.png,0,0.998254955,645,68,1101,524,456,456,twilight sparkle
324704.png,https://derpicdn.net/img/view/2013/5/14/324704.png,0,0.957526863,124,0,488,359,364,359,twilight sparkle
327103.png,https://derpicdn.net/img/view/2013/5/17/327103.png,0,0.987105966,847,193,1509,855,662,662,twilight sparkle
331973.png,https://derpicdn.net/img/view/2013/5/23/331973.png,0,0.973292291,386,218,926,758,540,540,twilight sparkle
3370.png,https://derpicdn.net/img/view/2012/2/21/3370.png,0,0.951718211,123,9,299,185,176,176,twilight sparkle
339762.png,https://derpicdn.net/img/view/2013/6/3/339762.png,0,0.955467284,54,323,474,743,420,420,twilight sparkle
339863.jpg,https://derpicdn.net/img/view/2013/6/3/339863.jpg,0,0.974252641,554,960,898,1304,344,344,twilight sparkle
343265.png,https://derpicdn.net/img/view/2013/6/8/343265.png,0,0.949510813,285,0,2115,1753,1830,1753,twilight sparkle
344694.png,https://derpicdn.net/img/view/2013/6/9/344694.png,0,0.994569182,0,0,536,535,536,535,twilight sparkle
344696.png,https://derpicdn.net/img/view/2013/6/9/344696.png,0,0.99746424,1308,0,3000,1834,1692,1834,twilight sparkle
344945.png,https://derpicdn.net/img/view/2013/6/10/344945.png,0,0.999023676,536,0,1190,541,654,541,twilight sparkle
346424.jpg,https://derpicdn.net/img/view/2013/6/12/346424.jpg,0,0.985295594,417,0,883,442,466,442,twilight sparkle
347563.jpg,https://derpicdn.net/img/view/2013/6/13/347563.jpg,0,0.982201874,197,342,677,822,480,480,twilight sparkle
349884.png,https://derpicdn.net/img/view/2013/6/16/349884.png,0,0.987907052,105,28,469,392,364,364,twilight sparkle
349962.jpg,https://derpicdn.net/img/view/2013/6/16/349962.jpg,0,0.992055237,359,30,579,250,220,220,twilight sparkle
349962.jpg,https://derpicdn.net/img/view/2013/6/16/349962.jpg,1,0.989494622,19,50,235,266,216,216,twilight sparkle
349962.jpg,https://derpicdn.net/img/view/2013/6/16/349962.jpg,2,0.958992958,183,59,401,277,218,218,twilight sparkle
353943.png,https://derpicdn.net/img/view/2013/6/21/353943.png,0,0.984695435,818,355,2968,2505,2150,2150,twilight sparkle
35746.png,https://derpicdn.net/img/view/2012/7/7/35746.png,0,0.912264347,504,0,922,413,418,413,twilight sparkle
360044.png,https://derpicdn.net/img/view/2013/6/29/360044.png,0,0.987933397,1008,0,2000,1027,992,1027,twilight sparkle
3612.png,https://derpicdn.net/img/view/2012/2/28/3612.png,0,0.997142434,602,72,862,332,260,260,twilight sparkle
363984.png,https://derpicdn.net/img/view/2013/7/4/363984.png,0,0.926724255,723,393,1663,1333,940,940,twilight sparkle
364321.png,https://derpicdn.net/img/view/2013/7/4/364321.png,0,0.976400912,0,0,276,286,276,286,twilight sparkle
366832.png,https://derpicdn.net/img/view/2013/7/7/366832.png,0,0.936746597,0,0,550,554,550,554,twilight sparkle
368634.png,https://derpicdn.net/img/view/2013/7/9/368634.png,0,0.992500424,166,4,420,258,254,254,twilight sparkle
374396.png,https://derpicdn.net/img/view/2013/7/15/374396.png,0,0.9747473,0,0,996,1125,996,1125,twilight sparkle
375720.png,https://derpicdn.net/img/view/2013/7/16/375720.png,0,0.995866477,182,0,1196,883,1014,883,twilight sparkle
3811.png,https://derpicdn.net/img/view/2012/3/21/3811.png,0,0.991132975,544,8,1106,570,562,562,twilight sparkle
381780.jpg,https://derpicdn.net/img/view/2013/7/23/381780.jpg,0,0.995286286,95,18,509,432,414,414,twilight sparkle
382605.png,https://derpicdn.net/img/view/2013/7/24/382605.png,0,0.991755188,354,400,732,778,378,378,twilight sparkle
384980.png,https://derpicdn.net/img/view/2013/7/29/384980.png,0,0.945590198,0,426,2176,2698,2176,2272,twilight sparkle
386.png,https://derpicdn.net/img/view/2012/1/15/386.png,0,0.99966681,24,26,280,282,256,256,twilight sparkle
386800.jpg,https://derpicdn.net/img/view/2013/7/30/386800.jpg,0,0.995978177,86,17,524,455,438,438,twilight sparkle
387117.png,https://derpicdn.net/img/view/2013/7/31/387117.png,0,0.930224895,286,22,722,458,436,436,twilight sparkle
396436.jpg,https://derpicdn.net/img/view/2013/8/10/396436.jpg,0,0.993649483,197,272,1221,1296,1024,1024,twilight sparkle
396448.png,https://derpicdn.net/img/view/2013/8/10/396448.png,0,0.926935256,4040,1188,6068,3304,2028,2116,twilight sparkle
397339.png,https://derpicdn.net/img/view/2013/8/11/397339.png,0,0.915306568,65,7,483,425,418,418,twilight sparkle
399166.png,https://derpicdn.net/img/view/2013/8/13/399166.png,0,0.983803391,0,0,404,424,404,424,twilight sparkle
39956.jpg,https://derpicdn.net/img/view/2012/7/10/39956.jpg,0,0.954239011,106,23,550,467,444,444,twilight sparkle
400105.jpg,https://derpicdn.net/img/view/2013/8/14/400105.jpg,0,0.982106984,356,46,712,402,356,356,twilight sparkle
400105.jpg,https://derpicdn.net/img/view/2013/8/14/400105.jpg,1,0.923068285,199,105,507,413,308,308,twilight sparkle
402823.png,https://derpicdn.net/img/view/2013/8/17/402823.png,0,0.957461178,157,153,883,879,726,726,twilight sparkle
403266.png,https://derpicdn.net/img/view/2013/8/18/403266.png,0,0.999572098,260,5,838,583,578,578,twilight sparkle
406483.jpg,https://derpicdn.net/img/view/2013/8/21/406483.jpg,1,0.987988055,827,1309,1621,2103,794,794,twilight sparkle
406483.jpg,https://derpicdn.net/img/view/2013/8/21/406483.jpg,2,0.980438709,1035,294,1787,1046,752,752,twilight sparkle
409757.png,https://derpicdn.net/img/view/2013/8/25/409757.png,0,0.935732663,172,40,534,402,362,362,twilight sparkle
412783.png,https://derpicdn.net/img/view/2013/8/28/412783.png,0,0.983692825,3151,1003,5235,3087,2084,2084,twilight sparkle
412891.png,https://derpicdn.net/img/view/2013/8/28/412891.png,0,0.993965209,330,0,880,526,550,526,twilight sparkle
416208.png,https://derpicdn.net/img/view/2013/9/1/416208.png,0,0.979386747,97,0,517,387,420,387,twilight sparkle
41868.jpg,https://derpicdn.net/img/view/2012/7/12/41868.jpg,0,0.922742009,219,21,1237,1039,1018,1018,twilight sparkle
418853.png,https://derpicdn.net/img/view/2013/9/4/418853.png,0,0.964419842,9,0,900,896,891,896,twilight sparkle
420895.png,https://derpicdn.net/img/view/2013/9/6/420895.png,0,0.921369016,0,0,481,453,481,453,twilight sparkle
421312.png,https://derpicdn.net/img/view/2013/9/7/421312.png,0,0.935288072,0,0,1007,1019,1007,1019,twilight sparkle
428930.png,https://derpicdn.net/img/view/2013/9/16/428930.png,0,0.987047493,5,34,309,338,304,304,twilight sparkle
430184.png,https://derpicdn.net/img/view/2013/9/18/430184.png,0,0.997410715,126,0,838,634,712,634,twilight sparkle
430764.jpg,https://derpicdn.net/img/view/2013/9/19/430764.jpg,0,0.997511327,779,0,1661,787,882,787,twilight sparkle
434880.jpg,https://derpicdn.net/img/view/2013/9/25/434880.jpg,0,0.996978998,0,0,351,345,351,345,twilight sparkle
436952.png,https://derpicdn.net/img/view/2013/9/28/436952.png,0,0.982378125,1420,128,2174,882,754,754,twilight sparkle
449598.jpg,https://derpicdn.net/img/view/2013/10/15/449598.jpg,0,0.99399358,170,0,572,361,402,361,twilight sparkle
450225.jpg,https://derpicdn.net/img/view/2013/10/16/450225.jpg,0,0.99813652,300,16,688,404,388,388,twilight sparkle
453662.png,https://derpicdn.net/img/view/2013/10/21/453662.png,0,0.950573027,432,104,758,430,326,326,twilight sparkle
454094.png,https://derpicdn.net/img/view/2013/10/22/454094.png,0,0.962893426,0,36,274,314,274,278,twilight sparkle
459110.png,https://derpicdn.net/img/view/2013/10/28/459110.png,1,0.94742924,1472,669,2358,1555,886,886,twilight sparkle
459447.png,https://derpicdn.net/img/view/2013/10/29/459447.png,0,0.901698232,312,0,668,353,356,353,twilight sparkle
460180.png,https://derpicdn.net/img/view/2013/10/30/460180.png,0,0.923737109,38,0,940,893,902,893,twilight sparkle
462209.png,https://derpicdn.net/img/view/2013/11/2/462209.png,0,0.990496457,55,0,1723,1667,1668,1667,twilight sparkle
471417.png,https://derpicdn.net/img/view/2013/11/13/471417.png,0,0.999030352,1356,990,2394,2028,1038,1038,twilight sparkle
47212.jpg,https://derpicdn.net/img/view/2012/7/17/47212.jpg,0,0.999292374,55,26,429,400,374,374,twilight sparkle
472212.png,https://derpicdn.net/img/view/2013/11/14/472212.png,0,0.979532838,255,0,2285,1923,2030,1923,twilight sparkle
472732.png,https://derpicdn.net/img/view/2013/11/14/472732.png,0,0.988038242,0,0,4030,3728,4030,3728,twilight sparkle
47415.jpg,https://derpicdn.net/img/view/2012/7/17/47415.jpg,0,0.998189926,685,344,955,614,270,270,twilight sparkle
47459.png,https://derpicdn.net/img/view/2012/7/17/47459.png,0,0.99431181,41,49,931,939,890,890,twilight sparkle
475138.png,https://derpicdn.net/img/view/2013/11/18/475138.png,0,0.92874074,23,0,606,570,583,570,twilight sparkle
479871.jpg,https://derpicdn.net/img/view/2013/11/24/479871.jpg,0,0.910499454,308,0,1542,1057,1234,1057,twilight sparkle
480631.png,https://derpicdn.net/img/view/2013/11/24/480631.png,0,0.948605299,210,0,680,468,470,468,twilight sparkle
481722.png,https://derpicdn.net/img/view/2013/11/25/481722.png,0,0.948817611,0,0,919,931,919,931,twilight sparkle
481740.png,https://derpicdn.net/img/view/2013/11/25/481740.png,0,0.991162956,298,0,700,363,402,363,twilight sparkle
482437.png,https://derpicdn.net/img/view/2013/11/26/482437.png,0,0.9367401,163,50,411,298,248,248,twilight sparkle
483879.png,https://derpicdn.net/img/view/2013/11/28/483879.png,0,0.986530662,191,119,1305,1233,1114,1114,twilight sparkle
484288.png,https://derpicdn.net/img/view/2013/11/28/484288.png,0,0.996686041,405,90,765,450,360,360,twilight sparkle
484533.png,https://derpicdn.net/img/view/2013/11/28/484533.png,0,0.932903945,214,61,822,669,608,608,twilight sparkle
49820.png,https://derpicdn.net/img/view/2012/7/19/49820.png,0,0.912054241,12,77,284,375,272,298,twilight sparkle
506492.png,https://derpicdn.net/img/view/2013/12/25/506492.png,0,0.997354627,524,117,1914,1507,1390,1390,twilight sparkle
508767.png,https://derpicdn.net/img/view/2013/12/29/508767.png,0,0.976781785,0,0,768,776,768,776,twilight sparkle
508767.png,https://derpicdn.net/img/view/2013/12/29/508767.png,1,0.900473833,61,44,960,974,899,930,twilight sparkle
510438.png,https://derpicdn.net/img/view/2013/12/30/510438.png,0,0.995815694,766,0,1611,903,845,903,twilight sparkle
510444.png,https://derpicdn.net/img/view/2013/12/30/510444.png,0,0.981699049,1779,0,4245,2178,2466,2178,twilight sparkle
510515.png,https://derpicdn.net/img/view/2013/12/30/510515.png,0,0.996871471,2914,588,5364,3038,2450,2450,twilight sparkle
513797.png,https://derpicdn.net/img/view/2014/1/3/513797.png,0,0.976531982,94,25,1462,1393,1368,1368,twilight sparkle
515018.png,https://derpicdn.net/img/view/2014/1/4/515018.png,0,0.982974291,98,0,822,673,724,673,twilight sparkle
515684.png,https://derpicdn.net/img/view/2014/1/5/515684.png,0,0.997224987,142,158,660,676,518,518,twilight sparkle
517887.png,https://derpicdn.net/img/view/2014/1/7/517887.png,0,0.993538022,672,74,1124,526,452,452,twilight sparkle
518193.png,https://derpicdn.net/img/view/2014/1/7/518193.png,0,0.994480968,609,303,1147,841,538,538,twilight sparkle
518256.png,https://derpicdn.net/img/view/2014/1/7/518256.png,0,0.988045216,1100,282,1840,1022,740,740,twilight sparkle
522092.png,https://derpicdn.net/img/view/2014/1/12/522092.png,0,0.989432514,41,0,498,456,457,456,twilight sparkle
522620.png,https://derpicdn.net/img/view/2014/1/12/522620.png,0,0.949691772,260,19,966,725,706,706,twilight sparkle
527588.png,https://derpicdn.net/img/view/2014/1/18/527588.png,0,0.922865331,567,0,1111,540,544,540,twilight sparkle
533932.png,https://derpicdn.net/img/view/2014/1/25/533932.png,0,0.983992636,0,0,488,298,488,298,twilight sparkle
534306.png,https://derpicdn.net/img/view/2014/1/25/534306.png,0,0.997607946,0,0,1311,1269,1311,1269,twilight sparkle
535072.png,https://derpicdn.net/img/view/2014/1/26/535072.png,0,0.995778859,0,0,2185,2158,2185,2158,twilight sparkle
535557.png,https://derpicdn.net/img/view/2014/1/27/535557.png,0,0.968750477,31,0,495,384,464,384,twilight sparkle
535687.png,https://derpicdn.net/img/view/2014/1/27/535687.png,0,0.999327779,27,0,323,284,296,284,twilight sparkle
536652.png,https://derpicdn.net/img/view/2014/1/28/536652.png,0,0.913572967,348,43,704,399,356,356,twilight sparkle
540298.png,https://derpicdn.net/img/view/2014/2/1/540298.png,0,0.999697626,728,0,2086,1193,1358,1193,twilight sparkle
543164.png,https://derpicdn.net/img/view/2014/2/4/543164.png,0,0.998955965,804,0,1840,1006,1036,1006,twilight sparkle
544073.png,https://derpicdn.net/img/view/2014/2/5/544073.png,0,0.923573852,1131,269,4511,3649,3380,3380,twilight sparkle
545733.png,https://derpicdn.net/img/view/2014/2/7/545733.png,0,0.994588077,6739,819,12901,6981,6162,6162,twilight sparkle
546295.jpg,https://derpicdn.net/img/view/2014/2/8/546295.jpg,0,0.999369323,626,0,1514,710,888,710,twilight sparkle
547255.png,https://derpicdn.net/img/view/2014/2/9/547255.png,0,0.958363295,253,0,719,492,466,492,twilight sparkle
548833.png,https://derpicdn.net/img/view/2014/2/10/548833.png,0,0.990454495,215,72,509,366,294,294,twilight sparkle
549069.png,https://derpicdn.net/img/view/2014/2/11/549069.png,0,0.996626258,1018,449,1490,921,472,472,twilight sparkle
549069.png,https://derpicdn.net/img/view/2014/2/11/549069.png,1,0.941667974,405,1177,873,1645,468,468,twilight sparkle
549865.png,https://derpicdn.net/img/view/2014/2/12/549865.png,0,0.997395933,126,120,922,916,796,796,twilight sparkle
555536.jpg,https://derpicdn.net/img/view/2014/2/18/555536.jpg,0,0.987458229,15,0,303,276,288,276,twilight sparkle
556276.png,https://derpicdn.net/img/view/2014/2/19/556276.png,0,0.999049008,185,0,623,416,438,416,twilight sparkle
558097.jpg,https://derpicdn.net/img/view/2014/2/21/558097.jpg,0,0.925513268,194,30,1042,878,848,848,twilight sparkle
55964.jpg,https://derpicdn.net/img/view/2012/7/25/55964.jpg,0,0.923791707,9,0,441,413,432,413,twilight sparkle
559721.png,https://derpicdn.net/img/view/2014/2/23/559721.png,0,0.953781545,0,0,1024,1280,1024,1280,twilight sparkle
560153.jpg,https://derpicdn.net/img/view/2014/2/23/560153.jpg,0,0.977686226,850,197,1464,811,614,614,twilight sparkle
560359.png,https://derpicdn.net/img/view/2014/2/24/560359.png,0,0.924868405,0,0,478,595,478,595,twilight sparkle
560650.png,https://derpicdn.net/img/view/2014/2/24/560650.png,0,0.94663626,516,319,802,605,286,286,twilight sparkle
561964.png,https://derpicdn.net/img/view/2014/2/26/561964.png,0,0.935298681,504,30,966,492,462,462,twilight sparkle
564248.png,https://derpicdn.net/img/view/2014/3/1/564248.png,0,0.969593346,306,55,706,455,400,400,twilight sparkle
566589.png,https://derpicdn.net/img/view/2014/3/4/566589.png,0,0.932780266,748,99,1476,827,728,728,twilight sparkle
568757.png,https://derpicdn.net/img/view/2014/3/7/568757.png,0,0.968679488,316,55,732,471,416,416,twilight sparkle
572243.png,https://derpicdn.net/img/view/2014/3/11/572243.png,0,0.943018436,54,39,748,733,694,694,twilight sparkle
573044.png,https://derpicdn.net/img/view/2014/3/12/573044.png,0,0.901525974,140,0,570,407,430,407,twilight sparkle
578528.png,https://derpicdn.net/img/view/2014/3/18/578528.png,0,0.960313976,71,270,341,540,270,270,twilight sparkle
578528.png,https://derpicdn.net/img/view/2014/3/18/578528.png,1,0.946278512,95,0,363,249,268,249,twilight sparkle
583174.png,https://derpicdn.net/img/view/2014/3/23/583174.png,0,0.991762996,339,147,671,479,332,332,twilight sparkle
583398.png,https://derpicdn.net/img/view/2014/3/23/583398.png,0,0.998419881,0,0,2507,2844,2507,2844,twilight sparkle
588949.png,https://derpicdn.net/img/view/2014/3/30/588949.png,0,0.903236389,699,0,3551,2302,2852,2302,twilight sparkle
591121.png,https://derpicdn.net/img/view/2014/4/2/591121.png,0,0.973259389,937,553,2457,2073,1520,1520,twilight sparkle
593304.jpg,https://derpicdn.net/img/view/2014/4/5/593304.jpg,0,0.992656946,0,184,423,614,423,430,twilight sparkle
596657.jpg,https://derpicdn.net/img/view/2014/4/9/596657.jpg,0,0.994736433,1519,53,2205,739,686,686,twilight sparkle
596658.jpg,https://derpicdn.net/img/view/2014/4/9/596658.jpg,0,0.99614501,1542,70,2196,724,654,654,twilight sparkle
596660.jpg,https://derpicdn.net/img/view/2014/4/9/596660.jpg,0,0.983510017,1559,79,2193,713,634,634,twilight sparkle
597218.png,https://derpicdn.net/img/view/2014/4/10/597218.png,0,0.997599304,3153,0,6323,2778,3170,2778,twilight sparkle
597295.png,https://derpicdn.net/img/view/2014/4/10/597295.png,0,0.917074919,9,430,345,766,336,336,twilight sparkle
599086.png,https://derpicdn.net/img/view/2014/4/13/599086.png,0,0.963092208,53,131,453,531,400,400,twilight sparkle
599299.png,https://derpicdn.net/img/view/2014/4/13/599299.png,0,0.94845295,247,0,531,279,284,279,twilight sparkle
607241.png,https://derpicdn.net/img/view/2014/4/22/607241.png,0,0.996825099,1,0,513,464,512,464,twilight sparkle
608532.png,https://derpicdn.net/img/view/2014/4/24/608532.png,0,0.998757839,3355,0,6353,2917,2998,2917,twilight sparkle
611539.png,https://derpicdn.net/img/view/2014/4/27/611539.png,0,0.92515856,227,274,495,542,268,268,twilight sparkle
613607.png,https://derpicdn.net/img/view/2014/4/30/613607.png,0,0.979470193,0,5,453,479,453,474,twilight sparkle
617400.png,https://derpicdn.net/img/view/2014/5/4/617400.png,0,0.98929584,0,0,629,574,629,574,twilight sparkle
620195.png,https://derpicdn.net/img/view/2014/5/7/620195.png,0,0.959171772,138,0,518,367,380,367,twilight sparkle
621159.png,https://derpicdn.net/img/view/2014/5/8/621159.png,0,0.992336035,638,299,932,593,294,294,twilight sparkle
623001.png,https://derpicdn.net/img/view/2014/5/10/623001.png,0,0.976949513,44,0,958,700,914,700,twilight sparkle
623562.png,https://derpicdn.net/img/view/2014/5/11/623562.png,0,0.958034992,97,15,721,639,624,624,twilight sparkle
625066.png,https://derpicdn.net/img/view/2014/5/12/625066.png,0,0.980625629,134,9,955,800,821,791,twilight sparkle
626405.png,https://derpicdn.net/img/view/2014/5/14/626405.png,0,0.997876644,98,0,2914,2658,2816,2658,twilight sparkle
626613.png,https://derpicdn.net/img/view/2014/5/14/626613.png,0,0.9678545,7,32,1695,1720,1688,1688,twilight sparkle
627438.png,https://derpicdn.net/img/view/2014/5/15/627438.png,0,0.906624973,2708,0,5844,2994,3136,2994,twilight sparkle
628154.jpg,https://derpicdn.net/img/view/2014/5/16/628154.jpg,0,0.999535382,346,116,910,680,564,564,twilight sparkle
629562.png,https://derpicdn.net/img/view/2014/5/17/629562.png,0,0.998610973,677,0,1723,905,1046,905,twilight sparkle
631132.png,https://derpicdn.net/img/view/2014/5/19/631132.png,0,0.90484333,748,114,1366,732,618,618,twilight sparkle
632451.png,https://derpicdn.net/img/view/2014/5/21/632451.png,0,0.967159986,101,13,425,337,324,324,twilight sparkle
63437.jpg,https://derpicdn.net/img/view/2012/7/31/63437.jpg,0,0.998778939,265,106,747,588,482,482,twilight sparkle
634898.jpg,https://derpicdn.net/img/view/2014/5/24/634898.jpg,2,0.99841404,84,215,440,571,356,356,twilight sparkle
636773.png,https://derpicdn.net/img/view/2014/5/26/636773.png,0,0.958568156,243,0,529,276,286,276,twilight sparkle
637738.png,https://derpicdn.net/img/view/2014/5/27/637738.png,0,0.935931623,89,42,793,746,704,704,twilight sparkle
637921.png,https://derpicdn.net/img/view/2014/5/27/637921.png,0,0.924914896,1352,58,1870,576,518,518,twilight sparkle
64066.png,https://derpicdn.net/img/view/2012/8/1/64066.png,0,0.959803879,0,0,272,264,272,264,twilight sparkle
642221.jpg,https://derpicdn.net/img/view/2014/6/1/642221.jpg,0,0.912261367,786,0,2746,1957,1960,1957,twilight sparkle
643840.png,https://derpicdn.net/img/view/2014/6/3/643840.png,0,0.989931047,152,7,386,241,234,234,twilight sparkle
644226.png,https://derpicdn.net/img/view/2014/6/3/644226.png,0,0.984981835,246,0,482,234,236,234,twilight sparkle
645748.png,https://derpicdn.net/img/view/2014/6/5/645748.png,0,0.972968876,85,0,327,231,242,231,twilight sparkle
647045.png,https://derpicdn.net/img/view/2014/6/7/647045.png,0,0.99620229,393,5,629,241,236,236,twilight sparkle
649528.png,https://derpicdn.net/img/view/2014/6/10/649528.png,0,0.960464478,0,2,197,216,197,214,twilight sparkle
651983.png,https://derpicdn.net/img/view/2014/6/13/651983.png,0,0.996425509,47,102,313,368,266,266,twilight sparkle
652533.png,https://derpicdn.net/img/view/2014/6/14/652533.png,0,0.94418484,66,0,386,285,320,285,twilight sparkle
654641.png,https://derpicdn.net/img/view/2014/6/16/654641.png,0,0.959908962,0,0,243,190,243,190,twilight sparkle
66040.jpg,https://derpicdn.net/img/view/2012/8/3/66040.jpg,0,0.941173136,186,0,322,109,136,109,twilight sparkle
661974.jpg,https://derpicdn.net/img/view/2014/6/26/661974.jpg,0,0.976596713,176,18,488,330,312,312,twilight sparkle
662509.png,https://derpicdn.net/img/view/2014/6/27/662509.png,0,0.996041596,0,92,526,628,526,536,twilight sparkle
666546.png,https://derpicdn.net/img/view/2014/7/3/666546.png,0,0.987947047,273,81,1257,1065,984,984,twilight sparkle
666646.png,https://derpicdn.net/img/view/2014/7/3/666646.png,0,0.935820341,444,0,868,391,424,391,twilight sparkle
66753.png,https://derpicdn.net/img/view/2012/8/4/66753.png,0,0.976583183,3,0,535,498,532,498,twilight sparkle
667778.png,https://derpicdn.net/img/view/2014/7/5/667778.png,0,0.980345845,0,1433,2873,4707,2873,3274,twilight sparkle
668696.png,https://derpicdn.net/img/view/2014/7/6/668696.png,0,0.986500144,1765,246,2539,1020,774,774,twilight sparkle
668893.png,https://derpicdn.net/img/view/2014/7/6/668893.png,0,0.991150677,283,42,865,624,582,582,twilight sparkle
66938.png,https://derpicdn.net/img/view/2012/8/4/66938.png,0,0.987835407,192,31,434,273,242,242,twilight sparkle
669476.png,https://derpicdn.net/img/view/2014/7/7/669476.png,0,0.997436881,3035,1126,8155,6246,5120,5120,twilight sparkle
670681.png,https://derpicdn.net/img/view/2014/7/8/670681.png,0,0.998869479,1434,0,3396,1900,1962,1900,twilight sparkle
670908.png,https://derpicdn.net/img/view/2014/7/9/670908.png,0,0.998300731,1624,0,4074,2114,2450,2114,twilight sparkle
671763.png,https://derpicdn.net/img/view/2014/7/10/671763.png,0,0.981911719,43,0,707,586,664,586,twilight sparkle
673901.jpg,https://derpicdn.net/img/view/2014/7/13/673901.jpg,0,0.986780882,194,0,522,328,328,328,twilight sparkle
676463.png,https://derpicdn.net/img/view/2014/7/16/676463.png,0,0.953672588,855,1331,1401,1877,546,546,twilight sparkle
677287.png,https://derpicdn.net/img/view/2014/7/17/677287.png,0,0.99142307,70,0,654,575,584,575,twilight sparkle
678745.png,https://derpicdn.net/img/view/2014/7/20/678745.png,0,0.997844696,0,1,2850,2949,2850,2948,twilight sparkle
678936.png,https://derpicdn.net/img/view/2014/7/20/678936.png,0,0.973465621,260,42,576,358,316,316,twilight sparkle
679943.png,https://derpicdn.net/img/view/2014/7/21/679943.png,0,0.980385363,0,80,3244,3646,3244,3566,twilight sparkle
681207.png,https://derpicdn.net/img/view/2014/7/22/681207.png,0,0.973199308,142,0,522,366,380,366,twilight sparkle
681279.png,https://derpicdn.net/img/view/2014/7/23/681279.png,0,0.978699446,710,0,1128,390,418,390,twilight sparkle
682189.png,https://derpicdn.net/img/view/2014/7/24/682189.png,0,0.999539196,157,0,941,708,784,708,twilight sparkle
686688.png,https://derpicdn.net/img/view/2014/7/30/686688.png,0,0.999511421,0,0,568,572,568,572,twilight sparkle
687747.png,https://derpicdn.net/img/view/2014/7/31/687747.png,0,0.912665188,326,0,1826,1080,1500,1080,twilight sparkle
687760.jpg,https://derpicdn.net/img/view/2014/7/31/687760.jpg,0,0.99960798,283,1,675,393,392,392,twilight sparkle
688474.jpg,https://derpicdn.net/img/view/2014/8/1/688474.jpg,0,0.936914504,643,981,1437,1775,794,794,twilight sparkle
689833.png,https://derpicdn.net/img/view/2014/8/3/689833.png,0,0.994451582,268,0,814,489,546,489,twilight sparkle
693961.png,https://derpicdn.net/img/view/2014/8/7/693961.png,0,0.990037918,100,0,370,261,270,261,twilight sparkle
694834.png,https://derpicdn.net/img/view/2014/8/8/694834.png,0,0.95239681,145,0,563,391,418,391,twilight sparkle
702353.jpg,https://derpicdn.net/img/view/2014/8/18/702353.jpg,0,0.993250012,225,0,1489,1222,1264,1222,twilight sparkle
703172.png,https://derpicdn.net/img/view/2014/8/19/703172.png,0,0.94895196,117,0,1181,1044,1064,1044,twilight sparkle
703553.png,https://derpicdn.net/img/view/2014/8/19/703553.png,0,0.953758955,184,0,682,453,498,453,twilight sparkle
712024.png,https://derpicdn.net/img/view/2014/8/31/712024.png,0,0.975432634,0,15,1250,1317,1250,1302,twilight sparkle
712880.png,https://derpicdn.net/img/view/2014/9/1/712880.png,0,0.993577063,7,0,837,769,830,769,twilight sparkle
713632.png,https://derpicdn.net/img/view/2014/9/2/713632.png,0,0.992406547,501,7,957,463,456,456,twilight sparkle
714001.png,https://derpicdn.net/img/view/2014/9/3/714001.png,0,0.916534603,359,0,2000,1728,1641,1728,twilight sparkle
716186.png,https://derpicdn.net/img/view/2014/9/6/716186.png,0,0.94124341,188,0,650,448,462,448,twilight sparkle
716982.png,https://derpicdn.net/img/view/2014/9/7/716982.png,0,0.966581702,103,1315,1395,2607,1292,1292,twilight sparkle
719154.png,https://derpicdn.net/img/view/2014/9/10/719154.png,0,0.972259939,405,0,861,446,456,446,twilight sparkle
719475.png,https://derpicdn.net/img/view/2014/9/10/719475.png,0,0.999709785,264,0,712,381,448,381,twilight sparkle
720663.png,https://derpicdn.net/img/view/2014/9/12/720663.png,0,0.990713656,463,156,933,626,470,470,twilight sparkle
723088.png,https://derpicdn.net/img/view/2014/9/16/723088.png,0,0.99222225,40,0,3400,3351,3360,3351,twilight sparkle
726528.png,https://derpicdn.net/img/view/2014/9/21/726528.png,0,0.997016907,32,6,896,870,864,864,twilight sparkle
728045.png,https://derpicdn.net/img/view/2014/9/23/728045.png,0,0.997517049,190,11,578,399,388,388,twilight sparkle
730252.png,https://derpicdn.net/img/view/2014/9/27/730252.png,0,0.9938429,0,0,381,393,381,393,twilight sparkle
730481.png,https://derpicdn.net/img/view/2014/9/27/730481.png,0,0.979221702,1293,126,1993,826,700,700,twilight sparkle
736793.png,https://derpicdn.net/img/view/2014/10/6/736793.png,0,0.962544084,201,64,689,552,488,488,twilight sparkle
737287.png,https://derpicdn.net/img/view/2014/10/6/737287.png,0,0.991354704,46,57,2116,2127,2070,2070,twilight sparkle
737623.png,https://derpicdn.net/img/view/2014/10/7/737623.png,0,0.987566233,0,0,720,707,720,707,twilight sparkle
739351.png,https://derpicdn.net/img/view/2014/10/9/739351.png,0,0.99930501,203,1,845,643,642,642,twilight sparkle
740211.png,https://derpicdn.net/img/view/2014/10/10/740211.png,0,0.986986339,175,65,585,475,410,410,twilight sparkle
740770.png,https://derpicdn.net/img/view/2014/10/11/740770.png,0,0.957294345,321,29,1215,923,894,894,twilight sparkle
743257.png,https://derpicdn.net/img/view/2014/10/15/743257.png,0,0.993405342,363,0,933,518,570,518,twilight sparkle
747689.png,https://derpicdn.net/img/view/2014/10/21/747689.png,0,0.998122394,170,0,494,302,324,302,twilight sparkle
750031.png,https://derpicdn.net/img/view/2014/10/25/750031.png,0,0.94788307,163,147,393,377,230,230,twilight sparkle
750728.png,https://derpicdn.net/img/view/2014/10/26/750728.png,0,0.993253291,145,4,579,438,434,434,twilight sparkle
752725.png,https://derpicdn.net/img/view/2014/10/28/752725.png,0,0.920006216,0,0,6438,7954,6438,7954,twilight sparkle
752988.png,https://derpicdn.net/img/view/2014/10/29/752988.png,0,0.943559349,343,16,851,524,508,508,twilight sparkle
75358.png,https://derpicdn.net/img/view/2012/8/15/75358.png,0,0.990213156,530,0,3788,3195,3258,3195,twilight sparkle
754249.png,https://derpicdn.net/img/view/2014/10/30/754249.png,0,0.981749117,373,66,749,442,376,376,twilight sparkle
755757.png,https://derpicdn.net/img/view/2014/11/2/755757.png,0,0.991708755,11,0,309,286,298,286,twilight sparkle
756211.png,https://derpicdn.net/img/view/2014/11/2/756211.png,0,0.998675466,3944,429,8273,4901,4329,4472,twilight sparkle
759160.png,https://derpicdn.net/img/view/2014/11/6/759160.png,0,0.998161614,176,0,772,580,596,580,twilight sparkle
76245.png,https://derpicdn.net/img/view/2012/8/17/76245.png,0,0.984260917,0,954,4518,5347,4518,4393,twilight sparkle
764626.png,https://derpicdn.net/img/view/2014/11/14/764626.png,0,0.996730566,236,0,650,405,414,405,twilight sparkle
767595.png,https://derpicdn.net/img/view/2014/11/19/767595.png,0,0.998090744,1376,0,2698,1193,1322,1193,twilight sparkle
768637.png,https://derpicdn.net/img/view/2014/11/21/768637.png,0,0.993375123,2922,251,7296,4625,4374,4374,twilight sparkle
768830.png,https://derpicdn.net/img/view/2014/11/21/768830.png,0,0.985121667,134,41,950,857,816,816,twilight sparkle
773597.png,https://derpicdn.net/img/view/2014/11/28/773597.png,0,0.999681354,558,42,948,432,390,390,twilight sparkle
774340.png,https://derpicdn.net/img/view/2014/11/29/774340.png,0,0.956017077,11,0,855,813,844,813,twilight sparkle
777765.png,https://derpicdn.net/img/view/2014/12/4/777765.png,0,0.985789835,573,55,1691,1173,1118,1118,twilight sparkle
779491.png,https://derpicdn.net/img/view/2014/12/6/779491.png,0,0.998379707,189,53,639,503,450,450,twilight sparkle
781889.jpg,https://derpicdn.net/img/view/2014/12/10/781889.jpg,0,0.976677418,837,240,1291,694,454,454,twilight sparkle
786486.png,https://derpicdn.net/img/view/2014/12/17/786486.png,0,0.953264594,429,67,935,573,506,506,twilight sparkle
786688.png,https://derpicdn.net/img/view/2014/12/17/786688.png,0,0.999793351,0,143,795,975,795,832,twilight sparkle
786688.png,https://derpicdn.net/img/view/2014/12/17/786688.png,1,0.997511268,1157,353,1941,1137,784,784,twilight sparkle
787786.png,https://derpicdn.net/img/view/2014/12/19/787786.png,0,0.995357931,202,74,724,596,522,522,twilight sparkle
788181.png,https://derpicdn.net/img/view/2014/12/19/788181.png,0,0.994440258,239,2,2097,1860,1858,1858,twilight sparkle
79176.png,https://derpicdn.net/img/view/2012/8/21/79176.png,0,0.991914809,229,0,829,516,600,516,twilight sparkle
799024.jpg,https://derpicdn.net/img/view/2015/1/4/799024.jpg,0,0.960330188,232,0,1278,934,1046,934,twilight sparkle
799741.png,https://derpicdn.net/img/view/2015/1/5/799741.png,0,0.995915949,225,0,2557,2317,2332,2317,twilight sparkle
800278.png,https://derpicdn.net/img/view/2015/1/5/800278.png,0,0.997146726,2570,0,4966,2157,2396,2157,twilight sparkle
803290.png,https://derpicdn.net/img/view/2015/1/10/803290.png,0,0.989121616,258,50,794,586,536,536,twilight sparkle
804296.png,https://derpicdn.net/img/view/2015/1/11/804296.png,0,0.992076993,123,0,751,614,628,614,twilight sparkle
806483.png,https://derpicdn.net/img/view/2015/1/14/806483.png,0,0.914530158,1955,87,3837,1969,1882,1882,twilight sparkle
806567.png,https://derpicdn.net/img/view/2015/1/14/806567.png,0,0.908119023,269,81,641,453,372,372,twilight sparkle
807437.png,https://derpicdn.net/img/view/2015/1/16/807437.png,0,0.997634649,215,13,495,293,280,280,twilight sparkle
808906.png,https://derpicdn.net/img/view/2015/1/18/808906.png,0,0.998911083,222,0,770,505,548,505,twilight sparkle
809303.png,https://derpicdn.net/img/view/2015/1/18/809303.png,0,0.988786578,311,160,741,590,430,430,twilight sparkle
810556.png,https://derpicdn.net/img/view/2015/1/20/810556.png,0,0.987137556,1505,0,3107,1767,1602,1767,twilight sparkle
811437.png,https://derpicdn.net/img/view/2015/1/21/811437.png,0,0.95028007,2901,0,5387,2143,2486,2143,twilight sparkle
812206.png,https://derpicdn.net/img/view/2015/1/22/812206.png,0,0.964478493,126,0,880,743,754,743,twilight sparkle
816257.png,https://derpicdn.net/img/view/2015/1/28/816257.png,0,0.990552902,50,3,424,377,374,374,twilight sparkle
819260.jpg,https://derpicdn.net/img/view/2015/2/1/819260.jpg,0,0.991589129,396,288,802,694,406,406,twilight sparkle
821003.png,https://derpicdn.net/img/view/2015/2/4/821003.png,0,0.975818455,34,103,532,599,498,496,twilight sparkle
822778.png,https://derpicdn.net/img/view/2015/2/6/822778.png,0,0.995504558,126,41,536,451,410,410,twilight sparkle
825001.png,https://derpicdn.net/img/view/2015/2/9/825001.png,0,0.985940278,102,0,400,285,298,285,twilight sparkle
825484.png,https://derpicdn.net/img/view/2015/2/10/825484.png,0,0.98653698,451,60,841,450,390,390,twilight sparkle
825659.png,https://derpicdn.net/img/view/2015/2/10/825659.png,0,0.985307574,188,52,818,682,630,630,twilight sparkle
826665.png,https://derpicdn.net/img/view/2015/2/12/826665.png,0,0.982488334,606,5,1746,1145,1140,1140,twilight sparkle
826848.png,https://derpicdn.net/img/view/2015/2/12/826848.png,0,0.959625781,275,0,800,530,525,530,twilight sparkle
828244.png,https://derpicdn.net/img/view/2015/2/14/828244.png,0,0.994821906,230,0,440,194,210,194,twilight sparkle
832495.jpg,https://derpicdn.net/img/view/2015/2/19/832495.jpg,0,0.968088448,59,0,423,364,364,364,twilight sparkle
832508.png,https://derpicdn.net/img/view/2015/2/19/832508.png,0,0.989317656,151,0,2871,2623,2720,2623,twilight sparkle
832791.jpg,https://derpicdn.net/img/view/2015/2/20/832791.jpg,0,0.987458408,552,0,872,278,320,278,twilight sparkle
839215.png,https://derpicdn.net/img/view/2015/2/28/839215.png,0,0.993293107,201,19,525,343,324,324,twilight sparkle
842959.png,https://derpicdn.net/img/view/2015/3/5/842959.png,0,0.989884734,340,432,2738,2830,2398,2398,twilight sparkle
843776.png,https://derpicdn.net/img/view/2015/3/6/843776.png,0,0.972816169,6,112,448,554,442,442,twilight sparkle
845445.jpg,https://derpicdn.net/img/view/2015/3/8/845445.jpg,0,0.994030774,144,0,554,373,410,373,twilight sparkle
845851.png,https://derpicdn.net/img/view/2015/3/9/845851.png,0,0.985607505,169,245,563,639,394,394,twilight sparkle
851644.png,https://derpicdn.net/img/view/2015/3/17/851644.png,0,0.980031073,430,537,1082,1189,652,652,twilight sparkle
853155.jpg,https://derpicdn.net/img/view/2015/3/19/853155.jpg,0,0.969318688,39,0,489,419,450,419,twilight sparkle
853803.jpg,https://derpicdn.net/img/view/2015/3/20/853803.jpg,0,0.994840801,1869,148,3000,1306,1131,1158,twilight sparkle
853803.jpg,https://derpicdn.net/img/view/2015/3/20/853803.jpg,1,0.902742743,0,0,2655,2161,2655,2161,twilight sparkle
854225.png,https://derpicdn.net/img/view/2015/3/21/854225.png,0,0.99242264,154,1,924,771,770,770,twilight sparkle
855654.png,https://derpicdn.net/img/view/2015/3/23/855654.png,0,0.994017601,313,18,771,476,458,458,twilight sparkle
857299.png,https://derpicdn.net/img/view/2015/3/26/857299.png,0,0.998037994,126,0,2766,2593,2640,2593,twilight sparkle
860000.jpg,https://derpicdn.net/img/view/2015/3/29/860000.jpg,0,0.999488473,591,46,1851,1306,1260,1260,twilight sparkle
860609.jpg,https://derpicdn.net/img/view/2015/3/30/860609.jpg,0,0.943545222,199,0,720,564,521,564,twilight sparkle
863305.png,https://derpicdn.net/img/view/2015/4/2/863305.png,0,0.935412824,845,0,1833,975,988,975,twilight sparkle
868466.png,https://derpicdn.net/img/view/2015/4/8/868466.png,0,0.999034643,125,0,2801,2591,2676,2591,twilight sparkle
869145.jpg,https://derpicdn.net/img/view/2015/4/8/869145.jpg,0,0.902953088,184,229,634,679,450,450,twilight sparkle
869636.png,https://derpicdn.net/img/view/2015/4/9/869636.png,0,0.969909549,0,193,972,1200,972,1007,twilight sparkle
871353.png,https://derpicdn.net/img/view/2015/4/11/871353.png,0,0.936513007,140,24,666,550,526,526,twilight sparkle
872671.png,https://derpicdn.net/img/view/2015/4/12/872671.png,0,0.956958652,350,35,884,569,534,534,twilight sparkle
873093.png,https://derpicdn.net/img/view/2015/4/13/873093.png,0,0.980752468,391,0,1401,905,1010,905,twilight sparkle
874139.png,https://derpicdn.net/img/view/2015/4/14/874139.png,0,0.913110733,34,92,1436,1494,1402,1402,twilight sparkle
875842.jpg,https://derpicdn.net/img/view/2015/4/17/875842.jpg,0,0.987730026,560,163,1996,1599,1436,1436,twilight sparkle
878547.png,https://derpicdn.net/img/view/2015/4/20/878547.png,0,0.977656126,490,342,784,636,294,294,twilight sparkle
881661.png,https://derpicdn.net/img/view/2015/4/24/881661.png,0,0.999464035,278,0,648,365,370,365,twilight sparkle
882326.png,https://derpicdn.net/img/view/2015/4/25/882326.png,0,0.994384766,52,0,1364,768,1312,768,twilight sparkle
883947.png,https://derpicdn.net/img/view/2015/4/27/883947.png,0,0.987993896,29,0,679,621,650,621,twilight sparkle
884100.png,https://derpicdn.net/img/view/2015/4/27/884100.png,0,0.983572662,2,0,596,568,594,568,twilight sparkle
884503.png,https://derpicdn.net/img/view/2015/4/28/884503.png,0,0.907322586,1961,86,3551,1742,1590,1656,twilight sparkle
884556.png,https://derpicdn.net/img/view/2015/4/28/884556.png,0,0.999494791,140,69,936,865,796,796,twilight sparkle
884688.png,https://derpicdn.net/img/view/2015/4/28/884688.png,0,0.997188866,215,1005,1149,1939,934,934,twilight sparkle
892001.png,https://derpicdn.net/img/view/2015/5/9/892001.png,0,0.999112606,0,0,416,397,416,397,twilight sparkle
893798.png,https://derpicdn.net/img/view/2015/5/11/893798.png,0,0.959515274,142,18,530,406,388,388,twilight sparkle
898707.png,https://derpicdn.net/img/view/2015/5/17/898707.png,0,0.980448663,0,0,510,497,510,497,twilight sparkle
899922.png,https://derpicdn.net/img/view/2015/5/19/899922.png,1,0.999001682,745,4,955,214,210,210,twilight sparkle
899922.png,https://derpicdn.net/img/view/2015/5/19/899922.png,3,0.983034849,434,155,602,323,168,168,twilight sparkle
902273.jpg,https://derpicdn.net/img/view/2015/5/23/902273.jpg,0,0.91571784,69,59,847,837,778,778,twilight sparkle
903013.png,https://derpicdn.net/img/view/2015/5/24/903013.png,0,0.968560517,1146,1335,1768,1957,622,622,twilight sparkle
906032.png,https://derpicdn.net/img/view/2015/5/29/906032.png,0,0.984055758,0,126,2532,2766,2532,2640,twilight sparkle
910418.png,https://derpicdn.net/img/view/2015/6/5/910418.png,0,0.981903732,1416,514,1874,972,458,458,twilight sparkle
91237.jpg,https://derpicdn.net/img/view/2012/9/6/91237.jpg,0,0.994408667,514,139,742,367,228,228,twilight sparkle
916507.png,https://derpicdn.net/img/view/2015/6/14/916507.png,0,0.945208669,0,0,331,337,331,337,twilight sparkle
922334.png,https://derpicdn.net/img/view/2015/6/23/922334.png,0,0.97267127,896,1589,1434,2127,538,538,twilight sparkle
922755.png,https://derpicdn.net/img/view/2015/6/24/922755.png,0,0.983775079,65,56,517,508,452,452,twilight sparkle
925043.png,https://derpicdn.net/img/view/2015/6/27/925043.png,0,0.962694526,0,0,482,457,482,457,twilight sparkle
925459.png,https://derpicdn.net/img/view/2015/6/28/925459.png,0,0.972430825,0,561,400,991,400,430,twilight sparkle
926436.png,https://derpicdn.net/img/view/2015/6/29/926436.png,0,0.999100029,403,95,693,385,290,290,twilight sparkle
926859.png,https://derpicdn.net/img/view/2015/6/30/926859.png,0,0.994141519,173,0,1173,955,1000,955,twilight sparkle
927447.png,https://derpicdn.net/img/view/2015/7/1/927447.png,0,0.983979583,651,117,3361,2827,2710,2710,twilight sparkle
927479.png,https://derpicdn.net/img/view/2015/7/1/927479.png,0,0.923147261,955,180,3341,2566,2386,2386,twilight sparkle
929994.png,https://derpicdn.net/img/view/2015/7/4/929994.png,0,0.999095917,729,282,973,526,244,244,twilight sparkle
929994.png,https://derpicdn.net/img/view/2015/7/4/929994.png,1,0.986631572,345,265,691,611,346,346,twilight sparkle
929994.png,https://derpicdn.net/img/view/2015/7/4/929994.png,2,0.9853701,150,0,536,313,386,313,twilight sparkle
932506.png,https://derpicdn.net/img/view/2015/7/8/932506.png,0,0.968860149,760,0,1554,790,794,790,twilight sparkle
933702.png,https://derpicdn.net/img/view/2015/7/9/933702.png,0,0.998186588,49,11,1395,1357,1346,1346,twilight sparkle
933702.png,https://derpicdn.net/img/view/2015/7/9/933702.png,1,0.995254397,0,1650,1511,3242,1511,1592,twilight sparkle
935790.png,https://derpicdn.net/img/view/2015/7/12/935790.png,0,0.973182023,178,0,1804,1080,1626,1080,twilight sparkle
936548.png,https://derpicdn.net/img/view/2015/7/13/936548.png,0,0.95212394,20,0,240,203,220,203,twilight sparkle
938793.png,https://derpicdn.net/img/view/2015/7/17/938793.png,0,0.98822552,725,127,1859,1261,1134,1134,twilight sparkle
947550.png,https://derpicdn.net/img/view/2015/7/30/947550.png,0,0.991661012,994,98,1988,1092,994,994,twilight sparkle
948185.jpg,https://derpicdn.net/img/view/2015/8/1/948185.jpg,0,0.992312014,309,18,645,354,336,336,twilight sparkle
952495.png,https://derpicdn.net/img/view/2015/8/6/952495.png,0,0.978975892,45,0,831,786,786,786,twilight sparkle
953593.jpg,https://derpicdn.net/img/view/2015/8/8/953593.jpg,0,0.995705187,787,0,1345,453,558,453,twilight sparkle
953593.jpg,https://derpicdn.net/img/view/2015/8/8/953593.jpg,1,0.907154381,0,0,572,563,572,563,twilight sparkle
956180.png,https://derpicdn.net/img/view/2015/8/12/956180.png,0,0.996780515,7,0,319,297,312,297,twilight sparkle
956180.png,https://derpicdn.net/img/view/2015/8/12/956180.png,1,0.991440892,613,87,889,363,276,276,twilight sparkle
959463.png,https://derpicdn.net/img/view/2015/8/17/959463.png,0,0.981005669,189,0,729,536,540,536,twilight sparkle
961167.png,https://derpicdn.net/img/view/2015/8/19/961167.png,0,0.963324606,359,0,845,470,486,470,twilight sparkle
961758.png,https://derpicdn.net/img/view/2015/8/20/961758.png,0,0.968669713,56,146,876,966,820,820,twilight sparkle
965450.png,https://derpicdn.net/img/view/2015/8/25/965450.png,0,0.99930656,1516,0,3432,1833,1916,1833,twilight sparkle
967381.png,https://derpicdn.net/img/view/2015/8/28/967381.png,0,0.929330289,49,0,801,688,752,688,twilight sparkle
969877.png,https://derpicdn.net/img/view/2015/8/31/969877.png,0,0.991752625,180,0,2406,2152,2226,2152,twilight sparkle
971376.png,https://derpicdn.net/img/view/2015/9/2/971376.png,0,0.935056269,0,0,364,345,364,345,twilight sparkle
975972.png,https://derpicdn.net/img/view/2015/9/9/975972.png,0,0.978077054,12,23,2302,2313,2290,2290,twilight sparkle
977337.png,https://derpicdn.net/img/view/2015/9/11/977337.png,0,0.984224916,405,122,1029,746,624,624,twilight sparkle
977880.jpg,https://derpicdn.net/img/view/2015/9/12/977880.jpg,0,0.988456249,430,39,2252,1861,1822,1822,twilight sparkle
979053.png,https://derpicdn.net/img/view/2015/9/13/979053.png,0,0.99035269,75,0,1101,967,1026,967,twilight sparkle
980454.png,https://derpicdn.net/img/view/2015/9/15/980454.png,0,0.983477473,256,0,964,553,708,553,twilight sparkle
982221.png,https://derpicdn.net/img/view/2015/9/18/982221.png,0,0.99870348,573,58,835,320,262,262,twilight sparkle
98288.png,https://derpicdn.net/img/view/2012/9/15/98288.png,0,0.999648094,292,0,732,427,440,427,twilight sparkle
984451.png,https://derpicdn.net/img/view/2015/9/21/984451.png,0,0.941597879,30,157,2496,2623,2466,2466,twilight sparkle
986410.png,https://derpicdn.net/img/view/2015/9/23/986410.png,0,0.997580945,34,5,486,457,452,452,twilight sparkle
989925.png,https://derpicdn.net/img/view/2015/9/28/989925.png,0,0.991802335,525,38,1067,580,542,542,twilight sparkle
990785.png,https://derpicdn.net/img/view/2015/9/29/990785.png,0,0.973444581,237,94,655,512,418,418,twilight sparkle
990874.png,https://derpicdn.net/img/view/2015/9/29/990874.png,0,0.997597873,365,21,639,295,274,274,twilight sparkle
990908.jpg,https://derpicdn.net/img/view/2015/9/29/990908.jpg,0,0.950554132,232,877,666,1311,434,434,twilight sparkle
992995.png,https://derpicdn.net/img/view/2015/10/2/992995.png,0,0.977903664,0,0,606,531,606,531,twilight sparkle
1002340.png,https://derpicdn.net/img/view/2015/10/15/1002340.png,0,0.98932755,174,0,952,746,778,746,twilight sparkle
100339.png,https://derpicdn.net/img/view/2012/9/17/100339.png,0,0.953610301,172,5,890,723,718,718,twilight sparkle
1005427.jpg,https://derpicdn.net/img/view/2015/10/18/1005427.jpg,0,0.982427657,720,146,2198,1624,1478,1478,twilight sparkle
1006426.png,https://derpicdn.net/img/view/2015/10/20/1006426.png,0,0.985328913,180,0,426,214,246,214,twilight sparkle
1006792.png,https://derpicdn.net/img/view/2015/10/21/1006792.png,0,0.996243775,0,0,782,642,782,642,twilight sparkle
1007229.png,https://derpicdn.net/img/view/2015/10/22/1007229.png,0,0.927086532,266,92,964,790,698,698,twilight sparkle
1008028.png,https://derpicdn.net/img/view/2015/10/23/1008028.png,0,0.982636511,283,344,505,566,222,222,twilight sparkle
1009702.png,https://derpicdn.net/img/view/2015/10/25/1009702.png,0,0.998333633,258,6,648,396,390,390,twilight sparkle
1010952.png,https://derpicdn.net/img/view/2015/10/28/1010952.png,0,0.997279763,510,17,806,313,296,296,twilight sparkle
1013029.png,https://derpicdn.net/img/view/2015/10/31/1013029.png,0,0.982832909,4,0,2960,2767,2956,2767,twilight sparkle
1014009.png,https://derpicdn.net/img/view/2015/11/1/1014009.png,0,0.953709483,493,192,1001,700,508,508,twilight sparkle
1018002.jpg,https://derpicdn.net/img/view/2015/11/7/1018002.jpg,0,0.983198047,905,190,1675,960,770,770,twilight sparkle
101962.png,https://derpicdn.net/img/view/2012/9/19/101962.png,0,0.992691815,35,13,313,291,278,278,twilight sparkle
1019860.png,https://derpicdn.net/img/view/2015/11/9/1019860.png,0,0.996165514,427,42,892,532,465,490,twilight sparkle
102490.png,https://derpicdn.net/img/view/2012/9/20/102490.png,0,0.994483054,43,20,2603,2580,2560,2560,twilight sparkle
1031130.png,https://derpicdn.net/img/view/2015/11/27/1031130.png,0,0.966574311,325,304,669,648,344,344,twilight sparkle
1031492.png,https://derpicdn.net/img/view/2015/11/28/1031492.png,0,0.992577195,219,0,505,274,286,274,twilight sparkle
103594.jpg,https://derpicdn.net/img/view/2012/9/21/103594.jpg,0,0.997294068,0,441,218,697,218,256,twilight sparkle
1039946.jpg,https://derpicdn.net/img/view/2015/12/8/1039946.jpg,1,0.998834312,787,0,1285,455,498,455,twilight sparkle
1043209.png,https://derpicdn.net/img/view/2015/12/13/1043209.png,0,0.981950462,0,0,885,927,885,927,twilight sparkle
1045648.jpg,https://derpicdn.net/img/view/2015/12/16/1045648.jpg,0,0.974043667,542,0,3150,2160,2608,2160,twilight sparkle
1046621.png,https://derpicdn.net/img/view/2015/12/18/1046621.png,0,0.982982278,207,0,551,315,344,315,twilight sparkle
1047937.png,https://derpicdn.net/img/view/2015/12/19/1047937.png,0,0.910946608,0,0,1171,1140,1171,1140,twilight sparkle
1048050.png,https://derpicdn.net/img/view/2015/12/19/1048050.png,0,0.982111216,43,59,900,965,857,906,twilight sparkle
1049137.png,https://derpicdn.net/img/view/2015/12/20/1049137.png,0,0.958231866,3856,0,6945,2800,3089,2800,twilight sparkle
1049253.png,https://derpicdn.net/img/view/2015/12/20/1049253.png,0,0.997639596,312,0,1102,755,790,755,twilight sparkle
1050427.png,https://derpicdn.net/img/view/2015/12/22/1050427.png,0,0.953668356,184,45,624,485,440,440,twilight sparkle
1055984.png,https://derpicdn.net/img/view/2015/12/30/1055984.png,0,0.986690879,0,0,799,836,799,836,twilight sparkle
105617.png,https://derpicdn.net/img/view/2012/9/24/105617.png,0,0.973915935,0,15,481,507,481,492,twilight sparkle
1058059.png,https://derpicdn.net/img/view/2016/1/2/1058059.png,0,0.971808553,498,179,1104,785,606,606,twilight sparkle
1061655.png,https://derpicdn.net/img/view/2016/1/7/1061655.png,0,0.969908476,850,266,1434,850,584,584,twilight sparkle
1063274.png,https://derpicdn.net/img/view/2016/1/10/1063274.png,0,0.985403955,1066,51,1966,951,900,900,twilight sparkle
1064981.jpg,https://derpicdn.net/img/view/2016/1/12/1064981.jpg,0,0.984433651,48,170,528,650,480,480,twilight sparkle
1065055.png,https://derpicdn.net/img/view/2016/1/12/1065055.png,0,0.981549144,3755,262,5097,1604,1342,1342,twilight sparkle
1067191.png,https://derpicdn.net/img/view/2016/1/15/1067191.png,0,0.986718059,640,295,912,567,272,272,twilight sparkle
1069771.png,https://derpicdn.net/img/view/2016/1/19/1069771.png,0,0.993388832,67,185,431,549,364,364,twilight sparkle
1069771.png,https://derpicdn.net/img/view/2016/1/19/1069771.png,1,0.992310464,410,246,710,546,300,300,twilight sparkle
1069868.png,https://derpicdn.net/img/view/2016/1/19/1069868.png,0,0.940312803,345,0,895,542,550,542,twilight sparkle
1070915.png,https://derpicdn.net/img/view/2016/1/21/1070915.png,0,0.999372125,568,188,1438,1058,870,870,twilight sparkle
1077241.png,https://derpicdn.net/img/view/2016/1/31/1077241.png,0,0.962909222,425,0,995,533,570,533,twilight sparkle
1078627.png,https://derpicdn.net/img/view/2016/2/2/1078627.png,0,0.973945856,9,24,423,393,414,369,twilight sparkle
1079251.png,https://derpicdn.net/img/view/2016/2/3/1079251.png,0,0.933247149,245,0,735,454,490,454,twilight sparkle
108021.png,https://derpicdn.net/img/view/2012/9/27/108021.png,0,0.996339798,56,0,484,396,428,396,twilight sparkle
1080917.png,https://derpicdn.net/img/view/2016/2/5/1080917.png,0,0.997421324,0,0,774,781,774,781,twilight sparkle
1082219.png,https://derpicdn.net/img/view/2016/2/7/1082219.png,0,0.976489842,264,0,650,372,386,372,twilight sparkle
1084411.png,https://derpicdn.net/img/view/2016/2/10/1084411.png,0,0.984962821,114,21,384,291,270,270,twilight sparkle
1089982.png,https://derpicdn.net/img/view/2016/2/16/1089982.png,0,0.971867383,185,89,539,443,354,354,twilight sparkle
1092014.png,https://derpicdn.net/img/view/2016/2/19/1092014.png,0,0.998274803,757,248,1725,1216,968,968,twilight sparkle
1092076.png,https://derpicdn.net/img/view/2016/2/19/1092076.png,0,0.918154001,269,0,1707,1366,1438,1366,twilight sparkle
1096369.png,https://derpicdn.net/img/view/2016/2/25/1096369.png,0,0.985676527,20,11,366,357,346,346,twilight sparkle
1098358.png,https://derpicdn.net/img/view/2016/2/28/1098358.png,0,0.99206388,2354,0,4800,2486,2446,2486,twilight sparkle
1102681.png,https://derpicdn.net/img/view/2016/3/5/1102681.png,0,0.998587906,635,203,1255,823,620,620,twilight sparkle
1103337.png,https://derpicdn.net/img/view/2016/3/6/1103337.png,0,0.993171513,753,0,1289,509,536,509,twilight sparkle
1103406.png,https://derpicdn.net/img/view/2016/3/6/1103406.png,0,0.937637269,6231,2403,8679,4869,2448,2466,twilight sparkle
1104763.png,https://derpicdn.net/img/view/2016/3/8/1104763.png,0,0.954976916,994,364,1698,1068,704,704,twilight sparkle
1111345.png,https://derpicdn.net/img/view/2016/3/18/1111345.png,0,0.998360395,1315,45,2285,1015,970,970,twilight sparkle
1112126.png,https://derpicdn.net/img/view/2016/3/19/1112126.png,0,0.950170696,916,150,1780,1014,864,864,twilight sparkle
1113829.png,https://derpicdn.net/img/view/2016/3/21/1113829.png,0,0.990959942,1280,0,2974,1953,1694,1953,twilight sparkle
1115704.jpg,https://derpicdn.net/img/view/2016/3/24/1115704.jpg,0,0.996422231,786,183,1204,601,418,418,twilight sparkle
1116375.png,https://derpicdn.net/img/view/2016/3/25/1116375.png,0,0.995619178,477,324,1107,954,630,630,twilight sparkle
1118249.png,https://derpicdn.net/img/view/2016/3/27/1118249.png,0,0.905116677,567,0,3000,2986,2433,2986,twilight sparkle
1119150.png,https://derpicdn.net/img/view/2016/3/28/1119150.png,0,0.978965759,3552,259,6526,3233,2974,2974,twilight sparkle
1121207.png,https://derpicdn.net/img/view/2016/3/31/1121207.png,0,0.943200946,453,0,1465,821,1012,821,twilight sparkle
1124386.png,https://derpicdn.net/img/view/2016/4/4/1124386.png,0,0.982590139,14,0,414,322,400,322,twilight sparkle
1124386.png,https://derpicdn.net/img/view/2016/4/4/1124386.png,1,0.963343918,442,148,730,436,288,288,twilight sparkle
1125933.png,https://derpicdn.net/img/view/2016/4/6/1125933.png,0,0.989375591,0,5,1787,1941,1787,1936,twilight sparkle
1128969.png,https://derpicdn.net/img/view/2016/4/10/1128969.png,0,0.982338667,146,387,390,631,244,244,twilight sparkle
1130294.png,https://derpicdn.net/img/view/2016/4/12/1130294.png,0,0.998553753,384,0,902,486,518,486,twilight sparkle
1132528.png,https://derpicdn.net/img/view/2016/4/15/1132528.png,0,0.987077057,2167,0,4411,2170,2244,2170,twilight sparkle
1134356.jpg,https://derpicdn.net/img/view/2016/4/17/1134356.jpg,0,0.971171081,203,0,1767,1200,1564,1200,twilight sparkle
1138214.png,https://derpicdn.net/img/view/2016/4/23/1138214.png,0,0.998379946,486,1,900,433,414,432,twilight sparkle
1138218.png,https://derpicdn.net/img/view/2016/4/23/1138218.png,0,0.997764707,147,9,502,377,355,368,twilight sparkle
1138220.png,https://derpicdn.net/img/view/2016/4/23/1138220.png,0,0.962956905,99,0,370,283,271,283,twilight sparkle
1148247.png,https://derpicdn.net/img/view/2016/5/7/1148247.png,0,0.996717393,2062,60,2906,904,844,844,twilight sparkle
1150146.png,https://derpicdn.net/img/view/2016/5/9/1150146.png,0,0.916156769,131,0,969,814,838,814,twilight sparkle
1151417.png,https://derpicdn.net/img/view/2016/5/11/1151417.png,0,0.974166512,0,474,3377,4110,3377,3636,twilight sparkle
1151483.png,https://derpicdn.net/img/view/2016/5/11/1151483.png,0,0.994773567,2795,212,5255,2672,2460,2460,twilight sparkle
1152770.png,https://derpicdn.net/img/view/2016/5/13/1152770.png,0,0.978956997,142,7,816,681,674,674,twilight sparkle
1156201.png,https://derpicdn.net/img/view/2016/5/17/1156201.png,0,0.928835928,704,79,1320,695,616,616,twilight sparkle
1157002.png,https://derpicdn.net/img/view/2016/5/18/1157002.png,0,0.983815491,25,16,491,508,466,492,twilight sparkle
1159035.png,https://derpicdn.net/img/view/2016/5/21/1159035.png,0,0.91430074,3711,247,7515,4051,3804,3804,twilight sparkle
1159269.png,https://derpicdn.net/img/view/2016/5/21/1159269.png,0,0.996172965,457,9,1119,671,662,662,twilight sparkle
1163326.jpg,https://derpicdn.net/img/view/2016/5/26/1163326.jpg,0,0.943431616,1050,509,2260,1719,1210,1210,twilight sparkle
1164950.png,https://derpicdn.net/img/view/2016/5/28/1164950.png,0,0.985575497,4,23,402,421,398,398,twilight sparkle
1167408.png,https://derpicdn.net/img/view/2016/5/31/1167408.png,0,0.91102773,1710,173,2108,571,398,398,twilight sparkle
1167517.png,https://derpicdn.net/img/view/2016/6/1/1167517.png,0,0.981049061,18,81,662,687,644,606,twilight sparkle
1168482.png,https://derpicdn.net/img/view/2016/6/2/1168482.png,0,0.99943167,64,0,2140,2065,2076,2065,twilight sparkle
1169202.png,https://derpicdn.net/img/view/2016/6/3/1169202.png,0,0.999560893,507,0,1115,584,608,584,twilight sparkle
1169810.png,https://derpicdn.net/img/view/2016/6/4/1169810.png,0,0.978046715,0,0,596,649,596,649,twilight sparkle
1173548.jpg,https://derpicdn.net/img/view/2016/6/8/1173548.jpg,0,0.935153782,373,53,1119,799,746,746,twilight sparkle
1174336.png,https://derpicdn.net/img/view/2016/6/9/1174336.png,0,0.946746528,143,0,993,814,850,814,twilight sparkle
1175852.png,https://derpicdn.net/img/view/2016/6/11/1175852.png,0,0.984439075,37,71,379,413,342,342,twilight sparkle
11778.png,https://derpicdn.net/img/view/2012/6/20/11778.png,0,0.97639662,427,29,1095,697,668,668,twilight sparkle
1178895.png,https://derpicdn.net/img/view/2016/6/15/1178895.png,0,0.994842589,1122,717,1918,1513,796,796,twilight sparkle
1181965.jpg,https://derpicdn.net/img/view/2016/6/19/1181965.jpg,0,0.993404448,520,0,1588,1052,1068,1052,twilight sparkle
1183831.png,https://derpicdn.net/img/view/2016/6/21/1183831.png,0,0.998948514,188,68,786,666,598,598,twilight sparkle
1184561.png,https://derpicdn.net/img/view/2016/6/22/1184561.png,0,0.970025778,680,45,1002,367,322,322,twilight sparkle
1185223.png,https://derpicdn.net/img/view/2016/6/23/1185223.png,0,0.942756832,341,272,1561,1492,1220,1220,twilight sparkle
11855.png,https://derpicdn.net/img/view/2012/6/20/11855.png,0,0.969665527,204,227,460,483,256,256,twilight sparkle
1187.png,https://derpicdn.net/img/view/2012/1/22/1187.png,0,0.988967061,0,0,640,703,640,703,twilight sparkle
1187638.png,https://derpicdn.net/img/view/2016/6/27/1187638.png,0,0.962614,417,320,1163,1066,746,746,twilight sparkle
1188619.png,https://derpicdn.net/img/view/2016/6/28/1188619.png,0,0.996214986,257,0,635,373,378,373,twilight sparkle
1190675.png,https://derpicdn.net/img/view/2016/7/1/1190675.png,0,0.985979557,100,0,854,719,754,719,twilight sparkle
1193108.png,https://derpicdn.net/img/view/2016/7/4/1193108.png,0,0.991871178,254,0,720,518,466,518,twilight sparkle
1193985.png,https://derpicdn.net/img/view/2016/7/5/1193985.png,0,0.986621499,0,0,1322,1303,1322,1303,twilight sparkle
1195807.png,https://derpicdn.net/img/view/2016/7/7/1195807.png,0,0.980928004,664,104,1174,614,510,510,twilight sparkle
1197456.png,https://derpicdn.net/img/view/2016/7/10/1197456.png,0,0.997604132,514,189,730,405,216,216,twilight sparkle
1201493.png,https://derpicdn.net/img/view/2016/7/15/1201493.png,0,0.999197662,1929,122,2443,636,514,514,twilight sparkle
1201493.png,https://derpicdn.net/img/view/2016/7/15/1201493.png,1,0.994076908,1071,0,1785,712,714,712,twilight sparkle
1202449.png,https://derpicdn.net/img/view/2016/7/16/1202449.png,0,0.995689332,34,89,454,509,420,420,twilight sparkle
1205976.png,https://derpicdn.net/img/view/2016/7/21/1205976.png,0,0.996235847,334,0,2194,1834,1860,1834,twilight sparkle
1208085.png,https://derpicdn.net/img/view/2016/7/24/1208085.png,0,0.993411601,177,0,471,262,294,262,twilight sparkle
1208271.png,https://derpicdn.net/img/view/2016/7/24/1208271.png,0,0.944401383,137,13,761,637,624,624,twilight sparkle
1210543.png,https://derpicdn.net/img/view/2016/7/27/1210543.png,0,0.932475746,204,89,694,579,490,490,twilight sparkle
1212862.png,https://derpicdn.net/img/view/2016/7/30/1212862.png,0,0.974550128,5,36,413,408,408,372,twilight sparkle
1216355.png,https://derpicdn.net/img/view/2016/8/3/1216355.png,0,0.966511726,73,178,485,590,412,412,twilight sparkle
1216355.png,https://derpicdn.net/img/view/2016/8/3/1216355.png,1,0.947551727,363,129,749,515,386,386,twilight sparkle
1216587.png,https://derpicdn.net/img/view/2016/8/4/1216587.png,0,0.984963119,239,391,499,651,260,260,twilight sparkle
1217774.png,https://derpicdn.net/img/view/2016/8/5/1217774.png,0,0.996418536,4,0,754,717,750,717,twilight sparkle
1218323.png,https://derpicdn.net/img/view/2016/8/6/1218323.png,0,0.998866916,16,77,852,913,836,836,twilight sparkle
1219215.png,https://derpicdn.net/img/view/2016/8/7/1219215.png,1,0.98884809,352,150,968,766,616,616,twilight sparkle
1219303.png,https://derpicdn.net/img/view/2016/8/7/1219303.png,0,0.935099661,295,7,1367,1079,1072,1072,twilight sparkle
1219991.png,https://derpicdn.net/img/view/2016/8/8/1219991.png,0,0.969121397,0,131,1346,1591,1346,1460,twilight sparkle
1222279.png,https://derpicdn.net/img/view/2016/8/11/1222279.png,0,0.955920815,0,0,2845,2876,2845,2876,twilight sparkle
1222981.png,https://derpicdn.net/img/view/2016/8/12/1222981.png,0,0.941766381,84,389,560,865,476,476,twilight sparkle
1226171.png,https://derpicdn.net/img/view/2016/8/15/1226171.png,0,0.909539402,266,57,964,755,698,698,twilight sparkle
1226624.png,https://derpicdn.net/img/view/2016/8/16/1226624.png,0,0.958256006,2007,0,5795,3102,3788,3102,twilight sparkle
1229637.png,https://derpicdn.net/img/view/2016/8/20/1229637.png,0,0.982841372,216,0,1298,768,1082,768,twilight sparkle
1229705.png,https://derpicdn.net/img/view/2016/8/20/1229705.png,0,0.957255065,0,0,288,308,288,308,twilight sparkle
1229751.png,https://derpicdn.net/img/view/2016/8/20/1229751.png,0,0.931022406,0,0,273,292,273,292,twilight sparkle
1233483.png,https://derpicdn.net/img/view/2016/8/25/1233483.png,0,0.983581126,73,622,3575,4124,3502,3502,twilight sparkle
1235212.png,https://derpicdn.net/img/view/2016/8/27/1235212.png,0,0.986585259,63,54,1935,1926,1872,1872,twilight sparkle
1238909.png,https://derpicdn.net/img/view/2016/9/1/1238909.png,0,0.958925307,2721,214,4349,1880,1628,1666,twilight sparkle
1241641.png,https://derpicdn.net/img/view/2016/9/4/1241641.png,0,0.992361963,10,0,956,881,946,881,twilight sparkle
1244005.png,https://derpicdn.net/img/view/2016/9/7/1244005.png,0,0.902255774,0,0,1514,1371,1514,1371,twilight sparkle
1244406.png,https://derpicdn.net/img/view/2016/9/8/1244406.png,0,0.964516044,140,0,762,586,622,586,twilight sparkle
124503.png,https://derpicdn.net/img/view/2012/10/16/124503.png,0,0.961041629,897,719,4365,4187,3468,3468,twilight sparkle
1247739.png,https://derpicdn.net/img/view/2016/9/12/1247739.png,0,0.993460536,0,23,1195,1411,1195,1388,twilight sparkle
1250287.png,https://derpicdn.net/img/view/2016/9/16/1250287.png,0,0.997029126,1312,0,3744,2318,2432,2318,twilight sparkle
1250783.png,https://derpicdn.net/img/view/2016/9/16/1250783.png,0,0.994579911,1757,791,2751,1785,994,994,twilight sparkle
1252512.png,https://derpicdn.net/img/view/2016/9/18/1252512.png,0,0.991504371,188,32,764,608,576,576,twilight sparkle
1259609.png,https://derpicdn.net/img/view/2016/9/27/1259609.png,0,0.974731088,0,161,1024,1357,1024,1196,twilight sparkle
1261577.png,https://derpicdn.net/img/view/2016/9/30/1261577.png,0,0.913583636,400,145,2176,1921,1776,1776,twilight sparkle
1263773.png,https://derpicdn.net/img/view/2016/10/3/1263773.png,0,0.918439865,2941,361,4627,2047,1686,1686,twilight sparkle
1265228.png,https://derpicdn.net/img/view/2016/10/5/1265228.png,0,0.967786252,506,9,902,405,396,396,twilight sparkle
1265920.png,https://derpicdn.net/img/view/2016/10/6/1265920.png,0,0.968601108,1170,0,2652,1355,1482,1355,twilight sparkle
1267147.png,https://derpicdn.net/img/view/2016/10/7/1267147.png,0,0.990620136,1234,0,3236,1993,2002,1993,twilight sparkle
1269565.png,https://derpicdn.net/img/view/2016/10/10/1269565.png,0,0.991913319,34,0,914,514,880,514,twilight sparkle
1270368.png,https://derpicdn.net/img/view/2016/10/11/1270368.png,0,0.933744609,0,34,408,492,408,458,twilight sparkle
1270698.png,https://derpicdn.net/img/view/2016/10/11/1270698.png,0,0.997527361,541,57,1067,583,526,526,twilight sparkle
1271014.png,https://derpicdn.net/img/view/2016/10/12/1271014.png,0,0.954657674,0,662,791,1490,791,828,twilight sparkle
1272512.png,https://derpicdn.net/img/view/2016/10/14/1272512.png,0,0.945249796,172,0,1106,875,934,875,twilight sparkle
1274582.png,https://derpicdn.net/img/view/2016/10/16/1274582.png,0,0.949169159,77,74,2187,2184,2110,2110,twilight sparkle
1274634.png,https://derpicdn.net/img/view/2016/10/16/1274634.png,0,0.989386737,1,3,525,527,524,524,twilight sparkle
1278533.png,https://derpicdn.net/img/view/2016/10/22/1278533.png,0,0.97268039,647,0,1555,826,908,826,twilight sparkle
1279563.png,https://derpicdn.net/img/view/2016/10/23/1279563.png,0,0.931513727,327,293,2589,2555,2262,2262,twilight sparkle
1282712.png,https://derpicdn.net/img/view/2016/10/27/1282712.png,1,0.996308923,655,0,953,261,298,261,twilight sparkle
1283293.png,https://derpicdn.net/img/view/2016/10/28/1283293.png,0,0.959748209,53,0,553,468,500,468,twilight sparkle
1286765.png,https://derpicdn.net/img/view/2016/11/2/1286765.png,0,0.954284072,67,0,621,511,554,511,twilight sparkle
1287027.png,https://derpicdn.net/img/view/2016/11/2/1287027.png,0,0.983477712,324,0,928,577,604,577,twilight sparkle
1289342.png,https://derpicdn.net/img/view/2016/11/5/1289342.png,0,0.976995707,0,23,535,567,535,544,twilight sparkle
1292694.png,https://derpicdn.net/img/view/2016/11/10/1292694.png,0,0.934807956,688,232,6174,5718,5486,5486,twilight sparkle
1293539.png,https://derpicdn.net/img/view/2016/11/11/1293539.png,0,0.911870062,342,55,866,579,524,524,twilight sparkle
1296330.png,https://derpicdn.net/img/view/2016/11/15/1296330.png,0,0.990521312,878,0,1872,980,994,980,twilight sparkle
1296576.png,https://derpicdn.net/img/view/2016/11/15/1296576.png,0,0.914688826,51,0,663,512,612,512,twilight sparkle
1296774.png,https://derpicdn.net/img/view/2016/11/16/1296774.png,0,0.989201486,35,4,287,268,252,264,twilight sparkle
1298182.png,https://derpicdn.net/img/view/2016/11/18/1298182.png,0,0.99604094,929,209,1277,557,348,348,twilight sparkle
1301287.png,https://derpicdn.net/img/view/2016/11/22/1301287.png,0,0.988678157,90,0,1704,1607,1614,1607,twilight sparkle
1304136.png,https://derpicdn.net/img/view/2016/11/26/1304136.png,0,0.93590039,84,0,978,701,894,701,twilight sparkle
1304178.png,https://derpicdn.net/img/view/2016/11/26/1304178.png,0,0.999333203,2346,0,4844,2169,2498,2169,twilight sparkle
1304991.png,https://derpicdn.net/img/view/2016/11/27/1304991.png,0,0.991945148,48,143,2198,2293,2150,2150,twilight sparkle
1306277.png,https://derpicdn.net/img/view/2016/11/29/1306277.png,0,0.996217847,1467,0,4027,2370,2560,2370,twilight sparkle
1315310.png,https://derpicdn.net/img/view/2016/12/11/1315310.png,0,0.924158394,262,30,796,564,534,534,twilight sparkle
1319931.png,https://derpicdn.net/img/view/2016/12/18/1319931.png,0,0.99585706,1425,339,3135,2049,1710,1710,twilight sparkle
1324148.png,https://derpicdn.net/img/view/2016/12/24/1324148.png,0,0.991035342,64,0,428,352,364,352,twilight sparkle
1324992.png,https://derpicdn.net/img/view/2016/12/25/1324992.png,0,0.993304551,312,127,1314,1129,1002,1002,twilight sparkle
1330546.png,https://derpicdn.net/img/view/2017/1/2/1330546.png,0,0.992553651,629,19,951,341,322,322,twilight sparkle
1330590.png,https://derpicdn.net/img/view/2017/1/2/1330590.png,0,0.9362185,6,0,350,284,344,284,twilight sparkle
1334075.png,https://derpicdn.net/img/view/2017/1/7/1334075.png,0,0.992233217,1947,123,4483,2659,2536,2536,twilight sparkle
1337742.png,https://derpicdn.net/img/view/2017/1/12/1337742.png,0,0.990156233,1124,0,1788,652,664,652,twilight sparkle
1337742.png,https://derpicdn.net/img/view/2017/1/12/1337742.png,1,0.901261389,426,80,1248,902,822,822,twilight sparkle
1342762.png,https://derpicdn.net/img/view/2017/1/19/1342762.png,0,0.931186676,13,0,981,962,968,962,twilight sparkle
1347412.png,https://derpicdn.net/img/view/2017/1/25/1347412.png,0,0.999619067,659,109,1255,705,596,596,twilight sparkle
1349808.png,https://derpicdn.net/img/view/2017/1/28/1349808.png,0,0.998991191,1130,0,3964,2367,2834,2367,twilight sparkle
1353618.png,https://derpicdn.net/img/view/2017/2/2/1353618.png,0,0.984377563,0,0,739,677,739,677,twilight sparkle
135503.png,https://derpicdn.net/img/view/2012/10/29/135503.png,0,0.993119419,352,15,622,285,270,270,twilight sparkle
1355929.png,https://derpicdn.net/img/view/2017/2/5/1355929.png,0,0.997372687,43,0,1001,952,958,952,twilight sparkle
1356912.png,https://derpicdn.net/img/view/2017/2/6/1356912.png,0,0.996228456,386,216,672,502,286,286,twilight sparkle
135713.png,https://derpicdn.net/img/view/2012/10/29/135713.png,0,0.955786526,132,421,388,677,256,256,twilight sparkle
1357715.png,https://derpicdn.net/img/view/2017/2/7/1357715.png,0,0.996738732,0,27,1982,2139,1982,2112,twilight sparkle
1358339.png,https://derpicdn.net/img/view/2017/2/8/1358339.png,0,0.992544889,778,1321,10642,11185,9864,9864,twilight sparkle
1359502.png,https://derpicdn.net/img/view/2017/2/10/1359502.png,0,0.995391607,180,35,948,803,768,768,twilight sparkle
1360599.png,https://derpicdn.net/img/view/2017/2/12/1360599.png,0,0.982984483,13,0,637,575,624,575,twilight sparkle
1364963.png,https://derpicdn.net/img/view/2017/2/16/1364963.png,0,0.964775562,123,89,347,313,224,224,twilight sparkle
1364969.png,https://derpicdn.net/img/view/2017/2/16/1364969.png,0,0.956896663,729,0,2977,1765,2248,1765,twilight sparkle
1365509.png,https://derpicdn.net/img/view/2017/2/17/1365509.png,0,0.917736113,164,0,946,772,782,772,twilight sparkle
1367431.png,https://derpicdn.net/img/view/2017/2/19/1367431.png,0,0.985045493,0,60,482,550,482,490,twilight sparkle
1368344.png,https://derpicdn.net/img/view/2017/2/20/1368344.png,0,0.990335286,1297,321,2127,1151,830,830,twilight sparkle
1371126.png,https://derpicdn.net/img/view/2017/2/23/1371126.png,0,0.999390483,117,32,537,452,420,420,twilight sparkle
1373830.png,https://derpicdn.net/img/view/2017/2/26/1373830.png,0,0.97911948,56,115,800,860,744,745,twilight sparkle
137948.png,https://derpicdn.net/img/view/2012/10/31/137948.png,0,0.996662796,313,0,893,543,580,543,twilight sparkle
1380962.png,https://derpicdn.net/img/view/2017/3/6/1380962.png,0,0.972388387,377,161,1169,953,792,792,twilight sparkle
1383342.png,https://derpicdn.net/img/view/2017/3/10/1383342.png,0,0.940302491,179,433,919,1173,740,740,twilight sparkle
1383705.png,https://derpicdn.net/img/view/2017/3/10/1383705.png,0,0.985832632,285,85,977,777,692,692,twilight sparkle
1386776.png,https://derpicdn.net/img/view/2017/3/14/1386776.png,0,0.999506712,482,178,768,464,286,286,twilight sparkle
1386776.png,https://derpicdn.net/img/view/2017/3/14/1386776.png,1,0.995974123,269,103,605,439,336,336,twilight sparkle
138741.jpg,https://derpicdn.net/img/view/2012/11/1/138741.jpg,0,0.982249558,87,434,521,868,434,434,twilight sparkle
1388397.png,https://derpicdn.net/img/view/2017/3/16/1388397.png,0,0.992928445,30,0,1634,1600,1604,1600,twilight sparkle
1392523.png,https://derpicdn.net/img/view/2017/3/20/1392523.png,0,0.990188122,2344,0,3318,968,974,968,twilight sparkle
1392523.png,https://derpicdn.net/img/view/2017/3/20/1392523.png,1,0.979165673,1302,1321,2138,2157,836,836,twilight sparkle
1399999.png,https://derpicdn.net/img/view/2017/3/30/1399999.png,0,0.901381612,1439,0,2758,1354,1319,1354,twilight sparkle
1400239.png,https://derpicdn.net/img/view/2017/3/31/1400239.png,0,0.985313118,35,120,689,774,654,654,twilight sparkle
140186.png,https://derpicdn.net/img/view/2012/11/2/140186.png,0,0.98385644,1412,0,2882,1342,1470,1342,twilight sparkle
1402997.png,https://derpicdn.net/img/view/2017/4/3/1402997.png,0,0.999746978,34,72,496,534,462,462,twilight sparkle
1403267.png,https://derpicdn.net/img/view/2017/4/3/1403267.png,0,0.982009828,240,21,440,221,200,200,twilight sparkle
1404005.png,https://derpicdn.net/img/view/2017/4/4/1404005.png,0,0.944602489,594,0,1344,739,750,739,twilight sparkle
1407621.png,https://derpicdn.net/img/view/2017/4/9/1407621.png,0,0.979013205,162,0,718,484,556,484,twilight sparkle
1408814.png,https://derpicdn.net/img/view/2017/4/11/1408814.png,0,0.997045994,493,4,801,312,308,308,twilight sparkle
1411841.png,https://derpicdn.net/img/view/2017/4/15/1411841.png,0,0.993459761,427,54,891,518,464,464,twilight sparkle
1414554.png,https://derpicdn.net/img/view/2017/4/17/1414554.png,0,0.926973581,0,4,207,224,207,220,twilight sparkle
1417388.png,https://derpicdn.net/img/view/2017/4/21/1417388.png,0,0.987551093,74,311,3378,3156,3304,2845,twilight sparkle
1418337.png,https://derpicdn.net/img/view/2017/4/22/1418337.png,0,0.938723564,61,158,453,550,392,392,twilight sparkle
1420014.png,https://derpicdn.net/img/view/2017/4/23/1420014.png,0,0.975692391,122,34,1194,1106,1072,1072,twilight sparkle
1420038.png,https://derpicdn.net/img/view/2017/4/23/1420038.png,0,0.993280351,668,0,992,310,324,310,twilight sparkle
1420435.png,https://derpicdn.net/img/view/2017/4/24/1420435.png,0,0.927605987,220,0,1778,1090,1558,1090,twilight sparkle
1421430.png,https://derpicdn.net/img/view/2017/4/25/1421430.png,0,0.960756421,331,238,965,872,634,634,twilight sparkle
1423509.png,https://derpicdn.net/img/view/2017/4/28/1423509.png,0,0.989995897,143,0,777,627,634,627,twilight sparkle
1424004.png,https://derpicdn.net/img/view/2017/4/29/1424004.png,0,0.931154728,138,0,2126,1440,1988,1440,twilight sparkle
1424009.png,https://derpicdn.net/img/view/2017/4/29/1424009.png,0,0.938679814,645,0,1625,891,980,891,twilight sparkle
1425067.png,https://derpicdn.net/img/view/2017/4/30/1425067.png,0,0.993288159,342,18,716,392,374,374,twilight sparkle
1425342.png,https://derpicdn.net/img/view/2017/4/30/1425342.png,0,0.97205168,133,0,700,564,567,564,twilight sparkle
1425857.png,https://derpicdn.net/img/view/2017/4/30/1425857.png,0,0.960050642,292,0,674,352,382,352,twilight sparkle
1432848.png,https://derpicdn.net/img/view/2017/5/9/1432848.png,0,0.99145472,0,30,895,936,895,906,twilight sparkle
1433424.png,https://derpicdn.net/img/view/2017/5/10/1433424.png,0,0.978393137,165,159,2537,2308,2372,2149,twilight sparkle
1438533.png,https://derpicdn.net/img/view/2017/5/17/1438533.png,0,0.995330989,681,0,1360,692,679,692,twilight sparkle
1445123.png,https://derpicdn.net/img/view/2017/5/24/1445123.png,0,0.981639504,774,772,2182,2180,1408,1408,twilight sparkle
1448235.png,https://derpicdn.net/img/view/2017/5/28/1448235.png,0,0.979181409,0,0,629,597,629,597,twilight sparkle
1452134.png,https://derpicdn.net/img/view/2017/6/2/1452134.png,0,0.997091174,0,285,2821,3301,2821,3016,twilight sparkle
1464633.png,https://derpicdn.net/img/view/2017/6/18/1464633.png,0,0.961699247,0,0,1661,1863,1661,1863,twilight sparkle
1466857.png,https://derpicdn.net/img/view/2017/6/20/1466857.png,0,0.948318541,1700,0,3540,1735,1840,1735,twilight sparkle
1467252.png,https://derpicdn.net/img/view/2017/6/20/1467252.png,0,0.947485924,127,403,2807,3083,2680,2680,twilight sparkle
1467349.png,https://derpicdn.net/img/view/2017/6/21/1467349.png,0,0.994472921,176,0,2840,2369,2664,2369,twilight sparkle
1468770.png,https://derpicdn.net/img/view/2017/6/22/1468770.png,0,0.967758477,2709,541,3789,1621,1080,1080,twilight sparkle
1471831.png,https://derpicdn.net/img/view/2017/6/26/1471831.png,0,0.978309751,1249,875,1771,1399,522,524,twilight sparkle
1473873.png,https://derpicdn.net/img/view/2017/6/29/1473873.png,0,0.980902612,1,184,697,880,696,696,twilight sparkle
1473965.png,https://derpicdn.net/img/view/2017/6/29/1473965.png,0,0.972194374,250,2,850,602,600,600,twilight sparkle
1474155.png,https://derpicdn.net/img/view/2017/6/29/1474155.png,0,0.98699981,105,300,541,736,436,436,twilight sparkle
1474155.png,https://derpicdn.net/img/view/2017/6/29/1474155.png,1,0.949027658,631,126,1159,654,528,528,twilight sparkle
1474426.png,https://derpicdn.net/img/view/2017/6/29/1474426.png,0,0.999022007,1046,97,1600,673,554,576,twilight sparkle
1476430.png,https://derpicdn.net/img/view/2017/7/1/1476430.png,0,0.995750785,203,184,567,548,364,364,twilight sparkle
1476430.png,https://derpicdn.net/img/view/2017/7/1/1476430.png,1,0.99019897,529,53,947,471,418,418,twilight sparkle
1477.jpg,https://derpicdn.net/img/view/2012/1/22/1477.jpg,0,0.974886954,41,0,385,329,344,329,twilight sparkle
1477.jpg,https://derpicdn.net/img/view/2012/1/22/1477.jpg,1,0.954294205,999,0,1297,285,298,285,twilight sparkle
1478279.png,https://derpicdn.net/img/view/2017/7/4/1478279.png,0,0.991450012,3208,229,5686,2731,2478,2502,twilight sparkle
1480755.png,https://derpicdn.net/img/view/2017/7/7/1480755.png,0,0.983577967,1567,0,5179,3714,3612,3714,twilight sparkle
1480769.png,https://derpicdn.net/img/view/2017/7/7/1480769.png,0,0.92758286,0,0,2995,5069,2995,5069,twilight sparkle
1480786.png,https://derpicdn.net/img/view/2017/7/7/1480786.png,0,0.995850742,1963,0,5037,2942,3074,2942,twilight sparkle
1480891.png,https://derpicdn.net/img/view/2017/7/7/1480891.png,0,0.995735765,264,130,3098,2964,2834,2834,twilight sparkle
1482697.png,https://derpicdn.net/img/view/2017/7/10/1482697.png,0,0.984366953,95,18,927,850,832,832,twilight sparkle
1484503.png,https://derpicdn.net/img/view/2017/7/12/1484503.png,0,0.994594514,2003,0,4080,1892,2077,1892,twilight sparkle
1485074.png,https://derpicdn.net/img/view/2017/7/13/1485074.png,0,0.967363238,0,182,860,1168,860,986,twilight sparkle
1485404.png,https://derpicdn.net/img/view/2017/7/13/1485404.png,0,0.972914696,227,97,1447,1337,1220,1240,twilight sparkle
1496581.png,https://derpicdn.net/img/view/2017/7/28/1496581.png,1,0.917611122,18,1495,1031,2511,1013,1016,twilight sparkle
1501645.png,https://derpicdn.net/img/view/2017/8/3/1501645.png,0,0.987367094,456,0,1794,1196,1338,1196,twilight sparkle
1502132.png,https://derpicdn.net/img/view/2017/8/3/1502132.png,0,0.996107161,121,435,821,1135,700,700,twilight sparkle
1504114.png,https://derpicdn.net/img/view/2017/8/6/1504114.png,0,0.966585338,41,788,2641,3318,2600,2530,twilight sparkle
1504925.png,https://derpicdn.net/img/view/2017/8/7/1504925.png,0,0.980949521,3143,137,4881,1875,1738,1738,twilight sparkle
1507023.png,https://derpicdn.net/img/view/2017/8/10/1507023.png,0,0.927525878,139,73,455,389,316,316,twilight sparkle
1510055.png,https://derpicdn.net/img/view/2017/8/13/1510055.png,0,0.99620384,851,348,3505,3002,2654,2654,twilight sparkle
1514664.png,https://derpicdn.net/img/view/2017/8/19/1514664.png,0,0.984298408,0,27,623,679,623,652,twilight sparkle
1520840.png,https://derpicdn.net/img/view/2017/8/27/1520840.png,0,0.995743334,238,102,800,664,562,562,twilight sparkle
1523560.png,https://derpicdn.net/img/view/2017/8/30/1523560.png,0,0.996125519,498,0,1024,505,526,505,twilight sparkle
15237.png,https://derpicdn.net/img/view/2012/6/22/15237.png,0,0.994913936,167,570,809,1212,642,642,twilight sparkle
1526290.png,https://derpicdn.net/img/view/2017/9/2/1526290.png,0,0.998181641,500,258,782,540,282,282,twilight sparkle
1527171.png,https://derpicdn.net/img/view/2017/9/3/1527171.png,0,0.940758288,32,63,586,564,554,501,twilight sparkle
1527849.png,https://derpicdn.net/img/view/2017/9/4/1527849.png,0,0.997857153,420,403,906,889,486,486,twilight sparkle
1534099.png,https://derpicdn.net/img/view/2017/9/12/1534099.png,0,0.984763384,306,0,2716,2339,2410,2339,twilight sparkle
1536776.png,https://derpicdn.net/img/view/2017/9/16/1536776.png,0,0.989910007,0,0,537,589,537,589,twilight sparkle
1539549.png,https://derpicdn.net/img/view/2017/9/19/1539549.png,0,0.981575549,315,0,1253,897,938,897,twilight sparkle
1540806.png,https://derpicdn.net/img/view/2017/9/21/1540806.png,0,0.996103883,395,0,813,400,418,400,twilight sparkle
1540967.png,https://derpicdn.net/img/view/2017/9/21/1540967.png,0,0.998230338,1181,0,2713,1397,1532,1397,twilight sparkle
1542112.png,https://derpicdn.net/img/view/2017/9/22/1542112.png,0,0.99834162,1373,0,2851,1434,1478,1434,twilight sparkle
1545371.png,https://derpicdn.net/img/view/2017/9/26/1545371.png,0,0.907954335,0,8,988,800,988,792,twilight sparkle
1548919.png,https://derpicdn.net/img/view/2017/10/1/1548919.png,0,0.919292808,0,0,621,546,621,546,twilight sparkle
1550606.png,https://derpicdn.net/img/view/2017/10/2/1550606.png,0,0.984531879,180,108,550,478,370,370,twilight sparkle
1550871.png,https://derpicdn.net/img/view/2017/10/3/1550871.png,0,0.983146667,1608,360,2202,954,594,594,twilight sparkle
1552712.png,https://derpicdn.net/img/view/2017/10/5/1552712.png,0,0.970423758,843,0,3785,3186,2942,3186,twilight sparkle
1554361.png,https://derpicdn.net/img/view/2017/10/7/1554361.png,0,0.989800751,78,0,1196,742,1118,742,twilight sparkle
1554953.png,https://derpicdn.net/img/view/2017/10/8/1554953.png,0,0.975386977,1559,0,2731,1120,1172,1120,twilight sparkle
1555330.png,https://derpicdn.net/img/view/2017/10/8/1555330.png,0,0.987181187,133,8,725,650,592,642,twilight sparkle
1555333.png,https://derpicdn.net/img/view/2017/10/8/1555333.png,0,0.9869169,111,0,1493,1080,1382,1080,twilight sparkle
1557236.png,https://derpicdn.net/img/view/2017/10/10/1557236.png,0,0.9997527,108,0,652,530,544,530,twilight sparkle
1557310.png,https://derpicdn.net/img/view/2017/10/10/1557310.png,0,0.996974468,1018,0,3086,1933,2068,1933,twilight sparkle
1558083.png,https://derpicdn.net/img/view/2017/10/11/1558083.png,0,0.959400356,123,0,987,824,864,824,twilight sparkle
1559374.png,https://derpicdn.net/img/view/2017/10/12/1559374.png,0,0.996172488,618,0,2250,1593,1632,1593,twilight sparkle
1564085.png,https://derpicdn.net/img/view/2017/10/18/1564085.png,0,0.997583926,172,40,1926,1794,1754,1754,twilight sparkle
1567752.png,https://derpicdn.net/img/view/2017/10/22/1567752.png,0,0.925560772,3194,0,6408,3168,3214,3168,twilight sparkle
1568959.png,https://derpicdn.net/img/view/2017/10/24/1568959.png,0,0.986188054,0,64,345,383,345,319,twilight sparkle
1572433.png,https://derpicdn.net/img/view/2017/10/29/1572433.png,0,0.995152414,3600,0,7569,4128,3969,4128,twilight sparkle
1573398.png,https://derpicdn.net/img/view/2017/10/30/1573398.png,0,0.994695663,0,0,472,480,472,480,twilight sparkle
1580030.png,https://derpicdn.net/img/view/2017/11/6/1580030.png,0,0.990414262,0,140,1412,1594,1412,1454,twilight sparkle
1583174.png,https://derpicdn.net/img/view/2017/11/10/1583174.png,0,0.961750984,0,91,2531,2811,2531,2720,twilight sparkle
1583846.png,https://derpicdn.net/img/view/2017/11/11/1583846.png,0,0.974480391,181,0,1175,885,994,885,twilight sparkle
1586085.png,https://derpicdn.net/img/view/2017/11/14/1586085.png,0,0.969091356,51,0,337,279,286,279,twilight sparkle
1588532.png,https://derpicdn.net/img/view/2017/11/17/1588532.png,0,0.993020833,4279,1171,7331,4223,3052,3052,twilight sparkle
1589110.png,https://derpicdn.net/img/view/2017/11/18/1589110.png,0,0.959657371,1452,0,4016,2403,2564,2403,twilight sparkle
1590878.png,https://derpicdn.net/img/view/2017/11/20/1590878.png,0,0.916265011,199,0,804,637,605,637,twilight sparkle
1591077.png,https://derpicdn.net/img/view/2017/11/21/1591077.png,0,0.992712677,465,86,775,396,310,310,twilight sparkle
1591077.png,https://derpicdn.net/img/view/2017/11/21/1591077.png,1,0.962874889,195,0,493,290,298,290,twilight sparkle
1596101.png,https://derpicdn.net/img/view/2017/11/28/1596101.png,0,0.964102089,234,0,905,718,671,718,twilight sparkle
1599165.png,https://derpicdn.net/img/view/2017/12/2/1599165.png,0,0.972228229,248,0,822,534,574,534,twilight sparkle
1599681.png,https://derpicdn.net/img/view/2017/12/3/1599681.png,0,0.997087121,382,92,876,586,494,494,twilight sparkle
159983.png,https://derpicdn.net/img/view/2012/11/22/159983.png,0,0.934153914,455,0,990,617,535,617,twilight sparkle
1600325.png,https://derpicdn.net/img/view/2017/12/4/1600325.png,0,0.994740367,154,153,1296,1295,1142,1142,twilight sparkle
1600364.png,https://derpicdn.net/img/view/2017/12/4/1600364.png,0,0.990399599,2591,0,5323,2490,2732,2490,twilight sparkle
1603850.png,https://derpicdn.net/img/view/2017/12/9/1603850.png,1,0.915348709,663,100,1015,452,352,352,twilight sparkle
1606708.png,https://derpicdn.net/img/view/2017/12/13/1606708.png,0,0.953174472,8,16,624,632,616,616,twilight sparkle
1608185.png,https://derpicdn.net/img/view/2017/12/15/1608185.png,0,0.982442915,0,0,198,197,198,197,twilight sparkle
160930.png,https://derpicdn.net/img/view/2012/11/23/160930.png,0,0.996990383,8,557,162,711,154,154,twilight sparkle
160951.png,https://derpicdn.net/img/view/2012/11/23/160951.png,0,0.988977969,0,0,7087,7457,7087,7457,twilight sparkle
1611611.png,https://derpicdn.net/img/view/2017/12/20/1611611.png,0,0.995620668,22,20,358,356,336,336,twilight sparkle
1611883.png,https://derpicdn.net/img/view/2017/12/20/1611883.png,0,0.9951846,923,443,2523,2043,1600,1600,twilight sparkle
161255.png,https://derpicdn.net/img/view/2012/11/24/161255.png,0,0.979913354,483,6,719,242,236,236,twilight sparkle
1613190.png,https://derpicdn.net/img/view/2017/12/22/1613190.png,0,0.998242497,883,0,2508,1739,1625,1739,twilight sparkle
16140.jpg,https://derpicdn.net/img/view/2012/6/23/16140.jpg,0,0.998105526,141,0,743,585,602,585,twilight sparkle
1616370.png,https://derpicdn.net/img/view/2017/12/26/1616370.png,0,0.99304992,4304,1196,7306,4198,3002,3002,twilight sparkle
16173.jpg,https://derpicdn.net/img/view/2012/6/23/16173.jpg,0,0.982799947,169,55,709,595,540,540,twilight sparkle
1619676.png,https://derpicdn.net/img/view/2017/12/30/1619676.png,0,0.994327366,867,1071,1321,1525,454,454,twilight sparkle
1621184.png,https://derpicdn.net/img/view/2018/1/1/1621184.png,0,0.943462491,283,0,688,402,405,402,twilight sparkle
1621207.png,https://derpicdn.net/img/view/2018/1/1/1621207.png,0,0.965121686,164,0,534,331,370,331,twilight sparkle
1623418.png,https://derpicdn.net/img/view/2018/1/3/1623418.png,0,0.993846059,628,419,2324,2115,1696,1696,twilight sparkle
1624021.png,https://derpicdn.net/img/view/2018/1/4/1624021.png,0,0.997828186,0,610,364,998,364,388,twilight sparkle
1627960.png,https://derpicdn.net/img/view/2018/1/9/1627960.png,0,0.995824933,0,1,364,365,364,364,twilight sparkle
1628159.png,https://derpicdn.net/img/view/2018/1/9/1628159.png,0,0.997529209,728,455,1380,1107,652,652,twilight sparkle
1629582.png,https://derpicdn.net/img/view/2018/1/11/1629582.png,0,0.997562647,23,145,947,1069,924,924,twilight sparkle
1630197.png,https://derpicdn.net/img/view/2018/1/12/1630197.png,0,0.982294142,0,0,472,474,472,474,twilight sparkle
1631204.png,https://derpicdn.net/img/view/2018/1/13/1631204.png,0,0.966446519,102,255,3712,3865,3610,3610,twilight sparkle
1632574.png,https://derpicdn.net/img/view/2018/1/15/1632574.png,0,0.994233966,1276,0,2866,1518,1590,1518,twilight sparkle
1634076.png,https://derpicdn.net/img/view/2018/1/17/1634076.png,0,0.990876615,452,37,738,323,286,286,twilight sparkle
1637014.png,https://derpicdn.net/img/view/2018/1/20/1637014.png,0,0.98879981,726,0,3758,2864,3032,2864,twilight sparkle
1637253.png,https://derpicdn.net/img/view/2018/1/21/1637253.png,0,0.913147926,0,81,2188,2299,2188,2218,twilight sparkle
1638856.png,https://derpicdn.net/img/view/2018/1/23/1638856.png,0,0.935072303,577,154,1249,826,672,672,twilight sparkle
1639004.png,https://derpicdn.net/img/view/2018/1/23/1639004.png,0,0.96492964,607,296,1173,862,566,566,twilight sparkle
1645097.png,https://derpicdn.net/img/view/2018/1/31/1645097.png,0,0.988578498,0,118,3494,3774,3494,3656,twilight sparkle
1645151.png,https://derpicdn.net/img/view/2018/1/31/1645151.png,0,0.973969817,531,64,833,366,302,302,twilight sparkle
1645288.png,https://derpicdn.net/img/view/2018/1/31/1645288.png,0,0.963120401,124,9,3956,3841,3832,3832,twilight sparkle
1648184.png,https://derpicdn.net/img/view/2018/2/4/1648184.png,0,0.981909275,41,0,1651,804,1610,804,twilight sparkle
1648308.png,https://derpicdn.net/img/view/2018/2/4/1648308.png,0,0.990571916,116,0,682,512,566,512,twilight sparkle
1652736.png,https://derpicdn.net/img/view/2018/2/10/1652736.png,0,0.937796295,651,0,1920,804,1269,804,twilight sparkle
1654490.png,https://derpicdn.net/img/view/2018/2/12/1654490.png,0,0.975617468,429,43,829,443,400,400,twilight sparkle
1660922.png,https://derpicdn.net/img/view/2018/2/20/1660922.png,0,0.994718492,348,10,2012,1674,1664,1664,twilight sparkle
1661068.png,https://derpicdn.net/img/view/2018/2/20/1661068.png,0,0.997972608,0,0,2526,2634,2526,2634,twilight sparkle
1662907.png,https://derpicdn.net/img/view/2018/2/22/1662907.png,0,0.94146204,57,1,317,261,260,260,twilight sparkle
1665174.png,https://derpicdn.net/img/view/2018/2/25/1665174.png,0,0.988892853,76,69,1784,1777,1708,1708,twilight sparkle
1667392.png,https://derpicdn.net/img/view/2018/2/27/1667392.png,0,0.970187366,155,81,1505,1431,1350,1350,twilight sparkle
1667772.png,https://derpicdn.net/img/view/2018/2/28/1667772.png,0,0.992881477,492,77,900,489,408,412,twilight sparkle
1670013.png,https://derpicdn.net/img/view/2018/3/2/1670013.png,0,0.998216093,25,117,895,987,870,870,twilight sparkle
1670190.png,https://derpicdn.net/img/view/2018/3/3/1670190.png,0,0.97001642,584,0,1698,1076,1114,1076,twilight sparkle
1670939.png,https://derpicdn.net/img/view/2018/3/3/1670939.png,0,0.98865962,268,5,1162,899,894,894,twilight sparkle
1671522.png,https://derpicdn.net/img/view/2018/3/4/1671522.png,0,0.990405619,298,0,938,608,640,608,twilight sparkle
1672972.png,https://derpicdn.net/img/view/2018/3/6/1672972.png,0,0.996708035,274,66,1030,822,756,756,twilight sparkle
1674156.png,https://derpicdn.net/img/view/2018/3/7/1674156.png,1,0.992770791,18,95,532,609,514,514,twilight sparkle
1676043.png,https://derpicdn.net/img/view/2018/3/10/1676043.png,0,0.974495351,11,0,487,455,476,455,twilight sparkle
1681718.png,https://derpicdn.net/img/view/2018/3/16/1681718.png,0,0.974281549,228,309,614,695,386,386,twilight sparkle
1684920.png,https://derpicdn.net/img/view/2018/3/19/1684920.png,1,0.921619356,149,813,2063,2727,1914,1914,twilight sparkle
1687139.png,https://derpicdn.net/img/view/2018/3/22/1687139.png,0,0.96803993,0,0,580,645,580,645,twilight sparkle
1687649.png,https://derpicdn.net/img/view/2018/3/22/1687649.png,0,0.996098518,543,0,1243,532,700,532,twilight sparkle
1689163.png,https://derpicdn.net/img/view/2018/3/24/1689163.png,0,0.97238493,124,0,1014,903,890,903,twilight sparkle
1689699.png,https://derpicdn.net/img/view/2018/3/25/1689699.png,0,0.967484593,80,77,988,985,908,908,twilight sparkle
1690153.png,https://derpicdn.net/img/view/2018/3/25/1690153.png,0,0.989119411,0,0,1280,1015,1280,1015,twilight sparkle
1690155.png,https://derpicdn.net/img/view/2018/3/25/1690155.png,0,0.99168992,92,0,1748,1080,1656,1080,twilight sparkle
1690190.png,https://derpicdn.net/img/view/2018/3/25/1690190.png,0,0.981596708,176,0,1054,784,878,784,twilight sparkle
1694270.png,https://derpicdn.net/img/view/2018/3/30/1694270.png,0,0.944650471,87,115,343,371,256,256,twilight sparkle
1694375.png,https://derpicdn.net/img/view/2018/3/30/1694375.png,0,0.956925809,448,49,786,387,338,338,twilight sparkle
1694618.png,https://derpicdn.net/img/view/2018/3/30/1694618.png,0,0.998807371,1221,806,2129,1714,908,908,twilight sparkle
1696150.png,https://derpicdn.net/img/view/2018/4/1/1696150.png,0,0.983832598,87,16,1397,1326,1310,1310,twilight sparkle
1699763.png,https://derpicdn.net/img/view/2018/4/5/1699763.png,0,0.986749411,562,0,1450,832,888,832,twilight sparkle
1700894.png,https://derpicdn.net/img/view/2018/4/6/1700894.png,1,0.986713052,896,79,1156,339,260,260,twilight sparkle
1701109.png,https://derpicdn.net/img/view/2018/4/6/1701109.png,0,0.971464455,193,0,1147,720,954,720,twilight sparkle
1710193.png,https://derpicdn.net/img/view/2018/4/17/1710193.png,0,0.984646022,529,759,917,1147,388,388,twilight sparkle
1710203.png,https://derpicdn.net/img/view/2018/4/17/1710203.png,0,0.999569237,310,282,848,820,538,538,twilight sparkle
1710422.png,https://derpicdn.net/img/view/2018/4/17/1710422.png,0,0.995501578,175,0,609,430,434,430,twilight sparkle
1713767.png,https://derpicdn.net/img/view/2018/4/21/1713767.png,0,0.970507205,773,1093,1681,2001,908,908,twilight sparkle
1714412.png,https://derpicdn.net/img/view/2018/4/22/1714412.png,0,0.972456634,196,0,380,176,184,176,twilight sparkle
1714746.png,https://derpicdn.net/img/view/2018/4/22/1714746.png,0,0.91703105,780,266,2136,1622,1356,1356,twilight sparkle
1717750.png,https://derpicdn.net/img/view/2018/4/26/1717750.png,0,0.965886474,0,200,3928,4600,3928,4400,twilight sparkle
1718311.png,https://derpicdn.net/img/view/2018/4/27/1718311.png,0,0.997545362,577,0,1431,821,854,821,twilight sparkle
1719029.png,https://derpicdn.net/img/view/2018/4/28/1719029.png,0,0.987480402,5,39,579,613,574,574,twilight sparkle
1723376.png,https://derpicdn.net/img/view/2018/5/3/1723376.png,0,0.979495466,187,0,683,494,496,494,twilight sparkle
1723964.png,https://derpicdn.net/img/view/2018/5/4/1723964.png,0,0.992816985,0,69,921,1033,921,964,twilight sparkle
1725724.png,https://derpicdn.net/img/view/2018/5/6/1725724.png,0,0.961496949,410,70,858,518,448,448,twilight sparkle
1725724.png,https://derpicdn.net/img/view/2018/5/6/1725724.png,1,0.911099195,226,583,408,765,182,182,twilight sparkle
1728282.png,https://derpicdn.net/img/view/2018/5/9/1728282.png,0,0.933225393,692,95,1862,1265,1170,1170,twilight sparkle
1729262.png,https://derpicdn.net/img/view/2018/5/10/1729262.png,0,0.95700556,0,0,950,990,950,990,twilight sparkle
1729818.png,https://derpicdn.net/img/view/2018/5/11/1729818.png,0,0.988558054,225,0,583,310,358,310,twilight sparkle
1731930.png,https://derpicdn.net/img/view/2018/5/13/1731930.png,0,0.95514971,243,0,1239,943,996,943,twilight sparkle
1735236.png,https://derpicdn.net/img/view/2018/5/18/1735236.png,0,0.999363303,393,130,3349,3086,2956,2956,twilight sparkle
1738146.png,https://derpicdn.net/img/view/2018/5/21/1738146.png,0,0.999423325,29,0,431,392,402,392,twilight sparkle
1741413.png,https://derpicdn.net/img/view/2018/5/26/1741413.png,0,0.997613192,80,0,722,597,642,597,twilight sparkle
174257.jpg,https://derpicdn.net/img/view/2012/12/6/174257.jpg,0,0.992800832,93,0,633,481,540,481,twilight sparkle
1743579.png,https://derpicdn.net/img/view/2018/5/28/1743579.png,0,0.997204721,294,77,560,343,266,266,twilight sparkle
1743826.png,https://derpicdn.net/img/view/2018/5/28/1743826.png,0,0.975250959,443,0,851,368,408,368,twilight sparkle
1744024.png,https://derpicdn.net/img/view/2018/5/28/1744024.png,0,0.986845195,938,0,1480,525,542,525,twilight sparkle
1745884.png,https://derpicdn.net/img/view/2018/5/31/1745884.png,0,0.982690692,96,0,570,447,474,447,twilight sparkle
1746025.png,https://derpicdn.net/img/view/2018/5/31/1746025.png,0,0.915591955,2294,7,5000,2859,2706,2852,twilight sparkle
1746880.png,https://derpicdn.net/img/view/2018/6/1/1746880.png,0,0.919436574,0,27,474,615,474,588,twilight sparkle
1750976.png,https://derpicdn.net/img/view/2018/6/6/1750976.png,0,0.973416328,276,143,522,389,246,246,twilight sparkle
1751298.png,https://derpicdn.net/img/view/2018/6/6/1751298.png,0,0.936035454,110,0,876,576,766,576,twilight sparkle
1754525.png,https://derpicdn.net/img/view/2018/6/10/1754525.png,0,0.999191999,1345,96,3107,1858,1762,1762,twilight sparkle
1755324.png,https://derpicdn.net/img/view/2018/6/11/1755324.png,0,0.949838698,0,0,1424,1080,1424,1080,twilight sparkle
1756024.png,https://derpicdn.net/img/view/2018/6/12/1756024.png,0,0.991794884,310,72,646,408,336,336,twilight sparkle
1759477.png,https://derpicdn.net/img/view/2018/6/17/1759477.png,0,0.9745754,692,554,1490,1352,798,798,twilight sparkle
1759477.png,https://derpicdn.net/img/view/2018/6/17/1759477.png,1,0.900876224,1338,191,2268,1121,930,930,twilight sparkle
1765473.png,https://derpicdn.net/img/view/2018/6/25/1765473.png,0,0.99978894,382,0,744,347,362,347,twilight sparkle
1769215.png,https://derpicdn.net/img/view/2018/6/30/1769215.png,0,0.98568368,145,0,1935,1594,1790,1594,twilight sparkle
177036.png,https://derpicdn.net/img/view/2012/12/9/177036.png,0,0.975182116,0,70,844,931,844,861,twilight sparkle
1770525.png,https://derpicdn.net/img/view/2018/7/1/1770525.png,0,0.990337968,406,0,934,512,528,512,twilight sparkle
1772109.png,https://derpicdn.net/img/view/2018/7/3/1772109.png,0,0.937002957,1451,696,1927,1172,476,476,twilight sparkle
1772438.png,https://derpicdn.net/img/view/2018/7/4/1772438.png,0,0.988150537,1473,238,3995,2760,2522,2522,twilight sparkle
1775266.png,https://derpicdn.net/img/view/2018/7/7/1775266.png,0,0.982767522,0,0,709,758,709,758,twilight sparkle
1775382.png,https://derpicdn.net/img/view/2018/7/7/1775382.png,0,0.929872692,1268,0,3156,1817,1888,1817,twilight sparkle
1775862.png,https://derpicdn.net/img/view/2018/7/8/1775862.png,0,0.995605767,96,0,1300,1006,1204,1006,twilight sparkle
1776777.png,https://derpicdn.net/img/view/2018/7/9/1776777.png,0,0.987749994,0,0,1371,1673,1371,1673,twilight sparkle
1778371.png,https://derpicdn.net/img/view/2018/7/11/1778371.png,0,0.983408988,1403,0,4335,2890,2932,2890,twilight sparkle
1779127.png,https://derpicdn.net/img/view/2018/7/12/1779127.png,0,0.926561117,109,30,729,650,620,620,twilight sparkle
1780489.png,https://derpicdn.net/img/view/2018/7/14/1780489.png,0,0.998032689,148,0,684,534,536,534,twilight sparkle
1784789.png,https://derpicdn.net/img/view/2018/7/19/1784789.png,0,0.972991824,111,3,591,483,480,480,twilight sparkle
1786360.png,https://derpicdn.net/img/view/2018/7/21/1786360.png,0,0.998647869,895,0,1385,457,490,457,twilight sparkle
1789150.png,https://derpicdn.net/img/view/2018/7/25/1789150.png,0,0.999009967,920,1058,1592,1730,672,672,twilight sparkle
1791201.png,https://derpicdn.net/img/view/2018/7/27/1791201.png,0,0.998819172,1807,685,2875,1753,1068,1068,twilight sparkle
1793383.png,https://derpicdn.net/img/view/2018/7/30/1793383.png,0,0.991542101,3348,638,6704,3994,3356,3356,twilight sparkle
1793386.png,https://derpicdn.net/img/view/2018/7/30/1793386.png,0,0.991406441,620,0,1810,1000,1190,1000,twilight sparkle
1795984.png,https://derpicdn.net/img/view/2018/8/2/1795984.png,0,0.99494195,574,0,916,315,342,315,twilight sparkle
1796334.png,https://derpicdn.net/img/view/2018/8/2/1796334.png,0,0.992070436,0,43,1908,2003,1908,1960,twilight sparkle
1796459.png,https://derpicdn.net/img/view/2018/8/3/1796459.png,0,0.99326992,255,123,733,601,478,478,twilight sparkle
1796516.png,https://derpicdn.net/img/view/2018/8/3/1796516.png,0,0.993335724,32,0,496,425,464,425,twilight sparkle
1796663.png,https://derpicdn.net/img/view/2018/8/3/1796663.png,0,0.997921228,0,45,1663,1787,1663,1742,twilight sparkle
1799210.png,https://derpicdn.net/img/view/2018/8/6/1799210.png,0,0.984052718,1301,212,3277,2282,1976,2070,twilight sparkle
1799375.png,https://derpicdn.net/img/view/2018/8/6/1799375.png,0,0.990354896,2359,0,7800,5535,5441,5535,twilight sparkle
1800317.png,https://derpicdn.net/img/view/2018/8/7/1800317.png,0,0.977291286,252,146,2054,1948,1802,1802,twilight sparkle
1801113.png,https://derpicdn.net/img/view/2018/8/8/1801113.png,0,0.987787783,613,0,4869,3954,4256,3954,twilight sparkle
1804180.png,https://derpicdn.net/img/view/2018/8/11/1804180.png,0,0.969999313,95,181,1165,1079,1070,898,twilight sparkle
1804180.png,https://derpicdn.net/img/view/2018/8/11/1804180.png,1,0.939431012,301,0,1206,904,905,904,twilight sparkle
1808167.png,https://derpicdn.net/img/view/2018/8/16/1808167.png,0,0.943048179,834,118,2500,1784,1666,1666,twilight sparkle
1809326.png,https://derpicdn.net/img/view/2018/8/17/1809326.png,0,0.98699677,0,0,576,618,576,618,twilight sparkle
1809803.png,https://derpicdn.net/img/view/2018/8/18/1809803.png,0,0.991565943,0,0,704,769,704,769,twilight sparkle
1812568.png,https://derpicdn.net/img/view/2018/8/21/1812568.png,0,0.99841696,12,0,1752,1405,1740,1405,twilight sparkle
1812773.png,https://derpicdn.net/img/view/2018/8/21/1812773.png,0,0.994486272,0,8,571,608,571,600,twilight sparkle
181429.png,https://derpicdn.net/img/view/2012/12/13/181429.png,0,0.941884696,255,116,453,314,198,198,twilight sparkle
1814321.png,https://derpicdn.net/img/view/2018/8/23/1814321.png,0,0.941982269,159,0,807,588,648,588,twilight sparkle
1816584.png,https://derpicdn.net/img/view/2018/8/26/1816584.png,0,0.979028285,0,0,906,1057,906,1057,twilight sparkle
1817192.png,https://derpicdn.net/img/view/2018/8/26/1817192.png,0,0.996267855,477,0,1067,576,590,576,twilight sparkle
1820207.png,https://derpicdn.net/img/view/2018/8/30/1820207.png,0,0.982499778,2484,0,5500,2635,3016,2635,twilight sparkle
1820723.png,https://derpicdn.net/img/view/2018/8/30/1820723.png,0,0.939312994,507,22,1197,712,690,690,twilight sparkle
1822562.png,https://derpicdn.net/img/view/2018/9/2/1822562.png,0,0.938175857,280,127,1392,1239,1112,1112,twilight sparkle
1822699.png,https://derpicdn.net/img/view/2018/9/2/1822699.png,0,0.997366607,133,0,461,325,328,325,twilight sparkle
1823542.png,https://derpicdn.net/img/view/2018/9/3/1823542.png,0,0.993014812,374,23,890,539,516,516,twilight sparkle
1828182.png,https://derpicdn.net/img/view/2018/9/9/1828182.png,0,0.986099601,342,0,870,517,528,517,twilight sparkle
1830671.png,https://derpicdn.net/img/view/2018/9/12/1830671.png,0,0.975444496,98,0,968,858,870,858,twilight sparkle
1833450.png,https://derpicdn.net/img/view/2018/9/15/1833450.png,0,0.936297774,110,0,1294,932,1184,932,twilight sparkle
1834276.png,https://derpicdn.net/img/view/2018/9/16/1834276.png,0,0.997987807,716,11,1700,995,984,984,twilight sparkle
1834432.png,https://derpicdn.net/img/view/2018/9/16/1834432.png,0,0.996642947,79,0,1259,1165,1180,1165,twilight sparkle
1834536.png,https://derpicdn.net/img/view/2018/9/17/1834536.png,0,0.944793403,1142,0,1576,425,434,425,twilight sparkle
1834708.png,https://derpicdn.net/img/view/2018/9/17/1834708.png,0,0.977496386,0,0,433,445,433,445,twilight sparkle
1836875.png,https://derpicdn.net/img/view/2018/9/20/1836875.png,0,0.981482565,1751,138,4737,3124,2986,2986,twilight sparkle
1839956.png,https://derpicdn.net/img/view/2018/9/24/1839956.png,0,0.998982906,4024,102,7347,3692,3323,3590,twilight sparkle
1844992.png,https://derpicdn.net/img/view/2018/9/30/1844992.png,0,0.930533946,193,0,1241,1001,1048,1001,twilight sparkle
1849782.png,https://derpicdn.net/img/view/2018/10/6/1849782.png,0,0.948743761,56,0,900,816,844,816,twilight sparkle
1850117.png,https://derpicdn.net/img/view/2018/10/7/1850117.png,0,0.977739573,492,540,1518,1566,1026,1026,twilight sparkle
1850567.png,https://derpicdn.net/img/view/2018/10/7/1850567.png,0,0.936185598,126,3,406,261,280,258,twilight sparkle
1852857.png,https://derpicdn.net/img/view/2018/10/10/1852857.png,0,0.963551819,92,0,1584,1080,1492,1080,twilight sparkle
1854269.png,https://derpicdn.net/img/view/2018/10/12/1854269.png,0,0.962635338,263,0,1536,1292,1273,1292,twilight sparkle
1854588.png,https://derpicdn.net/img/view/2018/10/12/1854588.png,0,0.996600211,2060,970,2798,1708,738,738,twilight sparkle
1854620.png,https://derpicdn.net/img/view/2018/10/12/1854620.png,0,0.941013157,603,855,1459,1711,856,856,twilight sparkle
1855723.png,https://derpicdn.net/img/view/2018/10/13/1855723.png,0,0.994319916,202,0,842,608,640,608,twilight sparkle
1856218.png,https://derpicdn.net/img/view/2018/10/14/1856218.png,0,0.996654272,3435,0,6669,3114,3234,3114,twilight sparkle
1856219.png,https://derpicdn.net/img/view/2018/10/14/1856219.png,0,0.982203424,5205,2280,8825,5900,3620,3620,twilight sparkle
1856655.png,https://derpicdn.net/img/view/2018/10/14/1856655.png,0,0.982018888,49,0,338,324,289,324,twilight sparkle
1858158.png,https://derpicdn.net/img/view/2018/10/16/1858158.png,0,0.990342021,0,0,463,490,463,490,twilight sparkle
1860870.png,https://derpicdn.net/img/view/2018/10/19/1860870.png,0,0.997600436,1202,1063,3450,3311,2248,2248,twilight sparkle
1861516.png,https://derpicdn.net/img/view/2018/10/20/1861516.png,0,0.994100273,2257,233,2913,889,656,656,twilight sparkle
1861516.png,https://derpicdn.net/img/view/2018/10/20/1861516.png,1,0.985132158,1349,2231,2045,2927,696,696,twilight sparkle
1861516.png,https://derpicdn.net/img/view/2018/10/20/1861516.png,2,0.965410948,153,2222,887,2956,734,734,twilight sparkle
1861516.png,https://derpicdn.net/img/view/2018/10/20/1861516.png,3,0.964426458,3341,40,4173,872,832,832,twilight sparkle
1863628.png,https://derpicdn.net/img/view/2018/10/23/1863628.png,0,0.998343825,81,1177,1213,2309,1132,1132,twilight sparkle
1867480.png,https://derpicdn.net/img/view/2018/10/27/1867480.png,0,0.957455575,48,0,532,438,484,438,twilight sparkle
1867757.png,https://derpicdn.net/img/view/2018/10/27/1867757.png,0,0.988360763,85,0,801,629,716,629,twilight sparkle
1868079.png,https://derpicdn.net/img/view/2018/10/28/1868079.png,0,0.976287544,118,0,1000,827,882,827,twilight sparkle
1869626.png,https://derpicdn.net/img/view/2018/10/29/1869626.png,0,0.998316169,605,17,1207,619,602,602,twilight sparkle
1872319.png,https://derpicdn.net/img/view/2018/11/1/1872319.png,0,0.97633785,0,0,281,333,281,333,twilight sparkle
1874467.png,https://derpicdn.net/img/view/2018/11/4/1874467.png,0,0.950300336,99,64,391,356,292,292,twilight sparkle
1877696.png,https://derpicdn.net/img/view/2018/11/8/1877696.png,0,0.990533054,13,0,1221,720,1208,720,twilight sparkle
1877981.png,https://derpicdn.net/img/view/2018/11/8/1877981.png,0,0.972936153,3486,123,4016,653,530,530,twilight sparkle
1877981.png,https://derpicdn.net/img/view/2018/11/8/1877981.png,1,0.922872007,66,649,640,1223,574,574,twilight sparkle
187819.png,https://derpicdn.net/img/view/2012/12/19/187819.png,0,0.953493237,718,63,1318,663,600,600,twilight sparkle
1879725.png,https://derpicdn.net/img/view/2018/11/11/1879725.png,0,0.994330645,729,290,1119,680,390,390,twilight sparkle
1879868.png,https://derpicdn.net/img/view/2018/11/11/1879868.png,0,0.932913303,3442,781,6294,3633,2852,2852,twilight sparkle
1881576.png,https://derpicdn.net/img/view/2018/11/13/1881576.png,0,0.953633726,61,159,1229,1327,1168,1168,twilight sparkle
1882873.png,https://derpicdn.net/img/view/2018/11/15/1882873.png,0,0.999642849,31,0,361,320,330,320,twilight sparkle
1884363.png,https://derpicdn.net/img/view/2018/11/17/1884363.png,0,0.994411767,1307,273,2000,971,693,698,twilight sparkle
1886135.png,https://derpicdn.net/img/view/2018/11/19/1886135.png,0,0.957273722,622,243,1216,837,594,594,twilight sparkle
1887904.png,https://derpicdn.net/img/view/2018/11/21/1887904.png,0,0.995492518,394,0,844,428,450,428,twilight sparkle
1889612.png,https://derpicdn.net/img/view/2018/11/24/1889612.png,0,0.996678293,168,48,632,512,464,464,twilight sparkle
1890025.png,https://derpicdn.net/img/view/2018/11/24/1890025.png,0,0.910885274,822,1242,1924,2344,1102,1102,twilight sparkle
1891753.png,https://derpicdn.net/img/view/2018/11/26/1891753.png,0,0.962263823,66,72,194,200,128,128,twilight sparkle
1893233.png,https://derpicdn.net/img/view/2018/11/28/1893233.png,0,0.997656226,6,0,590,548,584,548,twilight sparkle
1895335.png,https://derpicdn.net/img/view/2018/12/1/1895335.png,0,0.996825516,475,0,1721,1209,1246,1209,twilight sparkle
1895749.png,https://derpicdn.net/img/view/2018/12/1/1895749.png,0,0.998715281,474,300,1086,912,612,612,twilight sparkle
1900682.png,https://derpicdn.net/img/view/2018/12/6/1900682.png,0,0.989862084,413,187,657,431,244,244,twilight sparkle
1900691.png,https://derpicdn.net/img/view/2018/12/7/1900691.png,0,0.999728024,407,0,727,280,320,280,twilight sparkle
1900692.png,https://derpicdn.net/img/view/2018/12/7/1900692.png,0,0.99967134,332,0,678,289,346,289,twilight sparkle
1900820.png,https://derpicdn.net/img/view/2018/12/7/1900820.png,0,0.987779319,0,3191,1744,4960,1744,1769,twilight sparkle
1900820.png,https://derpicdn.net/img/view/2018/12/7/1900820.png,1,0.971563041,315,1640,1507,2832,1192,1192,twilight sparkle
1901854.png,https://derpicdn.net/img/view/2018/12/8/1901854.png,1,0.949926019,557,146,849,438,292,292,twilight sparkle
1906575.png,https://derpicdn.net/img/view/2018/12/12/1906575.png,0,0.99126184,3,0,645,552,642,552,twilight sparkle
1907803.png,https://derpicdn.net/img/view/2018/12/14/1907803.png,0,0.989454448,0,0,599,598,599,598,twilight sparkle
1912146.png,https://derpicdn.net/img/view/2018/12/18/1912146.png,0,0.994694948,132,12,882,762,750,750,twilight sparkle
1913061.png,https://derpicdn.net/img/view/2018/12/19/1913061.png,0,0.980696976,290,95,604,409,314,314,twilight sparkle
1913679.png,https://derpicdn.net/img/view/2018/12/20/1913679.png,0,0.999764502,590,0,1162,563,572,563,twilight sparkle
1920511.png,https://derpicdn.net/img/view/2018/12/28/1920511.png,0,0.993454754,102,0,1842,1080,1740,1080,twilight sparkle
1925100.png,https://derpicdn.net/img/view/2019/1/2/1925100.png,0,0.94903034,0,0,583,579,583,579,twilight sparkle
1926793.png,https://derpicdn.net/img/view/2019/1/5/1926793.png,0,0.992313921,5365,0,11203,5573,5838,5573,twilight sparkle
1926851.png,https://derpicdn.net/img/view/2019/1/5/1926851.png,0,0.995983541,133,8,573,448,440,440,twilight sparkle
1928322.png,https://derpicdn.net/img/view/2019/1/6/1928322.png,0,0.955490947,0,61,515,579,515,518,twilight sparkle
1930031.png,https://derpicdn.net/img/view/2019/1/8/1930031.png,0,0.993893802,214,12,1462,1260,1248,1248,twilight sparkle
1936351.png,https://derpicdn.net/img/view/2019/1/15/1936351.png,0,0.982800484,1040,0,3274,2149,2234,2149,twilight sparkle
1937137.png,https://derpicdn.net/img/view/2019/1/16/1937137.png,0,0.981105566,432,0,1018,495,586,495,twilight sparkle
1937455.png,https://derpicdn.net/img/view/2019/1/17/1937455.png,0,0.999413967,564,66,962,464,398,398,twilight sparkle
1937455.png,https://derpicdn.net/img/view/2019/1/17/1937455.png,1,0.99916482,24,95,400,471,376,376,twilight sparkle
193860.png,https://derpicdn.net/img/view/2012/12/26/193860.png,0,0.996902704,106,0,340,231,234,231,twilight sparkle
1939171.png,https://derpicdn.net/img/view/2019/1/19/1939171.png,0,0.973441482,1980,3,4856,2879,2876,2876,twilight sparkle
1939172.png,https://derpicdn.net/img/view/2019/1/19/1939172.png,0,0.953998625,3194,216,6666,3688,3472,3472,twilight sparkle
1939173.png,https://derpicdn.net/img/view/2019/1/19/1939173.png,0,0.981402159,200,198,2786,2784,2586,2586,twilight sparkle
1942807.png,https://derpicdn.net/img/view/2019/1/23/1942807.png,0,0.997864306,177,0,589,395,412,395,twilight sparkle
1946195.png,https://derpicdn.net/img/view/2019/1/27/1946195.png,0,0.973366201,130,0,702,644,572,644,twilight sparkle
1948102.png,https://derpicdn.net/img/view/2019/1/29/1948102.png,0,0.943011165,991,0,4847,3202,3856,3202,twilight sparkle
1948106.png,https://derpicdn.net/img/view/2019/1/29/1948106.png,0,0.997582138,172,40,1926,1794,1754,1754,twilight sparkle
1948777.png,https://derpicdn.net/img/view/2019/1/30/1948777.png,0,0.992054164,189,0,1531,1091,1342,1091,twilight sparkle
1949120.png,https://derpicdn.net/img/view/2019/1/31/1949120.png,0,0.92798543,475,76,871,472,396,396,twilight sparkle
1949279.png,https://derpicdn.net/img/view/2019/1/31/1949279.png,0,0.980968356,35,11,581,557,546,546,twilight sparkle
1949637.png,https://derpicdn.net/img/view/2019/1/31/1949637.png,0,0.97221005,294,0,956,591,662,591,twilight sparkle
1950682.png,https://derpicdn.net/img/view/2019/2/1/1950682.png,0,0.999821484,896,113,1514,731,618,618,twilight sparkle
1950682.png,https://derpicdn.net/img/view/2019/2/1/1950682.png,1,0.9953897,509,94,1103,688,594,594,twilight sparkle
1951508.png,https://derpicdn.net/img/view/2019/2/2/1951508.png,0,0.923000515,43,71,973,1001,930,930,twilight sparkle
1962006.png,https://derpicdn.net/img/view/2019/2/14/1962006.png,0,0.994408667,559,279,1687,1407,1128,1128,twilight sparkle
1963054.png,https://derpicdn.net/img/view/2019/2/15/1963054.png,0,0.989300072,0,68,746,820,746,752,twilight sparkle
1963656.png,https://derpicdn.net/img/view/2019/2/16/1963656.png,0,0.989364088,421,0,1441,902,1020,902,twilight sparkle
1963791.png,https://derpicdn.net/img/view/2019/2/16/1963791.png,0,0.928787112,33,0,1147,1089,1114,1089,twilight sparkle
1963843.png,https://derpicdn.net/img/view/2019/2/16/1963843.png,0,0.974639893,1541,466,2681,1606,1140,1140,twilight sparkle
1965436.png,https://derpicdn.net/img/view/2019/2/18/1965436.png,0,0.984459639,134,27,708,635,574,608,twilight sparkle
1965454.png,https://derpicdn.net/img/view/2019/2/18/1965454.png,0,0.967222929,101,0,631,565,530,565,twilight sparkle
1966293.png,https://derpicdn.net/img/view/2019/2/19/1966293.png,0,0.95084697,86,0,308,217,222,217,twilight sparkle
1966604.png,https://derpicdn.net/img/view/2019/2/20/1966604.png,0,0.980677903,333,39,723,429,390,390,twilight sparkle
1968720.png,https://derpicdn.net/img/view/2019/2/22/1968720.png,0,0.999035478,481,400,927,846,446,446,twilight sparkle
1968720.png,https://derpicdn.net/img/view/2019/2/22/1968720.png,1,0.989468455,43,112,345,414,302,302,twilight sparkle
1970095.png,https://derpicdn.net/img/view/2019/2/23/1970095.png,0,0.98115164,14,0,632,614,618,614,twilight sparkle
197102.png,https://derpicdn.net/img/view/2012/12/29/197102.png,0,0.982889771,382,0,1280,915,898,915,twilight sparkle
1972475.png,https://derpicdn.net/img/view/2019/2/26/1972475.png,0,0.936155796,200,0,1918,1591,1718,1591,twilight sparkle
1972676.png,https://derpicdn.net/img/view/2019/2/27/1972676.png,0,0.992835939,231,59,609,437,378,378,twilight sparkle
1973457.png,https://derpicdn.net/img/view/2019/2/28/1973457.png,0,0.988071978,1027,152,1935,1060,908,908,twilight sparkle
1973457.png,https://derpicdn.net/img/view/2019/2/28/1973457.png,1,0.97405225,422,208,1278,1064,856,856,twilight sparkle
1974203.png,https://derpicdn.net/img/view/2019/3/1/1974203.png,0,0.988971055,75,16,801,742,726,726,twilight sparkle
1974278.png,https://derpicdn.net/img/view/2019/3/1/1974278.png,0,0.999186695,28,38,606,616,578,578,twilight sparkle
1975767.png,https://derpicdn.net/img/view/2019/3/2/1975767.png,0,0.990724087,113,41,781,709,668,668,twilight sparkle
1976277.png,https://derpicdn.net/img/view/2019/3/3/1976277.png,0,0.985736251,0,0,476,560,476,560,twilight sparkle
1976869.png,https://derpicdn.net/img/view/2019/3/3/1976869.png,0,0.956599712,206,65,970,829,764,764,twilight sparkle
1978513.png,https://derpicdn.net/img/view/2019/3/6/1978513.png,0,0.996301413,492,0,1408,844,916,844,twilight sparkle
1979081.png,https://derpicdn.net/img/view/2019/3/6/1979081.png,0,0.986763716,126,19,884,797,758,778,twilight sparkle
1980684.png,https://derpicdn.net/img/view/2019/3/8/1980684.png,1,0.951161802,531,136,727,332,196,196,twilight sparkle
1981200.png,https://derpicdn.net/img/view/2019/3/9/1981200.png,0,0.971056521,750,358,1346,954,596,596,twilight sparkle
1981239.png,https://derpicdn.net/img/view/2019/3/9/1981239.png,0,0.996147037,1817,57,3287,1527,1470,1470,twilight sparkle
1981511.png,https://derpicdn.net/img/view/2019/3/9/1981511.png,0,0.986669123,0,0,857,823,857,823,twilight sparkle
1982137.png,https://derpicdn.net/img/view/2019/3/10/1982137.png,0,0.997243762,581,13,1341,773,760,760,twilight sparkle
1982837.png,https://derpicdn.net/img/view/2019/3/11/1982837.png,0,0.97995466,601,74,1393,866,792,792,twilight sparkle
1983831.png,https://derpicdn.net/img/view/2019/3/12/1983831.png,0,0.990631819,174,17,770,613,596,596,twilight sparkle
1984662.png,https://derpicdn.net/img/view/2019/3/13/1984662.png,0,0.984966934,280,0,1252,929,972,929,twilight sparkle
1984894.png,https://derpicdn.net/img/view/2019/3/14/1984894.png,0,0.969038785,482,0,1120,621,638,621,twilight sparkle
1985105.png,https://derpicdn.net/img/view/2019/3/14/1985105.png,0,0.97408545,434,503,1142,1211,708,708,twilight sparkle
1985258.png,https://derpicdn.net/img/view/2019/3/14/1985258.png,0,0.983494163,42,0,872,788,830,788,twilight sparkle
1985330.png,https://derpicdn.net/img/view/2019/3/14/1985330.png,0,0.936854959,693,110,1577,939,884,829,twilight sparkle
1985331.png,https://derpicdn.net/img/view/2019/3/14/1985331.png,0,0.977373004,50,22,308,280,258,258,twilight sparkle
1988878.png,https://derpicdn.net/img/view/2019/3/18/1988878.png,0,0.927873969,481,50,893,486,412,436,twilight sparkle
1989683.png,https://derpicdn.net/img/view/2019/3/19/1989683.png,0,0.994727492,402,0,798,387,396,387,twilight sparkle
1990972.png,https://derpicdn.net/img/view/2019/3/20/1990972.png,0,0.990058661,343,27,907,591,564,564,twilight sparkle
1991165.png,https://derpicdn.net/img/view/2019/3/21/1991165.png,0,0.99941057,0,11,680,711,680,700,twilight sparkle
1991167.png,https://derpicdn.net/img/view/2019/3/21/1991167.png,0,0.904670358,67,0,969,1029,902,1029,twilight sparkle
1991232.png,https://derpicdn.net/img/view/2019/3/21/1991232.png,0,0.914577901,0,0,991,838,991,838,twilight sparkle
1993565.png,https://derpicdn.net/img/view/2019/3/24/1993565.png,0,0.996223748,128,94,2098,2064,1970,1970,twilight sparkle
1994688.png,https://derpicdn.net/img/view/2019/3/25/1994688.png,0,0.909193635,83,117,871,915,788,798,twilight sparkle
1996294.png,https://derpicdn.net/img/view/2019/3/27/1996294.png,0,0.988273919,376,3,816,467,440,464,twilight sparkle
1996296.png,https://derpicdn.net/img/view/2019/3/27/1996296.png,0,0.948240101,456,82,1326,938,870,856,twilight sparkle
1996969.png,https://derpicdn.net/img/view/2019/3/28/1996969.png,0,0.989738166,212,0,684,400,472,400,twilight sparkle
1999809.png,https://derpicdn.net/img/view/2019/4/1/1999809.png,0,0.986700118,473,179,951,657,478,478,twilight sparkle
2001679.png,https://derpicdn.net/img/view/2019/4/3/2001679.png,0,0.952153563,254,398,1340,1484,1086,1086,twilight sparkle
20018.png,https://derpicdn.net/img/view/2012/6/25/20018.png,0,0.967125058,82,11,488,417,406,406,twilight sparkle
2002725.png,https://derpicdn.net/img/view/2019/4/4/2002725.png,0,0.947466075,1288,0,5810,3977,4522,3977,twilight sparkle
2003032.png,https://derpicdn.net/img/view/2019/4/4/2003032.png,0,0.991588593,227,559,583,915,356,356,twilight sparkle
2003677.png,https://derpicdn.net/img/view/2019/4/5/2003677.png,0,0.992308021,152,283,490,621,338,338,twilight sparkle
2004463.png,https://derpicdn.net/img/view/2019/4/6/2004463.png,0,0.977411568,537,196,2467,2126,1930,1930,twilight sparkle
2004629.png,https://derpicdn.net/img/view/2019/4/6/2004629.png,0,0.988398314,120,63,1018,961,898,898,twilight sparkle
200522.png,https://derpicdn.net/img/view/2013/1/2/200522.png,0,0.994933009,187,0,467,275,280,275,twilight sparkle
2007462.png,https://derpicdn.net/img/view/2019/4/9/2007462.png,0,0.982077479,0,0,628,723,628,723,twilight sparkle
2008494.png,https://derpicdn.net/img/view/2019/4/10/2008494.png,0,0.95204109,50,1,444,365,394,364,twilight sparkle
2009596.png,https://derpicdn.net/img/view/2019/4/12/2009596.png,1,0.984722495,945,85,2479,1619,1534,1534,twilight sparkle
2009596.png,https://derpicdn.net/img/view/2019/4/12/2009596.png,2,0.977196217,2178,2444,3522,3836,1344,1392,twilight sparkle
2010917.png,https://derpicdn.net/img/view/2019/4/13/2010917.png,0,0.982210517,171,47,1094,995,923,948,twilight sparkle
2013891.png,https://derpicdn.net/img/view/2019/4/16/2013891.png,0,0.993462443,186,6,1980,1763,1794,1757,twilight sparkle
2015219.png,https://derpicdn.net/img/view/2019/4/17/2015219.png,0,0.98421675,17,814,3931,4728,3914,3914,twilight sparkle
2015712.png,https://derpicdn.net/img/view/2019/4/18/2015712.png,0,0.987931967,737,0,4985,3988,4248,3988,twilight sparkle
2016790.png,https://derpicdn.net/img/view/2019/4/19/2016790.png,0,0.949475646,52,3,759,833,707,830,twilight sparkle
2017697.png,https://derpicdn.net/img/view/2019/4/20/2017697.png,0,0.902420163,258,0,1718,1080,1460,1080,twilight sparkle
2019209.png,https://derpicdn.net/img/view/2019/4/21/2019209.png,0,0.980427861,0,0,1840,1080,1840,1080,twilight sparkle
2019889.png,https://derpicdn.net/img/view/2019/4/22/2019889.png,0,0.971502662,92,22,776,706,684,684,twilight sparkle
2019913.png,https://derpicdn.net/img/view/2019/4/22/2019913.png,0,0.995615959,0,0,3276,3490,3276,3490,twilight sparkle
2020484.png,https://derpicdn.net/img/view/2019/4/23/2020484.png,0,0.925367713,75,0,1773,1080,1698,1080,twilight sparkle
2020623.png,https://derpicdn.net/img/view/2019/4/23/2020623.png,0,0.941482186,0,0,641,655,641,655,twilight sparkle
2022604.png,https://derpicdn.net/img/view/2019/4/25/2022604.png,0,0.973045647,0,0,339,405,339,405,twilight sparkle
2023138.png,https://derpicdn.net/img/view/2019/4/26/2023138.png,0,0.990198195,1139,129,2647,1637,1508,1508,twilight sparkle
2023387.png,https://derpicdn.net/img/view/2019/4/26/2023387.png,0,0.981481791,96,79,540,523,444,444,twilight sparkle
2023583.png,https://derpicdn.net/img/view/2019/4/26/2023583.png,0,0.996565521,2501,332,3859,1690,1358,1358,twilight sparkle
2023983.png,https://derpicdn.net/img/view/2019/4/27/2023983.png,0,0.91105479,26,0,798,795,772,795,twilight sparkle
2024446.png,https://derpicdn.net/img/view/2019/4/27/2024446.png,0,0.980953515,23,0,936,896,913,896,twilight sparkle
2024447.png,https://derpicdn.net/img/view/2019/4/27/2024447.png,0,0.967148006,197,56,1054,976,857,920,twilight sparkle
2024895.png,https://derpicdn.net/img/view/2019/4/28/2024895.png,0,0.952180028,487,333,6209,6055,5722,5722,twilight sparkle
2024986.png,https://derpicdn.net/img/view/2019/4/28/2024986.png,0,0.929361522,0,10,387,468,387,458,twilight sparkle
2026282.png,https://derpicdn.net/img/view/2019/4/29/2026282.png,0,0.966020763,36,36,322,322,286,286,twilight sparkle
2026569.png,https://derpicdn.net/img/view/2019/4/29/2026569.png,0,0.967182636,255,0,3237,2550,2982,2550,twilight sparkle
2027665.png,https://derpicdn.net/img/view/2019/5/1/2027665.png,0,0.990859807,1000,98,2420,1518,1420,1420,twilight sparkle
2028387.png,https://derpicdn.net/img/view/2019/5/1/2028387.png,0,0.978197157,15,110,559,654,544,544,twilight sparkle
2028690.png,https://derpicdn.net/img/view/2019/5/2/2028690.png,0,0.973552763,1104,119,3396,2411,2292,2292,twilight sparkle
203174.png,https://derpicdn.net/img/view/2013/1/5/203174.png,0,0.993934929,215,57,449,291,234,234,twilight sparkle
2034559.png,https://derpicdn.net/img/view/2019/5/9/2034559.png,0,0.998472333,52,8,560,516,508,508,twilight sparkle
2038637.png,https://derpicdn.net/img/view/2019/5/14/2038637.png,0,0.96967113,92,5,490,403,398,398,twilight sparkle
2044514.png,https://derpicdn.net/img/view/2019/5/20/2044514.png,0,0.999005556,1337,128,3481,2272,2144,2144,twilight sparkle
2046324.png,https://derpicdn.net/img/view/2019/5/22/2046324.png,0,0.998146236,719,35,3311,2627,2592,2592,twilight sparkle
204769.png,https://derpicdn.net/img/view/2013/1/7/204769.png,0,0.980625629,20,11,220,211,200,200,twilight sparkle
2049679.png,https://derpicdn.net/img/view/2019/5/26/2049679.png,0,0.987851918,370,0,1222,886,852,886,twilight sparkle
2051306.png,https://derpicdn.net/img/view/2019/5/28/2051306.png,0,0.988953471,44,0,552,479,508,479,twilight sparkle
2052899.png,https://derpicdn.net/img/view/2019/5/29/2052899.png,0,0.953232467,926,0,1798,833,872,833,twilight sparkle
2053328.png,https://derpicdn.net/img/view/2019/5/30/2053328.png,0,0.950345814,0,80,5707,6258,5707,6178,twilight sparkle
2054877.png,https://derpicdn.net/img/view/2019/6/1/2054877.png,0,0.918314338,0,82,692,790,692,708,twilight sparkle
20554.jpg,https://derpicdn.net/img/view/2012/6/25/20554.jpg,1,0.953784466,2573,89,3213,729,640,640,twilight sparkle
2061655.png,https://derpicdn.net/img/view/2019/6/9/2061655.png,0,0.950402081,0,40,459,514,459,474,twilight sparkle
2064952.png,https://derpicdn.net/img/view/2019/6/14/2064952.png,0,0.99960953,321,425,797,901,476,476,twilight sparkle
2064959.png,https://derpicdn.net/img/view/2019/6/14/2064959.png,0,0.917637885,1136,2107,2512,3483,1376,1376,twilight sparkle
2074539.png,https://derpicdn.net/img/view/2019/6/24/2074539.png,0,0.99487704,125,0,1761,1533,1636,1533,twilight sparkle
2076216.png,https://derpicdn.net/img/view/2019/6/27/2076216.png,0,0.998332024,309,6,743,440,434,434,twilight sparkle
2076307.png,https://derpicdn.net/img/view/2019/6/27/2076307.png,0,0.981692851,0,0,795,791,795,791,twilight sparkle
2077662.png,https://derpicdn.net/img/view/2019/6/28/2077662.png,0,0.903979063,0,16,514,530,514,514,twilight sparkle
2077816.png,https://derpicdn.net/img/view/2019/6/28/2077816.png,0,0.975533664,434,393,1396,1355,962,962,twilight sparkle
2078418.png,https://derpicdn.net/img/view/2019/6/29/2078418.png,0,0.924450576,167,213,529,575,362,362,twilight sparkle
2078583.png,https://derpicdn.net/img/view/2019/6/29/2078583.png,0,0.92710036,0,0,310,319,310,319,twilight sparkle
2078876.png,https://derpicdn.net/img/view/2019/6/29/2078876.png,0,0.942826807,1139,536,1977,1374,838,838,twilight sparkle
2079555.png,https://derpicdn.net/img/view/2019/6/30/2079555.png,0,0.991435766,59,16,967,924,908,908,twilight sparkle
2079719.png,https://derpicdn.net/img/view/2019/6/30/2079719.png,0,0.956798673,220,0,903,616,683,616,twilight sparkle
2086430.png,https://derpicdn.net/img/view/2019/7/8/2086430.png,0,0.951209486,37,25,526,521,489,496,twilight sparkle
2087448.png,https://derpicdn.net/img/view/2019/7/9/2087448.png,0,0.99914062,409,109,1057,757,648,648,twilight sparkle
2089839.png,https://derpicdn.net/img/view/2019/7/12/2089839.png,0,0.997243822,1406,343,1856,793,450,450,twilight sparkle
2089839.png,https://derpicdn.net/img/view/2019/7/12/2089839.png,1,0.996304572,380,324,850,794,470,470,twilight sparkle
2089839.png,https://derpicdn.net/img/view/2019/7/12/2089839.png,2,0.953381062,1580,1090,2098,1608,518,518,twilight sparkle
2094753.png,https://derpicdn.net/img/view/2019/7/18/2094753.png,0,0.974619389,0,0,494,491,494,491,twilight sparkle
2095301.png,https://derpicdn.net/img/view/2019/7/18/2095301.png,0,0.996035039,0,114,1685,1932,1685,1818,twilight sparkle
2102078.png,https://derpicdn.net/img/view/2019/7/27/2102078.png,0,0.967054188,1275,533,2233,1491,958,958,twilight sparkle
2105183.png,https://derpicdn.net/img/view/2019/7/30/2105183.png,0,0.979633451,0,0,1045,1079,1045,1079,twilight sparkle
2107261.png,https://derpicdn.net/img/view/2019/8/2/2107261.png,0,0.942316115,214,0,1500,1080,1286,1080,twilight sparkle
2107722.png,https://derpicdn.net/img/view/2019/8/3/2107722.png,0,0.998118162,14,0,252,235,238,235,twilight sparkle
2112186.png,https://derpicdn.net/img/view/2019/8/8/2112186.png,0,0.99532932,1,0,889,845,888,845,twilight sparkle
2116156.png,https://derpicdn.net/img/view/2019/8/12/2116156.png,0,0.999359727,308,421,2086,2199,1778,1778,twilight sparkle
2117557.png,https://derpicdn.net/img/view/2019/8/14/2117557.png,0,0.991111159,36,1,878,843,842,842,twilight sparkle
2118204.png,https://derpicdn.net/img/view/2019/8/14/2118204.png,0,0.999728143,145,0,989,781,844,781,twilight sparkle
2122716.png,https://derpicdn.net/img/view/2019/8/20/2122716.png,0,0.99437201,388,242,802,656,414,414,twilight sparkle
2122716.png,https://derpicdn.net/img/view/2019/8/20/2122716.png,1,0.9803918,1063,210,1463,610,400,400,twilight sparkle
2122897.png,https://derpicdn.net/img/view/2019/8/20/2122897.png,0,0.92657429,273,43,1647,1417,1374,1374,twilight sparkle
2125959.png,https://derpicdn.net/img/view/2019/8/24/2125959.png,0,0.996908844,450,411,1674,1635,1224,1224,twilight sparkle
2126316.png,https://derpicdn.net/img/view/2019/8/24/2126316.png,0,0.962731004,162,0,1034,851,872,851,twilight sparkle
2129994.png,https://derpicdn.net/img/view/2019/8/28/2129994.png,0,0.995261371,19,217,235,433,216,216,twilight sparkle
2129994.png,https://derpicdn.net/img/view/2019/8/28/2129994.png,1,0.948187113,216,253,386,423,170,170,twilight sparkle
2130074.png,https://derpicdn.net/img/view/2019/8/28/2130074.png,0,0.99057591,1940,130,3102,1292,1162,1162,twilight sparkle
2130080.png,https://derpicdn.net/img/view/2019/8/28/2130080.png,0,0.988287985,1933,125,3109,1301,1176,1176,twilight sparkle
2135623.png,https://derpicdn.net/img/view/2019/9/3/2135623.png,0,0.983834207,984,629,2184,1829,1200,1200,twilight sparkle
2137925.png,https://derpicdn.net/img/view/2019/9/6/2137925.png,0,0.946679175,50,0,626,560,576,560,twilight sparkle
2138007.png,https://derpicdn.net/img/view/2019/9/6/2138007.png,0,0.981609762,0,0,346,385,346,385,twilight sparkle
2138154.png,https://derpicdn.net/img/view/2019/9/7/2138154.png,0,0.986287057,0,0,461,522,461,522,twilight sparkle
2141014.png,https://derpicdn.net/img/view/2019/9/10/2141014.png,0,0.946880341,22,5,202,185,180,180,twilight sparkle
2142353.png,https://derpicdn.net/img/view/2019/9/12/2142353.png,0,0.977357924,0,13,545,607,545,594,twilight sparkle
2143821.png,https://derpicdn.net/img/view/2019/9/14/2143821.png,1,0.951750815,1050,603,1666,1219,616,616,twilight sparkle
2143877.png,https://derpicdn.net/img/view/2019/9/14/2143877.png,0,0.947098494,10,53,3162,3205,3152,3152,twilight sparkle
2144013.png,https://derpicdn.net/img/view/2019/9/14/2144013.png,0,0.99906075,432,0,876,432,444,432,twilight sparkle
2144072.png,https://derpicdn.net/img/view/2019/9/14/2144072.png,0,0.967676103,3605,414,6919,3728,3314,3314,twilight sparkle
2144073.png,https://derpicdn.net/img/view/2019/9/14/2144073.png,0,0.955794394,13,152,3117,3256,3104,3104,twilight sparkle
2144161.png,https://derpicdn.net/img/view/2019/9/14/2144161.png,0,0.998902142,777,170,3647,3040,2870,2870,twilight sparkle
2144203.png,https://derpicdn.net/img/view/2019/9/14/2144203.png,0,0.916299522,985,70,4029,3114,3044,3044,twilight sparkle
2147470.png,https://derpicdn.net/img/view/2019/9/19/2147470.png,0,0.966906071,747,73,2401,1727,1654,1654,twilight sparkle
2148623.png,https://derpicdn.net/img/view/2019/9/20/2148623.png,0,0.989174962,328,81,620,373,292,292,twilight sparkle
2150112.png,https://derpicdn.net/img/view/2019/9/22/2150112.png,0,0.981749415,185,0,563,377,378,377,twilight sparkle
2152219.png,https://derpicdn.net/img/view/2019/9/24/2152219.png,0,0.997765779,464,253,948,737,484,484,twilight sparkle
2157483.png,https://derpicdn.net/img/view/2019/10/1/2157483.png,0,0.936950743,479,119,3577,3217,3098,3098,twilight sparkle
215795.png,https://derpicdn.net/img/view/2013/1/18/215795.png,0,0.951211154,83,25,705,612,622,587,twilight sparkle
2162070.png,https://derpicdn.net/img/view/2019/10/6/2162070.png,1,0.957476974,632,175,858,401,226,226,twilight sparkle
2163152.png,https://derpicdn.net/img/view/2019/10/8/2163152.png,0,0.998823345,928,446,2308,1826,1380,1380,twilight sparkle
2165652.png,https://derpicdn.net/img/view/2019/10/11/2165652.png,0,0.964225948,547,0,1453,832,906,832,twilight sparkle
2166832.png,https://derpicdn.net/img/view/2019/10/13/2166832.png,0,0.99669987,161,197,1903,1939,1742,1742,twilight sparkle
2167748.png,https://derpicdn.net/img/view/2019/10/13/2167748.png,0,0.987258613,239,152,759,672,520,520,twilight sparkle
2169232.png,https://derpicdn.net/img/view/2019/10/15/2169232.png,0,0.986257315,0,38,725,940,725,902,twilight sparkle
2169235.png,https://derpicdn.net/img/view/2019/10/15/2169235.png,0,0.970590174,14,57,841,897,827,840,twilight sparkle
2171556.png,https://derpicdn.net/img/view/2019/10/17/2171556.png,0,0.964120865,11,0,594,622,583,622,twilight sparkle
2173770.png,https://derpicdn.net/img/view/2019/10/19/2173770.png,0,0.976831675,413,7,905,499,492,492,twilight sparkle
2174212.png,https://derpicdn.net/img/view/2019/10/20/2174212.png,0,0.974665046,256,478,708,930,452,452,twilight sparkle
2178043.png,https://derpicdn.net/img/view/2019/10/24/2178043.png,0,0.934653878,118,0,1008,847,890,847,twilight sparkle
2178354.png,https://derpicdn.net/img/view/2019/10/25/2178354.png,0,0.951041102,303,147,597,441,294,294,twilight sparkle
2179588.png,https://derpicdn.net/img/view/2019/10/26/2179588.png,0,0.987848997,24,0,928,861,904,861,twilight sparkle
2180105.png,https://derpicdn.net/img/view/2019/10/27/2180105.png,0,0.997175694,166,2630,656,3120,490,490,twilight sparkle
2180105.png,https://derpicdn.net/img/view/2019/10/27/2180105.png,1,0.99626708,0,1702,859,2744,859,1042,twilight sparkle
2180105.png,https://derpicdn.net/img/view/2019/10/27/2180105.png,2,0.988947213,0,477,868,1385,868,908,twilight sparkle
2180105.png,https://derpicdn.net/img/view/2019/10/27/2180105.png,3,0.977769732,939,1854,1787,2702,848,848,twilight sparkle
2180105.png,https://derpicdn.net/img/view/2019/10/27/2180105.png,4,0.976220965,1918,160,2480,822,562,662,twilight sparkle
2183173.png,https://derpicdn.net/img/view/2019/10/30/2183173.png,0,0.944439411,336,87,936,687,600,600,twilight sparkle
2183781.png,https://derpicdn.net/img/view/2019/10/31/2183781.png,0,0.983166575,175,0,1499,1320,1324,1320,twilight sparkle
2185960.png,https://derpicdn.net/img/view/2019/11/2/2185960.png,0,0.96256572,0,0,182,178,182,178,twilight sparkle
2186549.png,https://derpicdn.net/img/view/2019/11/3/2186549.png,0,0.997131765,0,552,781,1344,781,792,twilight sparkle
2186549.png,https://derpicdn.net/img/view/2019/11/3/2186549.png,1,0.972262502,696,547,1528,1379,832,832,twilight sparkle
2188316.png,https://derpicdn.net/img/view/2019/11/5/2188316.png,0,0.993623435,158,0,626,454,468,454,twilight sparkle
2189063.png,https://derpicdn.net/img/view/2019/11/6/2189063.png,0,0.999232352,989,0,2027,982,1038,982,twilight sparkle
2189063.png,https://derpicdn.net/img/view/2019/11/6/2189063.png,1,0.992024601,2027,1574,2477,2024,450,450,twilight sparkle
2194170.png,https://derpicdn.net/img/view/2019/11/12/2194170.png,0,0.98585093,289,111,593,415,304,304,twilight sparkle
2194304.png,https://derpicdn.net/img/view/2019/11/13/2194304.png,0,0.995954454,0,0,748,673,748,673,twilight sparkle
2195324.png,https://derpicdn.net/img/view/2019/11/14/2195324.png,0,0.911438942,792,205,1356,769,564,564,twilight sparkle
2196343.png,https://derpicdn.net/img/view/2019/11/15/2196343.png,0,0.997814298,816,185,1556,925,740,740,twilight sparkle
2196343.png,https://derpicdn.net/img/view/2019/11/15/2196343.png,1,0.971419811,239,207,871,839,632,632,twilight sparkle
2197834.png,https://derpicdn.net/img/view/2019/11/16/2197834.png,0,0.982774258,0,0,759,766,759,766,twilight sparkle
2197834.png,https://derpicdn.net/img/view/2019/11/16/2197834.png,1,0.918666959,196,31,952,787,756,756,twilight sparkle
2197838.png,https://derpicdn.net/img/view/2019/11/16/2197838.png,0,0.992207289,0,0,631,656,631,656,twilight sparkle
219789.png,https://derpicdn.net/img/view/2013/1/21/219789.png,0,0.997823179,70,5,334,269,264,264,twilight sparkle
2200487.png,https://derpicdn.net/img/view/2019/11/19/2200487.png,0,0.995502591,33,42,373,382,340,340,twilight sparkle
2200490.png,https://derpicdn.net/img/view/2019/11/19/2200490.png,0,0.97514528,0,0,717,755,717,755,twilight sparkle
2202259.png,https://derpicdn.net/img/view/2019/11/21/2202259.png,0,0.972089112,0,102,634,736,634,634,twilight sparkle
2203160.png,https://derpicdn.net/img/view/2019/11/23/2203160.png,0,0.939391851,513,908,3869,3915,3356,3007,twilight sparkle
2205806.png,https://derpicdn.net/img/view/2019/11/26/2205806.png,0,0.955092311,108,27,512,455,404,428,twilight sparkle
2207243.png,https://derpicdn.net/img/view/2019/11/27/2207243.png,0,0.96629107,381,154,1345,1128,964,974,twilight sparkle
22092.jpg,https://derpicdn.net/img/view/2012/6/26/22092.jpg,0,0.958455026,80,3,558,503,478,500,twilight sparkle
2211998.png,https://derpicdn.net/img/view/2019/12/4/2211998.png,0,0.94276762,0,45,608,757,608,712,twilight sparkle
221497.jpg,https://derpicdn.net/img/view/2013/1/23/221497.jpg,0,0.958593607,500,12,800,342,300,330,twilight sparkle
2217553.png,https://derpicdn.net/img/view/2019/12/10/2217553.png,0,0.936364174,33,0,900,961,867,961,twilight sparkle
2217656.png,https://derpicdn.net/img/view/2019/12/10/2217656.png,0,0.979605556,399,53,915,569,516,516,twilight sparkle
22210.jpg,https://derpicdn.net/img/view/2012/6/26/22210.jpg,0,0.998502254,445,0,905,443,460,443,twilight sparkle
2221664.png,https://derpicdn.net/img/view/2019/12/15/2221664.png,0,0.991485298,13,0,673,603,660,603,twilight sparkle
2221743.png,https://derpicdn.net/img/view/2019/12/16/2221743.png,0,0.910222232,0,10,654,734,654,724,twilight sparkle
2221765.png,https://derpicdn.net/img/view/2019/12/16/2221765.png,0,0.960389078,204,0,1120,765,916,765,twilight sparkle
2222505.png,https://derpicdn.net/img/view/2019/12/16/2222505.png,0,0.981673837,0,47,823,1059,823,1012,twilight sparkle
2226472.png,https://derpicdn.net/img/view/2019/12/21/2226472.png,0,0.996486068,132,46,520,434,388,388,twilight sparkle
2229564.png,https://derpicdn.net/img/view/2019/12/25/2229564.png,0,0.994021297,182,27,806,651,624,624,twilight sparkle
2232051.png,https://derpicdn.net/img/view/2019/12/28/2232051.png,0,0.94350636,0,0,197,199,197,199,twilight sparkle
2232558.png,https://derpicdn.net/img/view/2019/12/29/2232558.png,0,0.97516185,0,85,738,873,738,788,twilight sparkle
223366.jpg,https://derpicdn.net/img/view/2013/1/25/223366.jpg,0,0.973193824,40,0,436,375,396,375,twilight sparkle
2238602.jpg,https://derpicdn.net/img/view/2020/1/4/2238602.jpg,0,0.986480176,810,1077,1124,1391,314,314,twilight sparkle
2240750.png,https://derpicdn.net/img/view/2020/1/7/2240750.png,0,0.98893851,145,0,1330,939,1185,939,twilight sparkle
2240751.png,https://derpicdn.net/img/view/2020/1/7/2240751.png,0,0.98002857,147,0,744,601,597,601,twilight sparkle
2246952.png,https://derpicdn.net/img/view/2020/1/14/2246952.png,0,0.997332215,197,0,737,514,540,514,twilight sparkle
2248405.png,https://derpicdn.net/img/view/2020/1/15/2248405.png,0,0.991337657,2,0,446,398,444,398,twilight sparkle
2249080.png,https://derpicdn.net/img/view/2020/1/16/2249080.png,0,0.96491456,346,0,1636,1220,1290,1220,twilight sparkle
2249126.png,https://derpicdn.net/img/view/2020/1/16/2249126.png,0,0.995485127,220,0,756,501,536,501,twilight sparkle
2251457.png,https://derpicdn.net/img/view/2020/1/19/2251457.png,0,0.993792355,59,0,675,560,616,560,twilight sparkle
2255976.png,https://derpicdn.net/img/view/2020/1/24/2255976.png,0,0.977634728,0,0,717,754,717,754,twilight sparkle
2262371.png,https://derpicdn.net/img/view/2020/2/1/2262371.png,0,0.960674942,83,108,899,924,816,816,twilight sparkle
2262943.png,https://derpicdn.net/img/view/2020/2/1/2262943.png,0,0.969261527,0,19,581,605,581,586,twilight sparkle
2262944.png,https://derpicdn.net/img/view/2020/2/1/2262944.png,0,0.989434898,26,0,814,753,788,753,twilight sparkle
2264718.jpg,https://derpicdn.net/img/view/2020/2/3/2264718.jpg,0,0.998912454,223,101,487,365,264,264,twilight sparkle
2268925.png,https://derpicdn.net/img/view/2020/2/8/2268925.png,0,0.990168869,0,38,751,852,751,814,twilight sparkle
2268973.png,https://derpicdn.net/img/view/2020/2/8/2268973.png,0,0.980507135,119,34,904,854,785,820,twilight sparkle
2268976.png,https://derpicdn.net/img/view/2020/2/8/2268976.png,0,0.960695624,96,10,334,248,238,238,twilight sparkle
2269329.png,https://derpicdn.net/img/view/2020/2/9/2269329.png,0,0.995743752,155,81,523,449,368,368,twilight sparkle
2269608.png,https://derpicdn.net/img/view/2020/2/9/2269608.png,1,0.984510124,1223,606,2393,1776,1170,1170,twilight sparkle
2269934.png,https://derpicdn.net/img/view/2020/2/9/2269934.png,0,0.986742079,222,65,686,529,464,464,twilight sparkle
2270183.png,https://derpicdn.net/img/view/2020/2/10/2270183.png,0,0.977142036,20,0,928,861,908,861,twilight sparkle
2270951.png,https://derpicdn.net/img/view/2020/2/11/2270951.png,0,0.901991427,464,49,1226,811,762,762,twilight sparkle
2271084.png,https://derpicdn.net/img/view/2020/2/11/2271084.png,0,0.967479229,113,32,565,484,452,452,twilight sparkle
227271.png,https://derpicdn.net/img/view/2013/1/29/227271.png,0,0.981489778,266,0,500,250,234,250,twilight sparkle
2273245.png,https://derpicdn.net/img/view/2020/2/13/2273245.png,0,0.963081181,239,0,1000,814,761,814,twilight sparkle
2276525.png,https://derpicdn.net/img/view/2020/2/17/2276525.png,0,0.982400239,0,0,621,766,621,766,twilight sparkle
2276525.png,https://derpicdn.net/img/view/2020/2/17/2276525.png,1,0.979026794,0,0,621,856,621,856,twilight sparkle
2276527.png,https://derpicdn.net/img/view/2020/2/17/2276527.png,0,0.988723814,0,0,662,841,662,841,twilight sparkle
2276543.png,https://derpicdn.net/img/view/2020/2/17/2276543.png,0,0.993425608,16,0,682,637,666,637,twilight sparkle
2277032.jpg,https://derpicdn.net/img/view/2020/2/17/2277032.jpg,1,0.92979449,526,23,934,431,408,408,twilight sparkle
227811.png,https://derpicdn.net/img/view/2013/1/30/227811.png,0,0.950465798,22,0,228,200,206,200,twilight sparkle
2281155.png,https://derpicdn.net/img/view/2020/2/22/2281155.png,0,0.988587737,326,124,812,610,486,486,twilight sparkle
2281946.png,https://derpicdn.net/img/view/2020/2/23/2281946.png,0,0.93341428,658,264,1020,626,362,362,twilight sparkle
2283236.png,https://derpicdn.net/img/view/2020/2/25/2283236.png,0,0.985965669,542,0,974,432,432,432,twilight sparkle
2283979.jpg,https://derpicdn.net/img/view/2020/2/26/2283979.jpg,0,0.945251584,221,34,717,606,496,572,twilight sparkle
2284333.png,https://derpicdn.net/img/view/2020/2/26/2284333.png,0,0.965006351,610,0,1506,671,896,671,twilight sparkle
2285740.png,https://derpicdn.net/img/view/2020/2/28/2285740.png,0,0.983678639,1804,276,2558,1030,754,754,twilight sparkle
2286380.jpg,https://derpicdn.net/img/view/2020/2/29/2286380.jpg,0,0.999446273,353,50,821,518,468,468,twilight sparkle
2286416.png,https://derpicdn.net/img/view/2020/2/29/2286416.png,0,0.902874351,62,0,425,425,363,425,twilight sparkle
228692.png,https://derpicdn.net/img/view/2013/1/30/228692.png,0,0.993768334,547,216,893,562,346,346,twilight sparkle
2288084.png,https://derpicdn.net/img/view/2020/3/2/2288084.png,0,0.985757232,0,100,286,396,286,296,twilight sparkle
2288270.jpg,https://derpicdn.net/img/view/2020/3/2/2288270.jpg,1,0.984763563,367,62,625,320,258,258,twilight sparkle
2288270.jpg,https://derpicdn.net/img/view/2020/3/2/2288270.jpg,2,0.96957767,447,259,669,481,222,222,twilight sparkle
2291913.png,https://derpicdn.net/img/view/2020/3/7/2291913.png,0,0.92375952,174,0,1426,1060,1252,1060,twilight sparkle
2293259.png,https://derpicdn.net/img/view/2020/3/9/2293259.png,0,0.97811377,37,0,803,691,766,691,twilight sparkle
2293628.png,https://derpicdn.net/img/view/2020/3/9/2293628.png,0,0.968921542,503,970,857,1324,354,354,twilight sparkle
2293746.jpg,https://derpicdn.net/img/view/2020/3/9/2293746.jpg,0,0.969680011,1593,1462,2480,2508,887,1046,twilight sparkle
2293746.jpg,https://derpicdn.net/img/view/2020/3/9/2293746.jpg,1,0.953454196,291,14,1547,1270,1256,1256,twilight sparkle
2293877.png,https://derpicdn.net/img/view/2020/3/9/2293877.png,0,0.986748934,630,629,966,965,336,336,twilight sparkle
2294332.png,https://derpicdn.net/img/view/2020/3/10/2294332.png,0,0.998481929,455,0,994,564,539,564,twilight sparkle
2294775.png,https://derpicdn.net/img/view/2020/3/11/2294775.png,0,0.9763304,186,91,638,543,452,452,twilight sparkle
2294782.png,https://derpicdn.net/img/view/2020/3/11/2294782.png,0,0.998739183,56,175,478,597,422,422,twilight sparkle
2295547.png,https://derpicdn.net/img/view/2020/3/12/2295547.png,0,0.9754951,338,0,1090,645,752,645,twilight sparkle
2295800.jpg,https://derpicdn.net/img/view/2020/3/12/2295800.jpg,0,0.922636509,0,0,1550,1441,1550,1441,twilight sparkle
2298387.png,https://derpicdn.net/img/view/2020/3/15/2298387.png,0,0.994289935,68,32,946,910,878,878,twilight sparkle
2298853.jpg,https://derpicdn.net/img/view/2020/3/16/2298853.jpg,0,0.980556369,374,40,836,502,462,462,twilight sparkle
2299381.png,https://derpicdn.net/img/view/2020/3/17/2299381.png,0,0.966483235,0,471,578,1133,578,662,twilight sparkle
2303562.png,https://derpicdn.net/img/view/2020/3/22/2303562.png,0,0.995749831,511,0,711,181,200,181,twilight sparkle
2303562.png,https://derpicdn.net/img/view/2020/3/22/2303562.png,1,0.994792461,171,0,405,196,234,196,twilight sparkle
2304778.png,https://derpicdn.net/img/view/2020/3/24/2304778.png,0,0.989922762,1334,1221,1964,1851,630,630,twilight sparkle
2305038.png,https://derpicdn.net/img/view/2020/3/24/2305038.png,0,0.900958359,102,0,1120,974,1018,974,twilight sparkle
2305052.png,https://derpicdn.net/img/view/2020/3/24/2305052.png,0,0.932538509,77,36,611,570,534,534,twilight sparkle
2306737.png,https://derpicdn.net/img/view/2020/3/26/2306737.png,0,0.979011118,0,0,3942,3584,3942,3584,twilight sparkle
2307106.jpg,https://derpicdn.net/img/view/2020/3/27/2307106.jpg,0,0.985513031,1099,364,1689,954,590,590,twilight sparkle
2307975.png,https://derpicdn.net/img/view/2020/3/28/2307975.png,0,0.962573946,0,0,3643,3817,3643,3817,twilight sparkle
2308175.png,https://derpicdn.net/img/view/2020/3/28/2308175.png,0,0.948582351,107,355,3577,3825,3470,3470,twilight sparkle
2308399.png,https://derpicdn.net/img/view/2020/3/28/2308399.png,0,0.91321975,435,234,1680,1506,1245,1272,twilight sparkle
2308917.png,https://derpicdn.net/img/view/2020/3/29/2308917.png,0,0.908566296,2092,97,5684,3689,3592,3592,twilight sparkle
2310100.png,https://derpicdn.net/img/view/2020/3/30/2310100.png,0,0.997037828,172,0,570,383,398,383,twilight sparkle
2311514.png,https://derpicdn.net/img/view/2020/4/1/2311514.png,0,0.985496998,0,26,459,550,459,524,twilight sparkle
2311515.png,https://derpicdn.net/img/view/2020/4/1/2311515.png,0,0.979521275,0,32,509,604,509,572,twilight sparkle
2312803.png,https://derpicdn.net/img/view/2020/4/3/2312803.png,0,0.998544157,160,55,630,525,470,470,twilight sparkle
2313944.png,https://derpicdn.net/img/view/2020/4/4/2313944.png,0,0.999632716,120,23,576,479,456,456,twilight sparkle
2313944.png,https://derpicdn.net/img/view/2020/4/4/2313944.png,1,0.993170559,1227,0,1951,614,724,614,twilight sparkle
2314061.png,https://derpicdn.net/img/view/2020/4/4/2314061.png,0,0.995350361,0,0,467,463,467,463,twilight sparkle
2319386.png,https://derpicdn.net/img/view/2020/4/11/2319386.png,0,0.982525885,881,33,1513,665,632,632,twilight sparkle
2319386.png,https://derpicdn.net/img/view/2020/4/11/2319386.png,1,0.946523964,349,57,1045,753,696,696,twilight sparkle
2320361.jpg,https://derpicdn.net/img/view/2020/4/12/2320361.jpg,0,0.993359745,394,76,1258,940,864,864,twilight sparkle
2321686.png,https://derpicdn.net/img/view/2020/4/13/2321686.png,0,0.977683187,57,101,885,929,828,828,twilight sparkle
2322048.jpg,https://derpicdn.net/img/view/2020/4/14/2322048.jpg,0,0.995990217,508,0,786,256,278,256,twilight sparkle
2324258.jpg,https://derpicdn.net/img/view/2020/4/16/2324258.jpg,0,0.995653689,91,15,439,363,348,348,twilight sparkle
2324306.png,https://derpicdn.net/img/view/2020/4/17/2324306.png,0,0.927500606,177,0,1491,1251,1314,1251,twilight sparkle
2326497.png,https://derpicdn.net/img/view/2020/4/19/2326497.png,0,0.983703613,1,0,859,733,858,733,twilight sparkle
2326502.png,https://derpicdn.net/img/view/2020/4/19/2326502.png,0,0.996357739,0,0,388,404,388,404,twilight sparkle
232685.png,https://derpicdn.net/img/view/2013/2/3/232685.png,0,0.950100839,2818,210,5841,3236,3023,3026,twilight sparkle
2327498.jpg,https://derpicdn.net/img/view/2020/4/20/2327498.jpg,0,0.905200124,450,457,1052,1059,602,602,twilight sparkle
2327685.png,https://derpicdn.net/img/view/2020/4/21/2327685.png,0,0.99021244,184,0,3794,3379,3610,3379,twilight sparkle
2328254.png,https://derpicdn.net/img/view/2020/4/21/2328254.png,0,0.963105023,50,0,601,614,551,614,twilight sparkle
2330994.jpg,https://derpicdn.net/img/view/2020/4/25/2330994.jpg,0,0.9991436,497,293,1103,899,606,606,twilight sparkle
2331980.png,https://derpicdn.net/img/view/2020/4/26/2331980.png,0,0.954282165,902,260,1308,666,406,406,twilight sparkle
2331980.png,https://derpicdn.net/img/view/2020/4/26/2331980.png,1,0.950162768,0,98,474,588,474,490,twilight sparkle
2332039.png,https://derpicdn.net/img/view/2020/4/26/2332039.png,0,0.99537766,98,0,662,529,564,529,twilight sparkle
2333222.png,https://derpicdn.net/img/view/2020/4/27/2333222.png,0,0.972930431,25,7,527,509,502,502,twilight sparkle
2334403.png,https://derpicdn.net/img/view/2020/4/29/2334403.png,0,0.956385612,188,0,1688,1080,1500,1080,twilight sparkle
2336364.jpg,https://derpicdn.net/img/view/2020/5/1/2336364.jpg,0,0.970505416,21,70,441,490,420,420,twilight sparkle
2338115.jpg,https://derpicdn.net/img/view/2020/5/3/2338115.jpg,0,0.999795616,328,148,704,524,376,376,twilight sparkle
2338115.jpg,https://derpicdn.net/img/view/2020/5/3/2338115.jpg,1,0.999075413,605,485,851,731,246,246,twilight sparkle
2339496.png,https://derpicdn.net/img/view/2020/5/4/2339496.png,0,0.986778021,209,0,689,475,480,475,twilight sparkle
2341613.png,https://derpicdn.net/img/view/2020/5/7/2341613.png,0,0.999052465,473,65,759,351,286,286,twilight sparkle
2344733.png,https://derpicdn.net/img/view/2020/5/10/2344733.png,0,0.983243465,36,20,466,450,430,430,twilight sparkle
2344735.png,https://derpicdn.net/img/view/2020/5/10/2344735.png,0,0.965143383,24,99,854,937,830,838,twilight sparkle
2348440.png,https://derpicdn.net/img/view/2020/5/14/2348440.png,0,0.998740911,252,179,528,455,276,276,twilight sparkle
2349011.png,https://derpicdn.net/img/view/2020/5/15/2349011.png,0,0.990182161,0,0,410,417,410,417,twilight sparkle
2349830.png,https://derpicdn.net/img/view/2020/5/16/2349830.png,0,0.98661536,0,4,446,466,446,462,twilight sparkle
2349832.png,https://derpicdn.net/img/view/2020/5/16/2349832.png,0,0.985698819,101,0,807,620,706,620,twilight sparkle
235063.jpg,https://derpicdn.net/img/view/2013/2/6/235063.jpg,0,0.998059154,277,9,625,357,348,348,twilight sparkle
2350883.jpg,https://derpicdn.net/img/view/2020/5/17/2350883.jpg,0,0.989119053,0,349,2466,2985,2466,2636,twilight sparkle
2352554.png,https://derpicdn.net/img/view/2020/5/19/2352554.png,0,0.974971712,89,0,933,701,844,701,twilight sparkle
2353160.jpg,https://derpicdn.net/img/view/2020/5/20/2353160.jpg,0,0.970307767,58,18,396,356,338,338,twilight sparkle
2353575.png,https://derpicdn.net/img/view/2020/5/20/2353575.png,0,0.970146954,435,434,1191,1190,756,756,twilight sparkle
2353575.png,https://derpicdn.net/img/view/2020/5/20/2353575.png,1,0.905420303,1661,556,2299,1194,638,638,twilight sparkle
2353642.jpg,https://derpicdn.net/img/view/2020/5/20/2353642.jpg,0,0.998946905,995,387,1867,1259,872,872,twilight sparkle
2354678.jpg,https://derpicdn.net/img/view/2020/5/21/2354678.jpg,0,0.906526446,0,0,798,730,798,730,twilight sparkle
2354693.jpg,https://derpicdn.net/img/view/2020/5/21/2354693.jpg,0,0.985802472,0,127,2900,3177,2900,3050,twilight sparkle
2355130.jpg,https://derpicdn.net/img/view/2020/5/22/2355130.jpg,0,0.988565385,913,897,1805,1789,892,892,twilight sparkle
2355241.png,https://derpicdn.net/img/view/2020/5/22/2355241.png,0,0.913389146,251,0,1727,1429,1476,1429,twilight sparkle
235537.png,https://derpicdn.net/img/view/2013/2/6/235537.png,0,0.999447942,270,0,1682,1340,1412,1340,twilight sparkle
237866.png,https://derpicdn.net/img/view/2013/2/9/237866.png,0,0.960147917,88,214,662,788,574,574,twilight sparkle
245116.png,https://derpicdn.net/img/view/2013/2/16/245116.png,0,0.962522805,33,57,253,277,220,220,twilight sparkle
245936.png,https://derpicdn.net/img/view/2013/2/16/245936.png,0,0.971767068,122,188,618,684,496,496,twilight sparkle
245949.png,https://derpicdn.net/img/view/2013/2/16/245949.png,0,0.963080764,362,0,2492,1440,2130,1440,twilight sparkle
246005.png,https://derpicdn.net/img/view/2013/2/17/246005.png,0,0.924748302,461,57,1779,1375,1318,1318,twilight sparkle
246042.png,https://derpicdn.net/img/view/2013/2/17/246042.png,0,0.992655098,768,182,2062,1476,1294,1294,twilight sparkle
246380.png,https://derpicdn.net/img/view/2013/2/17/246380.png,0,0.985987067,663,122,1509,968,846,846,twilight sparkle
247227.png,https://derpicdn.net/img/view/2013/2/18/247227.png,0,0.975188911,162,27,484,349,322,322,twilight sparkle
250489.png,https://derpicdn.net/img/view/2013/2/21/250489.png,0,0.996448934,440,171,864,595,424,424,twilight sparkle
253716.png,https://derpicdn.net/img/view/2013/2/24/253716.png,0,0.963617623,0,118,293,444,293,326,twilight sparkle
254017.png,https://derpicdn.net/img/view/2013/2/24/254017.png,0,0.977561712,289,114,663,488,374,374,twilight sparkle
255353.png,https://derpicdn.net/img/view/2013/2/25/255353.png,0,0.995683432,540,210,1334,1004,794,794,twilight sparkle
255415.png,https://derpicdn.net/img/view/2013/2/25/255415.png,0,0.937688231,314,33,1040,759,726,726,twilight sparkle
256048.png,https://derpicdn.net/img/view/2013/2/26/256048.png,0,0.993543506,1697,430,2845,1578,1148,1148,twilight sparkle
261209.png,https://derpicdn.net/img/view/2013/3/3/261209.png,0,0.957964063,229,34,566,386,337,352,twilight sparkle
261685.jpg,https://derpicdn.net/img/view/2013/3/3/261685.jpg,0,0.977211595,0,16,261,277,261,261,twilight sparkle
261685.jpg,https://derpicdn.net/img/view/2013/3/3/261685.jpg,1,0.925316453,46,0,288,221,242,221,twilight sparkle
262653.png,https://derpicdn.net/img/view/2013/3/4/262653.png,0,0.984924018,2193,80,5999,3886,3806,3806,twilight sparkle
263138.png,https://derpicdn.net/img/view/2013/3/5/263138.png,0,0.988593876,897,0,1635,708,738,708,twilight sparkle
263558.png,https://derpicdn.net/img/view/2013/3/5/263558.png,0,0.98567462,200,253,562,615,362,362,twilight sparkle
265625.png,https://derpicdn.net/img/view/2013/3/8/265625.png,0,0.96809864,0,0,424,457,424,457,twilight sparkle
266238.png,https://derpicdn.net/img/view/2013/3/9/266238.png,0,0.998963237,406,222,694,510,288,288,twilight sparkle
266743.png,https://derpicdn.net/img/view/2013/3/9/266743.png,0,0.970773697,686,152,1038,504,352,352,twilight sparkle
2698.png,https://derpicdn.net/img/view/2012/1/29/2698.png,0,0.981445968,237,72,755,590,518,518,twilight sparkle
274829.png,https://derpicdn.net/img/view/2013/3/20/274829.png,0,0.933412373,206,0,508,268,302,268,twilight sparkle
275774.png,https://derpicdn.net/img/view/2013/3/21/275774.png,0,0.996596515,0,100,522,644,522,544,twilight sparkle
278152.png,https://derpicdn.net/img/view/2013/3/24/278152.png,0,0.911359191,60,2,284,226,224,224,twilight sparkle
279363.png,https://derpicdn.net/img/view/2013/3/25/279363.png,0,0.988305628,667,188,1115,636,448,448,twilight sparkle
286794.png,https://derpicdn.net/img/view/2013/4/3/286794.png,0,0.995126188,338,0,760,392,422,392,twilight sparkle
2890.png,https://derpicdn.net/img/view/2012/2/2/2890.png,0,0.974906027,451,1,1024,601,573,600,twilight sparkle
289719.png,https://derpicdn.net/img/view/2013/4/6/289719.png,0,0.973997712,479,99,911,531,432,432,twilight sparkle
290166.png,https://derpicdn.net/img/view/2013/4/6/290166.png,0,0.974160373,0,117,2751,2973,2751,2856,twilight sparkle
292775.jpg,https://derpicdn.net/img/view/2013/4/9/292775.jpg,0,0.995767355,201,23,473,295,272,272,twilight sparkle
294268.png,https://derpicdn.net/img/view/2013/4/11/294268.png,0,0.955703139,1389,34,2607,1252,1218,1218,twilight sparkle
295899.png,https://derpicdn.net/img/view/2013/4/12/295899.png,0,0.96740526,23,18,250,250,227,232,twilight sparkle
299959.png,https://derpicdn.net/img/view/2013/4/16/299959.png,0,0.991487861,215,0,597,381,382,381,twilight sparkle
3042.jpg,https://derpicdn.net/img/view/2012/2/15/3042.jpg,0,0.990560651,27,0,631,538,604,538,twilight sparkle
310092.png,https://derpicdn.net/img/view/2013/4/27/310092.png,0,0.974482238,80,20,586,526,506,506,twilight sparkle
310317.png,https://derpicdn.net/img/view/2013/4/28/310317.png,0,0.952920914,0,0,2633,2789,2633,2789,twilight sparkle
31736.jpg,https://derpicdn.net/img/view/2012/7/4/31736.jpg,0,0.990353465,268,214,582,528,314,314,twilight sparkle
320327.jpg,https://derpicdn.net/img/view/2013/5/9/320327.jpg,0,0.950437903,485,142,819,476,334,334,twilight sparkle
320668.png,https://derpicdn.net/img/view/2013/5/9/320668.png,0,0.936346412,615,0,1545,909,930,909,twilight sparkle
326511.png,https://derpicdn.net/img/view/2013/5/16/326511.png,0,0.989098251,0,0,2312,2168,2312,2168,twilight sparkle
330357.png,https://derpicdn.net/img/view/2013/5/21/330357.png,0,0.99908793,197,0,555,343,358,343,twilight sparkle
33987.jpg,https://derpicdn.net/img/view/2012/7/6/33987.jpg,0,0.997768164,316,0,762,422,446,422,twilight sparkle
34584.jpg,https://derpicdn.net/img/view/2012/7/6/34584.jpg,0,0.900480449,106,127,758,779,652,652,twilight sparkle
349692.png,https://derpicdn.net/img/view/2013/6/16/349692.png,0,0.999424279,242,2,572,332,330,330,twilight sparkle
349771.png,https://derpicdn.net/img/view/2013/6/16/349771.png,0,0.973051429,0,29,612,665,612,636,twilight sparkle
353644.jpg,https://derpicdn.net/img/view/2013/6/21/353644.jpg,0,0.998906016,0,266,842,1142,842,876,twilight sparkle
356632.jpg,https://derpicdn.net/img/view/2013/6/25/356632.jpg,0,0.992043257,368,140,764,536,396,396,twilight sparkle
3570.jpg,https://derpicdn.net/img/view/2012/2/26/3570.jpg,0,0.937698007,247,46,571,370,324,324,twilight sparkle
357624.jpg,https://derpicdn.net/img/view/2013/6/26/357624.jpg,0,0.999014676,274,17,648,391,374,374,twilight sparkle
358275.png,https://derpicdn.net/img/view/2013/6/27/358275.png,0,0.993014991,19,0,295,276,276,276,twilight sparkle
364174.png,https://derpicdn.net/img/view/2013/7/4/364174.png,0,0.988497198,0,0,3075,2771,3075,2771,twilight sparkle
367089.png,https://derpicdn.net/img/view/2013/7/8/367089.png,0,0.983166754,3524,0,7348,3364,3824,3364,twilight sparkle
36725.png,https://derpicdn.net/img/view/2012/7/8/36725.png,0,0.985554457,489,217,1567,1295,1078,1078,twilight sparkle
367715.png,https://derpicdn.net/img/view/2013/7/8/367715.png,0,0.992477477,406,61,2104,1759,1698,1698,twilight sparkle
37335.png,https://derpicdn.net/img/view/2012/7/8/37335.png,0,0.975963593,1369,296,2015,942,646,646,twilight sparkle
377246.png,https://derpicdn.net/img/view/2013/7/18/377246.png,0,0.905604064,3836,58,6428,2650,2592,2592,twilight sparkle
379196.png,https://derpicdn.net/img/view/2013/7/20/379196.png,0,0.980089784,80,0,402,309,322,309,twilight sparkle
3807.png,https://derpicdn.net/img/view/2012/3/21/3807.png,0,0.992762208,146,0,1284,1130,1138,1130,twilight sparkle
3807.png,https://derpicdn.net/img/view/2012/3/21/3807.png,1,0.982837617,1200,0,2380,1173,1180,1173,twilight sparkle
382933.png,https://derpicdn.net/img/view/2013/7/24/382933.png,0,0.990610063,67,0,1795,1080,1728,1080,twilight sparkle
383120.png,https://derpicdn.net/img/view/2013/7/24/383120.png,0,0.966868997,0,39,298,375,298,336,twilight sparkle
383533.png,https://derpicdn.net/img/view/2013/7/25/383533.png,0,0.998389363,2212,0,4656,2392,2444,2392,twilight sparkle
386026.png,https://derpicdn.net/img/view/2013/7/30/386026.png,0,0.945804715,443,211,705,473,262,262,twilight sparkle
387.png,https://derpicdn.net/img/view/2012/1/15/387.png,0,0.939396322,1774,641,2486,1353,712,712,twilight sparkle
388470.png,https://derpicdn.net/img/view/2013/8/1/388470.png,0,0.985991716,481,132,1329,980,848,848,twilight sparkle
389538.png,https://derpicdn.net/img/view/2013/8/2/389538.png,0,0.993474305,297,59,2000,1835,1703,1776,twilight sparkle
39161.png,https://derpicdn.net/img/view/2012/7/10/39161.png,0,0.942951143,446,225,1702,1481,1256,1256,twilight sparkle
392008.png,https://derpicdn.net/img/view/2013/8/5/392008.png,0,0.998821855,250,0,796,541,546,541,twilight sparkle
394127.png,https://derpicdn.net/img/view/2013/8/7/394127.png,0,0.990732789,781,268,1795,1282,1014,1014,twilight sparkle
394442.png,https://derpicdn.net/img/view/2013/8/8/394442.png,0,0.998694837,506,73,1300,867,794,794,twilight sparkle
398599.jpg,https://derpicdn.net/img/view/2013/8/12/398599.jpg,0,0.989029288,52,3,468,419,416,416,twilight sparkle
400974.png,https://derpicdn.net/img/view/2013/8/15/400974.png,0,0.995199561,1322,0,2602,1161,1280,1161,twilight sparkle
4058.png,https://derpicdn.net/img/view/2012/5/21/4058.png,0,0.990870893,200,1,532,333,332,332,twilight sparkle
407423.jpg,https://derpicdn.net/img/view/2013/8/22/407423.jpg,0,0.969982862,119,114,509,504,390,390,twilight sparkle
410169.png,https://derpicdn.net/img/view/2013/8/25/410169.png,0,0.987413108,0,149,746,967,746,818,twilight sparkle
412530.png,https://derpicdn.net/img/view/2013/8/27/412530.png,0,0.997176409,296,0,986,666,690,666,twilight sparkle
41276.png,https://derpicdn.net/img/view/2012/7/12/41276.png,0,0.979216039,24,0,504,475,480,475,twilight sparkle
414336.png,https://derpicdn.net/img/view/2013/8/30/414336.png,1,0.975863934,244,44,608,408,364,364,twilight sparkle
415288.png,https://derpicdn.net/img/view/2013/8/31/415288.png,0,0.917607903,48,54,590,596,542,542,twilight sparkle
415961.png,https://derpicdn.net/img/view/2013/9/1/415961.png,0,0.998773396,19,0,295,262,276,262,twilight sparkle
416315.png,https://derpicdn.net/img/view/2013/9/1/416315.png,0,0.930882275,87,2,717,632,630,630,twilight sparkle
416899.png,https://derpicdn.net/img/view/2013/9/2/416899.png,0,0.969969571,1443,0,1688,235,245,235,twilight sparkle
418864.png,https://derpicdn.net/img/view/2013/9/4/418864.png,0,0.993865609,0,0,833,822,833,822,twilight sparkle
419125.png,https://derpicdn.net/img/view/2013/9/4/419125.png,0,0.998510897,218,42,660,484,442,442,twilight sparkle
419695.png,https://derpicdn.net/img/view/2013/9/5/419695.png,0,0.988209844,3,0,581,542,578,542,twilight sparkle
420577.png,https://derpicdn.net/img/view/2013/9/6/420577.png,0,0.96210593,0,196,515,728,515,532,twilight sparkle
420577.png,https://derpicdn.net/img/view/2013/9/6/420577.png,1,0.953563452,487,0,979,465,492,465,twilight sparkle
422240.png,https://derpicdn.net/img/view/2013/9/8/422240.png,0,0.963148475,251,15,797,561,546,546,twilight sparkle
423252.png,https://derpicdn.net/img/view/2013/9/9/423252.png,0,0.974913359,271,179,631,539,360,360,twilight sparkle
429995.png,https://derpicdn.net/img/view/2013/9/18/429995.png,0,0.909553707,238,109,510,381,272,272,twilight sparkle
435721.jpg,https://derpicdn.net/img/view/2013/9/26/435721.jpg,0,0.940091968,132,7,453,377,321,370,twilight sparkle
440510.png,https://derpicdn.net/img/view/2013/10/3/440510.png,0,0.964277983,330,2,798,470,468,468,twilight sparkle
441393.png,https://derpicdn.net/img/view/2013/10/4/441393.png,0,0.991046965,578,431,854,707,276,276,twilight sparkle
445275.png,https://derpicdn.net/img/view/2013/10/10/445275.png,0,0.956619263,353,133,557,337,204,204,twilight sparkle
450760.png,https://derpicdn.net/img/view/2013/10/17/450760.png,0,0.974792123,0,0,3074,3653,3074,3653,twilight sparkle
453199.png,https://derpicdn.net/img/view/2013/10/20/453199.png,0,0.934530914,469,243,1035,809,566,566,twilight sparkle
455955.png,https://derpicdn.net/img/view/2013/10/25/455955.png,0,0.998477399,288,626,708,1046,420,420,twilight sparkle
458016.png,https://derpicdn.net/img/view/2013/10/27/458016.png,0,0.975635707,455,0,891,384,436,384,twilight sparkle
468809.png,https://derpicdn.net/img/view/2013/11/10/468809.png,0,0.983031392,555,490,1441,1376,886,886,twilight sparkle
470555.jpg,https://derpicdn.net/img/view/2013/11/12/470555.jpg,0,0.979479671,51,106,635,690,584,584,twilight sparkle
47747.png,https://derpicdn.net/img/view/2012/7/18/47747.png,0,0.976598263,399,190,823,614,424,424,twilight sparkle
478934.png,https://derpicdn.net/img/view/2013/11/23/478934.png,0,0.937505603,218,0,542,305,324,305,twilight sparkle
4792.png,https://derpicdn.net/img/view/2012/6/17/4792.png,0,0.994291842,133,0,553,403,420,403,twilight sparkle
481548.png,https://derpicdn.net/img/view/2013/11/25/481548.png,0,0.999454618,50,0,548,423,498,423,twilight sparkle
481747.jpg,https://derpicdn.net/img/view/2013/11/25/481747.jpg,0,0.950090051,1172,0,1592,388,420,388,twilight sparkle
484298.png,https://derpicdn.net/img/view/2013/11/28/484298.png,0,0.993776143,739,0,1363,614,624,614,twilight sparkle
484871.png,https://derpicdn.net/img/view/2013/11/29/484871.png,0,0.983909249,0,479,323,809,323,330,twilight sparkle
484871.png,https://derpicdn.net/img/view/2013/11/29/484871.png,1,0.983202457,23,23,381,381,358,358,twilight sparkle
487680.png,https://derpicdn.net/img/view/2013/12/2/487680.png,0,0.991539359,57,0,599,535,542,535,twilight sparkle
48837.png,https://derpicdn.net/img/view/2012/7/19/48837.png,0,0.974642336,139,62,585,508,446,446,twilight sparkle
489225.png,https://derpicdn.net/img/view/2013/12/4/489225.png,0,0.922328532,0,564,3066,3820,3066,3256,twilight sparkle
489488.png,https://derpicdn.net/img/view/2013/12/4/489488.png,0,0.97314781,35,55,315,335,280,280,twilight sparkle
491346.png,https://derpicdn.net/img/view/2013/12/7/491346.png,0,0.948582709,1295,289,2219,1213,924,924,twilight sparkle
493087.png,https://derpicdn.net/img/view/2013/12/8/493087.png,0,0.998080909,166,99,558,491,392,392,twilight sparkle
495252.png,https://derpicdn.net/img/view/2013/12/12/495252.png,0,0.935856223,216,119,396,299,180,180,twilight sparkle
497979.png,https://derpicdn.net/img/view/2013/12/15/497979.png,0,0.946145952,4,0,672,612,668,612,twilight sparkle
500313.jpg,https://derpicdn.net/img/view/2013/12/18/500313.jpg,0,0.960153937,429,44,620,254,191,210,twilight sparkle
500313.jpg,https://derpicdn.net/img/view/2013/12/18/500313.jpg,1,0.954774022,0,0,490,413,490,413,twilight sparkle
503546.png,https://derpicdn.net/img/view/2013/12/22/503546.png,0,0.993030488,396,35,696,335,300,300,twilight sparkle
504979.jpg,https://derpicdn.net/img/view/2013/12/24/504979.jpg,0,0.946912289,427,331,921,825,494,494,twilight sparkle
50638.jpg,https://derpicdn.net/img/view/2012/7/20/50638.jpg,0,0.961106598,94,0,440,306,346,306,twilight sparkle
50638.jpg,https://derpicdn.net/img/view/2012/7/20/50638.jpg,1,0.928557456,511,29,857,375,346,346,twilight sparkle
506885.png,https://derpicdn.net/img/view/2013/12/26/506885.png,0,0.959204733,250,138,658,546,408,408,twilight sparkle
506940.png,https://derpicdn.net/img/view/2013/12/26/506940.png,0,0.96459049,18,0,460,438,442,438,twilight sparkle
508547.png,https://derpicdn.net/img/view/2013/12/28/508547.png,0,0.977432907,0,0,718,680,718,680,twilight sparkle
510317.jpg,https://derpicdn.net/img/view/2013/12/30/510317.jpg,0,0.991398692,77,0,1245,1047,1168,1047,twilight sparkle
510829.png,https://derpicdn.net/img/view/2013/12/31/510829.png,0,0.995870411,34,134,368,468,334,334,twilight sparkle
510829.png,https://derpicdn.net/img/view/2013/12/31/510829.png,1,0.945284903,374,101,714,441,340,340,twilight sparkle
511559.png,https://derpicdn.net/img/view/2014/1/1/511559.png,0,0.918665469,1297,116,4239,3058,2942,2942,twilight sparkle
512773.png,https://derpicdn.net/img/view/2014/1/2/512773.png,0,0.962851882,471,0,989,461,518,461,twilight sparkle
514144.png,https://derpicdn.net/img/view/2014/1/3/514144.png,0,0.966668308,54,0,607,568,553,568,twilight sparkle
515546.jpg,https://derpicdn.net/img/view/2014/1/5/515546.jpg,0,0.996885061,329,4,871,546,542,542,twilight sparkle
517766.png,https://derpicdn.net/img/view/2014/1/7/517766.png,0,0.994517803,85,43,507,465,422,422,twilight sparkle
519339.png,https://derpicdn.net/img/view/2014/1/9/519339.png,0,0.990912974,11,0,193,169,182,169,twilight sparkle
519940.png,https://derpicdn.net/img/view/2014/1/9/519940.png,0,0.995404065,0,16,413,458,413,442,twilight sparkle
529.png,https://derpicdn.net/img/view/2012/1/16/529.png,0,0.998771608,2099,0,3929,1744,1830,1744,twilight sparkle
532063.png,https://derpicdn.net/img/view/2014/1/23/532063.png,0,0.901223421,83,0,417,316,334,316,twilight sparkle
532229.png,https://derpicdn.net/img/view/2014/1/23/532229.png,0,0.996272206,382,33,972,623,590,590,twilight sparkle
532438.png,https://derpicdn.net/img/view/2014/1/23/532438.png,0,0.997980237,329,410,881,962,552,552,twilight sparkle
537869.png,https://derpicdn.net/img/view/2014/1/29/537869.png,0,0.996997893,594,0,990,386,396,386,twilight sparkle
538028.png,https://derpicdn.net/img/view/2014/1/29/538028.png,0,0.997548282,503,110,825,432,322,322,twilight sparkle
540.jpg,https://derpicdn.net/img/view/2012/1/16/540.jpg,0,0.998020589,313,183,919,789,606,606,twilight sparkle
544951.jpg,https://derpicdn.net/img/view/2014/2/6/544951.jpg,0,0.989360571,372,0,2884,2000,2512,2000,twilight sparkle
546053.jpg,https://derpicdn.net/img/view/2014/2/7/546053.jpg,0,0.939769626,0,124,879,1034,879,910,twilight sparkle
546053.jpg,https://derpicdn.net/img/view/2014/2/7/546053.jpg,1,0.922769129,687,0,1650,906,963,906,twilight sparkle
546557.png,https://derpicdn.net/img/view/2014/2/8/546557.png,0,0.974168897,225,137,1731,1643,1506,1506,twilight sparkle
556745.png,https://derpicdn.net/img/view/2014/2/20/556745.png,0,0.995274961,759,238,1071,550,312,312,twilight sparkle
556912.png,https://derpicdn.net/img/view/2014/2/20/556912.png,0,0.995626748,3961,854,8957,5930,4996,5076,twilight sparkle
557110.png,https://derpicdn.net/img/view/2014/2/20/557110.png,0,0.950771928,424,5,836,417,412,412,twilight sparkle
559719.png,https://derpicdn.net/img/view/2014/2/23/559719.png,0,0.99878639,2427,12,5451,3036,3024,3024,twilight sparkle
559720.png,https://derpicdn.net/img/view/2014/2/23/559720.png,0,0.984243691,1678,433,5000,4085,3322,3652,twilight sparkle
561963.png,https://derpicdn.net/img/view/2014/2/26/561963.png,0,0.997645795,282,149,926,793,644,644,twilight sparkle
562607.png,https://derpicdn.net/img/view/2014/2/27/562607.png,0,0.999363899,290,58,638,428,348,370,twilight sparkle
565720.png,https://derpicdn.net/img/view/2014/3/3/565720.png,0,0.994453728,394,99,882,587,488,488,twilight sparkle
56657.jpg,https://derpicdn.net/img/view/2012/7/25/56657.jpg,0,0.980819285,454,0,932,472,478,472,twilight sparkle
567447.png,https://derpicdn.net/img/view/2014/3/5/567447.png,0,0.944121718,0,0,1487,1974,1487,1974,twilight sparkle
567585.png,https://derpicdn.net/img/view/2014/3/5/567585.png,0,0.99223429,191,0,3285,3065,3094,3065,twilight sparkle
567731.png,https://derpicdn.net/img/view/2014/3/6/567731.png,0,0.973320067,13,0,757,653,744,653,twilight sparkle
568000.png,https://derpicdn.net/img/view/2014/3/6/568000.png,0,0.989120662,537,118,1007,588,470,470,twilight sparkle
569202.png,https://derpicdn.net/img/view/2014/3/8/569202.png,0,0.988354862,55,0,457,393,402,393,twilight sparkle
569416.png,https://derpicdn.net/img/view/2014/3/8/569416.png,0,0.99841553,65,105,397,437,332,332,twilight sparkle
569685.png,https://derpicdn.net/img/view/2014/3/8/569685.png,0,0.995751917,2261,0,5040,2855,2779,2855,twilight sparkle
585232.png,https://derpicdn.net/img/view/2014/3/26/585232.png,0,0.963946223,2930,99,8976,6145,6046,6046,twilight sparkle
585438.png,https://derpicdn.net/img/view/2014/3/26/585438.png,0,0.990415215,23,0,551,474,528,474,twilight sparkle
58976.png,https://derpicdn.net/img/view/2012/7/27/58976.png,0,0.999586165,248,0,692,406,444,406,twilight sparkle
591248.png,https://derpicdn.net/img/view/2014/4/2/591248.png,0,0.997775376,536,255,1126,845,590,590,twilight sparkle
593089.png,https://derpicdn.net/img/view/2014/4/5/593089.png,0,0.960364342,104,0,522,387,418,387,twilight sparkle
59733.png,https://derpicdn.net/img/view/2012/7/28/59733.png,0,0.99015826,176,17,638,479,462,462,twilight sparkle
598419.png,https://derpicdn.net/img/view/2014/4/12/598419.png,0,0.976690888,349,70,761,482,412,412,twilight sparkle
600297.png,https://derpicdn.net/img/view/2014/4/14/600297.png,0,0.993311584,269,0,747,477,478,477,twilight sparkle
603608.png,https://derpicdn.net/img/view/2014/4/18/603608.png,0,0.993165255,1153,0,2459,1288,1306,1288,twilight sparkle
611540.png,https://derpicdn.net/img/view/2014/4/27/611540.png,0,0.922739983,1208,0,2282,1022,1074,1022,twilight sparkle
611686.png,https://derpicdn.net/img/view/2014/4/27/611686.png,0,0.989192069,625,276,1087,738,462,462,twilight sparkle
611885.png,https://derpicdn.net/img/view/2014/4/28/611885.png,0,0.912036896,0,11,820,865,820,854,twilight sparkle
615060.png,https://derpicdn.net/img/view/2014/5/2/615060.png,0,0.981296957,639,0,1857,1106,1218,1106,twilight sparkle
615682.png,https://derpicdn.net/img/view/2014/5/2/615682.png,0,0.995313823,0,25,569,605,569,580,twilight sparkle
616130.png,https://derpicdn.net/img/view/2014/5/3/616130.png,0,0.997202337,393,405,563,575,170,170,twilight sparkle
616130.png,https://derpicdn.net/img/view/2014/5/3/616130.png,2,0.990873516,570,579,750,783,180,204,twilight sparkle
616130.png,https://derpicdn.net/img/view/2014/5/3/616130.png,3,0.986969292,113,787,315,989,202,202,twilight sparkle
616130.png,https://derpicdn.net/img/view/2014/5/3/616130.png,4,0.983158529,398,193,592,387,194,194,twilight sparkle
616130.png,https://derpicdn.net/img/view/2014/5/3/616130.png,6,0.956209183,434,12,610,188,176,176,twilight sparkle
616130.png,https://derpicdn.net/img/view/2014/5/3/616130.png,7,0.942031205,557,399,741,583,184,184,twilight sparkle
616130.png,https://derpicdn.net/img/view/2014/5/3/616130.png,8,0.940207005,226,382,422,578,196,196,twilight sparkle
616130.png,https://derpicdn.net/img/view/2014/5/3/616130.png,9,0.908949971,579,793,750,975,171,182,twilight sparkle
617091.png,https://derpicdn.net/img/view/2014/5/4/617091.png,0,0.929448843,416,0,974,540,558,540,twilight sparkle
617373.png,https://derpicdn.net/img/view/2014/5/4/617373.png,0,0.992032707,497,185,997,685,500,500,twilight sparkle
617816.jpg,https://derpicdn.net/img/view/2014/5/4/617816.jpg,0,0.965189815,458,0,2104,1493,1646,1493,twilight sparkle
623269.png,https://derpicdn.net/img/view/2014/5/10/623269.png,0,0.972486198,209,252,899,942,690,690,twilight sparkle
624089.png,https://derpicdn.net/img/view/2014/5/11/624089.png,0,0.930213451,10,754,2272,3299,2262,2545,twilight sparkle
624103.png,https://derpicdn.net/img/view/2014/5/11/624103.png,0,0.92266494,13,763,2272,3299,2259,2536,twilight sparkle
624849.png,https://derpicdn.net/img/view/2014/5/12/624849.png,0,0.987120271,304,8,848,552,544,544,twilight sparkle
628167.jpg,https://derpicdn.net/img/view/2014/5/16/628167.jpg,0,0.946182549,599,0,2001,1330,1402,1330,twilight sparkle
628727.png,https://derpicdn.net/img/view/2014/5/17/628727.png,0,0.945692301,67,72,457,462,390,390,twilight sparkle
629580.png,https://derpicdn.net/img/view/2014/5/18/629580.png,0,0.91081208,384,27,778,421,394,394,twilight sparkle
630439.png,https://derpicdn.net/img/view/2014/5/18/630439.png,0,0.932568491,163,0,697,499,534,499,twilight sparkle
631451.png,https://derpicdn.net/img/view/2014/5/19/631451.png,0,0.997866392,24,186,466,628,442,442,twilight sparkle
631451.png,https://derpicdn.net/img/view/2014/5/19/631451.png,1,0.966737449,378,0,914,534,536,534,twilight sparkle
632562.png,https://derpicdn.net/img/view/2014/5/21/632562.png,0,0.997530222,80,0,4970,4442,4890,4442,twilight sparkle
633615.jpg,https://derpicdn.net/img/view/2014/5/22/633615.jpg,0,0.966989279,1764,160,3634,2030,1870,1870,twilight sparkle
633964.jpg,https://derpicdn.net/img/view/2014/5/22/633964.jpg,0,0.983100116,0,0,698,622,698,622,twilight sparkle
634849.png,https://derpicdn.net/img/view/2014/5/23/634849.png,0,0.994592369,56,0,612,531,556,531,twilight sparkle
635171.png,https://derpicdn.net/img/view/2014/5/24/635171.png,0,0.993037879,4915,0,9977,4503,5062,4503,twilight sparkle
635678.jpg,https://derpicdn.net/img/view/2014/5/24/635678.jpg,0,0.996128917,118,0,442,319,324,319,twilight sparkle
64047.jpg,https://derpicdn.net/img/view/2012/8/1/64047.jpg,0,0.969415128,250,134,536,420,286,286,twilight sparkle
640981.png,https://derpicdn.net/img/view/2014/5/30/640981.png,0,0.919269621,940,294,1776,1130,836,836,twilight sparkle
642329.png,https://derpicdn.net/img/view/2014/6/1/642329.png,0,0.99597615,45,0,493,437,448,437,twilight sparkle
642935.jpg,https://derpicdn.net/img/view/2014/6/2/642935.jpg,0,0.984485269,5,3,383,381,378,378,twilight sparkle
643907.png,https://derpicdn.net/img/view/2014/6/3/643907.png,0,0.987323821,1932,2497,2724,3289,792,792,twilight sparkle
644481.png,https://derpicdn.net/img/view/2014/6/4/644481.png,0,0.900802374,135,0,1023,691,888,691,twilight sparkle
646867.png,https://derpicdn.net/img/view/2014/6/6/646867.png,0,0.995799363,203,239,431,467,228,228,twilight sparkle
647095.png,https://derpicdn.net/img/view/2014/6/7/647095.png,0,0.999171436,1132,34,1618,520,486,486,twilight sparkle
649134.png,https://derpicdn.net/img/view/2014/6/9/649134.png,0,0.934200227,17,159,1311,1453,1294,1294,twilight sparkle
649491.png,https://derpicdn.net/img/view/2014/6/10/649491.png,1,0.973572552,433,175,897,639,464,464,twilight sparkle
649823.jpg,https://derpicdn.net/img/view/2014/6/10/649823.jpg,0,0.9962852,83,1,361,279,278,278,twilight sparkle
652484.png,https://derpicdn.net/img/view/2014/6/13/652484.png,0,0.990866184,722,0,1660,811,938,811,twilight sparkle
652595.jpg,https://derpicdn.net/img/view/2014/6/14/652595.jpg,0,0.988187373,395,82,753,440,358,358,twilight sparkle
653676.png,https://derpicdn.net/img/view/2014/6/15/653676.png,0,0.973494947,33,0,545,493,512,493,twilight sparkle
654096.png,https://derpicdn.net/img/view/2014/6/15/654096.png,0,0.950014174,26,26,330,330,304,304,twilight sparkle
659227.png,https://derpicdn.net/img/view/2014/6/22/659227.png,0,0.970192134,0,0,529,472,529,472,twilight sparkle
659935.png,https://derpicdn.net/img/view/2014/6/23/659935.png,0,0.992691755,1253,156,1635,538,382,382,twilight sparkle
660422.png,https://derpicdn.net/img/view/2014/6/24/660422.png,0,0.99255687,609,0,1199,557,590,557,twilight sparkle
661096.png,https://derpicdn.net/img/view/2014/6/25/661096.png,0,0.996984601,0,0,533,532,533,532,twilight sparkle
661119.png,https://derpicdn.net/img/view/2014/6/25/661119.png,0,0.990630448,1820,210,3118,1570,1298,1360,twilight sparkle
66116.jpg,https://derpicdn.net/img/view/2012/8/3/66116.jpg,0,0.996666968,166,350,784,968,618,618,twilight sparkle
661779.png,https://derpicdn.net/img/view/2014/6/26/661779.png,0,0.980401576,0,0,793,743,793,743,twilight sparkle
6620.png,https://derpicdn.net/img/view/2012/6/18/6620.png,0,0.969959974,359,115,875,631,516,516,twilight sparkle
668315.png,https://derpicdn.net/img/view/2014/7/5/668315.png,0,0.915540218,50,0,1884,1691,1834,1691,twilight sparkle
668771.png,https://derpicdn.net/img/view/2014/7/6/668771.png,0,0.998492241,148,4,848,704,700,700,twilight sparkle
670654.png,https://derpicdn.net/img/view/2014/7/8/670654.png,0,0.999462485,2480,50,4660,2230,2180,2180,twilight sparkle
670740.png,https://derpicdn.net/img/view/2014/7/9/670740.png,0,0.996384203,0,0,1115,1126,1115,1126,twilight sparkle
674793.png,https://derpicdn.net/img/view/2014/7/14/674793.png,0,0.94208473,220,0,1194,784,974,784,twilight sparkle
675961.png,https://derpicdn.net/img/view/2014/7/16/675961.png,0,0.983645558,529,1057,1667,2195,1138,1138,twilight sparkle
676174.jpg,https://derpicdn.net/img/view/2014/7/16/676174.jpg,0,0.983939886,313,0,925,533,612,533,twilight sparkle
677076.png,https://derpicdn.net/img/view/2014/7/17/677076.png,0,0.992440522,212,75,894,757,682,682,twilight sparkle
679990.png,https://derpicdn.net/img/view/2014/7/21/679990.png,0,0.998429,303,29,701,427,398,398,twilight sparkle
685817.png,https://derpicdn.net/img/view/2014/7/29/685817.png,0,0.997887671,318,3,670,355,352,352,twilight sparkle
686174.png,https://derpicdn.net/img/view/2014/7/29/686174.png,0,0.931101799,0,36,1028,1142,1028,1106,twilight sparkle
686839.png,https://derpicdn.net/img/view/2014/7/30/686839.png,0,0.952917337,1473,210,2497,1234,1024,1024,twilight sparkle
687290.png,https://derpicdn.net/img/view/2014/7/30/687290.png,0,0.996737719,175,0,701,515,526,515,twilight sparkle
688596.png,https://derpicdn.net/img/view/2014/8/1/688596.png,0,0.980787516,189,10,651,472,462,462,twilight sparkle
690074.png,https://derpicdn.net/img/view/2014/8/3/690074.png,0,0.987222433,231,0,477,240,246,240,twilight sparkle
690533.jpg,https://derpicdn.net/img/view/2014/8/3/690533.jpg,0,0.997629821,245,87,1379,1221,1134,1134,twilight sparkle
691771.png,https://derpicdn.net/img/view/2014/8/5/691771.png,0,0.995060384,344,275,794,725,450,450,twilight sparkle
693929.png,https://derpicdn.net/img/view/2014/8/7/693929.png,1,0.928419888,856,18,1016,178,160,160,twilight sparkle
696138.png,https://derpicdn.net/img/view/2014/8/10/696138.png,0,0.994175613,773,0,2335,1284,1562,1284,twilight sparkle
697078.png,https://derpicdn.net/img/view/2014/8/11/697078.png,0,0.975668371,0,122,499,676,499,554,twilight sparkle
698428.png,https://derpicdn.net/img/view/2014/8/13/698428.png,0,0.992504537,345,0,701,353,356,353,twilight sparkle
698597.png,https://derpicdn.net/img/view/2014/8/13/698597.png,0,0.960275829,1298,0,2790,1141,1492,1141,twilight sparkle
699800.png,https://derpicdn.net/img/view/2014/8/14/699800.png,0,0.934856415,0,0,370,370,370,370,twilight sparkle
700115.png,https://derpicdn.net/img/view/2014/8/15/700115.png,0,0.987458646,104,23,432,351,328,328,twilight sparkle
700246.png,https://derpicdn.net/img/view/2014/8/15/700246.png,0,0.985425234,0,0,327,342,327,342,twilight sparkle
701091.png,https://derpicdn.net/img/view/2014/8/16/701091.png,0,0.988744974,419,65,793,439,374,374,twilight sparkle
701526.png,https://derpicdn.net/img/view/2014/8/17/701526.png,0,0.999260247,1155,0,1703,462,548,462,twilight sparkle
7027.png,https://derpicdn.net/img/view/2012/6/18/7027.png,0,0.966034949,589,0,1357,629,768,629,twilight sparkle
703389.png,https://derpicdn.net/img/view/2014/8/19/703389.png,0,0.939807653,0,0,541,474,541,474,twilight sparkle
704103.png,https://derpicdn.net/img/view/2014/8/20/704103.png,0,0.978145361,356,0,2590,2133,2234,2133,twilight sparkle
705545.png,https://derpicdn.net/img/view/2014/8/22/705545.png,0,0.952639878,130,0,614,381,484,381,twilight sparkle
706677.png,https://derpicdn.net/img/view/2014/8/24/706677.png,0,0.904204845,82,0,956,852,874,852,twilight sparkle
709482.jpg,https://derpicdn.net/img/view/2014/8/27/709482.jpg,0,0.964345694,696,641,1010,955,314,314,twilight sparkle
709677.png,https://derpicdn.net/img/view/2014/8/28/709677.png,0,0.947066128,3097,0,8000,5197,4903,5197,twilight sparkle
717136.png,https://derpicdn.net/img/view/2014/9/7/717136.png,0,0.977171779,3387,0,6012,2696,2625,2696,twilight sparkle
719463.png,https://derpicdn.net/img/view/2014/9/10/719463.png,0,0.967477858,522,386,1040,904,518,518,twilight sparkle
722539.png,https://derpicdn.net/img/view/2014/9/15/722539.png,0,0.997050643,327,0,803,471,476,471,twilight sparkle
722727.png,https://derpicdn.net/img/view/2014/9/15/722727.png,0,0.98934865,68,0,992,876,924,876,twilight sparkle
724022.png,https://derpicdn.net/img/view/2014/9/17/724022.png,0,0.967739344,0,0,562,505,562,505,twilight sparkle
724682.png,https://derpicdn.net/img/view/2014/9/18/724682.png,0,0.984482229,205,127,521,443,316,316,twilight sparkle
726746.png,https://derpicdn.net/img/view/2014/9/21/726746.png,0,0.969631076,21,0,1085,728,1064,728,twilight sparkle
729066.png,https://derpicdn.net/img/view/2014/9/25/729066.png,0,0.909825265,231,119,1101,989,870,870,twilight sparkle
730731.png,https://derpicdn.net/img/view/2014/9/27/730731.png,0,0.975461841,5,0,523,516,518,516,twilight sparkle
734871.png,https://derpicdn.net/img/view/2014/10/3/734871.png,0,0.935579658,138,0,512,372,374,372,twilight sparkle
735560.png,https://derpicdn.net/img/view/2014/10/4/735560.png,0,0.96290499,34,39,384,363,350,324,twilight sparkle
737411.png,https://derpicdn.net/img/view/2014/10/7/737411.png,0,0.99679482,158,233,1720,1795,1562,1562,twilight sparkle
737512.png,https://derpicdn.net/img/view/2014/10/7/737512.png,0,0.997954011,502,0,1638,1123,1136,1123,twilight sparkle
738918.png,https://derpicdn.net/img/view/2014/10/8/738918.png,0,0.994057298,0,0,356,371,356,371,twilight sparkle
7390.jpg,https://derpicdn.net/img/view/2012/6/18/7390.jpg,0,0.965166152,385,3,733,351,348,348,twilight sparkle
739094.png,https://derpicdn.net/img/view/2014/10/9/739094.png,0,0.90161109,472,110,886,524,414,414,twilight sparkle
739321.png,https://derpicdn.net/img/view/2014/10/9/739321.png,0,0.990207493,0,0,495,488,495,488,twilight sparkle
742570.png,https://derpicdn.net/img/view/2014/10/14/742570.png,0,0.983365417,980,176,1434,630,454,454,twilight sparkle
744001.png,https://derpicdn.net/img/view/2014/10/16/744001.png,0,0.997510314,0,0,254,238,254,238,twilight sparkle
746798.png,https://derpicdn.net/img/view/2014/10/20/746798.png,0,0.989865959,178,119,1466,1407,1288,1288,twilight sparkle
749041.png,https://derpicdn.net/img/view/2014/10/23/749041.png,0,0.99982065,801,0,1815,986,1014,986,twilight sparkle
749041.png,https://derpicdn.net/img/view/2014/10/23/749041.png,1,0.990247846,1556,0,2518,932,962,932,twilight sparkle
751127.jpg,https://derpicdn.net/img/view/2014/10/26/751127.jpg,0,0.997359872,84,25,564,505,480,480,twilight sparkle
757851.jpg,https://derpicdn.net/img/view/2014/11/4/757851.jpg,0,0.988497138,708,163,1452,907,744,744,twilight sparkle
759186.png,https://derpicdn.net/img/view/2014/11/6/759186.png,0,0.993773222,785,602,1849,1666,1064,1064,twilight sparkle
761330.png,https://derpicdn.net/img/view/2014/11/9/761330.png,0,0.987245083,1261,231,2229,1199,968,968,twilight sparkle
762097.png,https://derpicdn.net/img/view/2014/11/10/762097.png,0,0.992262661,0,0,637,766,637,766,twilight sparkle
763259.png,https://derpicdn.net/img/view/2014/11/12/763259.png,0,0.999356747,259,0,635,361,376,361,twilight sparkle
763259.png,https://derpicdn.net/img/view/2014/11/12/763259.png,1,0.988935113,172,307,452,587,280,280,twilight sparkle
763580.png,https://derpicdn.net/img/view/2014/11/13/763580.png,0,0.970307946,878,436,1588,1146,710,710,twilight sparkle
764530.png,https://derpicdn.net/img/view/2014/11/14/764530.png,0,0.990708172,896,0,1660,751,764,751,twilight sparkle
765844.png,https://derpicdn.net/img/view/2014/11/16/765844.png,0,0.992944479,422,68,1248,894,826,826,twilight sparkle
767142.png,https://derpicdn.net/img/view/2014/11/18/767142.png,0,0.954513848,157,2,631,476,474,474,twilight sparkle
7675.jpg,https://derpicdn.net/img/view/2012/6/18/7675.jpg,0,0.964306593,291,212,529,450,238,238,twilight sparkle
767645.png,https://derpicdn.net/img/view/2014/11/19/767645.png,0,0.984966338,440,666,1128,1354,688,688,twilight sparkle
768340.png,https://derpicdn.net/img/view/2014/11/20/768340.png,0,0.964515567,185,4,697,568,512,564,twilight sparkle
768342.png,https://derpicdn.net/img/view/2014/11/20/768342.png,0,0.952244639,306,0,790,471,484,471,twilight sparkle
770864.png,https://derpicdn.net/img/view/2014/11/24/770864.png,0,0.979052961,196,366,412,582,216,216,twilight sparkle
771060.png,https://derpicdn.net/img/view/2014/11/24/771060.png,0,0.984535038,351,22,1171,842,820,820,twilight sparkle
771588.png,https://derpicdn.net/img/view/2014/11/25/771588.png,0,0.97733146,213,0,2200,1956,1987,1956,twilight sparkle
773399.png,https://derpicdn.net/img/view/2014/11/28/773399.png,0,0.998586595,17,90,341,414,324,324,twilight sparkle
774236.png,https://derpicdn.net/img/view/2014/11/29/774236.png,0,0.993463695,418,0,1066,637,648,637,twilight sparkle
775161.png,https://derpicdn.net/img/view/2014/11/30/775161.png,0,0.948507905,206,0,856,598,650,598,twilight sparkle
775833.png,https://derpicdn.net/img/view/2014/12/1/775833.png,0,0.993064165,94,89,440,435,346,346,twilight sparkle
777896.png,https://derpicdn.net/img/view/2014/12/4/777896.png,0,0.985636771,11,445,323,757,312,312,twilight sparkle
777965.png,https://derpicdn.net/img/view/2014/12/4/777965.png,0,0.960491717,158,12,490,344,332,332,twilight sparkle
778083.jpg,https://derpicdn.net/img/view/2014/12/4/778083.jpg,0,0.923388004,346,172,1732,1558,1386,1386,twilight sparkle
782621.png,https://derpicdn.net/img/view/2014/12/11/782621.png,0,0.991286933,746,765,1426,1445,680,680,twilight sparkle
784337.jpg,https://derpicdn.net/img/view/2014/12/13/784337.jpg,0,0.994680524,585,0,1405,803,820,803,twilight sparkle
786820.png,https://derpicdn.net/img/view/2014/12/17/786820.png,0,0.989830554,420,122,978,680,558,558,twilight sparkle
787133.png,https://derpicdn.net/img/view/2014/12/18/787133.png,0,0.948099196,132,110,556,534,424,424,twilight sparkle
789491.png,https://derpicdn.net/img/view/2014/12/21/789491.png,0,0.988725364,0,196,840,1248,840,1052,twilight sparkle
790040.png,https://derpicdn.net/img/view/2014/12/22/790040.png,0,0.956221223,1680,406,2084,810,404,404,twilight sparkle
794108.png,https://derpicdn.net/img/view/2014/12/28/794108.png,0,0.987262189,807,144,1767,1104,960,960,twilight sparkle
794653.png,https://derpicdn.net/img/view/2014/12/28/794653.png,0,0.984737396,92,0,1232,1112,1140,1112,twilight sparkle
796104.png,https://derpicdn.net/img/view/2014/12/30/796104.png,0,0.992284715,856,111,2342,1597,1486,1486,twilight sparkle
796174.jpg,https://derpicdn.net/img/view/2014/12/30/796174.jpg,0,0.93573153,2474,1043,3082,1651,608,608,twilight sparkle
796458.png,https://derpicdn.net/img/view/2014/12/31/796458.png,0,0.960681856,42,0,1180,718,1138,718,twilight sparkle
79716.jpg,https://derpicdn.net/img/view/2012/8/22/79716.jpg,0,0.983755112,388,132,808,552,420,420,twilight sparkle
797290.png,https://derpicdn.net/img/view/2015/1/1/797290.png,0,0.955076396,548,88,1280,820,732,732,twilight sparkle
801935.png,https://derpicdn.net/img/view/2015/1/8/801935.png,0,0.954459846,1455,512,2359,1416,904,904,twilight sparkle
805237.png,https://derpicdn.net/img/view/2015/1/13/805237.png,0,0.957841754,88,0,378,277,290,277,twilight sparkle
810553.png,https://derpicdn.net/img/view/2015/1/20/810553.png,0,0.998423636,1732,0,3545,1673,1813,1673,twilight sparkle
812530.png,https://derpicdn.net/img/view/2015/1/23/812530.png,0,0.983686924,475,0,1495,806,1020,806,twilight sparkle
813540.png,https://derpicdn.net/img/view/2015/1/24/813540.png,0,0.999228776,665,159,1277,771,612,612,twilight sparkle
816365.png,https://derpicdn.net/img/view/2015/1/28/816365.png,0,0.974770308,42,37,486,481,444,444,twilight sparkle
816656.png,https://derpicdn.net/img/view/2015/1/28/816656.png,0,0.988184214,0,0,1150,1146,1150,1146,twilight sparkle
817992.png,https://derpicdn.net/img/view/2015/1/30/817992.png,0,0.943234146,0,0,3312,3346,3312,3346,twilight sparkle
818207.png,https://derpicdn.net/img/view/2015/1/31/818207.png,0,0.999407172,272,0,906,625,634,625,twilight sparkle
818428.png,https://derpicdn.net/img/view/2015/1/31/818428.png,0,0.953266382,1461,104,3559,2202,2098,2098,twilight sparkle
821012.png,https://derpicdn.net/img/view/2015/2/4/821012.png,0,0.932506979,194,0,962,671,768,671,twilight sparkle
825435.png,https://derpicdn.net/img/view/2015/2/10/825435.png,0,0.990849018,419,114,1833,1528,1414,1414,twilight sparkle
827579.png,https://derpicdn.net/img/view/2015/2/13/827579.png,0,0.995334029,2041,0,3891,1753,1850,1753,twilight sparkle
827580.png,https://derpicdn.net/img/view/2015/2/13/827580.png,0,0.988778591,83,66,2207,2190,2124,2124,twilight sparkle
829590.png,https://derpicdn.net/img/view/2015/2/15/829590.png,0,0.915480971,258,1645,4724,6111,4466,4466,twilight sparkle
832739.png,https://derpicdn.net/img/view/2015/2/19/832739.png,0,0.951284647,74,27,896,849,822,822,twilight sparkle
834068.png,https://derpicdn.net/img/view/2015/2/21/834068.png,1,0.985767007,791,262,1159,630,368,368,twilight sparkle
835498.png,https://derpicdn.net/img/view/2015/2/23/835498.png,0,0.996827185,89,0,3393,3224,3304,3224,twilight sparkle
838146.png,https://derpicdn.net/img/view/2015/2/27/838146.png,0,0.99941653,631,245,955,569,324,324,twilight sparkle
838729.png,https://derpicdn.net/img/view/2015/2/28/838729.png,0,0.985184491,915,677,1671,1433,756,756,twilight sparkle
839452.png,https://derpicdn.net/img/view/2015/3/1/839452.png,0,0.990588486,247,114,727,594,480,480,twilight sparkle
844388.png,https://derpicdn.net/img/view/2015/3/7/844388.png,0,0.955128431,997,0,2079,1010,1082,1010,twilight sparkle
844898.png,https://derpicdn.net/img/view/2015/3/8/844898.png,0,0.978432775,0,0,675,694,675,694,twilight sparkle
848627.png,https://derpicdn.net/img/view/2015/3/13/848627.png,0,0.993709207,152,28,486,362,334,334,twilight sparkle
848826.png,https://derpicdn.net/img/view/2015/3/13/848826.png,0,0.991280079,104,31,572,499,468,468,twilight sparkle
850532.png,https://derpicdn.net/img/view/2015/3/16/850532.png,0,0.997173131,1529,1408,3177,3056,1648,1648,twilight sparkle
85134.png,https://derpicdn.net/img/view/2012/8/28/85134.png,0,0.993263662,12,16,800,804,788,788,twilight sparkle
852176.png,https://derpicdn.net/img/view/2015/3/18/852176.png,0,0.992034256,602,94,1920,1412,1318,1318,twilight sparkle
852414.jpg,https://derpicdn.net/img/view/2015/3/18/852414.jpg,0,0.99153012,982,95,1646,759,664,664,twilight sparkle
855655.png,https://derpicdn.net/img/view/2015/3/23/855655.png,0,0.994361341,365,22,775,432,410,410,twilight sparkle
856300.png,https://derpicdn.net/img/view/2015/3/24/856300.png,0,0.981391668,581,88,1423,930,842,842,twilight sparkle
860874.png,https://derpicdn.net/img/view/2015/3/30/860874.png,0,0.998997211,1313,216,2711,1614,1398,1398,twilight sparkle
870415.png,https://derpicdn.net/img/view/2015/4/10/870415.png,0,0.99591738,90,31,478,419,388,388,twilight sparkle
870528.png,https://derpicdn.net/img/view/2015/4/10/870528.png,0,0.976930261,735,184,1375,824,640,640,twilight sparkle
872236.png,https://derpicdn.net/img/view/2015/4/12/872236.png,0,0.982628703,73,23,941,891,868,868,twilight sparkle
872792.png,https://derpicdn.net/img/view/2015/4/12/872792.png,0,0.957601845,215,55,479,319,264,264,twilight sparkle
873446.png,https://derpicdn.net/img/view/2015/4/13/873446.png,0,0.977601528,205,0,1793,1080,1588,1080,twilight sparkle
875316.png,https://derpicdn.net/img/view/2015/4/16/875316.png,0,0.994456351,0,14,1229,1258,1229,1244,twilight sparkle
876105.png,https://derpicdn.net/img/view/2015/4/17/876105.png,0,0.996468425,1066,45,1926,905,860,860,twilight sparkle
879182.jpg,https://derpicdn.net/img/view/2015/4/21/879182.jpg,0,0.997455657,232,0,1616,1354,1384,1354,twilight sparkle
880843.png,https://derpicdn.net/img/view/2015/4/23/880843.png,0,0.940897703,0,206,393,604,393,398,twilight sparkle
883875.png,https://derpicdn.net/img/view/2015/4/27/883875.png,0,0.998505533,441,0,873,409,432,409,twilight sparkle
885015.png,https://derpicdn.net/img/view/2015/4/28/885015.png,0,0.979624808,149,0,1250,1192,1101,1192,twilight sparkle
886995.png,https://derpicdn.net/img/view/2015/5/2/886995.png,0,0.926707327,303,167,703,567,400,400,twilight sparkle
887380.jpg,https://derpicdn.net/img/view/2015/5/2/887380.jpg,0,0.978655934,956,0,2112,1153,1156,1153,twilight sparkle
887419.png,https://derpicdn.net/img/view/2015/5/2/887419.png,0,0.971790314,2452,0,8000,5625,5548,5625,twilight sparkle
888391.png,https://derpicdn.net/img/view/2015/5/3/888391.png,1,0.960557401,10,92,402,484,392,392,twilight sparkle
888393.png,https://derpicdn.net/img/view/2015/5/3/888393.png,0,0.989004791,1226,0,2350,1073,1124,1073,twilight sparkle
88855.jpg,https://derpicdn.net/img/view/2012/9/3/88855.jpg,0,0.926597655,81,41,500,469,419,428,twilight sparkle
890558.png,https://derpicdn.net/img/view/2015/5/6/890558.png,0,0.985019684,317,0,1223,871,906,871,twilight sparkle
891260.png,https://derpicdn.net/img/view/2015/5/7/891260.png,0,0.99417311,3769,415,6347,2993,2578,2578,twilight sparkle
89149.jpg,https://derpicdn.net/img/view/2012/9/3/89149.jpg,0,0.987818301,951,40,2341,1430,1390,1390,twilight sparkle
897491.png,https://derpicdn.net/img/view/2015/5/16/897491.png,0,0.943744063,0,4,298,316,298,312,twilight sparkle
897584.png,https://derpicdn.net/img/view/2015/5/16/897584.png,0,0.947445273,0,100,775,902,775,802,twilight sparkle
897620.png,https://derpicdn.net/img/view/2015/5/16/897620.png,0,0.980915606,227,34,749,556,522,522,twilight sparkle
899931.png,https://derpicdn.net/img/view/2015/5/19/899931.png,0,0.962952793,150,0,672,482,522,482,twilight sparkle
900147.png,https://derpicdn.net/img/view/2015/5/19/900147.png,0,0.998008192,96,180,510,594,414,414,twilight sparkle
900147.png,https://derpicdn.net/img/view/2015/5/19/900147.png,1,0.965506732,1390,232,1814,656,424,424,twilight sparkle
901300.png,https://derpicdn.net/img/view/2015/5/21/901300.png,0,0.991792619,1562,99,3414,1951,1852,1852,twilight sparkle
901302.png,https://derpicdn.net/img/view/2015/5/21/901302.png,0,0.995914042,1496,57,3270,1831,1774,1774,twilight sparkle
904846.png,https://derpicdn.net/img/view/2015/5/27/904846.png,0,0.999241352,3213,0,5989,2786,2776,2786,twilight sparkle
905689.png,https://derpicdn.net/img/view/2015/5/28/905689.png,0,0.959556103,918,105,2052,1239,1134,1134,twilight sparkle
906419.png,https://derpicdn.net/img/view/2015/5/29/906419.png,0,0.998018742,2780,0,3844,979,1064,979,twilight sparkle
907264.png,https://derpicdn.net/img/view/2015/5/31/907264.png,0,0.991556287,6,98,540,632,534,534,twilight sparkle
907978.png,https://derpicdn.net/img/view/2015/6/1/907978.png,0,0.99694699,0,0,1746,1730,1746,1730,twilight sparkle
911778.png,https://derpicdn.net/img/view/2015/6/6/911778.png,0,0.900122523,24,0,1000,945,976,945,twilight sparkle
91373.png,https://derpicdn.net/img/view/2012/9/6/91373.png,0,0.988021493,51,0,405,338,354,338,twilight sparkle
915315.png,https://derpicdn.net/img/view/2015/6/12/915315.png,0,0.997443438,0,0,2459,2608,2459,2608,twilight sparkle
921334.png,https://derpicdn.net/img/view/2015/6/22/921334.png,0,0.992367268,137,5,1149,1017,1012,1012,twilight sparkle
921336.png,https://derpicdn.net/img/view/2015/6/22/921336.png,0,0.93693459,246,7,1244,1005,998,998,twilight sparkle
929516.png,https://derpicdn.net/img/view/2015/7/4/929516.png,0,0.999344289,0,0,363,365,363,365,twilight sparkle
931976.png,https://derpicdn.net/img/view/2015/7/7/931976.png,0,0.948783636,562,0,1572,935,1010,935,twilight sparkle
935554.jpg,https://derpicdn.net/img/view/2015/7/12/935554.jpg,0,0.994813919,0,241,254,551,254,310,twilight sparkle
941169.png,https://derpicdn.net/img/view/2015/7/21/941169.png,0,0.985848367,1639,108,2535,1004,896,896,twilight sparkle
944985.png,https://derpicdn.net/img/view/2015/7/27/944985.png,0,0.976435184,714,0,2148,1177,1434,1177,twilight sparkle
945349.png,https://derpicdn.net/img/view/2015/7/27/945349.png,0,0.948279679,4520,0,6942,2097,2422,2097,twilight sparkle
948285.jpg,https://derpicdn.net/img/view/2015/8/1/948285.jpg,0,0.998696506,360,0,888,467,528,467,twilight sparkle
953461.png,https://derpicdn.net/img/view/2015/8/8/953461.png,0,0.962715983,0,54,2502,3068,2502,3014,twilight sparkle
954285.jpg,https://derpicdn.net/img/view/2015/8/9/954285.jpg,0,0.979776442,505,1026,1497,2018,992,992,twilight sparkle
954426.jpg,https://derpicdn.net/img/view/2015/8/9/954426.jpg,0,0.995745122,314,144,822,652,508,508,twilight sparkle
955974.png,https://derpicdn.net/img/view/2015/8/12/955974.png,0,0.948474169,443,200,2413,2170,1970,1970,twilight sparkle
957710.png,https://derpicdn.net/img/view/2015/8/14/957710.png,0,0.989892542,1535,189,2893,1547,1358,1358,twilight sparkle
960122.jpg,https://derpicdn.net/img/view/2015/8/18/960122.jpg,0,0.986459374,399,209,1111,921,712,712,twilight sparkle
964155.png,https://derpicdn.net/img/view/2015/8/23/964155.png,0,0.906107724,115,1273,451,1609,336,336,twilight sparkle
965390.png,https://derpicdn.net/img/view/2015/8/25/965390.png,0,0.997909069,37,0,769,687,732,687,twilight sparkle
972211.png,https://derpicdn.net/img/view/2015/9/3/972211.png,0,0.982315838,882,116,1128,362,246,246,twilight sparkle
972487.png,https://derpicdn.net/img/view/2015/9/4/972487.png,0,0.975366056,2023,312,3840,2160,1817,1848,twilight sparkle
988325.png,https://derpicdn.net/img/view/2015/9/26/988325.png,0,0.967966139,16,31,490,505,474,474,twilight sparkle
996994.png,https://derpicdn.net/img/view/2015/10/8/996994.png,0,0.997908115,142,0,712,543,570,543,twilight sparkle
997200.jpg,https://derpicdn.net/img/view/2015/10/8/997200.jpg,0,0.996003449,63,521,1023,1481,960,960,twilight sparkle
998036.png,https://derpicdn.net/img/view/2015/10/9/998036.png,0,0.998646259,456,321,840,705,384,384,twilight sparkle
999455.png,https://derpicdn.net/img/view/2015/10/11/999455.png,1,0.922642291,630,1549,849,1773,219,224,twilight sparkle
999512.png,https://derpicdn.net/img/view/2015/10/11/999512.png,0,0.999491215,332,23,826,517,494,494,twilight sparkle
1000127.jpeg,https://derpicdn.net/img/view/2015/10/11/1000127.jpeg,0,0.997404277,262,2,600,346,338,344,twilight sparkle
1002842.jpeg,https://derpicdn.net/img/view/2015/10/15/1002842.jpeg,0,0.991954505,142,0,2248,1810,2106,1810,twilight sparkle
1005334.jpeg,https://derpicdn.net/img/view/2015/10/18/1005334.jpeg,0,0.998484254,144,239,358,453,214,214,twilight sparkle
1005334.jpeg,https://derpicdn.net/img/view/2015/10/18/1005334.jpeg,1,0.948665142,699,192,925,418,226,226,twilight sparkle
1007527.jpeg,https://derpicdn.net/img/view/2015/10/22/1007527.jpeg,0,0.998030484,262,5,600,347,338,342,twilight sparkle
1010509.jpeg,https://derpicdn.net/img/view/2015/10/28/1010509.jpeg,0,0.976711571,67,0,1535,1406,1468,1406,twilight sparkle
1011168.jpeg,https://derpicdn.net/img/view/2015/10/28/1011168.jpeg,0,0.970338583,475,214,849,588,374,374,twilight sparkle
1014916.jpeg,https://derpicdn.net/img/view/2015/11/2/1014916.jpeg,0,0.998885572,392,0,1134,690,742,690,twilight sparkle
1019666.jpeg,https://derpicdn.net/img/view/2015/11/9/1019666.jpeg,0,0.997623622,454,162,1170,878,716,716,twilight sparkle
1020568.jpeg,https://derpicdn.net/img/view/2015/11/10/1020568.jpeg,0,0.948122501,225,57,621,453,396,396,twilight sparkle
1025092.jpeg,https://derpicdn.net/img/view/2015/11/18/1025092.jpeg,0,0.990753829,307,23,971,687,664,664,twilight sparkle
1025197.jpeg,https://derpicdn.net/img/view/2015/11/18/1025197.jpeg,0,0.990313351,733,0,1871,1057,1138,1057,twilight sparkle
1025252.jpeg,https://derpicdn.net/img/view/2015/11/18/1025252.jpeg,0,0.999314487,1008,0,2082,980,1074,980,twilight sparkle
1025287.jpeg,https://derpicdn.net/img/view/2015/11/18/1025287.jpeg,0,0.993147314,296,792,596,1092,300,300,twilight sparkle
1026398.jpeg,https://derpicdn.net/img/view/2015/11/20/1026398.jpeg,0,0.994195342,81,0,939,817,858,817,twilight sparkle
1026534.jpeg,https://derpicdn.net/img/view/2015/11/20/1026534.jpeg,0,0.983759284,672,0,1368,663,696,663,twilight sparkle
1028583.jpeg,https://derpicdn.net/img/view/2015/11/23/1028583.jpeg,0,0.999406874,102,0,424,310,322,310,twilight sparkle
1028875.jpeg,https://derpicdn.net/img/view/2015/11/23/1028875.jpeg,0,0.999440134,90,240,318,468,228,228,twilight sparkle
1029514.jpeg,https://derpicdn.net/img/view/2015/11/24/1029514.jpeg,0,0.925262272,291,117,625,451,334,334,twilight sparkle
1032939.jpeg,https://derpicdn.net/img/view/2015/11/29/1032939.jpeg,0,0.934252441,852,1877,1618,2643,766,766,twilight sparkle
1034659.jpeg,https://derpicdn.net/img/view/2015/12/1/1034659.jpeg,0,0.972144306,1651,114,2453,916,802,802,twilight sparkle
1036468.jpeg,https://derpicdn.net/img/view/2015/12/4/1036468.jpeg,0,0.998896956,1148,0,2914,1679,1766,1679,twilight sparkle
1036468.jpeg,https://derpicdn.net/img/view/2015/12/4/1036468.jpeg,1,0.998576641,0,0,1290,1370,1290,1370,twilight sparkle
1036468.jpeg,https://derpicdn.net/img/view/2015/12/4/1036468.jpeg,2,0.952143133,0,1223,1552,2835,1552,1612,twilight sparkle
1036823.jpeg,https://derpicdn.net/img/view/2015/12/4/1036823.jpeg,0,0.998102605,163,6,649,492,486,486,twilight sparkle
1038653.jpeg,https://derpicdn.net/img/view/2015/12/7/1038653.jpeg,0,0.96714747,1689,33,2607,1003,918,970,twilight sparkle
1038957.jpeg,https://derpicdn.net/img/view/2015/12/7/1038957.jpeg,0,0.946357965,393,0,1167,728,774,728,twilight sparkle
1040523.jpeg,https://derpicdn.net/img/view/2015/12/9/1040523.jpeg,0,0.999288142,100,0,532,400,432,400,twilight sparkle
1041331.jpeg,https://derpicdn.net/img/view/2015/12/10/1041331.jpeg,0,0.95018518,245,6,539,300,294,294,twilight sparkle
1044046.jpeg,https://derpicdn.net/img/view/2015/12/14/1044046.jpeg,0,0.931858063,499,48,972,528,473,480,twilight sparkle
1049806.jpeg,https://derpicdn.net/img/view/2015/12/21/1049806.jpeg,0,0.989965558,243,368,473,598,230,230,twilight sparkle
1050244.jpeg,https://derpicdn.net/img/view/2015/12/22/1050244.jpeg,0,0.965901554,796,147,1168,519,372,372,twilight sparkle
1053016.jpeg,https://derpicdn.net/img/view/2015/12/26/1053016.jpeg,0,0.997363985,383,135,781,533,398,398,twilight sparkle
1054589.jpeg,https://derpicdn.net/img/view/2015/12/28/1054589.jpeg,0,0.932217479,633,99,1483,949,850,850,twilight sparkle
1054710.jpeg,https://derpicdn.net/img/view/2015/12/28/1054710.jpeg,0,0.999548137,863,0,1369,459,506,459,twilight sparkle
1056240.jpeg,https://derpicdn.net/img/view/2015/12/31/1056240.jpeg,0,0.994498134,45,0,573,512,528,512,twilight sparkle
1056278.jpeg,https://derpicdn.net/img/view/2015/12/31/1056278.jpeg,0,0.903404593,52,0,472,401,420,401,twilight sparkle
1058308.jpeg,https://derpicdn.net/img/view/2016/1/2/1058308.jpeg,0,0.957446396,192,1,602,411,410,410,twilight sparkle
1063699.jpeg,https://derpicdn.net/img/view/2016/1/10/1063699.jpeg,0,0.978525698,1823,337,3999,2513,2176,2176,twilight sparkle
1065373.jpeg,https://derpicdn.net/img/view/2016/1/12/1065373.jpeg,0,0.91023016,1014,0,1970,889,956,889,twilight sparkle
1065402.jpeg,https://derpicdn.net/img/view/2016/1/12/1065402.jpeg,0,0.948478639,938,50,2800,1877,1862,1827,twilight sparkle
1065497.jpeg,https://derpicdn.net/img/view/2016/1/13/1065497.jpeg,0,0.992384672,0,13,910,983,910,970,twilight sparkle
1067623.jpeg,https://derpicdn.net/img/view/2016/1/16/1067623.jpeg,0,0.983608961,562,88,1036,562,474,474,twilight sparkle
1068599.jpeg,https://derpicdn.net/img/view/2016/1/17/1068599.jpeg,0,0.901590407,274,89,388,203,114,114,twilight sparkle
1068604.jpeg,https://derpicdn.net/img/view/2016/1/17/1068604.jpeg,0,0.999190629,588,0,1098,463,510,463,twilight sparkle
1071232.jpeg,https://derpicdn.net/img/view/2016/1/22/1071232.jpeg,0,0.965100765,89,119,865,895,776,776,twilight sparkle
1074342.jpeg,https://derpicdn.net/img/view/2016/1/26/1074342.jpeg,0,0.938017786,374,232,772,630,398,398,twilight sparkle
1076061.jpeg,https://derpicdn.net/img/view/2016/1/29/1076061.jpeg,1,0.951513469,0,611,373,1057,373,446,twilight sparkle
1076101.jpeg,https://derpicdn.net/img/view/2016/1/29/1076101.jpeg,0,0.998023808,323,0,807,462,484,462,twilight sparkle
1077932.jpeg,https://derpicdn.net/img/view/2016/2/1/1077932.jpeg,0,0.929084897,250,30,890,670,640,640,twilight sparkle
1079739.jpeg,https://derpicdn.net/img/view/2016/2/4/1079739.jpeg,0,0.912613213,486,562,2186,2262,1700,1700,twilight sparkle
1079918.jpeg,https://derpicdn.net/img/view/2016/2/4/1079918.jpeg,0,0.990782499,542,0,860,288,318,288,twilight sparkle
1080381.jpeg,https://derpicdn.net/img/view/2016/2/4/1080381.jpeg,0,0.992008746,0,0,1536,1525,1536,1525,twilight sparkle
1080628.jpeg,https://derpicdn.net/img/view/2016/2/5/1080628.jpeg,0,0.987933755,151,13,573,435,422,422,twilight sparkle
1080641.jpeg,https://derpicdn.net/img/view/2016/2/5/1080641.jpeg,0,0.976096213,0,0,655,598,655,598,twilight sparkle
1080882.jpeg,https://derpicdn.net/img/view/2016/2/5/1080882.jpeg,0,0.975102007,1409,82,2013,686,604,604,twilight sparkle
1081575.jpeg,https://derpicdn.net/img/view/2016/2/6/1081575.jpeg,0,0.997352123,393,1,585,193,192,192,twilight sparkle
1081599.jpeg,https://derpicdn.net/img/view/2016/2/6/1081599.jpeg,0,0.992798924,55,82,611,638,556,556,twilight sparkle
1082725.jpeg,https://derpicdn.net/img/view/2016/2/7/1082725.jpeg,0,0.992722273,582,0,2084,1401,1502,1401,twilight sparkle
1084862.jpeg,https://derpicdn.net/img/view/2016/2/10/1084862.jpeg,0,0.99833113,1059,223,2071,1235,1012,1012,twilight sparkle
1088128.jpeg,https://derpicdn.net/img/view/2016/2/14/1088128.jpeg,0,0.98742485,502,11,762,271,260,260,twilight sparkle
1088128.jpeg,https://derpicdn.net/img/view/2016/2/14/1088128.jpeg,1,0.966176093,108,87,302,281,194,194,twilight sparkle
1089794.jpeg,https://derpicdn.net/img/view/2016/2/16/1089794.jpeg,0,0.935584605,28,0,476,439,448,439,twilight sparkle
1089994.jpeg,https://derpicdn.net/img/view/2016/2/16/1089994.jpeg,0,0.99517113,1251,201,1600,565,349,364,twilight sparkle
1089994.jpeg,https://derpicdn.net/img/view/2016/2/16/1089994.jpeg,1,0.972032309,77,145,555,623,478,478,twilight sparkle
1089999.jpeg,https://derpicdn.net/img/view/2016/2/16/1089999.jpeg,0,0.929011285,909,163,1371,625,462,462,twilight sparkle
1092720.jpeg,https://derpicdn.net/img/view/2016/2/20/1092720.jpeg,0,0.922352791,0,37,396,499,396,462,twilight sparkle
1094454.jpeg,https://derpicdn.net/img/view/2016/2/22/1094454.jpeg,0,0.988593459,598,128,1336,866,738,738,twilight sparkle
1100969.jpeg,https://derpicdn.net/img/view/2016/3/3/1100969.jpeg,0,0.990157008,2952,179,4972,2199,2020,2020,twilight sparkle
1101952.jpeg,https://derpicdn.net/img/view/2016/3/4/1101952.jpeg,0,0.958460629,389,0,1745,1220,1356,1220,twilight sparkle
1102478.jpeg,https://derpicdn.net/img/view/2016/3/5/1102478.jpeg,0,0.999577463,593,20,1200,652,607,632,twilight sparkle
1102478.jpeg,https://derpicdn.net/img/view/2016/3/5/1102478.jpeg,1,0.993797183,0,0,679,673,679,673,twilight sparkle
1107180.jpeg,https://derpicdn.net/img/view/2016/3/12/1107180.jpeg,0,0.988186121,233,0,725,441,492,441,twilight sparkle
1107200.jpeg,https://derpicdn.net/img/view/2016/3/12/1107200.jpeg,0,0.996351421,411,0,1477,913,1066,913,twilight sparkle
1107204.jpeg,https://derpicdn.net/img/view/2016/3/12/1107204.jpeg,0,0.99689275,0,293,406,711,406,418,twilight sparkle
1110952.jpeg,https://derpicdn.net/img/view/2016/3/17/1110952.jpeg,0,0.991990328,0,22,427,538,427,516,twilight sparkle
1110975.jpeg,https://derpicdn.net/img/view/2016/3/17/1110975.jpeg,0,0.998672187,647,48,1227,628,580,580,twilight sparkle
1112274.jpeg,https://derpicdn.net/img/view/2016/3/19/1112274.jpeg,0,0.973271728,550,363,934,747,384,384,twilight sparkle
1112281.jpeg,https://derpicdn.net/img/view/2016/3/19/1112281.jpeg,0,0.950311244,439,562,729,852,290,290,twilight sparkle
1112298.jpeg,https://derpicdn.net/img/view/2016/3/19/1112298.jpeg,0,0.967926443,308,190,636,518,328,328,twilight sparkle
1113182.jpeg,https://derpicdn.net/img/view/2016/3/20/1113182.jpeg,0,0.98481822,191,453,2843,3105,2652,2652,twilight sparkle
1116400.jpeg,https://derpicdn.net/img/view/2016/3/25/1116400.jpeg,0,0.94375509,452,9,948,505,496,496,twilight sparkle
1117371.jpeg,https://derpicdn.net/img/view/2016/3/26/1117371.jpeg,0,0.987884998,609,0,2997,1688,2388,1688,twilight sparkle
1117568.jpeg,https://derpicdn.net/img/view/2016/3/26/1117568.jpeg,0,0.998887897,434,453,720,739,286,286,twilight sparkle
1117646.jpeg,https://derpicdn.net/img/view/2016/3/26/1117646.jpeg,0,0.983131349,1527,384,2013,870,486,486,twilight sparkle
1122320.jpeg,https://derpicdn.net/img/view/2016/4/2/1122320.jpeg,0,0.989385307,147,7,599,459,452,452,twilight sparkle
1123248.jpeg,https://derpicdn.net/img/view/2016/4/3/1123248.jpeg,0,0.987561703,300,37,1242,979,942,942,twilight sparkle
1123249.jpeg,https://derpicdn.net/img/view/2016/4/3/1123249.jpeg,0,0.953341603,131,14,843,726,712,712,twilight sparkle
1123775.jpeg,https://derpicdn.net/img/view/2016/4/3/1123775.jpeg,0,0.952635229,0,71,814,975,814,904,twilight sparkle
1128503.jpeg,https://derpicdn.net/img/view/2016/4/9/1128503.jpeg,0,0.993167162,3172,329,5370,2527,2198,2198,twilight sparkle
1128930.jpeg,https://derpicdn.net/img/view/2016/4/10/1128930.jpeg,0,0.995120943,528,86,962,520,434,434,twilight sparkle
1129453.jpeg,https://derpicdn.net/img/view/2016/4/10/1129453.jpeg,0,0.91710633,20,109,1112,1201,1092,1092,twilight sparkle
1129858.jpeg,https://derpicdn.net/img/view/2016/4/11/1129858.jpeg,0,0.975022495,0,0,1358,1445,1358,1445,twilight sparkle
1129859.jpeg,https://derpicdn.net/img/view/2016/4/11/1129859.jpeg,0,0.922917187,291,0,1859,1080,1568,1080,twilight sparkle
1131778.jpeg,https://derpicdn.net/img/view/2016/4/14/1131778.jpeg,0,0.993349016,326,137,638,449,312,312,twilight sparkle
1131778.jpeg,https://derpicdn.net/img/view/2016/4/14/1131778.jpeg,1,0.993084788,789,364,1024,620,235,256,twilight sparkle
1137699.jpeg,https://derpicdn.net/img/view/2016/4/22/1137699.jpeg,0,0.941310883,46,0,618,548,572,548,twilight sparkle
1138221.jpeg,https://derpicdn.net/img/view/2016/4/23/1138221.jpeg,0,0.986714423,216,26,948,758,732,732,twilight sparkle
1138666.jpeg,https://derpicdn.net/img/view/2016/4/23/1138666.jpeg,0,0.985219896,127,0,561,406,434,406,twilight sparkle
1139346.jpeg,https://derpicdn.net/img/view/2016/4/24/1139346.jpeg,0,0.997804463,389,40,761,412,372,372,twilight sparkle
1140911.jpeg,https://derpicdn.net/img/view/2016/4/27/1140911.jpeg,0,0.912305951,47,0,587,559,540,559,twilight sparkle
1142619.jpeg,https://derpicdn.net/img/view/2016/4/29/1142619.jpeg,0,0.994231105,148,0,1024,778,876,778,twilight sparkle
1151885.jpeg,https://derpicdn.net/img/view/2016/5/11/1151885.jpeg,0,0.993837893,626,0,1194,528,568,528,twilight sparkle
1157762.jpeg,https://derpicdn.net/img/view/2016/5/19/1157762.jpeg,0,0.995895684,471,0,1659,1020,1188,1020,twilight sparkle
1168554.jpeg,https://derpicdn.net/img/view/2016/6/2/1168554.jpeg,0,0.993247628,141,142,471,472,330,330,twilight sparkle
1172590.jpeg,https://derpicdn.net/img/view/2016/6/7/1172590.jpeg,0,0.999165058,590,0,946,345,356,345,twilight sparkle
1178648.jpeg,https://derpicdn.net/img/view/2016/6/15/1178648.jpeg,0,0.964712739,905,1024,1209,1328,304,304,twilight sparkle
1183204.jpeg,https://derpicdn.net/img/view/2016/6/21/1183204.jpeg,0,0.989813268,1049,164,1813,928,764,764,twilight sparkle
1183389.jpeg,https://derpicdn.net/img/view/2016/6/21/1183389.jpeg,0,0.981294155,163,27,895,759,732,732,twilight sparkle
1184884.jpeg,https://derpicdn.net/img/view/2016/6/23/1184884.jpeg,0,0.945450544,106,135,470,499,364,364,twilight sparkle
1185654.jpeg,https://derpicdn.net/img/view/2016/6/24/1185654.jpeg,0,0.920933485,1404,824,2834,2254,1430,1430,twilight sparkle
1188566.jpeg,https://derpicdn.net/img/view/2016/6/28/1188566.jpeg,0,0.994509041,448,0,897,463,449,463,twilight sparkle
1190875.jpeg,https://derpicdn.net/img/view/2016/7/1/1190875.jpeg,0,0.997481048,860,189,1654,983,794,794,twilight sparkle
1191581.jpeg,https://derpicdn.net/img/view/2016/7/2/1191581.jpeg,0,0.959467471,0,83,243,327,243,244,twilight sparkle
1192916.jpeg,https://derpicdn.net/img/view/2016/7/4/1192916.jpeg,0,0.910166085,367,21,881,535,514,514,twilight sparkle
1194708.jpeg,https://derpicdn.net/img/view/2016/7/6/1194708.jpeg,0,0.967806756,263,135,423,295,160,160,twilight sparkle
1194708.jpeg,https://derpicdn.net/img/view/2016/7/6/1194708.jpeg,1,0.941674113,651,59,893,301,242,242,twilight sparkle
1195360.jpeg,https://derpicdn.net/img/view/2016/7/7/1195360.jpeg,0,0.996670604,322,0,850,528,528,528,twilight sparkle
1195385.jpeg,https://derpicdn.net/img/view/2016/7/7/1195385.jpeg,0,0.998714089,415,26,1083,694,668,668,twilight sparkle
1196257.jpeg,https://derpicdn.net/img/view/2016/7/8/1196257.jpeg,0,0.945198298,416,49,998,631,582,582,twilight sparkle
1196607.jpeg,https://derpicdn.net/img/view/2016/7/9/1196607.jpeg,0,0.958384216,291,6,603,318,312,312,twilight sparkle
1196607.jpeg,https://derpicdn.net/img/view/2016/7/9/1196607.jpeg,1,0.954741776,121,111,425,415,304,304,twilight sparkle
1200169.jpeg,https://derpicdn.net/img/view/2016/7/13/1200169.jpeg,0,0.985384703,190,0,1794,1532,1604,1532,twilight sparkle
1206235.jpeg,https://derpicdn.net/img/view/2016/7/21/1206235.jpeg,0,0.984290242,193,61,495,363,302,302,twilight sparkle
1210076.jpeg,https://derpicdn.net/img/view/2016/7/27/1210076.jpeg,0,0.918452382,252,113,1068,929,816,816,twilight sparkle
1215507.jpeg,https://derpicdn.net/img/view/2016/8/2/1215507.jpeg,0,0.965553403,38,0,448,406,410,406,twilight sparkle
1215519.jpeg,https://derpicdn.net/img/view/2016/8/2/1215519.jpeg,0,0.996213734,2047,500,5099,3552,3052,3052,twilight sparkle
1218765.jpeg,https://derpicdn.net/img/view/2016/8/6/1218765.jpeg,0,0.961906016,165,29,409,273,244,244,twilight sparkle
1218897.jpeg,https://derpicdn.net/img/view/2016/8/6/1218897.jpeg,0,0.999265909,150,30,520,400,370,370,twilight sparkle
1219298.jpeg,https://derpicdn.net/img/view/2016/8/7/1219298.jpeg,0,0.980271399,109,0,651,542,542,542,twilight sparkle
1219716.jpeg,https://derpicdn.net/img/view/2016/8/7/1219716.jpeg,0,0.987801611,489,129,825,465,336,336,twilight sparkle
1226802.jpeg,https://derpicdn.net/img/view/2016/8/16/1226802.jpeg,0,0.956418812,585,222,1071,708,486,486,twilight sparkle
1227198.jpeg,https://derpicdn.net/img/view/2016/8/17/1227198.jpeg,0,0.984897673,78,28,1232,1182,1154,1154,twilight sparkle
1227879.jpeg,https://derpicdn.net/img/view/2016/8/18/1227879.jpeg,0,0.997827649,195,0,561,359,366,359,twilight sparkle
1228704.jpeg,https://derpicdn.net/img/view/2016/8/19/1228704.jpeg,0,0.998238862,418,116,730,428,312,312,twilight sparkle
1231134.jpeg,https://derpicdn.net/img/view/2016/8/22/1231134.jpeg,0,0.995601594,206,53,556,403,350,350,twilight sparkle
1231978.jpeg,https://derpicdn.net/img/view/2016/8/23/1231978.jpeg,0,0.997969031,661,352,1643,1334,982,982,twilight sparkle
1232989.jpeg,https://derpicdn.net/img/view/2016/8/24/1232989.jpeg,0,0.990360141,33,0,745,674,712,674,twilight sparkle
1233325.jpeg,https://derpicdn.net/img/view/2016/8/25/1233325.jpeg,0,0.936055899,208,430,600,822,392,392,twilight sparkle
1234788.jpeg,https://derpicdn.net/img/view/2016/8/27/1234788.jpeg,0,0.951866984,234,63,838,667,604,604,twilight sparkle
1237652.jpeg,https://derpicdn.net/img/view/2016/8/30/1237652.jpeg,0,0.99676609,453,273,773,593,320,320,twilight sparkle
1240286.jpeg,https://derpicdn.net/img/view/2016/9/2/1240286.jpeg,0,0.99097383,282,84,636,438,354,354,twilight sparkle
1240886.jpeg,https://derpicdn.net/img/view/2016/9/3/1240886.jpeg,1,0.961938381,1503,335,1759,591,256,256,twilight sparkle
1243037.jpeg,https://derpicdn.net/img/view/2016/9/6/1243037.jpeg,0,0.963590026,439,531,1015,1107,576,576,twilight sparkle
1243133.jpeg,https://derpicdn.net/img/view/2016/9/6/1243133.jpeg,0,0.95484823,573,236,2851,2514,2278,2278,twilight sparkle
1244343.jpeg,https://derpicdn.net/img/view/2016/9/7/1244343.jpeg,0,0.987175584,1195,841,2007,1653,812,812,twilight sparkle
1244574.jpeg,https://derpicdn.net/img/view/2016/9/8/1244574.jpeg,0,0.993566811,191,287,1059,1155,868,868,twilight sparkle
1244810.jpeg,https://derpicdn.net/img/view/2016/9/8/1244810.jpeg,0,0.909531653,96,387,2884,3175,2788,2788,twilight sparkle
1246990.jpeg,https://derpicdn.net/img/view/2016/9/11/1246990.jpeg,0,0.990650594,0,0,595,623,595,623,twilight sparkle
1250284.jpeg,https://derpicdn.net/img/view/2016/9/16/1250284.jpeg,0,0.949800611,7,0,385,334,378,334,twilight sparkle
1254647.jpeg,https://derpicdn.net/img/view/2016/9/21/1254647.jpeg,0,0.934661269,206,221,518,533,312,312,twilight sparkle
1255572.jpeg,https://derpicdn.net/img/view/2016/9/22/1255572.jpeg,0,0.97372824,628,251,1788,1411,1160,1160,twilight sparkle
1255750.jpeg,https://derpicdn.net/img/view/2016/9/22/1255750.jpeg,0,0.988733232,267,25,600,359,333,334,twilight sparkle
1255754.jpeg,https://derpicdn.net/img/view/2016/9/22/1255754.jpeg,0,0.994686484,271,29,597,355,326,326,twilight sparkle
1258873.jpeg,https://derpicdn.net/img/view/2016/9/26/1258873.jpeg,0,0.975874424,94,17,826,749,732,732,twilight sparkle
1262016.jpeg,https://derpicdn.net/img/view/2016/10/1/1262016.jpeg,0,0.983098209,76,0,574,422,498,422,twilight sparkle
1265009.jpeg,https://derpicdn.net/img/view/2016/10/4/1265009.jpeg,0,0.996948302,195,0,827,630,632,630,twilight sparkle
1265136.jpeg,https://derpicdn.net/img/view/2016/10/4/1265136.jpeg,0,0.979856789,212,0,536,322,324,322,twilight sparkle
1269662.jpeg,https://derpicdn.net/img/view/2016/10/10/1269662.jpeg,0,0.997198403,180,0,592,390,412,390,twilight sparkle
1270734.jpeg,https://derpicdn.net/img/view/2016/10/11/1270734.jpeg,0,0.996764123,321,0,1719,1378,1398,1378,twilight sparkle
1271017.jpeg,https://derpicdn.net/img/view/2016/10/12/1271017.jpeg,0,0.986836314,212,24,974,786,762,762,twilight sparkle
1272621.jpeg,https://derpicdn.net/img/view/2016/10/14/1272621.jpeg,0,0.963160455,1907,531,2527,1151,620,620,twilight sparkle
1279133.jpeg,https://derpicdn.net/img/view/2016/10/22/1279133.jpeg,0,0.962953269,130,61,1280,1229,1150,1168,twilight sparkle
1279134.jpeg,https://derpicdn.net/img/view/2016/10/22/1279134.jpeg,0,0.965454936,23,0,697,552,674,552,twilight sparkle
1283177.jpeg,https://derpicdn.net/img/view/2016/10/28/1283177.jpeg,0,0.991845429,486,0,1956,1406,1470,1406,twilight sparkle
1285465.jpeg,https://derpicdn.net/img/view/2016/10/31/1285465.jpeg,0,0.954751074,191,27,597,433,406,406,twilight sparkle
1285803.jpeg,https://derpicdn.net/img/view/2016/10/31/1285803.jpeg,0,0.982306302,1602,0,3346,1555,1744,1555,twilight sparkle
1288182.jpeg,https://derpicdn.net/img/view/2016/11/3/1288182.jpeg,0,0.92415309,964,209,2160,1405,1196,1196,twilight sparkle
1288321.jpeg,https://derpicdn.net/img/view/2016/11/4/1288321.jpeg,0,0.981607914,80,128,1276,1324,1196,1196,twilight sparkle
1288412.jpeg,https://derpicdn.net/img/view/2016/11/4/1288412.jpeg,0,0.926355004,347,190,983,826,636,636,twilight sparkle
1289602.jpeg,https://derpicdn.net/img/view/2016/11/5/1289602.jpeg,1,0.971429169,403,0,817,368,414,368,twilight sparkle
1290870.jpeg,https://derpicdn.net/img/view/2016/11/7/1290870.jpeg,0,0.994454682,1238,363,2960,2085,1722,1722,twilight sparkle
1299431.jpeg,https://derpicdn.net/img/view/2016/11/20/1299431.jpeg,0,0.939053118,418,0,1568,913,1150,913,twilight sparkle
1301267.jpeg,https://derpicdn.net/img/view/2016/11/22/1301267.jpeg,0,0.947641075,378,175,1370,1167,992,992,twilight sparkle
1303576.jpeg,https://derpicdn.net/img/view/2016/11/25/1303576.jpeg,0,0.997398019,108,0,584,468,476,468,twilight sparkle
1304184.jpeg,https://derpicdn.net/img/view/2016/11/26/1304184.jpeg,0,0.991279066,167,0,688,464,521,464,twilight sparkle
1304557.jpeg,https://derpicdn.net/img/view/2016/11/27/1304557.jpeg,0,0.964243293,62,3,378,319,316,316,twilight sparkle
1306130.jpeg,https://derpicdn.net/img/view/2016/11/29/1306130.jpeg,0,0.974866092,0,15,1024,1185,1024,1170,twilight sparkle
1306674.jpeg,https://derpicdn.net/img/view/2016/11/30/1306674.jpeg,0,0.931136131,221,0,501,259,280,259,twilight sparkle
1306835.jpeg,https://derpicdn.net/img/view/2016/11/30/1306835.jpeg,0,0.962806225,129,680,443,994,314,314,twilight sparkle
1311169.jpeg,https://derpicdn.net/img/view/2016/12/6/1311169.jpeg,0,0.986594379,2647,11,4429,1793,1782,1782,twilight sparkle
1312446.jpeg,https://derpicdn.net/img/view/2016/12/8/1312446.jpeg,0,0.998172402,217,40,365,188,148,148,twilight sparkle
1316832.jpeg,https://derpicdn.net/img/view/2016/12/13/1316832.jpeg,0,0.970733225,0,0,383,371,383,371,twilight sparkle
1318358.jpeg,https://derpicdn.net/img/view/2016/12/15/1318358.jpeg,0,0.981113791,0,61,1080,1323,1080,1262,twilight sparkle
1319000.jpeg,https://derpicdn.net/img/view/2016/12/16/1319000.jpeg,0,0.999259651,33,0,319,282,286,282,twilight sparkle
1319432.jpeg,https://derpicdn.net/img/view/2016/12/17/1319432.jpeg,0,0.997439563,370,0,832,427,462,427,twilight sparkle
1319987.jpeg,https://derpicdn.net/img/view/2016/12/18/1319987.jpeg,0,0.983949006,0,17,686,723,686,706,twilight sparkle
1320537.jpeg,https://derpicdn.net/img/view/2016/12/19/1320537.jpeg,0,0.979604244,987,0,1705,676,718,676,twilight sparkle
1320538.jpeg,https://derpicdn.net/img/view/2016/12/19/1320538.jpeg,0,0.981604338,984,0,1656,658,672,658,twilight sparkle
1320898.jpeg,https://derpicdn.net/img/view/2016/12/19/1320898.jpeg,0,0.961667597,95,63,439,407,344,344,twilight sparkle
1321593.jpeg,https://derpicdn.net/img/view/2016/12/20/1321593.jpeg,0,0.933438897,17,57,403,443,386,386,twilight sparkle
1322002.jpeg,https://derpicdn.net/img/view/2016/12/21/1322002.jpeg,0,0.965082049,781,0,1757,907,976,907,twilight sparkle
1322066.jpeg,https://derpicdn.net/img/view/2016/12/21/1322066.jpeg,0,0.969364524,27,0,1321,1274,1294,1274,twilight sparkle
1322899.jpeg,https://derpicdn.net/img/view/2016/12/22/1322899.jpeg,0,0.976160526,49,0,709,613,660,613,twilight sparkle
1326843.jpeg,https://derpicdn.net/img/view/2016/12/28/1326843.jpeg,0,0.990439773,50,4,190,144,140,140,twilight sparkle
1327313.jpeg,https://derpicdn.net/img/view/2016/12/29/1327313.jpeg,0,0.999309778,1897,315,3387,1805,1490,1490,twilight sparkle
1330596.jpeg,https://derpicdn.net/img/view/2017/1/2/1330596.jpeg,0,0.941420257,684,372,2532,2220,1848,1848,twilight sparkle
1331963.jpeg,https://derpicdn.net/img/view/2017/1/4/1331963.jpeg,0,0.99675262,320,31,1270,981,950,950,twilight sparkle
1334355.jpeg,https://derpicdn.net/img/view/2017/1/7/1334355.jpeg,0,0.970141172,114,43,458,387,344,344,twilight sparkle
1335048.jpeg,https://derpicdn.net/img/view/2017/1/8/1335048.jpeg,0,0.99649328,253,20,547,314,294,294,twilight sparkle
1337309.jpeg,https://derpicdn.net/img/view/2017/1/11/1337309.jpeg,0,0.9855178,323,85,2102,1937,1779,1852,twilight sparkle
1339908.jpeg,https://derpicdn.net/img/view/2017/1/15/1339908.jpeg,0,0.998102903,329,0,1857,1459,1528,1459,twilight sparkle
1340990.jpeg,https://derpicdn.net/img/view/2017/1/16/1340990.jpeg,0,0.988190472,449,17,737,305,288,288,twilight sparkle
1341109.jpeg,https://derpicdn.net/img/view/2017/1/17/1341109.jpeg,0,0.988980293,1324,0,2374,960,1050,960,twilight sparkle
1341805.jpeg,https://derpicdn.net/img/view/2017/1/18/1341805.jpeg,0,0.918954968,619,13,1027,421,408,408,twilight sparkle
1341832.jpeg,https://derpicdn.net/img/view/2017/1/18/1341832.jpeg,1,0.932180822,566,832,1436,1702,870,870,twilight sparkle
1342830.jpeg,https://derpicdn.net/img/view/2017/1/19/1342830.jpeg,0,0.98168838,1215,555,2721,2061,1506,1506,twilight sparkle
1344965.jpeg,https://derpicdn.net/img/view/2017/1/22/1344965.jpeg,0,0.99600184,588,0,2228,1574,1640,1574,twilight sparkle
1346171.jpeg,https://derpicdn.net/img/view/2017/1/23/1346171.jpeg,0,0.99178797,19,164,2000,2000,1981,1836,twilight sparkle
1347089.jpeg,https://derpicdn.net/img/view/2017/1/24/1347089.jpeg,0,0.919864118,132,0,764,536,632,536,twilight sparkle
1349707.jpeg,https://derpicdn.net/img/view/2017/1/28/1349707.jpeg,0,0.998117864,87,23,419,355,332,332,twilight sparkle
1352113.jpeg,https://derpicdn.net/img/view/2017/1/31/1352113.jpeg,0,0.999104679,602,51,826,275,224,224,twilight sparkle
1352113.jpeg,https://derpicdn.net/img/view/2017/1/31/1352113.jpeg,1,0.997513056,0,0,258,260,258,260,twilight sparkle
1352113.jpeg,https://derpicdn.net/img/view/2017/1/31/1352113.jpeg,2,0.986855924,244,7,482,245,238,238,twilight sparkle
1352826.jpeg,https://derpicdn.net/img/view/2017/2/1/1352826.jpeg,0,0.984235764,359,0,933,572,574,572,twilight sparkle
1352834.jpeg,https://derpicdn.net/img/view/2017/2/1/1352834.jpeg,0,0.988983989,361,0,935,572,574,572,twilight sparkle
1357725.jpeg,https://derpicdn.net/img/view/2017/2/8/1357725.jpeg,0,0.971985102,133,20,677,564,544,544,twilight sparkle
1359148.jpeg,https://derpicdn.net/img/view/2017/2/10/1359148.jpeg,0,0.995782018,9,0,867,708,858,708,twilight sparkle
1361979.jpeg,https://derpicdn.net/img/view/2017/2/13/1361979.jpeg,0,0.990893364,395,0,1025,624,630,624,twilight sparkle
1362714.jpeg,https://derpicdn.net/img/view/2017/2/14/1362714.jpeg,0,0.989890575,329,0,1343,991,1014,991,twilight sparkle
1364487.jpeg,https://derpicdn.net/img/view/2017/2/16/1364487.jpeg,0,0.96274966,0,45,2235,2781,2235,2736,twilight sparkle
1366423.jpeg,https://derpicdn.net/img/view/2017/2/18/1366423.jpeg,0,0.998944581,366,25,1286,945,920,920,twilight sparkle
1367256.jpeg,https://derpicdn.net/img/view/2017/2/19/1367256.jpeg,0,0.984656215,0,0,692,643,692,643,twilight sparkle
1368951.jpeg,https://derpicdn.net/img/view/2017/2/21/1368951.jpeg,0,0.992085159,250,58,680,488,430,430,twilight sparkle
1370170.jpeg,https://derpicdn.net/img/view/2017/2/22/1370170.jpeg,0,0.99850589,804,0,1582,744,778,744,twilight sparkle
1372665.jpeg,https://derpicdn.net/img/view/2017/2/25/1372665.jpeg,0,0.944222152,393,5,811,423,418,418,twilight sparkle
1373193.jpeg,https://derpicdn.net/img/view/2017/2/25/1373193.jpeg,0,0.995271981,126,967,566,1407,440,440,twilight sparkle
1373390.jpeg,https://derpicdn.net/img/view/2017/2/26/1373390.jpeg,0,0.962611496,0,47,594,685,594,638,twilight sparkle
1374415.jpeg,https://derpicdn.net/img/view/2017/2/27/1374415.jpeg,0,0.963738203,162,30,724,592,562,562,twilight sparkle
1376629.jpeg,https://derpicdn.net/img/view/2017/3/1/1376629.jpeg,0,0.992681623,466,129,922,585,456,456,twilight sparkle
1376711.jpeg,https://derpicdn.net/img/view/2017/3/1/1376711.jpeg,0,0.993270755,206,0,968,748,762,748,twilight sparkle
1377001.jpeg,https://derpicdn.net/img/view/2017/3/2/1377001.jpeg,0,0.943039596,760,223,1368,831,608,608,twilight sparkle
1380782.jpeg,https://derpicdn.net/img/view/2017/3/6/1380782.jpeg,0,0.997148275,355,0,1325,968,970,968,twilight sparkle
1380829.jpeg,https://derpicdn.net/img/view/2017/3/6/1380829.jpeg,0,0.983408093,473,4,893,424,420,420,twilight sparkle
1381517.jpeg,https://derpicdn.net/img/view/2017/3/7/1381517.jpeg,0,0.999527454,383,0,671,285,288,285,twilight sparkle
1382978.jpeg,https://derpicdn.net/img/view/2017/3/9/1382978.jpeg,0,0.982266068,349,66,853,570,504,504,twilight sparkle
1383456.jpeg,https://derpicdn.net/img/view/2017/3/10/1383456.jpeg,0,0.980047584,204,11,434,241,230,230,twilight sparkle
1384438.jpeg,https://derpicdn.net/img/view/2017/3/11/1384438.jpeg,0,0.994386971,378,0,1000,540,622,540,twilight sparkle
1385063.jpeg,https://derpicdn.net/img/view/2017/3/12/1385063.jpeg,0,0.981951058,0,25,298,389,298,364,twilight sparkle
1385063.jpeg,https://derpicdn.net/img/view/2017/3/12/1385063.jpeg,1,0.956569552,0,0,311,355,311,355,twilight sparkle
1385143.jpeg,https://derpicdn.net/img/view/2017/3/12/1385143.jpeg,0,0.993066788,432,18,808,394,376,376,twilight sparkle
1386340.jpeg,https://derpicdn.net/img/view/2017/3/13/1386340.jpeg,0,0.991172314,114,0,628,485,514,485,twilight sparkle
1386443.jpeg,https://derpicdn.net/img/view/2017/3/13/1386443.jpeg,0,0.989742458,270,0,1562,1151,1292,1151,twilight sparkle
1386988.jpeg,https://derpicdn.net/img/view/2017/3/14/1386988.jpeg,0,0.99695909,587,86,1391,890,804,804,twilight sparkle
1390390.jpeg,https://derpicdn.net/img/view/2017/3/18/1390390.jpeg,0,0.95142442,306,293,872,859,566,566,twilight sparkle
1391358.jpeg,https://derpicdn.net/img/view/2017/3/19/1391358.jpeg,0,0.981748998,7,0,701,641,694,641,twilight sparkle
1392802.jpeg,https://derpicdn.net/img/view/2017/3/21/1392802.jpeg,0,0.966113806,383,43,937,597,554,554,twilight sparkle
1393235.jpeg,https://derpicdn.net/img/view/2017/3/21/1393235.jpeg,0,0.975875795,0,0,512,634,512,634,twilight sparkle
1395341.jpeg,https://derpicdn.net/img/view/2017/3/24/1395341.jpeg,0,0.991752803,204,29,550,375,346,346,twilight sparkle
1397227.jpeg,https://derpicdn.net/img/view/2017/3/26/1397227.jpeg,0,0.987152517,887,957,3385,3455,2498,2498,twilight sparkle
1397591.jpeg,https://derpicdn.net/img/view/2017/3/27/1397591.jpeg,0,0.906007767,1058,0,2634,1505,1576,1505,twilight sparkle
1398480.jpeg,https://derpicdn.net/img/view/2017/3/28/1398480.jpeg,1,0.91565901,1135,0,2089,923,954,923,twilight sparkle
1398641.jpeg,https://derpicdn.net/img/view/2017/3/28/1398641.jpeg,0,0.967889965,493,0,1243,721,750,721,twilight sparkle
1401568.jpeg,https://derpicdn.net/img/view/2017/4/1/1401568.jpeg,0,0.994978487,2514,1262,3168,1916,654,654,twilight sparkle
1401790.jpeg,https://derpicdn.net/img/view/2017/4/2/1401790.jpeg,0,0.980534077,197,78,699,580,502,502,twilight sparkle
1402870.jpeg,https://derpicdn.net/img/view/2017/4/3/1402870.jpeg,0,0.971614659,0,0,883,986,883,986,twilight sparkle
1404052.jpeg,https://derpicdn.net/img/view/2017/4/4/1404052.jpeg,0,0.998400688,11,282,249,520,238,238,twilight sparkle
1404052.jpeg,https://derpicdn.net/img/view/2017/4/4/1404052.jpeg,1,0.987447262,726,434,1106,814,380,380,twilight sparkle
1404052.jpeg,https://derpicdn.net/img/view/2017/4/4/1404052.jpeg,2,0.949233174,507,259,753,505,246,246,twilight sparkle
1406138.jpeg,https://derpicdn.net/img/view/2017/4/7/1406138.jpeg,0,0.980312526,261,0,709,394,448,394,twilight sparkle
1406870.jpeg,https://derpicdn.net/img/view/2017/4/8/1406870.jpeg,0,0.996283054,2444,467,3452,1475,1008,1008,twilight sparkle
1406870.jpeg,https://derpicdn.net/img/view/2017/4/8/1406870.jpeg,1,0.923605144,0,188,1828,2088,1828,1900,twilight sparkle
1407604.jpeg,https://derpicdn.net/img/view/2017/4/9/1407604.jpeg,0,0.993898153,50,0,258,197,208,197,twilight sparkle
1412973.jpeg,https://derpicdn.net/img/view/2017/4/16/1412973.jpeg,0,0.927439153,198,44,726,572,528,528,twilight sparkle
1414362.jpeg,https://derpicdn.net/img/view/2017/4/17/1414362.jpeg,0,0.998568773,302,10,622,330,320,320,twilight sparkle
1414704.jpeg,https://derpicdn.net/img/view/2017/4/18/1414704.jpeg,0,0.933359206,237,179,639,581,402,402,twilight sparkle
1417548.jpeg,https://derpicdn.net/img/view/2017/4/21/1417548.jpeg,0,0.987445116,343,5,1225,887,882,882,twilight sparkle
1417856.jpeg,https://derpicdn.net/img/view/2017/4/21/1417856.jpeg,0,0.99889636,257,39,649,431,392,392,twilight sparkle
1418672.jpeg,https://derpicdn.net/img/view/2017/4/22/1418672.jpeg,0,0.982519925,48,0,756,690,708,690,twilight sparkle
1422655.jpeg,https://derpicdn.net/img/view/2017/4/27/1422655.jpeg,0,0.958976626,0,0,898,792,898,792,twilight sparkle
1423345.jpeg,https://derpicdn.net/img/view/2017/4/28/1423345.jpeg,0,0.998890162,330,414,1702,1786,1372,1372,twilight sparkle
1423630.jpeg,https://derpicdn.net/img/view/2017/4/28/1423630.jpeg,0,0.97309494,171,113,773,715,602,602,twilight sparkle
1426314.jpeg,https://derpicdn.net/img/view/2017/5/1/1426314.jpeg,0,0.926753521,0,0,1141,1167,1141,1167,twilight sparkle
1426406.jpeg,https://derpicdn.net/img/view/2017/5/1/1426406.jpeg,0,0.976121366,517,72,959,514,442,442,twilight sparkle
1426406.jpeg,https://derpicdn.net/img/view/2017/5/1/1426406.jpeg,1,0.959718525,0,67,456,543,456,476,twilight sparkle
1427588.jpeg,https://derpicdn.net/img/view/2017/5/3/1427588.jpeg,0,0.900770783,403,130,873,600,470,470,twilight sparkle
1427964.jpeg,https://derpicdn.net/img/view/2017/5/3/1427964.jpeg,0,0.995689154,541,0,2599,1983,2058,1983,twilight sparkle
1429670.jpeg,https://derpicdn.net/img/view/2017/5/6/1429670.jpeg,0,0.916650057,568,662,1302,1396,734,734,twilight sparkle
1432654.jpeg,https://derpicdn.net/img/view/2017/5/9/1432654.jpeg,0,0.997990668,205,69,863,727,658,658,twilight sparkle
1435570.jpeg,https://derpicdn.net/img/view/2017/5/13/1435570.jpeg,0,0.992736697,533,148,2145,1760,1612,1612,twilight sparkle
1437898.jpeg,https://derpicdn.net/img/view/2017/5/16/1437898.jpeg,0,0.992344499,611,0,2015,1304,1404,1304,twilight sparkle
1440151.jpeg,https://derpicdn.net/img/view/2017/5/19/1440151.jpeg,0,0.998936951,574,253,966,645,392,392,twilight sparkle
1440716.jpeg,https://derpicdn.net/img/view/2017/5/19/1440716.jpeg,0,0.984702289,176,0,1090,881,914,881,twilight sparkle
1441185.jpeg,https://derpicdn.net/img/view/2017/5/20/1441185.jpeg,0,0.958275974,619,0,897,268,278,268,twilight sparkle
1442608.jpeg,https://derpicdn.net/img/view/2017/5/21/1442608.jpeg,0,0.98848629,188,22,670,504,482,482,twilight sparkle
1442903.jpeg,https://derpicdn.net/img/view/2017/5/22/1442903.jpeg,0,0.998289585,562,45,1358,841,796,796,twilight sparkle
1443564.jpeg,https://derpicdn.net/img/view/2017/5/22/1443564.jpeg,0,0.989308774,366,0,1754,1076,1388,1076,twilight sparkle
1444696.jpeg,https://derpicdn.net/img/view/2017/5/24/1444696.jpeg,0,0.945599556,330,215,822,707,492,492,twilight sparkle
1445941.jpeg,https://derpicdn.net/img/view/2017/5/25/1445941.jpeg,0,0.986745656,665,253,975,563,310,310,twilight sparkle
1445941.jpeg,https://derpicdn.net/img/view/2017/5/25/1445941.jpeg,1,0.906698823,467,257,777,567,310,310,twilight sparkle
1447842.jpeg,https://derpicdn.net/img/view/2017/5/28/1447842.jpeg,0,0.982842445,242,8,552,318,310,310,twilight sparkle
1448184.jpeg,https://derpicdn.net/img/view/2017/5/28/1448184.jpeg,0,0.937867045,118,0,1268,889,1150,889,twilight sparkle
1448792.jpeg,https://derpicdn.net/img/view/2017/5/29/1448792.jpeg,0,0.998030365,43,42,733,732,690,690,twilight sparkle
1449590.jpeg,https://derpicdn.net/img/view/2017/5/30/1449590.jpeg,0,0.95238471,19,9,727,717,708,708,twilight sparkle
1450318.jpeg,https://derpicdn.net/img/view/2017/5/31/1450318.jpeg,0,0.97562784,0,0,2342,2419,2342,2419,twilight sparkle
1451301.jpeg,https://derpicdn.net/img/view/2017/6/1/1451301.jpeg,0,0.995984077,182,5,564,387,382,382,twilight sparkle
1452006.jpeg,https://derpicdn.net/img/view/2017/6/2/1452006.jpeg,0,0.925808072,590,90,1900,1300,1310,1210,twilight sparkle
1455982.jpeg,https://derpicdn.net/img/view/2017/6/7/1455982.jpeg,0,0.970381677,0,0,567,542,567,542,twilight sparkle
1456169.jpeg,https://derpicdn.net/img/view/2017/6/7/1456169.jpeg,0,0.997152746,340,126,1126,912,786,786,twilight sparkle
1456737.jpeg,https://derpicdn.net/img/view/2017/6/8/1456737.jpeg,0,0.998539567,226,0,586,334,360,334,twilight sparkle
1457790.jpeg,https://derpicdn.net/img/view/2017/6/9/1457790.jpeg,0,0.994256437,544,134,1400,1016,856,882,twilight sparkle
1458300.jpeg,https://derpicdn.net/img/view/2017/6/10/1458300.jpeg,0,0.991878271,538,206,1118,786,580,580,twilight sparkle
1459180.jpeg,https://derpicdn.net/img/view/2017/6/11/1459180.jpeg,1,0.994063258,69,237,713,881,644,644,twilight sparkle
1460325.jpeg,https://derpicdn.net/img/view/2017/6/12/1460325.jpeg,0,0.958412528,136,0,1250,1026,1114,1026,twilight sparkle
1465687.jpeg,https://derpicdn.net/img/view/2017/6/19/1465687.jpeg,0,0.99864465,620,79,974,433,354,354,twilight sparkle
1465687.jpeg,https://derpicdn.net/img/view/2017/6/19/1465687.jpeg,1,0.991117895,16,47,324,355,308,308,twilight sparkle
1465922.jpeg,https://derpicdn.net/img/view/2017/6/19/1465922.jpeg,0,0.989176989,209,44,2263,2098,2054,2054,twilight sparkle
1473637.jpeg,https://derpicdn.net/img/view/2017/6/28/1473637.jpeg,0,0.980406642,656,1217,1230,1791,574,574,twilight sparkle
1473660.jpeg,https://derpicdn.net/img/view/2017/6/28/1473660.jpeg,0,0.930274963,92,86,384,378,292,292,twilight sparkle
1474356.jpeg,https://derpicdn.net/img/view/2017/6/29/1474356.jpeg,0,0.979449391,57,180,371,494,314,314,twilight sparkle
1475049.jpeg,https://derpicdn.net/img/view/2017/6/30/1475049.jpeg,0,0.983919978,889,216,1359,686,470,470,twilight sparkle
1476862.jpeg,https://derpicdn.net/img/view/2017/7/2/1476862.jpeg,0,0.981244206,224,9,592,377,368,368,twilight sparkle
1477070.jpeg,https://derpicdn.net/img/view/2017/7/2/1477070.jpeg,0,0.986323357,309,21,929,641,620,620,twilight sparkle
1477096.jpeg,https://derpicdn.net/img/view/2017/7/2/1477096.jpeg,0,0.99644959,0,0,1548,1396,1548,1396,twilight sparkle
1477799.jpeg,https://derpicdn.net/img/view/2017/7/3/1477799.jpeg,0,0.994218946,398,8,2138,1748,1740,1740,twilight sparkle
1478719.jpeg,https://derpicdn.net/img/view/2017/7/5/1478719.jpeg,0,0.986484349,472,429,850,807,378,378,twilight sparkle
1484261.jpeg,https://derpicdn.net/img/view/2017/7/12/1484261.jpeg,0,0.973627329,6,0,544,531,538,531,twilight sparkle
1485537.jpeg,https://derpicdn.net/img/view/2017/7/13/1485537.jpeg,0,0.992649734,424,0,1606,1103,1182,1103,twilight sparkle
1485794.jpeg,https://derpicdn.net/img/view/2017/7/14/1485794.jpeg,0,0.984425664,2705,595,3627,1517,922,922,twilight sparkle
1487597.jpeg,https://derpicdn.net/img/view/2017/7/16/1487597.jpeg,0,0.993179202,188,28,574,414,386,386,twilight sparkle
1492140.jpeg,https://derpicdn.net/img/view/2017/7/22/1492140.jpeg,0,0.986144483,106,98,3368,3360,3262,3262,twilight sparkle
1493085.jpeg,https://derpicdn.net/img/view/2017/7/23/1493085.jpeg,0,0.950559437,5,21,859,875,854,854,twilight sparkle
1495345.jpeg,https://derpicdn.net/img/view/2017/7/26/1495345.jpeg,0,0.948191345,0,0,800,1005,800,1005,twilight sparkle
1496009.jpeg,https://derpicdn.net/img/view/2017/7/27/1496009.jpeg,0,0.99763453,388,0,1338,917,950,917,twilight sparkle
1496011.jpeg,https://derpicdn.net/img/view/2017/7/27/1496011.jpeg,0,0.977123916,512,9,990,487,478,478,twilight sparkle
1496890.jpeg,https://derpicdn.net/img/view/2017/7/28/1496890.jpeg,0,0.997037709,85,33,645,593,560,560,twilight sparkle
1497247.jpeg,https://derpicdn.net/img/view/2017/7/29/1497247.jpeg,0,0.998192132,840,0,1672,802,832,802,twilight sparkle
1498719.jpeg,https://derpicdn.net/img/view/2017/7/30/1498719.jpeg,0,0.978809297,85,446,2563,2908,2478,2462,twilight sparkle
1499353.jpeg,https://derpicdn.net/img/view/2017/7/31/1499353.jpeg,0,0.968723655,115,6,715,606,600,600,twilight sparkle
1500550.jpeg,https://derpicdn.net/img/view/2017/8/1/1500550.jpeg,0,0.997470796,367,0,1381,993,1014,993,twilight sparkle
1501571.jpeg,https://derpicdn.net/img/view/2017/8/3/1501571.jpeg,0,0.985426128,880,0,1712,818,832,818,twilight sparkle
1503967.jpeg,https://derpicdn.net/img/view/2017/8/6/1503967.jpeg,0,0.995024681,781,98,1369,686,588,588,twilight sparkle
1503967.jpeg,https://derpicdn.net/img/view/2017/8/6/1503967.jpeg,1,0.956487775,425,182,921,678,496,496,twilight sparkle
1504682.jpeg,https://derpicdn.net/img/view/2017/8/6/1504682.jpeg,0,0.970433593,283,85,1100,925,817,840,twilight sparkle
1505956.jpeg,https://derpicdn.net/img/view/2017/8/8/1505956.jpeg,0,0.997312903,85,4,445,364,360,360,twilight sparkle
1507388.jpeg,https://derpicdn.net/img/view/2017/8/10/1507388.jpeg,0,0.985329807,15,45,407,437,392,392,twilight sparkle
1507984.jpeg,https://derpicdn.net/img/view/2017/8/11/1507984.jpeg,0,0.91997385,868,0,1870,994,1002,994,twilight sparkle
1512309.jpeg,https://derpicdn.net/img/view/2017/8/16/1512309.jpeg,0,0.963048339,118,47,616,545,498,498,twilight sparkle
1512875.jpeg,https://derpicdn.net/img/view/2017/8/17/1512875.jpeg,0,0.986701548,464,0,992,493,528,493,twilight sparkle
1515261.jpeg,https://derpicdn.net/img/view/2017/8/20/1515261.jpeg,0,0.970602632,94,887,666,1459,572,572,twilight sparkle
1517326.jpeg,https://derpicdn.net/img/view/2017/8/22/1517326.jpeg,0,0.901269078,523,139,1047,663,524,524,twilight sparkle
1517759.jpeg,https://derpicdn.net/img/view/2017/8/23/1517759.jpeg,0,0.994011879,331,18,1133,820,802,802,twilight sparkle
1517867.jpeg,https://derpicdn.net/img/view/2017/8/23/1517867.jpeg,0,0.959762573,82,74,876,868,794,794,twilight sparkle
1519335.jpeg,https://derpicdn.net/img/view/2017/8/25/1519335.jpeg,0,0.926000893,339,0,1659,1055,1320,1055,twilight sparkle
1519433.jpeg,https://derpicdn.net/img/view/2017/8/25/1519433.jpeg,0,0.990741551,422,0,1260,828,838,828,twilight sparkle
1519704.jpeg,https://derpicdn.net/img/view/2017/8/25/1519704.jpeg,0,0.998941839,1226,48,1932,754,706,706,twilight sparkle
1520854.jpeg,https://derpicdn.net/img/view/2017/8/27/1520854.jpeg,0,0.99491924,456,0,974,511,518,511,twilight sparkle
1521171.jpeg,https://derpicdn.net/img/view/2017/8/27/1521171.jpeg,0,0.997101963,348,0,3046,2614,2698,2614,twilight sparkle
1524096.jpeg,https://derpicdn.net/img/view/2017/8/31/1524096.jpeg,0,0.998606503,883,0,1671,765,788,765,twilight sparkle
1524096.jpeg,https://derpicdn.net/img/view/2017/8/31/1524096.jpeg,1,0.988006473,89,653,493,1057,404,404,twilight sparkle
1524377.jpeg,https://derpicdn.net/img/view/2017/8/31/1524377.jpeg,0,0.985424042,292,0,2000,1713,1708,1713,twilight sparkle
1524377.jpeg,https://derpicdn.net/img/view/2017/8/31/1524377.jpeg,1,0.936852157,0,100,1510,1656,1510,1556,twilight sparkle
1524671.jpeg,https://derpicdn.net/img/view/2017/8/31/1524671.jpeg,0,0.960187554,498,0,843,334,345,334,twilight sparkle
1524671.jpeg,https://derpicdn.net/img/view/2017/8/31/1524671.jpeg,1,0.959732413,16,96,254,334,238,238,twilight sparkle
1525495.jpeg,https://derpicdn.net/img/view/2017/9/2/1525495.jpeg,0,0.944614828,2257,0,4000,1533,1743,1533,twilight sparkle
1525731.jpeg,https://derpicdn.net/img/view/2017/9/2/1525731.jpeg,0,0.998781025,315,21,613,319,298,298,twilight sparkle
1525733.jpeg,https://derpicdn.net/img/view/2017/9/2/1525733.jpeg,0,0.997527957,180,77,534,431,354,354,twilight sparkle
1526756.jpeg,https://derpicdn.net/img/view/2017/9/3/1526756.jpeg,0,0.996331096,1747,133,2435,821,688,688,twilight sparkle
1529615.jpeg,https://derpicdn.net/img/view/2017/9/6/1529615.jpeg,0,0.973398149,665,38,1077,450,412,412,twilight sparkle
1532798.jpeg,https://derpicdn.net/img/view/2017/9/11/1532798.jpeg,0,0.978619277,125,0,417,257,292,257,twilight sparkle
1535041.jpeg,https://derpicdn.net/img/view/2017/9/14/1535041.jpeg,0,0.998379588,554,162,770,378,216,216,twilight sparkle
1535041.jpeg,https://derpicdn.net/img/view/2017/9/14/1535041.jpeg,1,0.98790729,80,169,306,395,226,226,twilight sparkle
1535041.jpeg,https://derpicdn.net/img/view/2017/9/14/1535041.jpeg,2,0.985063612,859,430,1065,636,206,206,twilight sparkle
1535625.jpeg,https://derpicdn.net/img/view/2017/9/15/1535625.jpeg,0,0.99888432,355,0,965,513,610,513,twilight sparkle
1538675.jpeg,https://derpicdn.net/img/view/2017/9/18/1538675.jpeg,0,0.982451975,103,0,1139,867,1036,867,twilight sparkle
1539401.jpeg,https://derpicdn.net/img/view/2017/9/19/1539401.jpeg,0,0.994581342,256,167,754,665,498,498,twilight sparkle
1540114.jpeg,https://derpicdn.net/img/view/2017/9/20/1540114.jpeg,0,0.961454451,341,45,827,531,486,486,twilight sparkle
1540873.jpeg,https://derpicdn.net/img/view/2017/9/21/1540873.jpeg,0,0.981156051,11,11,451,451,440,440,twilight sparkle
1542989.jpeg,https://derpicdn.net/img/view/2017/9/23/1542989.jpeg,0,0.981189132,87,0,969,736,882,736,twilight sparkle
1543364.jpeg,https://derpicdn.net/img/view/2017/9/24/1543364.jpeg,0,0.986434162,0,0,2032,2267,2032,2267,twilight sparkle
1545910.jpeg,https://derpicdn.net/img/view/2017/9/27/1545910.jpeg,0,0.967611909,224,9,850,635,626,626,twilight sparkle
1549956.jpeg,https://derpicdn.net/img/view/2017/10/2/1549956.jpeg,0,0.99677372,232,192,894,854,662,662,twilight sparkle
1551506.jpeg,https://derpicdn.net/img/view/2017/10/4/1551506.jpeg,0,0.990459442,191,0,2833,2437,2642,2437,twilight sparkle
1553284.jpeg,https://derpicdn.net/img/view/2017/10/6/1553284.jpeg,0,0.993364036,178,0,532,351,354,351,twilight sparkle
1553355.jpeg,https://derpicdn.net/img/view/2017/10/6/1553355.jpeg,0,0.962454438,1039,292,1709,962,670,670,twilight sparkle
1555432.jpeg,https://derpicdn.net/img/view/2017/10/8/1555432.jpeg,0,0.984490514,45,0,1801,1080,1756,1080,twilight sparkle
1555660.jpeg,https://derpicdn.net/img/view/2017/10/8/1555660.jpeg,0,0.919963062,210,0,1636,1080,1426,1080,twilight sparkle
1557108.jpeg,https://derpicdn.net/img/view/2017/10/10/1557108.jpeg,1,0.929870248,0,22,342,364,342,342,twilight sparkle
1558090.jpeg,https://derpicdn.net/img/view/2017/10/11/1558090.jpeg,0,0.977109492,2367,42,3753,1428,1386,1386,twilight sparkle
1560324.jpeg,https://derpicdn.net/img/view/2017/10/13/1560324.jpeg,0,0.984936476,277,0,654,401,377,401,twilight sparkle
1562115.jpeg,https://derpicdn.net/img/view/2017/10/15/1562115.jpeg,0,0.998766601,388,39,856,507,468,468,twilight sparkle
1563679.jpeg,https://derpicdn.net/img/view/2017/10/17/1563679.jpeg,0,0.99944061,374,17,822,465,448,448,twilight sparkle
1564572.jpeg,https://derpicdn.net/img/view/2017/10/18/1564572.jpeg,0,0.999107003,413,13,815,415,402,402,twilight sparkle
1564572.jpeg,https://derpicdn.net/img/view/2017/10/18/1564572.jpeg,1,0.992753863,153,151,493,491,340,340,twilight sparkle
1567890.jpeg,https://derpicdn.net/img/view/2017/10/22/1567890.jpeg,0,0.997523904,2346,296,4284,2234,1938,1938,twilight sparkle
1567977.jpeg,https://derpicdn.net/img/view/2017/10/22/1567977.jpeg,0,0.985335946,898,135,4294,3531,3396,3396,twilight sparkle
1570171.jpeg,https://derpicdn.net/img/view/2017/10/25/1570171.jpeg,0,0.961875319,204,0,568,357,364,357,twilight sparkle
1570545.jpeg,https://derpicdn.net/img/view/2017/10/26/1570545.jpeg,1,0.974013031,1637,72,2455,890,818,818,twilight sparkle
1570676.jpeg,https://derpicdn.net/img/view/2017/10/26/1570676.jpeg,0,0.983099282,294,131,2608,2445,2314,2314,twilight sparkle
1570961.jpeg,https://derpicdn.net/img/view/2017/10/27/1570961.jpeg,0,0.979362607,122,262,2384,2628,2262,2366,twilight sparkle
1572722.jpeg,https://derpicdn.net/img/view/2017/10/29/1572722.jpeg,0,0.994773209,143,45,315,217,172,172,twilight sparkle
1572722.jpeg,https://derpicdn.net/img/view/2017/10/29/1572722.jpeg,1,0.919216514,399,253,561,415,162,162,twilight sparkle
1572873.jpeg,https://derpicdn.net/img/view/2017/10/29/1572873.jpeg,0,0.970539212,0,29,526,559,526,530,twilight sparkle
1574816.jpeg,https://derpicdn.net/img/view/2017/10/31/1574816.jpeg,0,0.99626261,1571,56,2557,1042,986,986,twilight sparkle
1575458.jpeg,https://derpicdn.net/img/view/2017/11/1/1575458.jpeg,0,0.996379018,0,0,900,964,900,964,twilight sparkle
1576115.jpeg,https://derpicdn.net/img/view/2017/11/2/1576115.jpeg,0,0.962369502,24,210,1792,1978,1768,1768,twilight sparkle
1578068.jpeg,https://derpicdn.net/img/view/2017/11/4/1578068.jpeg,0,0.948692083,513,0,821,245,308,245,twilight sparkle
1579082.jpeg,https://derpicdn.net/img/view/2017/11/5/1579082.jpeg,0,0.947540283,555,0,2181,1153,1626,1153,twilight sparkle
1579463.jpeg,https://derpicdn.net/img/view/2017/11/6/1579463.jpeg,0,0.974500895,1412,139,2260,987,848,848,twilight sparkle
1579594.jpeg,https://derpicdn.net/img/view/2017/11/6/1579594.jpeg,0,0.971977592,1308,0,1766,447,458,447,twilight sparkle
1581098.jpeg,https://derpicdn.net/img/view/2017/11/8/1581098.jpeg,0,0.98297745,793,5,2539,1600,1746,1595,twilight sparkle
1581556.jpeg,https://derpicdn.net/img/view/2017/11/8/1581556.jpeg,1,0.939449728,455,191,699,435,244,244,twilight sparkle
1581652.jpeg,https://derpicdn.net/img/view/2017/11/8/1581652.jpeg,0,0.958706915,536,0,1704,935,1168,935,twilight sparkle
1583213.jpeg,https://derpicdn.net/img/view/2017/11/10/1583213.jpeg,0,0.989125848,33,153,2300,2455,2267,2302,twilight sparkle
1585480.jpeg,https://derpicdn.net/img/view/2017/11/13/1585480.jpeg,0,0.987833202,491,204,805,518,314,314,twilight sparkle
1585480.jpeg,https://derpicdn.net/img/view/2017/11/13/1585480.jpeg,1,0.979916871,764,141,1130,507,366,366,twilight sparkle
1585869.jpeg,https://derpicdn.net/img/view/2017/11/14/1585869.jpeg,0,0.978971541,4,0,512,500,508,500,twilight sparkle
1587711.jpeg,https://derpicdn.net/img/view/2017/11/16/1587711.jpeg,0,0.998699546,1182,71,2332,1221,1150,1150,twilight sparkle
1588247.jpeg,https://derpicdn.net/img/view/2017/11/17/1588247.jpeg,0,0.973350704,257,19,1075,837,818,818,twilight sparkle
1588584.jpeg,https://derpicdn.net/img/view/2017/11/17/1588584.jpeg,0,0.996932864,494,687,1650,1843,1156,1156,twilight sparkle
1589317.jpeg,https://derpicdn.net/img/view/2017/11/18/1589317.jpeg,0,0.997654676,1452,270,3862,2680,2410,2410,twilight sparkle
1590043.jpeg,https://derpicdn.net/img/view/2017/11/19/1590043.jpeg,0,0.919598341,0,0,808,757,808,757,twilight sparkle
1590825.jpeg,https://derpicdn.net/img/view/2017/11/20/1590825.jpeg,0,0.995410979,256,296,876,916,620,620,twilight sparkle
1591460.jpeg,https://derpicdn.net/img/view/2017/11/21/1591460.jpeg,0,0.992065251,0,0,1271,1447,1271,1447,twilight sparkle
1591982.jpeg,https://derpicdn.net/img/view/2017/11/22/1591982.jpeg,0,0.985584795,1064,158,1606,700,542,542,twilight sparkle
1593115.jpeg,https://derpicdn.net/img/view/2017/11/24/1593115.jpeg,0,0.994650602,853,0,1603,678,750,678,twilight sparkle
1593268.jpeg,https://derpicdn.net/img/view/2017/11/24/1593268.jpeg,0,0.966118515,444,27,1024,635,580,608,twilight sparkle
1593268.jpeg,https://derpicdn.net/img/view/2017/11/24/1593268.jpeg,1,0.907436073,0,0,696,678,696,678,twilight sparkle
1593530.jpeg,https://derpicdn.net/img/view/2017/11/25/1593530.jpeg,0,0.974443197,0,108,2246,2508,2246,2400,twilight sparkle
1596829.jpeg,https://derpicdn.net/img/view/2017/11/29/1596829.jpeg,0,0.964876711,232,0,1742,1329,1510,1329,twilight sparkle
1598617.jpeg,https://derpicdn.net/img/view/2017/12/2/1598617.jpeg,0,0.99898088,176,0,564,309,388,309,twilight sparkle
1599275.jpeg,https://derpicdn.net/img/view/2017/12/3/1599275.jpeg,0,0.978127658,171,127,1161,1117,990,990,twilight sparkle
1599943.jpeg,https://derpicdn.net/img/view/2017/12/3/1599943.jpeg,0,0.96837908,329,47,993,711,664,664,twilight sparkle
1600542.jpeg,https://derpicdn.net/img/view/2017/12/4/1600542.jpeg,0,0.988195777,235,0,699,462,464,462,twilight sparkle
1603250.jpeg,https://derpicdn.net/img/view/2017/12/8/1603250.jpeg,0,0.959906638,130,220,980,1000,850,780,twilight sparkle
1604151.jpeg,https://derpicdn.net/img/view/2017/12/10/1604151.jpeg,0,0.968976676,0,0,1410,1532,1410,1532,twilight sparkle
1604436.jpeg,https://derpicdn.net/img/view/2017/12/10/1604436.jpeg,0,0.981572211,5374,48,6782,1456,1408,1408,twilight sparkle
1604436.jpeg,https://derpicdn.net/img/view/2017/12/10/1604436.jpeg,1,0.978330433,1850,130,3236,1516,1386,1386,twilight sparkle
1605118.jpeg,https://derpicdn.net/img/view/2017/12/11/1605118.jpeg,0,0.999713004,340,0,704,360,364,360,twilight sparkle
1605609.jpeg,https://derpicdn.net/img/view/2017/12/11/1605609.jpeg,0,0.901730776,357,0,2138,1731,1781,1731,twilight sparkle
1605863.jpeg,https://derpicdn.net/img/view/2017/12/12/1605863.jpeg,0,0.986685634,219,79,463,323,244,244,twilight sparkle
1606439.jpeg,https://derpicdn.net/img/view/2017/12/13/1606439.jpeg,1,0.938878894,600,718,1240,1358,640,640,twilight sparkle
1606869.jpeg,https://derpicdn.net/img/view/2017/12/13/1606869.jpeg,0,0.929648936,501,0,985,482,484,482,twilight sparkle
1607271.jpeg,https://derpicdn.net/img/view/2017/12/14/1607271.jpeg,0,0.993934393,185,13,539,367,354,354,twilight sparkle
1611838.jpeg,https://derpicdn.net/img/view/2017/12/20/1611838.jpeg,0,0.954085588,51,30,539,518,488,488,twilight sparkle
1614764.jpeg,https://derpicdn.net/img/view/2017/12/24/1614764.jpeg,0,0.965787411,0,0,400,462,400,462,twilight sparkle
1614770.jpeg,https://derpicdn.net/img/view/2017/12/24/1614770.jpeg,1,0.912048638,81,10,341,270,260,260,twilight sparkle
1614920.jpeg,https://derpicdn.net/img/view/2017/12/24/1614920.jpeg,0,0.997683048,56,50,548,542,492,492,twilight sparkle
1614991.jpeg,https://derpicdn.net/img/view/2017/12/24/1614991.jpeg,0,0.998067379,204,100,888,784,684,684,twilight sparkle
1619185.jpeg,https://derpicdn.net/img/view/2017/12/29/1619185.jpeg,0,0.999008656,318,18,744,444,426,426,twilight sparkle
1620005.jpeg,https://derpicdn.net/img/view/2017/12/30/1620005.jpeg,0,0.996218026,662,0,3088,2384,2426,2384,twilight sparkle
1621214.jpeg,https://derpicdn.net/img/view/2018/1/1/1621214.jpeg,0,0.957634211,204,217,572,585,368,368,twilight sparkle
1622062.jpeg,https://derpicdn.net/img/view/2018/1/2/1622062.jpeg,0,0.998430252,146,32,1338,1224,1192,1192,twilight sparkle
1623124.jpeg,https://derpicdn.net/img/view/2018/1/3/1623124.jpeg,0,0.998827994,33,0,583,541,550,541,twilight sparkle
1624648.jpeg,https://derpicdn.net/img/view/2018/1/5/1624648.jpeg,0,0.988210559,164,0,2322,2120,2158,2120,twilight sparkle
1624988.jpeg,https://derpicdn.net/img/view/2018/1/5/1624988.jpeg,0,0.987745345,248,0,1856,1080,1608,1080,twilight sparkle
1625289.jpeg,https://derpicdn.net/img/view/2018/1/6/1625289.jpeg,0,0.962411225,136,1,1169,1037,1033,1036,twilight sparkle
1626542.jpeg,https://derpicdn.net/img/view/2018/1/7/1626542.jpeg,0,0.984374046,259,45,685,471,426,426,twilight sparkle
1626942.jpeg,https://derpicdn.net/img/view/2018/1/8/1626942.jpeg,0,0.989268839,1127,84,2988,2070,1861,1986,twilight sparkle
1626942.jpeg,https://derpicdn.net/img/view/2018/1/8/1626942.jpeg,1,0.965244532,0,0,2168,2277,2168,2277,twilight sparkle
1627022.jpeg,https://derpicdn.net/img/view/2018/1/8/1627022.jpeg,0,0.996582627,416,67,808,459,392,392,twilight sparkle
1627501.jpeg,https://derpicdn.net/img/view/2018/1/8/1627501.jpeg,0,0.994414389,945,112,1705,872,760,760,twilight sparkle
1628278.jpeg,https://derpicdn.net/img/view/2018/1/9/1628278.jpeg,0,0.980351925,696,0,1590,732,894,732,twilight sparkle
1628908.jpeg,https://derpicdn.net/img/view/2018/1/10/1628908.jpeg,0,0.982674479,883,1816,1745,2678,862,862,twilight sparkle
1629276.jpeg,https://derpicdn.net/img/view/2018/1/10/1629276.jpeg,0,0.998741508,36,5,396,365,360,360,twilight sparkle
1629560.jpeg,https://derpicdn.net/img/view/2018/1/11/1629560.jpeg,0,0.989151418,0,0,734,716,734,716,twilight sparkle
1630644.jpeg,https://derpicdn.net/img/view/2018/1/12/1630644.jpeg,0,0.987948477,670,138,1122,590,452,452,twilight sparkle
1631272.jpeg,https://derpicdn.net/img/view/2018/1/13/1631272.jpeg,0,0.970554233,627,214,2311,1898,1684,1684,twilight sparkle
1632412.jpeg,https://derpicdn.net/img/view/2018/1/14/1632412.jpeg,0,0.994698942,1858,1240,3234,2616,1376,1376,twilight sparkle
1633574.jpeg,https://derpicdn.net/img/view/2018/1/16/1633574.jpeg,0,0.966898263,120,53,2168,2101,2048,2048,twilight sparkle
1634029.jpeg,https://derpicdn.net/img/view/2018/1/17/1634029.jpeg,0,0.998907268,140,0,1450,1285,1310,1285,twilight sparkle
1634592.jpeg,https://derpicdn.net/img/view/2018/1/17/1634592.jpeg,0,0.980732679,372,0,1678,1161,1306,1161,twilight sparkle
1635969.jpeg,https://derpicdn.net/img/view/2018/1/19/1635969.jpeg,0,0.994743645,128,395,460,727,332,332,twilight sparkle
1636439.jpeg,https://derpicdn.net/img/view/2018/1/20/1636439.jpeg,0,0.921083987,69,162,973,1050,904,888,twilight sparkle
1637140.jpeg,https://derpicdn.net/img/view/2018/1/21/1637140.jpeg,0,0.939383209,473,33,1193,753,720,720,twilight sparkle
1637517.jpeg,https://derpicdn.net/img/view/2018/1/21/1637517.jpeg,0,0.995625973,45,0,523,470,478,470,twilight sparkle
1638390.jpeg,https://derpicdn.net/img/view/2018/1/22/1638390.jpeg,1,0.997121871,1061,81,2375,1395,1314,1314,twilight sparkle
1639829.jpeg,https://derpicdn.net/img/view/2018/1/24/1639829.jpeg,0,0.986529469,172,50,450,328,278,278,twilight sparkle
1641345.jpeg,https://derpicdn.net/img/view/2018/1/26/1641345.jpeg,0,0.933153391,1851,1645,3827,3621,1976,1976,twilight sparkle
1642181.jpeg,https://derpicdn.net/img/view/2018/1/27/1642181.jpeg,0,0.993427575,1532,770,2664,1902,1132,1132,twilight sparkle
1643253.jpeg,https://derpicdn.net/img/view/2018/1/29/1643253.jpeg,0,0.99965632,385,0,739,320,354,320,twilight sparkle
1644730.jpeg,https://derpicdn.net/img/view/2018/1/30/1644730.jpeg,0,0.994003654,2109,942,3179,2012,1070,1070,twilight sparkle
1647116.jpeg,https://derpicdn.net/img/view/2018/2/3/1647116.jpeg,0,0.972703278,796,845,2324,2373,1528,1528,twilight sparkle
1647847.jpeg,https://derpicdn.net/img/view/2018/2/4/1647847.jpeg,0,0.973932922,244,0,796,546,552,546,twilight sparkle
1652742.jpeg,https://derpicdn.net/img/view/2018/2/10/1652742.jpeg,0,0.900402784,442,88,808,454,366,366,twilight sparkle
1657336.jpeg,https://derpicdn.net/img/view/2018/2/16/1657336.jpeg,0,0.963505208,69,14,599,544,530,530,twilight sparkle
1659659.jpeg,https://derpicdn.net/img/view/2018/2/18/1659659.jpeg,1,0.999233007,516,193,1258,935,742,742,twilight sparkle
1660146.jpeg,https://derpicdn.net/img/view/2018/2/19/1660146.jpeg,0,0.915671468,714,135,1024,445,310,310,twilight sparkle
1661575.jpeg,https://derpicdn.net/img/view/2018/2/20/1661575.jpeg,0,0.988570571,1108,106,1784,782,676,676,twilight sparkle
1661638.jpeg,https://derpicdn.net/img/view/2018/2/20/1661638.jpeg,0,0.996415019,528,0,992,428,464,428,twilight sparkle
1661646.jpeg,https://derpicdn.net/img/view/2018/2/20/1661646.jpeg,0,0.982967973,37,0,583,522,546,522,twilight sparkle
1661662.jpeg,https://derpicdn.net/img/view/2018/2/21/1661662.jpeg,1,0.943629801,466,276,764,574,298,298,twilight sparkle
1662086.jpeg,https://derpicdn.net/img/view/2018/2/21/1662086.jpeg,0,0.982988238,179,0,593,409,414,409,twilight sparkle
1663014.jpeg,https://derpicdn.net/img/view/2018/2/22/1663014.jpeg,0,0.997934878,1299,556,3593,2850,2294,2294,twilight sparkle
1664086.jpeg,https://derpicdn.net/img/view/2018/2/24/1664086.jpeg,0,0.939639628,93,0,837,700,744,700,twilight sparkle
1664232.jpeg,https://derpicdn.net/img/view/2018/2/24/1664232.jpeg,0,0.930399001,48,36,504,492,456,456,twilight sparkle
1665449.jpeg,https://derpicdn.net/img/view/2018/2/25/1665449.jpeg,0,0.99799931,416,0,1718,1132,1302,1132,twilight sparkle
1665528.jpeg,https://derpicdn.net/img/view/2018/2/25/1665528.jpeg,0,0.967670679,443,51,1631,1239,1188,1188,twilight sparkle
1668370.jpeg,https://derpicdn.net/img/view/2018/2/28/1668370.jpeg,0,0.995338798,278,0,754,451,476,451,twilight sparkle
1668372.jpeg,https://derpicdn.net/img/view/2018/2/28/1668372.jpeg,0,0.99163121,140,0,764,568,624,568,twilight sparkle
1670027.jpeg,https://derpicdn.net/img/view/2018/3/2/1670027.jpeg,0,0.961800396,104,33,552,481,448,448,twilight sparkle
1673005.jpeg,https://derpicdn.net/img/view/2018/3/6/1673005.jpeg,0,0.998009682,723,602,1367,1246,644,644,twilight sparkle
1673872.jpeg,https://derpicdn.net/img/view/2018/3/7/1673872.jpeg,0,0.990539551,325,0,1391,1043,1066,1043,twilight sparkle
1674086.jpeg,https://derpicdn.net/img/view/2018/3/7/1674086.jpeg,1,0.942659438,640,0,1022,378,382,378,twilight sparkle
1674520.jpeg,https://derpicdn.net/img/view/2018/3/8/1674520.jpeg,0,0.979553938,510,60,1288,838,778,778,twilight sparkle
1675398.jpeg,https://derpicdn.net/img/view/2018/3/9/1675398.jpeg,0,0.953468144,20,578,298,856,278,278,twilight sparkle
1677916.jpeg,https://derpicdn.net/img/view/2018/3/12/1677916.jpeg,0,0.987428248,14,34,284,304,270,270,twilight sparkle
1679069.jpeg,https://derpicdn.net/img/view/2018/3/13/1679069.jpeg,0,0.922231972,0,0,530,552,530,552,twilight sparkle
1680462.jpeg,https://derpicdn.net/img/view/2018/3/14/1680462.jpeg,0,0.996273458,170,31,644,505,474,474,twilight sparkle
1686942.jpeg,https://derpicdn.net/img/view/2018/3/21/1686942.jpeg,0,0.997118115,436,24,740,328,304,304,twilight sparkle
1688001.jpeg,https://derpicdn.net/img/view/2018/3/23/1688001.jpeg,0,0.99805969,0,153,1264,1655,1264,1502,twilight sparkle
1688479.jpeg,https://derpicdn.net/img/view/2018/3/23/1688479.jpeg,0,0.963625431,17,38,473,494,456,456,twilight sparkle
1689293.jpeg,https://derpicdn.net/img/view/2018/3/24/1689293.jpeg,0,0.986387849,41,138,2237,2334,2196,2196,twilight sparkle
1689863.jpeg,https://derpicdn.net/img/view/2018/3/25/1689863.jpeg,0,0.997019827,145,0,811,647,666,647,twilight sparkle
1694448.jpeg,https://derpicdn.net/img/view/2018/3/30/1694448.jpeg,0,0.964086533,331,343,561,573,230,230,twilight sparkle
1698982.jpeg,https://derpicdn.net/img/view/2018/4/4/1698982.jpeg,0,0.998903811,118,0,686,539,568,539,twilight sparkle
1700677.jpeg,https://derpicdn.net/img/view/2018/4/6/1700677.jpeg,0,0.958978951,419,88,717,386,298,298,twilight sparkle
1701676.jpeg,https://derpicdn.net/img/view/2018/4/7/1701676.jpeg,0,0.997190595,608,0,1970,1313,1362,1313,twilight sparkle
1702947.jpeg,https://derpicdn.net/img/view/2018/4/8/1702947.jpeg,0,0.97936368,61,0,801,690,740,690,twilight sparkle
1703208.jpeg,https://derpicdn.net/img/view/2018/4/9/1703208.jpeg,0,0.979154587,106,60,808,762,702,702,twilight sparkle
1703399.jpeg,https://derpicdn.net/img/view/2018/4/9/1703399.jpeg,0,0.99906987,813,20,1451,658,638,638,twilight sparkle
1703401.jpeg,https://derpicdn.net/img/view/2018/4/9/1703401.jpeg,0,0.983646929,617,26,1131,540,514,514,twilight sparkle
1703869.jpeg,https://derpicdn.net/img/view/2018/4/9/1703869.jpeg,0,0.959192216,244,0,964,683,720,683,twilight sparkle
1704019.jpeg,https://derpicdn.net/img/view/2018/4/10/1704019.jpeg,0,0.974556029,80,281,332,533,252,252,twilight sparkle
1704019.jpeg,https://derpicdn.net/img/view/2018/4/10/1704019.jpeg,1,0.946039379,518,135,842,459,324,324,twilight sparkle
1705889.jpeg,https://derpicdn.net/img/view/2018/4/12/1705889.jpeg,0,0.984330058,173,52,467,346,294,294,twilight sparkle
1707222.jpeg,https://derpicdn.net/img/view/2018/4/14/1707222.jpeg,0,0.99787575,1095,64,2645,1614,1550,1550,twilight sparkle
1710263.jpeg,https://derpicdn.net/img/view/2018/4/17/1710263.jpeg,0,0.995751619,498,0,1908,1347,1410,1347,twilight sparkle
1710299.jpeg,https://derpicdn.net/img/view/2018/4/17/1710299.jpeg,0,0.958978534,0,0,1310,1295,1310,1295,twilight sparkle
1710351.jpeg,https://derpicdn.net/img/view/2018/4/17/1710351.jpeg,0,0.993565142,203,9,659,465,456,456,twilight sparkle
1710678.jpeg,https://derpicdn.net/img/view/2018/4/18/1710678.jpeg,0,0.909982264,447,167,767,487,320,320,twilight sparkle
1713458.jpeg,https://derpicdn.net/img/view/2018/4/21/1713458.jpeg,0,0.972113907,103,0,1463,1327,1360,1327,twilight sparkle
1713883.jpeg,https://derpicdn.net/img/view/2018/4/21/1713883.jpeg,0,0.999721229,558,0,1410,814,852,814,twilight sparkle
1714329.jpeg,https://derpicdn.net/img/view/2018/4/22/1714329.jpeg,0,0.997976065,208,36,420,248,212,212,twilight sparkle
1715547.jpeg,https://derpicdn.net/img/view/2018/4/23/1715547.jpeg,0,0.940152943,748,1279,1660,2191,912,912,twilight sparkle
1716063.jpeg,https://derpicdn.net/img/view/2018/4/24/1716063.jpeg,0,0.981394768,48,216,1524,1692,1476,1476,twilight sparkle
1718771.jpeg,https://derpicdn.net/img/view/2018/4/28/1718771.jpeg,0,0.991185308,57,0,635,577,578,577,twilight sparkle
1719425.jpeg,https://derpicdn.net/img/view/2018/4/28/1719425.jpeg,0,0.998343825,295,0,635,310,340,310,twilight sparkle
1719557.jpeg,https://derpicdn.net/img/view/2018/4/29/1719557.jpeg,0,0.992264032,144,0,4318,4055,4174,4055,twilight sparkle
1720426.jpeg,https://derpicdn.net/img/view/2018/4/29/1720426.jpeg,0,0.90008229,639,1327,1685,2373,1046,1046,twilight sparkle
1720651.jpeg,https://derpicdn.net/img/view/2018/4/30/1720651.jpeg,0,0.959275365,1348,120,2000,774,652,654,twilight sparkle
1721212.jpeg,https://derpicdn.net/img/view/2018/4/30/1721212.jpeg,0,0.923802912,566,179,2000,1701,1434,1522,twilight sparkle
1723199.jpeg,https://derpicdn.net/img/view/2018/5/3/1723199.jpeg,0,0.991930544,1583,73,2613,1103,1030,1030,twilight sparkle
1724141.jpeg,https://derpicdn.net/img/view/2018/5/4/1724141.jpeg,0,0.910886526,192,9,780,597,588,588,twilight sparkle
1725629.jpeg,https://derpicdn.net/img/view/2018/5/6/1725629.jpeg,0,0.991105437,27,0,451,411,424,411,twilight sparkle
1726349.jpeg,https://derpicdn.net/img/view/2018/5/7/1726349.jpeg,0,0.998502374,330,10,698,378,368,368,twilight sparkle
1727961.jpeg,https://derpicdn.net/img/view/2018/5/9/1727961.jpeg,0,0.99982053,1494,463,2270,1239,776,776,twilight sparkle
1732248.jpeg,https://derpicdn.net/img/view/2018/5/14/1732248.jpeg,0,0.999824107,585,0,1039,449,454,449,twilight sparkle
1733163.jpeg,https://derpicdn.net/img/view/2018/5/15/1733163.jpeg,0,0.990640283,0,0,169,172,169,172,twilight sparkle
1733163.jpeg,https://derpicdn.net/img/view/2018/5/15/1733163.jpeg,1,0.988480151,313,74,576,372,263,298,twilight sparkle
1733523.jpeg,https://derpicdn.net/img/view/2018/5/15/1733523.jpeg,0,0.958365977,16,14,724,722,708,708,twilight sparkle
1733858.jpeg,https://derpicdn.net/img/view/2018/5/16/1733858.jpeg,0,0.951932549,178,0,546,352,368,352,twilight sparkle
1735865.jpeg,https://derpicdn.net/img/view/2018/5/18/1735865.jpeg,0,0.907832563,639,181,895,437,256,256,twilight sparkle
1736061.jpeg,https://derpicdn.net/img/view/2018/5/19/1736061.jpeg,0,0.992676854,50,90,2170,2210,2120,2120,twilight sparkle
1738275.jpeg,https://derpicdn.net/img/view/2018/5/21/1738275.jpeg,0,0.993668854,77,0,643,504,566,504,twilight sparkle
1738752.jpeg,https://derpicdn.net/img/view/2018/5/22/1738752.jpeg,0,0.999177217,1943,0,4909,2580,2966,2580,twilight sparkle
1740101.jpeg,https://derpicdn.net/img/view/2018/5/24/1740101.jpeg,0,0.941608012,0,0,783,717,783,717,twilight sparkle
1740230.jpeg,https://derpicdn.net/img/view/2018/5/24/1740230.jpeg,0,0.955418587,107,0,639,496,532,496,twilight sparkle
1740580.jpeg,https://derpicdn.net/img/view/2018/5/24/1740580.jpeg,0,0.966795027,207,0,1019,779,812,779,twilight sparkle
1742022.jpeg,https://derpicdn.net/img/view/2018/5/26/1742022.jpeg,0,0.995715737,1577,852,2223,1498,646,646,twilight sparkle
1742022.jpeg,https://derpicdn.net/img/view/2018/5/26/1742022.jpeg,1,0.906848669,377,494,887,1004,510,510,twilight sparkle
1743458.jpeg,https://derpicdn.net/img/view/2018/5/28/1743458.jpeg,0,0.999234974,217,112,527,422,310,310,twilight sparkle
1744772.jpeg,https://derpicdn.net/img/view/2018/5/29/1744772.jpeg,0,0.939065635,351,36,1123,808,772,772,twilight sparkle
1745004.jpeg,https://derpicdn.net/img/view/2018/5/30/1745004.jpeg,0,0.996158183,184,0,642,434,458,434,twilight sparkle
1745013.jpeg,https://derpicdn.net/img/view/2018/5/30/1745013.jpeg,0,0.929996073,263,0,521,256,258,256,twilight sparkle
1751860.jpeg,https://derpicdn.net/img/view/2018/6/7/1751860.jpeg,0,0.937939048,3137,601,4227,1691,1090,1090,twilight sparkle
1752426.jpeg,https://derpicdn.net/img/view/2018/6/8/1752426.jpeg,0,0.950238168,119,0,521,332,402,332,twilight sparkle
1755183.jpeg,https://derpicdn.net/img/view/2018/6/11/1755183.jpeg,0,0.997820675,386,259,806,679,420,420,twilight sparkle
1755183.jpeg,https://derpicdn.net/img/view/2018/6/11/1755183.jpeg,1,0.994697809,723,224,1217,718,494,494,twilight sparkle
1755553.jpeg,https://derpicdn.net/img/view/2018/6/11/1755553.jpeg,0,0.992508352,180,0,1804,1080,1624,1080,twilight sparkle
1755757.jpeg,https://derpicdn.net/img/view/2018/6/12/1755757.jpeg,0,0.960076213,327,0,713,379,386,379,twilight sparkle
1758037.jpeg,https://derpicdn.net/img/view/2018/6/15/1758037.jpeg,0,0.980233431,213,0,635,415,422,415,twilight sparkle
1759847.jpeg,https://derpicdn.net/img/view/2018/6/17/1759847.jpeg,0,0.98991704,421,122,1535,1236,1114,1114,twilight sparkle
1764324.jpeg,https://derpicdn.net/img/view/2018/6/23/1764324.jpeg,0,0.982720256,259,0,1317,1013,1058,1013,twilight sparkle
1764335.jpeg,https://derpicdn.net/img/view/2018/6/23/1764335.jpeg,0,0.999504745,33,34,1575,1576,1542,1542,twilight sparkle
1765318.jpeg,https://derpicdn.net/img/view/2018/6/25/1765318.jpeg,0,0.997954309,492,159,1262,929,770,770,twilight sparkle
1765493.jpeg,https://derpicdn.net/img/view/2018/6/25/1765493.jpeg,0,0.999559462,505,378,1121,994,616,616,twilight sparkle
1765493.jpeg,https://derpicdn.net/img/view/2018/6/25/1765493.jpeg,1,0.999557674,1353,336,1961,944,608,608,twilight sparkle
1765495.jpeg,https://derpicdn.net/img/view/2018/6/25/1765495.jpeg,0,0.996495247,1089,617,2263,1708,1174,1091,twilight sparkle
1765495.jpeg,https://derpicdn.net/img/view/2018/6/25/1765495.jpeg,1,0.986904979,65,606,1271,1708,1206,1102,twilight sparkle
1765496.jpeg,https://derpicdn.net/img/view/2018/6/25/1765496.jpeg,0,0.995782256,834,312,2022,1370,1188,1058,twilight sparkle
1765496.jpeg,https://derpicdn.net/img/view/2018/6/25/1765496.jpeg,1,0.979026973,61,482,833,1254,772,772,twilight sparkle
1766270.jpeg,https://derpicdn.net/img/view/2018/6/26/1766270.jpeg,0,0.941643894,0,0,522,561,522,561,twilight sparkle
1766305.jpeg,https://derpicdn.net/img/view/2018/6/26/1766305.jpeg,0,0.977214098,86,626,2184,2724,2098,2098,twilight sparkle
1766494.jpeg,https://derpicdn.net/img/view/2018/6/26/1766494.jpeg,0,0.995299101,147,0,1377,1458,1230,1458,twilight sparkle
1766506.jpeg,https://derpicdn.net/img/view/2018/6/26/1766506.jpeg,1,0.984488845,654,502,996,844,342,342,twilight sparkle
1767224.jpeg,https://derpicdn.net/img/view/2018/6/27/1767224.jpeg,0,0.938026667,358,591,1174,1407,816,816,twilight sparkle
1767693.jpeg,https://derpicdn.net/img/view/2018/6/28/1767693.jpeg,0,0.981156051,234,246,586,598,352,352,twilight sparkle
1770368.jpeg,https://derpicdn.net/img/view/2018/7/1/1770368.jpeg,0,0.984742045,267,40,987,760,720,720,twilight sparkle
1771922.jpeg,https://derpicdn.net/img/view/2018/7/3/1771922.jpeg,0,0.995967329,365,0,935,569,570,569,twilight sparkle
1772654.jpeg,https://derpicdn.net/img/view/2018/7/4/1772654.jpeg,0,0.975799382,0,430,2397,3456,2397,3026,twilight sparkle
1773234.jpeg,https://derpicdn.net/img/view/2018/7/5/1773234.jpeg,0,0.956219137,0,69,1069,1151,1069,1082,twilight sparkle
1773926.jpeg,https://derpicdn.net/img/view/2018/7/6/1773926.jpeg,0,0.994175911,0,0,919,951,919,951,twilight sparkle
1774077.jpeg,https://derpicdn.net/img/view/2018/7/6/1774077.jpeg,0,0.957481742,0,9,825,929,825,920,twilight sparkle
1774319.jpeg,https://derpicdn.net/img/view/2018/7/6/1774319.jpeg,0,0.991820037,8,39,300,300,292,261,twilight sparkle
1774319.jpeg,https://derpicdn.net/img/view/2018/7/6/1774319.jpeg,1,0.915220618,3,4,259,260,256,256,twilight sparkle
1774455.jpeg,https://derpicdn.net/img/view/2018/7/6/1774455.jpeg,0,0.983378351,0,63,701,797,701,734,twilight sparkle
1775106.jpeg,https://derpicdn.net/img/view/2018/7/7/1775106.jpeg,0,0.963945448,210,183,498,471,288,288,twilight sparkle
1775468.jpeg,https://derpicdn.net/img/view/2018/7/8/1775468.jpeg,2,0.913773715,88,256,884,1052,796,796,twilight sparkle
1775581.jpeg,https://derpicdn.net/img/view/2018/7/8/1775581.jpeg,0,0.970130265,206,0,650,444,444,444,twilight sparkle
1779984.jpeg,https://derpicdn.net/img/view/2018/7/13/1779984.jpeg,0,0.999754369,244,0,722,461,478,461,twilight sparkle
1780653.jpeg,https://derpicdn.net/img/view/2018/7/14/1780653.jpeg,0,0.974855304,278,0,610,297,332,297,twilight sparkle
1781509.jpeg,https://derpicdn.net/img/view/2018/7/15/1781509.jpeg,0,0.994514167,304,0,794,468,490,468,twilight sparkle
1781563.jpeg,https://derpicdn.net/img/view/2018/7/15/1781563.jpeg,0,0.920239866,90,16,813,800,723,784,twilight sparkle
1782815.jpeg,https://derpicdn.net/img/view/2018/7/17/1782815.jpeg,0,0.994692147,57,0,929,778,872,778,twilight sparkle
1784343.jpeg,https://derpicdn.net/img/view/2018/7/19/1784343.jpeg,0,0.985766232,247,38,507,298,260,260,twilight sparkle
1784343.jpeg,https://derpicdn.net/img/view/2018/7/19/1784343.jpeg,1,0.935484886,364,532,766,934,402,402,twilight sparkle
1784678.jpeg,https://derpicdn.net/img/view/2018/7/19/1784678.jpeg,0,0.984145939,0,46,614,662,614,616,twilight sparkle
1784710.jpeg,https://derpicdn.net/img/view/2018/7/19/1784710.jpeg,0,0.974214315,1,69,919,987,918,918,twilight sparkle
1784729.jpeg,https://derpicdn.net/img/view/2018/7/19/1784729.jpeg,0,0.99457407,43,0,431,357,388,357,twilight sparkle
1785252.jpeg,https://derpicdn.net/img/view/2018/7/20/1785252.jpeg,0,0.976166606,687,0,3007,1899,2320,1899,twilight sparkle
1786167.jpeg,https://derpicdn.net/img/view/2018/7/21/1786167.jpeg,0,0.947661698,497,2,1203,708,706,706,twilight sparkle
1786782.jpeg,https://derpicdn.net/img/view/2018/7/22/1786782.jpeg,0,0.987448692,61,61,679,679,618,618,twilight sparkle
1787489.jpeg,https://derpicdn.net/img/view/2018/7/23/1787489.jpeg,0,0.973840415,0,34,424,498,424,464,twilight sparkle
1790815.jpeg,https://derpicdn.net/img/view/2018/7/27/1790815.jpeg,0,0.991806328,267,112,689,534,422,422,twilight sparkle
1791357.jpeg,https://derpicdn.net/img/view/2018/7/27/1791357.jpeg,0,0.930860281,218,222,454,458,236,236,twilight sparkle
1791527.jpeg,https://derpicdn.net/img/view/2018/7/28/1791527.jpeg,0,0.989427388,551,127,949,525,398,398,twilight sparkle
1793844.jpeg,https://derpicdn.net/img/view/2018/7/31/1793844.jpeg,0,0.998968363,737,332,1320,938,583,606,twilight sparkle
1794735.jpeg,https://derpicdn.net/img/view/2018/8/1/1794735.jpeg,0,0.996499181,120,0,1498,1360,1378,1360,twilight sparkle
1795778.jpeg,https://derpicdn.net/img/view/2018/8/2/1795778.jpeg,0,0.918275833,415,0,1159,743,744,743,twilight sparkle
1796426.jpeg,https://derpicdn.net/img/view/2018/8/3/1796426.jpeg,0,0.972109795,162,23,750,611,588,588,twilight sparkle
1797167.jpeg,https://derpicdn.net/img/view/2018/8/3/1797167.jpeg,0,0.969653666,0,133,720,895,720,762,twilight sparkle
1798825.jpeg,https://derpicdn.net/img/view/2018/8/5/1798825.jpeg,0,0.998801112,545,648,955,1058,410,410,twilight sparkle
1799512.jpeg,https://derpicdn.net/img/view/2018/8/6/1799512.jpeg,0,0.978819013,675,0,3859,2517,3184,2517,twilight sparkle
1799707.jpeg,https://derpicdn.net/img/view/2018/8/6/1799707.jpeg,0,0.994658828,972,250,1542,820,570,570,twilight sparkle
1800559.jpeg,https://derpicdn.net/img/view/2018/8/7/1800559.jpeg,0,0.987192035,49,155,193,299,144,144,twilight sparkle
1800910.jpeg,https://derpicdn.net/img/view/2018/8/7/1800910.jpeg,0,0.998371184,261,189,959,887,698,698,twilight sparkle
1801297.jpeg,https://derpicdn.net/img/view/2018/8/8/1801297.jpeg,0,0.976839125,1346,965,2140,1759,794,794,twilight sparkle
1802792.jpeg,https://derpicdn.net/img/view/2018/8/10/1802792.jpeg,0,0.997659385,0,0,624,602,624,602,twilight sparkle
1803498.jpeg,https://derpicdn.net/img/view/2018/8/10/1803498.jpeg,0,0.994992256,0,0,602,713,602,713,twilight sparkle
1804188.jpeg,https://derpicdn.net/img/view/2018/8/11/1804188.jpeg,0,0.995833695,1599,0,2833,1067,1234,1067,twilight sparkle
1804993.jpeg,https://derpicdn.net/img/view/2018/8/12/1804993.jpeg,0,0.974015296,19,0,459,437,440,437,twilight sparkle
1805915.jpeg,https://derpicdn.net/img/view/2018/8/13/1805915.jpeg,0,0.973666191,0,0,714,638,714,638,twilight sparkle
1806258.jpeg,https://derpicdn.net/img/view/2018/8/14/1806258.jpeg,0,0.988290012,141,282,829,970,688,688,twilight sparkle
1806798.jpeg,https://derpicdn.net/img/view/2018/8/14/1806798.jpeg,0,0.995477319,0,0,1103,900,1103,900,twilight sparkle
1807861.jpeg,https://derpicdn.net/img/view/2018/8/16/1807861.jpeg,0,0.942320764,407,293,1975,1861,1568,1568,twilight sparkle
1808084.jpeg,https://derpicdn.net/img/view/2018/8/16/1808084.jpeg,0,0.996023834,99,0,1881,1080,1782,1080,twilight sparkle
1808308.jpeg,https://derpicdn.net/img/view/2018/8/16/1808308.jpeg,0,0.996680081,1,0,931,907,930,907,twilight sparkle
1808325.jpeg,https://derpicdn.net/img/view/2018/8/16/1808325.jpeg,0,0.978235245,525,145,1027,647,502,502,twilight sparkle
1808349.jpeg,https://derpicdn.net/img/view/2018/8/16/1808349.jpeg,0,0.999312162,107,46,845,784,738,738,twilight sparkle
1808624.jpeg,https://derpicdn.net/img/view/2018/8/16/1808624.jpeg,0,0.98687923,789,51,1479,741,690,690,twilight sparkle
1808724.jpeg,https://derpicdn.net/img/view/2018/8/16/1808724.jpeg,0,0.988219798,23,99,501,577,478,478,twilight sparkle
1809984.jpeg,https://derpicdn.net/img/view/2018/8/18/1809984.jpeg,0,0.966750443,629,319,1125,815,496,496,twilight sparkle
1811777.jpeg,https://derpicdn.net/img/view/2018/8/20/1811777.jpeg,0,0.964402974,221,0,1455,1222,1234,1222,twilight sparkle
1812243.jpeg,https://derpicdn.net/img/view/2018/8/21/1812243.jpeg,0,0.97944659,68,0,926,858,858,858,twilight sparkle
1812747.jpeg,https://derpicdn.net/img/view/2018/8/21/1812747.jpeg,0,0.95863378,1518,976,2472,1930,954,954,twilight sparkle
1815830.jpeg,https://derpicdn.net/img/view/2018/8/25/1815830.jpeg,0,0.908067107,248,0,1336,1039,1088,1039,twilight sparkle
1817203.jpeg,https://derpicdn.net/img/view/2018/8/26/1817203.jpeg,0,0.995222688,85,76,363,354,278,278,twilight sparkle
1818523.jpeg,https://derpicdn.net/img/view/2018/8/28/1818523.jpeg,0,0.96724987,114,0,608,472,494,472,twilight sparkle
1821776.jpeg,https://derpicdn.net/img/view/2018/9/1/1821776.jpeg,0,0.999658108,591,0,1313,704,722,704,twilight sparkle
1824046.jpeg,https://derpicdn.net/img/view/2018/9/3/1824046.jpeg,0,0.986263633,42,53,600,673,558,620,twilight sparkle
1824046.jpeg,https://derpicdn.net/img/view/2018/9/3/1824046.jpeg,1,0.916179478,0,183,481,713,481,530,twilight sparkle
1824200.jpeg,https://derpicdn.net/img/view/2018/9/3/1824200.jpeg,0,0.997675598,405,0,1989,1581,1584,1581,twilight sparkle
1824433.jpeg,https://derpicdn.net/img/view/2018/9/4/1824433.jpeg,0,0.968940198,626,317,1128,819,502,502,twilight sparkle
1825483.jpeg,https://derpicdn.net/img/view/2018/9/5/1825483.jpeg,0,0.90055126,291,43,679,431,388,388,twilight sparkle
1829943.jpeg,https://derpicdn.net/img/view/2018/9/11/1829943.jpeg,0,0.975512743,70,27,882,839,812,812,twilight sparkle
1833299.jpeg,https://derpicdn.net/img/view/2018/9/15/1833299.jpeg,0,0.981094897,126,0,1218,728,1092,728,twilight sparkle
1834079.jpeg,https://derpicdn.net/img/view/2018/9/16/1834079.jpeg,0,0.976626635,2174,511,3772,2109,1598,1598,twilight sparkle
1834582.jpeg,https://derpicdn.net/img/view/2018/9/17/1834582.jpeg,0,0.999177873,586,0,1376,769,790,769,twilight sparkle
1836752.jpeg,https://derpicdn.net/img/view/2018/9/20/1836752.jpeg,0,0.989843071,334,480,1284,1430,950,950,twilight sparkle
1839058.jpeg,https://derpicdn.net/img/view/2018/9/23/1839058.jpeg,0,0.987500548,389,0,1081,674,692,674,twilight sparkle
1839862.jpeg,https://derpicdn.net/img/view/2018/9/23/1839862.jpeg,0,0.999631405,106,425,380,699,274,274,twilight sparkle
1840824.jpeg,https://derpicdn.net/img/view/2018/9/25/1840824.jpeg,0,0.994553685,557,514,895,852,338,338,twilight sparkle
1840824.jpeg,https://derpicdn.net/img/view/2018/9/25/1840824.jpeg,1,0.984318018,103,546,367,810,264,264,twilight sparkle
1841501.jpeg,https://derpicdn.net/img/view/2018/9/26/1841501.jpeg,0,0.982911646,61,0,750,669,689,669,twilight sparkle
1842650.jpeg,https://derpicdn.net/img/view/2018/9/27/1842650.jpeg,0,0.940868735,671,3,1397,729,726,726,twilight sparkle
1842700.jpeg,https://derpicdn.net/img/view/2018/9/27/1842700.jpeg,0,0.969593465,111,0,993,806,882,806,twilight sparkle
1843619.jpeg,https://derpicdn.net/img/view/2018/9/29/1843619.jpeg,0,0.996180058,147,117,929,899,782,782,twilight sparkle
1843793.jpeg,https://derpicdn.net/img/view/2018/9/29/1843793.jpeg,0,0.978477359,609,12,1159,562,550,550,twilight sparkle
1845289.jpeg,https://derpicdn.net/img/view/2018/10/1/1845289.jpeg,0,0.985804617,333,1531,757,1955,424,424,twilight sparkle
1845377.jpeg,https://derpicdn.net/img/view/2018/10/1/1845377.jpeg,0,0.933076859,0,0,539,549,539,549,twilight sparkle
1849602.jpeg,https://derpicdn.net/img/view/2018/10/6/1849602.jpeg,0,0.993589282,208,16,1336,1144,1128,1128,twilight sparkle
1851143.jpeg,https://derpicdn.net/img/view/2018/10/8/1851143.jpeg,0,0.967423856,286,106,992,812,706,706,twilight sparkle
1851165.jpeg,https://derpicdn.net/img/view/2018/10/8/1851165.jpeg,0,0.920732737,38,32,496,490,458,458,twilight sparkle
1853173.jpeg,https://derpicdn.net/img/view/2018/10/10/1853173.jpeg,0,0.997567773,772,0,1092,264,320,264,twilight sparkle
1853173.jpeg,https://derpicdn.net/img/view/2018/10/10/1853173.jpeg,1,0.997370481,85,0,409,295,324,295,twilight sparkle
1853173.jpeg,https://derpicdn.net/img/view/2018/10/10/1853173.jpeg,3,0.957398891,1194,0,1484,237,290,237,twilight sparkle
1853173.jpeg,https://derpicdn.net/img/view/2018/10/10/1853173.jpeg,4,0.928058565,1152,551,1486,885,334,334,twilight sparkle
1853438.jpeg,https://derpicdn.net/img/view/2018/10/11/1853438.jpeg,0,0.991867959,2430,154,4414,2138,1984,1984,twilight sparkle
1855126.jpeg,https://derpicdn.net/img/view/2018/10/13/1855126.jpeg,0,0.915089667,219,0,1759,1080,1540,1080,twilight sparkle
1855127.jpeg,https://derpicdn.net/img/view/2018/10/13/1855127.jpeg,0,0.909533441,399,0,1471,874,1072,874,twilight sparkle
1861985.jpeg,https://derpicdn.net/img/view/2018/10/21/1861985.jpeg,0,0.975178361,18,6,358,346,340,340,twilight sparkle
1862183.jpeg,https://derpicdn.net/img/view/2018/10/21/1862183.jpeg,0,0.99101001,191,0,865,608,674,608,twilight sparkle
1862207.jpeg,https://derpicdn.net/img/view/2018/10/21/1862207.jpeg,0,0.979139566,0,6,323,362,323,356,twilight sparkle
1862286.jpeg,https://derpicdn.net/img/view/2018/10/21/1862286.jpeg,0,0.968614221,0,0,949,926,949,926,twilight sparkle
1862389.jpeg,https://derpicdn.net/img/view/2018/10/21/1862389.jpeg,0,0.901184678,307,14,1202,922,895,908,twilight sparkle
1863333.jpeg,https://derpicdn.net/img/view/2018/10/22/1863333.jpeg,0,0.907161653,25,24,731,730,706,706,twilight sparkle
1863852.jpeg,https://derpicdn.net/img/view/2018/10/23/1863852.jpeg,0,0.988145769,461,0,1641,1148,1180,1148,twilight sparkle
1864346.jpeg,https://derpicdn.net/img/view/2018/10/23/1864346.jpeg,0,0.978504181,349,67,913,631,564,564,twilight sparkle
1865511.jpeg,https://derpicdn.net/img/view/2018/10/25/1865511.jpeg,0,0.901814759,939,0,1549,536,610,536,twilight sparkle
1865899.jpeg,https://derpicdn.net/img/view/2018/10/25/1865899.jpeg,0,0.985913634,79,0,718,589,639,589,twilight sparkle
1866163.jpeg,https://derpicdn.net/img/view/2018/10/26/1866163.jpeg,0,0.999211431,179,228,543,592,364,364,twilight sparkle
1866582.jpeg,https://derpicdn.net/img/view/2018/10/26/1866582.jpeg,0,0.998170376,501,420,921,840,420,420,twilight sparkle
1867805.jpeg,https://derpicdn.net/img/view/2018/10/27/1867805.jpeg,0,0.982330739,47,0,687,635,640,635,twilight sparkle
1868639.jpeg,https://derpicdn.net/img/view/2018/10/28/1868639.jpeg,0,0.935773373,31,0,643,368,612,368,twilight sparkle
1869340.jpeg,https://derpicdn.net/img/view/2018/10/29/1869340.jpeg,0,0.933545113,493,352,963,822,470,470,twilight sparkle
1870582.jpeg,https://derpicdn.net/img/view/2018/10/30/1870582.jpeg,0,0.997250319,464,0,1228,736,764,736,twilight sparkle
1874932.jpeg,https://derpicdn.net/img/view/2018/11/4/1874932.jpeg,0,0.986084163,195,136,1024,1096,829,960,twilight sparkle
1875875.jpeg,https://derpicdn.net/img/view/2018/11/5/1875875.jpeg,0,0.970616281,1654,477,2342,1165,688,688,twilight sparkle
1876865.jpeg,https://derpicdn.net/img/view/2018/11/7/1876865.jpeg,0,0.977856636,205,98,587,480,382,382,twilight sparkle
1879139.jpeg,https://derpicdn.net/img/view/2018/11/10/1879139.jpeg,0,0.966475904,25,48,553,576,528,528,twilight sparkle
1879217.jpeg,https://derpicdn.net/img/view/2018/11/10/1879217.jpeg,0,0.999340951,940,378,2626,2064,1686,1686,twilight sparkle
1881491.jpeg,https://derpicdn.net/img/view/2018/11/13/1881491.jpeg,0,0.995671272,96,0,1144,892,1048,892,twilight sparkle
1881709.jpeg,https://derpicdn.net/img/view/2018/11/13/1881709.jpeg,0,0.956859589,201,254,633,686,432,432,twilight sparkle
188272.jpeg,https://derpicdn.net/img/view/2012/12/20/188272.jpeg,0,0.904931664,0,0,554,568,554,568,twilight sparkle
188284.jpeg,https://derpicdn.net/img/view/2012/12/20/188284.jpeg,0,0.977679968,134,0,660,538,526,538,twilight sparkle
1883154.jpeg,https://derpicdn.net/img/view/2018/11/15/1883154.jpeg,0,0.997701645,161,5,471,315,310,310,twilight sparkle
1883711.jpeg,https://derpicdn.net/img/view/2018/11/16/1883711.jpeg,0,0.978196561,0,0,730,697,730,697,twilight sparkle
1884860.jpeg,https://derpicdn.net/img/view/2018/11/18/1884860.jpeg,0,0.998667777,601,0,1065,403,464,403,twilight sparkle
188547.jpeg,https://derpicdn.net/img/view/2012/12/20/188547.jpeg,0,0.953394413,1576,0,4738,2664,3162,2664,twilight sparkle
1887279.jpeg,https://derpicdn.net/img/view/2018/11/21/1887279.jpeg,0,0.993919313,759,477,1565,1283,806,806,twilight sparkle
1887574.jpeg,https://derpicdn.net/img/view/2018/11/21/1887574.jpeg,0,0.982923806,84,176,1152,1244,1068,1068,twilight sparkle
1888384.jpeg,https://derpicdn.net/img/view/2018/11/22/1888384.jpeg,0,0.998237014,142,0,636,449,494,449,twilight sparkle
1888569.jpeg,https://derpicdn.net/img/view/2018/11/22/1888569.jpeg,0,0.989920855,308,0,624,312,316,312,twilight sparkle
1889589.jpeg,https://derpicdn.net/img/view/2018/11/24/1889589.jpeg,0,0.994214416,123,0,521,360,398,360,twilight sparkle
1890318.jpeg,https://derpicdn.net/img/view/2018/11/25/1890318.jpeg,0,0.988611162,40,413,1136,1509,1096,1096,twilight sparkle
1890326.jpeg,https://derpicdn.net/img/view/2018/11/25/1890326.jpeg,0,0.992100179,472,14,990,532,518,518,twilight sparkle
1890326.jpeg,https://derpicdn.net/img/view/2018/11/25/1890326.jpeg,1,0.973415613,157,0,759,549,602,549,twilight sparkle
1890943.jpeg,https://derpicdn.net/img/view/2018/11/25/1890943.jpeg,0,0.989272535,803,87,1375,659,572,572,twilight sparkle
1892856.jpeg,https://derpicdn.net/img/view/2018/11/28/1892856.jpeg,0,0.965781152,867,446,1493,1072,626,626,twilight sparkle
1893108.jpeg,https://derpicdn.net/img/view/2018/11/28/1893108.jpeg,0,0.994266033,886,142,1800,1056,914,914,twilight sparkle
1893373.jpeg,https://derpicdn.net/img/view/2018/11/29/1893373.jpeg,0,0.913266957,37,19,455,437,418,418,twilight sparkle
1893413.jpeg,https://derpicdn.net/img/view/2018/11/29/1893413.jpeg,0,0.944381714,503,5,1513,1015,1010,1010,twilight sparkle
1894022.jpeg,https://derpicdn.net/img/view/2018/11/29/1894022.jpeg,0,0.992142141,163,0,467,301,304,301,twilight sparkle
1894376.jpeg,https://derpicdn.net/img/view/2018/11/30/1894376.jpeg,0,0.965801597,1004,0,3226,1920,2222,1920,twilight sparkle
1894411.jpeg,https://derpicdn.net/img/view/2018/11/30/1894411.jpeg,0,0.998625994,371,50,1158,878,787,828,twilight sparkle
1894419.jpeg,https://derpicdn.net/img/view/2018/11/30/1894419.jpeg,0,0.997547686,369,0,1021,601,652,601,twilight sparkle
1894543.jpeg,https://derpicdn.net/img/view/2018/11/30/1894543.jpeg,0,0.969593227,252,0,644,377,392,377,twilight sparkle
1895005.jpeg,https://derpicdn.net/img/view/2018/12/1/1895005.jpeg,0,0.997589231,0,0,371,373,371,373,twilight sparkle
1895663.jpeg,https://derpicdn.net/img/view/2018/12/1/1895663.jpeg,0,0.99276787,183,96,497,410,314,314,twilight sparkle
1895666.jpeg,https://derpicdn.net/img/view/2018/12/1/1895666.jpeg,0,0.979439139,250,5,786,541,536,536,twilight sparkle
1895666.jpeg,https://derpicdn.net/img/view/2018/12/1/1895666.jpeg,1,0.919744372,390,1716,882,2208,492,492,twilight sparkle
1895785.jpeg,https://derpicdn.net/img/view/2018/12/1/1895785.jpeg,0,0.989148378,129,0,857,688,728,688,twilight sparkle
1896393.jpeg,https://derpicdn.net/img/view/2018/12/2/1896393.jpeg,0,0.935393155,128,63,340,275,212,212,twilight sparkle
1896441.jpeg,https://derpicdn.net/img/view/2018/12/2/1896441.jpeg,0,0.985083282,38,0,278,226,240,226,twilight sparkle
1896744.jpeg,https://derpicdn.net/img/view/2018/12/3/1896744.jpeg,0,0.950537622,61,3,751,693,690,690,twilight sparkle
1896832.jpeg,https://derpicdn.net/img/view/2018/12/3/1896832.jpeg,0,0.967820108,66,401,462,797,396,396,twilight sparkle
1897453.jpeg,https://derpicdn.net/img/view/2018/12/3/1897453.jpeg,0,0.94512254,36,64,654,673,618,609,twilight sparkle
1897698.jpeg,https://derpicdn.net/img/view/2018/12/4/1897698.jpeg,0,0.997991085,2360,0,3740,1362,1380,1362,twilight sparkle
1899379.jpeg,https://derpicdn.net/img/view/2018/12/5/1899379.jpeg,0,0.994131565,218,130,1384,1296,1166,1166,twilight sparkle
1899842.jpeg,https://derpicdn.net/img/view/2018/12/6/1899842.jpeg,0,0.999040425,224,22,610,408,386,386,twilight sparkle
1900412.jpeg,https://derpicdn.net/img/view/2018/12/6/1900412.jpeg,0,0.962750375,5,166,800,998,795,832,twilight sparkle
1900483.jpeg,https://derpicdn.net/img/view/2018/12/6/1900483.jpeg,0,0.992331445,699,0,1621,851,922,851,twilight sparkle
1900654.jpeg,https://derpicdn.net/img/view/2018/12/6/1900654.jpeg,0,0.950817049,139,0,900,780,761,780,twilight sparkle
1901632.jpeg,https://derpicdn.net/img/view/2018/12/7/1901632.jpeg,0,0.963406265,742,195,1912,1365,1170,1170,twilight sparkle
1902367.jpeg,https://derpicdn.net/img/view/2018/12/8/1902367.jpeg,0,0.905396163,189,338,1293,1442,1104,1104,twilight sparkle
1903646.jpeg,https://derpicdn.net/img/view/2018/12/9/1903646.jpeg,0,0.996270895,446,6,954,514,508,508,twilight sparkle
1903662.jpeg,https://derpicdn.net/img/view/2018/12/9/1903662.jpeg,0,0.993468404,295,0,1349,1028,1054,1028,twilight sparkle
1905087.jpeg,https://derpicdn.net/img/view/2018/12/11/1905087.jpeg,0,0.996514618,383,1277,1535,2429,1152,1152,twilight sparkle
1907603.jpeg,https://derpicdn.net/img/view/2018/12/13/1907603.jpeg,0,0.998052657,843,0,2003,1154,1160,1154,twilight sparkle
1907883.jpeg,https://derpicdn.net/img/view/2018/12/14/1907883.jpeg,0,0.979721367,372,194,830,652,458,458,twilight sparkle
1908661.jpeg,https://derpicdn.net/img/view/2018/12/15/1908661.jpeg,0,0.984540403,761,453,1088,795,327,342,twilight sparkle
1910242.jpeg,https://derpicdn.net/img/view/2018/12/16/1910242.jpeg,0,0.983034909,728,721,1058,1051,330,330,twilight sparkle
1910696.jpeg,https://derpicdn.net/img/view/2018/12/17/1910696.jpeg,0,0.999664307,869,390,1733,1254,864,864,twilight sparkle
1910757.jpeg,https://derpicdn.net/img/view/2018/12/17/1910757.jpeg,0,0.909962296,188,18,624,454,436,436,twilight sparkle
1911176.jpeg,https://derpicdn.net/img/view/2018/12/17/1911176.jpeg,0,0.995640516,182,55,364,237,182,182,twilight sparkle
1911712.jpeg,https://derpicdn.net/img/view/2018/12/18/1911712.jpeg,2,0.97084415,1282,811,1708,1237,426,426,twilight sparkle
1911762.jpeg,https://derpicdn.net/img/view/2018/12/18/1911762.jpeg,0,0.983089507,0,60,934,1000,934,940,twilight sparkle
1911920.jpeg,https://derpicdn.net/img/view/2018/12/18/1911920.jpeg,0,0.945845902,1342,831,2696,2185,1354,1354,twilight sparkle
1913378.jpeg,https://derpicdn.net/img/view/2018/12/20/1913378.jpeg,0,0.915886879,761,175,2621,2035,1860,1860,twilight sparkle
1913473.jpeg,https://derpicdn.net/img/view/2018/12/20/1913473.jpeg,0,0.997376859,1192,515,2000,1323,808,808,twilight sparkle
1914826.jpeg,https://derpicdn.net/img/view/2018/12/21/1914826.jpeg,0,0.954837978,321,45,1103,827,782,782,twilight sparkle
1914858.jpeg,https://derpicdn.net/img/view/2018/12/21/1914858.jpeg,0,0.948207855,177,11,1043,877,866,866,twilight sparkle
1914859.jpeg,https://derpicdn.net/img/view/2018/12/21/1914859.jpeg,0,0.977639556,36,41,438,443,402,402,twilight sparkle
1914865.jpeg,https://derpicdn.net/img/view/2018/12/21/1914865.jpeg,0,0.988719106,119,0,1385,1141,1266,1141,twilight sparkle
1915615.jpeg,https://derpicdn.net/img/view/2018/12/22/1915615.jpeg,0,0.959163308,59,92,720,834,661,742,twilight sparkle
1916403.jpeg,https://derpicdn.net/img/view/2018/12/23/1916403.jpeg,0,0.988859177,215,214,1024,1024,809,810,twilight sparkle
1918303.jpeg,https://derpicdn.net/img/view/2018/12/25/1918303.jpeg,0,0.994420052,449,0,1267,710,818,710,twilight sparkle
1918966.jpeg,https://derpicdn.net/img/view/2018/12/26/1918966.jpeg,0,0.942444742,346,0,1218,781,872,781,twilight sparkle
1919735.jpeg,https://derpicdn.net/img/view/2018/12/27/1919735.jpeg,0,0.998305023,971,10,2017,1056,1046,1046,twilight sparkle
1920753.jpeg,https://derpicdn.net/img/view/2018/12/28/1920753.jpeg,0,0.994426429,112,0,1340,1187,1228,1187,twilight sparkle
1922133.jpeg,https://derpicdn.net/img/view/2018/12/30/1922133.jpeg,0,0.987441778,1028,139,2510,1621,1482,1482,twilight sparkle
1923903.jpeg,https://derpicdn.net/img/view/2019/1/1/1923903.jpeg,0,0.979771972,34,24,706,696,672,672,twilight sparkle
1924793.jpeg,https://derpicdn.net/img/view/2019/1/2/1924793.jpeg,0,0.994059205,678,3,994,319,316,316,twilight sparkle
1925214.jpeg,https://derpicdn.net/img/view/2019/1/2/1925214.jpeg,0,0.997396886,156,50,566,460,410,410,twilight sparkle
1925698.jpeg,https://derpicdn.net/img/view/2019/1/3/1925698.jpeg,0,0.991203845,284,47,720,483,436,436,twilight sparkle
1925981.jpeg,https://derpicdn.net/img/view/2019/1/3/1925981.jpeg,0,0.994017363,440,6,1022,588,582,582,twilight sparkle
1926083.jpeg,https://derpicdn.net/img/view/2019/1/4/1926083.jpeg,0,0.922794521,51,0,944,883,893,883,twilight sparkle
1926899.jpeg,https://derpicdn.net/img/view/2019/1/5/1926899.jpeg,0,0.993477702,21,0,649,615,628,615,twilight sparkle
1927760.jpeg,https://derpicdn.net/img/view/2019/1/6/1927760.jpeg,0,0.997175574,422,0,942,477,520,477,twilight sparkle
1928364.jpeg,https://derpicdn.net/img/view/2019/1/6/1928364.jpeg,0,0.991837502,202,0,668,466,466,466,twilight sparkle
1928831.jpeg,https://derpicdn.net/img/view/2019/1/7/1928831.jpeg,0,0.996658802,14,0,302,268,288,268,twilight sparkle
1929863.jpeg,https://derpicdn.net/img/view/2019/1/8/1929863.jpeg,0,0.912031233,618,0,2048,1323,1430,1323,twilight sparkle
1930712.jpeg,https://derpicdn.net/img/view/2019/1/9/1930712.jpeg,0,0.989666581,1157,63,2559,1465,1402,1402,twilight sparkle
1932227.jpeg,https://derpicdn.net/img/view/2019/1/11/1932227.jpeg,0,0.98256135,517,73,1119,675,602,602,twilight sparkle
1932647.jpeg,https://derpicdn.net/img/view/2019/1/11/1932647.jpeg,0,0.953544974,1326,221,2882,1777,1556,1556,twilight sparkle
1934604.jpeg,https://derpicdn.net/img/view/2019/1/13/1934604.jpeg,0,0.99910289,543,75,1083,615,540,540,twilight sparkle
1934609.jpeg,https://derpicdn.net/img/view/2019/1/13/1934609.jpeg,0,0.912284017,42,0,1094,1005,1052,1005,twilight sparkle
1935127.jpeg,https://derpicdn.net/img/view/2019/1/14/1935127.jpeg,0,0.998935819,613,77,1141,605,528,528,twilight sparkle
1935997.jpeg,https://derpicdn.net/img/view/2019/1/15/1935997.jpeg,0,0.998835802,24,25,310,311,286,286,twilight sparkle
1935997.jpeg,https://derpicdn.net/img/view/2019/1/15/1935997.jpeg,1,0.99879384,769,0,1249,409,480,409,twilight sparkle
1936263.jpeg,https://derpicdn.net/img/view/2019/1/15/1936263.jpeg,0,0.987303019,0,0,597,612,597,612,twilight sparkle
1936986.jpeg,https://derpicdn.net/img/view/2019/1/16/1936986.jpeg,0,0.921990693,443,170,1111,838,668,668,twilight sparkle
1937769.jpeg,https://derpicdn.net/img/view/2019/1/17/1937769.jpeg,0,0.998810351,204,19,846,661,642,642,twilight sparkle
1940591.jpeg,https://derpicdn.net/img/view/2019/1/21/1940591.jpeg,0,0.93237412,589,0,1053,429,464,429,twilight sparkle
1941257.jpeg,https://derpicdn.net/img/view/2019/1/21/1941257.jpeg,0,0.984819353,1445,849,1953,1357,508,508,twilight sparkle
1943706.jpeg,https://derpicdn.net/img/view/2019/1/25/1943706.jpeg,0,0.993940711,430,355,800,725,370,370,twilight sparkle
1943939.jpeg,https://derpicdn.net/img/view/2019/1/25/1943939.jpeg,0,0.953776658,42,230,844,987,802,757,twilight sparkle
1944390.jpeg,https://derpicdn.net/img/view/2019/1/25/1944390.jpeg,0,0.987169087,280,0,780,401,500,401,twilight sparkle
1945892.jpeg,https://derpicdn.net/img/view/2019/1/27/1945892.jpeg,0,0.996578574,24,17,302,295,278,278,twilight sparkle
1946800.jpeg,https://derpicdn.net/img/view/2019/1/28/1946800.jpeg,0,0.921034813,444,0,1720,1237,1276,1237,twilight sparkle
1947704.jpeg,https://derpicdn.net/img/view/2019/1/29/1947704.jpeg,0,0.993167877,244,57,712,525,468,468,twilight sparkle
1947729.jpeg,https://derpicdn.net/img/view/2019/1/29/1947729.jpeg,0,0.950623333,114,115,314,315,200,200,twilight sparkle
1947867.jpeg,https://derpicdn.net/img/view/2019/1/29/1947867.jpeg,0,0.942705154,14,0,503,499,489,499,twilight sparkle
1948398.jpeg,https://derpicdn.net/img/view/2019/1/30/1948398.jpeg,0,0.989991844,228,153,1324,1249,1096,1096,twilight sparkle
1949167.jpeg,https://derpicdn.net/img/view/2019/1/31/1949167.jpeg,0,0.932323933,422,0,932,394,510,394,twilight sparkle
1951341.jpeg,https://derpicdn.net/img/view/2019/2/2/1951341.jpeg,0,0.972822845,97,0,723,581,626,581,twilight sparkle
1953619.jpeg,https://derpicdn.net/img/view/2019/2/4/1953619.jpeg,0,0.992930114,273,0,2106,1900,1833,1900,twilight sparkle
1954606.jpeg,https://derpicdn.net/img/view/2019/2/5/1954606.jpeg,0,0.987709224,1011,140,1317,446,306,306,twilight sparkle
1955069.jpeg,https://derpicdn.net/img/view/2019/2/6/1955069.jpeg,2,0.994995296,104,584,378,858,274,274,twilight sparkle
1955082.jpeg,https://derpicdn.net/img/view/2019/2/6/1955082.jpeg,0,0.945793927,471,504,1537,1570,1066,1066,twilight sparkle
1955828.jpeg,https://derpicdn.net/img/view/2019/2/7/1955828.jpeg,0,0.979337752,0,0,700,758,700,758,twilight sparkle
1955990.jpeg,https://derpicdn.net/img/view/2019/2/7/1955990.jpeg,0,0.998540103,380,0,1052,664,672,664,twilight sparkle
1956538.jpeg,https://derpicdn.net/img/view/2019/2/8/1956538.jpeg,0,0.99900198,132,0,540,377,408,377,twilight sparkle
1956550.jpeg,https://derpicdn.net/img/view/2019/2/8/1956550.jpeg,0,0.989125073,131,6,517,392,386,386,twilight sparkle
1957165.jpeg,https://derpicdn.net/img/view/2019/2/9/1957165.jpeg,0,0.915512979,153,3,633,483,480,480,twilight sparkle
1957275.jpeg,https://derpicdn.net/img/view/2019/2/9/1957275.jpeg,0,0.992034674,89,0,521,371,432,371,twilight sparkle
1957340.jpeg,https://derpicdn.net/img/view/2019/2/9/1957340.jpeg,0,0.982676506,343,113,645,415,302,302,twilight sparkle
1957654.jpeg,https://derpicdn.net/img/view/2019/2/9/1957654.jpeg,0,0.951410413,837,457,1603,1223,766,766,twilight sparkle
1957980.jpeg,https://derpicdn.net/img/view/2019/2/10/1957980.jpeg,0,0.930347919,376,112,630,366,254,254,twilight sparkle
1957980.jpeg,https://derpicdn.net/img/view/2019/2/10/1957980.jpeg,1,0.914903283,580,804,924,1148,344,344,twilight sparkle
1958471.jpeg,https://derpicdn.net/img/view/2019/2/10/1958471.jpeg,0,0.999126315,210,114,452,356,242,242,twilight sparkle
1958477.jpeg,https://derpicdn.net/img/view/2019/2/10/1958477.jpeg,0,0.999322355,399,25,699,325,300,300,twilight sparkle
1958570.jpeg,https://derpicdn.net/img/view/2019/2/10/1958570.jpeg,0,0.912302732,0,22,840,872,840,850,twilight sparkle
1960633.jpeg,https://derpicdn.net/img/view/2019/2/13/1960633.jpeg,0,0.958969355,180,28,634,482,454,454,twilight sparkle
1961620.jpeg,https://derpicdn.net/img/view/2019/2/14/1961620.jpeg,0,0.990964711,85,0,699,599,614,599,twilight sparkle
1962583.jpeg,https://derpicdn.net/img/view/2019/2/15/1962583.jpeg,0,0.967006862,222,154,912,844,690,690,twilight sparkle
1963043.jpeg,https://derpicdn.net/img/view/2019/2/15/1963043.jpeg,0,0.949288309,146,0,810,624,664,624,twilight sparkle
1963654.jpeg,https://derpicdn.net/img/view/2019/2/16/1963654.jpeg,0,0.986963272,287,164,1059,936,772,772,twilight sparkle
1965008.jpeg,https://derpicdn.net/img/view/2019/2/18/1965008.jpeg,0,0.985230982,0,0,593,569,593,569,twilight sparkle
1965263.jpeg,https://derpicdn.net/img/view/2019/2/18/1965263.jpeg,0,0.965322912,0,106,696,968,696,862,twilight sparkle
1965349.jpeg,https://derpicdn.net/img/view/2019/2/18/1965349.jpeg,0,0.998657525,418,0,916,470,498,470,twilight sparkle
1966595.jpeg,https://derpicdn.net/img/view/2019/2/20/1966595.jpeg,0,0.975739658,9,7,792,859,783,852,twilight sparkle
1966858.jpeg,https://derpicdn.net/img/view/2019/2/20/1966858.jpeg,0,0.987558067,338,0,2390,2019,2052,2019,twilight sparkle
1967161.jpeg,https://derpicdn.net/img/view/2019/2/20/1967161.jpeg,0,0.96342814,36,434,1500,1914,1464,1480,twilight sparkle
1969493.jpeg,https://derpicdn.net/img/view/2019/2/23/1969493.jpeg,0,0.956915975,583,0,1118,549,535,549,twilight sparkle
1969493.jpeg,https://derpicdn.net/img/view/2019/2/23/1969493.jpeg,1,0.941482723,12,0,628,590,616,590,twilight sparkle
1971164.jpeg,https://derpicdn.net/img/view/2019/2/25/1971164.jpeg,0,0.930761516,166,104,1168,1106,1002,1002,twilight sparkle
1972817.jpeg,https://derpicdn.net/img/view/2019/2/27/1972817.jpeg,0,0.996053934,0,0,377,379,377,379,twilight sparkle
1973228.jpeg,https://derpicdn.net/img/view/2019/2/27/1973228.jpeg,0,0.977574289,0,6,379,414,379,408,twilight sparkle
1973511.jpeg,https://derpicdn.net/img/view/2019/2/28/1973511.jpeg,0,0.998405516,266,85,692,511,426,426,twilight sparkle
1975731.jpeg,https://derpicdn.net/img/view/2019/3/2/1975731.jpeg,0,0.958124638,209,105,1929,1825,1720,1720,twilight sparkle
1977815.jpeg,https://derpicdn.net/img/view/2019/3/5/1977815.jpeg,0,0.9697752,191,82,979,870,788,788,twilight sparkle
1977877.jpeg,https://derpicdn.net/img/view/2019/3/5/1977877.jpeg,0,0.999523997,226,54,516,344,290,290,twilight sparkle
1978939.jpeg,https://derpicdn.net/img/view/2019/3/6/1978939.jpeg,0,0.957891464,564,47,880,363,316,316,twilight sparkle
1979855.jpeg,https://derpicdn.net/img/view/2019/3/7/1979855.jpeg,0,0.999414623,2,0,346,344,344,344,twilight sparkle
1983339.jpeg,https://derpicdn.net/img/view/2019/3/11/1983339.jpeg,0,0.985995412,226,152,886,812,660,660,twilight sparkle
1983553.jpeg,https://derpicdn.net/img/view/2019/3/12/1983553.jpeg,0,0.997815192,391,10,935,554,544,544,twilight sparkle
1983622.jpeg,https://derpicdn.net/img/view/2019/3/12/1983622.jpeg,0,0.969852149,792,0,1240,429,448,429,twilight sparkle
1983674.jpeg,https://derpicdn.net/img/view/2019/3/12/1983674.jpeg,0,0.987596571,0,0,1052,1057,1052,1057,twilight sparkle
1983975.jpeg,https://derpicdn.net/img/view/2019/3/12/1983975.jpeg,0,0.982165039,377,20,713,356,336,336,twilight sparkle
1984956.jpeg,https://derpicdn.net/img/view/2019/3/14/1984956.jpeg,0,0.99773109,431,808,1375,1752,944,944,twilight sparkle
1986816.jpeg,https://derpicdn.net/img/view/2019/3/16/1986816.jpeg,0,0.99318254,259,14,1075,830,816,816,twilight sparkle
1987288.jpeg,https://derpicdn.net/img/view/2019/3/16/1987288.jpeg,0,0.995833695,253,150,623,520,370,370,twilight sparkle
1987515.jpeg,https://derpicdn.net/img/view/2019/3/16/1987515.jpeg,0,0.929705083,87,0,529,422,442,422,twilight sparkle
1987521.jpeg,https://derpicdn.net/img/view/2019/3/16/1987521.jpeg,0,0.910113215,759,0,1549,702,790,702,twilight sparkle
1988427.jpeg,https://derpicdn.net/img/view/2019/3/17/1988427.jpeg,0,0.998903394,1003,37,2063,1097,1060,1060,twilight sparkle
1989107.jpeg,https://derpicdn.net/img/view/2019/3/18/1989107.jpeg,0,0.972382426,233,24,577,368,344,344,twilight sparkle
1990965.jpeg,https://derpicdn.net/img/view/2019/3/20/1990965.jpeg,0,0.988546431,38,50,694,706,656,656,twilight sparkle
1990997.jpeg,https://derpicdn.net/img/view/2019/3/20/1990997.jpeg,0,0.987375736,157,0,1191,720,1034,720,twilight sparkle
1991366.jpeg,https://derpicdn.net/img/view/2019/3/21/1991366.jpeg,0,0.995150566,567,192,1159,784,592,592,twilight sparkle
1991456.jpeg,https://derpicdn.net/img/view/2019/3/21/1991456.jpeg,0,0.994268358,501,0,905,380,404,380,twilight sparkle
1992519.jpeg,https://derpicdn.net/img/view/2019/3/23/1992519.jpeg,0,0.998941779,588,0,1200,548,612,548,twilight sparkle
1992585.jpeg,https://derpicdn.net/img/view/2019/3/23/1992585.jpeg,0,0.922406971,0,0,677,661,677,661,twilight sparkle
1992833.jpeg,https://derpicdn.net/img/view/2019/3/23/1992833.jpeg,0,0.988041222,0,0,517,512,517,512,twilight sparkle
199329.jpeg,https://derpicdn.net/img/view/2013/1/1/199329.jpeg,0,0.995640099,101,2,383,284,282,282,twilight sparkle
1995591.jpeg,https://derpicdn.net/img/view/2019/3/26/1995591.jpeg,0,0.936425507,539,34,1705,1200,1166,1166,twilight sparkle
1996652.jpeg,https://derpicdn.net/img/view/2019/3/28/1996652.jpeg,0,0.989844143,47,0,497,450,450,450,twilight sparkle
1998413.jpeg,https://derpicdn.net/img/view/2019/3/30/1998413.jpeg,0,0.966612875,0,0,380,514,380,514,twilight sparkle
1998468.jpeg,https://derpicdn.net/img/view/2019/3/30/1998468.jpeg,0,0.982088864,0,39,1171,1211,1171,1172,twilight sparkle
1998964.jpeg,https://derpicdn.net/img/view/2019/3/31/1998964.jpeg,0,0.978633404,0,0,969,1082,969,1082,twilight sparkle
1999043.jpeg,https://derpicdn.net/img/view/2019/3/31/1999043.jpeg,0,0.999794304,7,0,705,649,698,649,twilight sparkle
1999043.jpeg,https://derpicdn.net/img/view/2019/3/31/1999043.jpeg,1,0.993511081,0,649,780,1451,780,802,twilight sparkle
1999043.jpeg,https://derpicdn.net/img/view/2019/3/31/1999043.jpeg,2,0.984519601,794,0,1412,605,618,605,twilight sparkle
2000196.jpeg,https://derpicdn.net/img/view/2019/4/1/2000196.jpeg,0,0.999159217,341,90,709,458,368,368,twilight sparkle
2003504.jpeg,https://derpicdn.net/img/view/2019/4/5/2003504.jpeg,0,0.960937858,549,21,1287,759,738,738,twilight sparkle
2004682.jpeg,https://derpicdn.net/img/view/2019/4/6/2004682.jpeg,0,0.990294099,479,240,921,682,442,442,twilight sparkle
2005389.jpeg,https://derpicdn.net/img/view/2019/4/7/2005389.jpeg,0,0.999301076,372,0,1100,696,728,696,twilight sparkle
2007564.jpeg,https://derpicdn.net/img/view/2019/4/9/2007564.jpeg,0,0.979486823,266,0,558,263,292,263,twilight sparkle
2007814.jpeg,https://derpicdn.net/img/view/2019/4/10/2007814.jpeg,0,0.900561988,323,0,793,391,470,391,twilight sparkle
2009965.jpeg,https://derpicdn.net/img/view/2019/4/12/2009965.jpeg,0,0.977022409,503,0,2805,2070,2302,2070,twilight sparkle
2010409.jpeg,https://derpicdn.net/img/view/2019/4/13/2010409.jpeg,0,0.965484977,0,0,2061,2110,2061,2110,twilight sparkle
2010967.jpeg,https://derpicdn.net/img/view/2019/4/13/2010967.jpeg,0,0.99703306,660,0,2470,1779,1810,1779,twilight sparkle
2011237.jpeg,https://derpicdn.net/img/view/2019/4/13/2011237.jpeg,0,0.927431166,726,0,1874,1143,1148,1143,twilight sparkle
2012982.jpeg,https://derpicdn.net/img/view/2019/4/15/2012982.jpeg,0,0.972302556,1111,227,1731,847,620,620,twilight sparkle
2013831.jpeg,https://derpicdn.net/img/view/2019/4/16/2013831.jpeg,0,0.982680023,495,311,747,563,252,252,twilight sparkle
2013954.jpeg,https://derpicdn.net/img/view/2019/4/16/2013954.jpeg,0,0.991935551,364,99,2120,1887,1756,1788,twilight sparkle
2014311.jpeg,https://derpicdn.net/img/view/2019/4/16/2014311.jpeg,0,0.930911064,763,0,2051,1184,1288,1184,twilight sparkle
2015485.jpeg,https://derpicdn.net/img/view/2019/4/18/2015485.jpeg,0,0.983054936,97,49,1205,1157,1108,1108,twilight sparkle
2016379.jpeg,https://derpicdn.net/img/view/2019/4/19/2016379.jpeg,0,0.9960109,195,50,613,468,418,418,twilight sparkle
2016880.jpeg,https://derpicdn.net/img/view/2019/4/19/2016880.jpeg,0,0.998372018,233,0,1125,875,892,875,twilight sparkle
2016895.jpeg,https://derpicdn.net/img/view/2019/4/19/2016895.jpeg,0,0.99945724,305,106,2879,2680,2574,2574,twilight sparkle
2017025.jpeg,https://derpicdn.net/img/view/2019/4/19/2017025.jpeg,0,0.957470238,17,0,732,791,715,791,twilight sparkle
2017089.jpeg,https://derpicdn.net/img/view/2019/4/19/2017089.jpeg,0,0.991514742,156,0,2988,2802,2832,2802,twilight sparkle
2017693.jpeg,https://derpicdn.net/img/view/2019/4/20/2017693.jpeg,0,0.92834568,64,0,1542,935,1478,935,twilight sparkle
2017845.jpeg,https://derpicdn.net/img/view/2019/4/20/2017845.jpeg,1,0.901351869,168,0,858,595,690,595,twilight sparkle
2019030.jpeg,https://derpicdn.net/img/view/2019/4/21/2019030.jpeg,0,0.982922733,106,585,1098,1532,992,947,twilight sparkle
2019030.jpeg,https://derpicdn.net/img/view/2019/4/21/2019030.jpeg,1,0.976091862,0,0,945,876,945,876,twilight sparkle
2020086.jpeg,https://derpicdn.net/img/view/2019/4/22/2020086.jpeg,0,0.999405563,823,50,1685,912,862,862,twilight sparkle
2021087.jpeg,https://derpicdn.net/img/view/2019/4/23/2021087.jpeg,0,0.949289083,134,0,1304,1009,1170,1009,twilight sparkle
2021667.jpeg,https://derpicdn.net/img/view/2019/4/24/2021667.jpeg,0,0.99723047,117,0,281,142,164,142,twilight sparkle
2022147.jpeg,https://derpicdn.net/img/view/2019/4/24/2022147.jpeg,0,0.985535264,109,36,475,402,366,366,twilight sparkle
2022506.jpeg,https://derpicdn.net/img/view/2019/4/25/2022506.jpeg,0,0.999187052,242,0,870,610,628,610,twilight sparkle
2026618.jpeg,https://derpicdn.net/img/view/2019/4/29/2026618.jpeg,0,0.98825711,55,59,1479,1483,1424,1424,twilight sparkle
2027062.jpeg,https://derpicdn.net/img/view/2019/4/30/2027062.jpeg,0,0.99455905,119,21,407,309,288,288,twilight sparkle
2027275.jpeg,https://derpicdn.net/img/view/2019/4/30/2027275.jpeg,0,0.992310762,70,0,908,665,838,665,twilight sparkle
2028593.jpeg,https://derpicdn.net/img/view/2019/5/1/2028593.jpeg,0,0.929208934,487,82,845,440,358,358,twilight sparkle
2029119.jpeg,https://derpicdn.net/img/view/2019/5/2/2029119.jpeg,0,0.993622363,319,27,667,375,348,348,twilight sparkle
2029295.jpeg,https://derpicdn.net/img/view/2019/5/2/2029295.jpeg,0,0.980805755,503,83,1109,689,606,606,twilight sparkle
2031239.jpeg,https://derpicdn.net/img/view/2019/5/5/2031239.jpeg,0,0.951947808,345,2,1367,1024,1022,1022,twilight sparkle
2032537.jpeg,https://derpicdn.net/img/view/2019/5/6/2032537.jpeg,0,0.978819251,404,0,1334,888,930,888,twilight sparkle
2032545.jpeg,https://derpicdn.net/img/view/2019/5/6/2032545.jpeg,0,0.970271826,222,0,1536,1247,1314,1247,twilight sparkle
2032754.jpeg,https://derpicdn.net/img/view/2019/5/6/2032754.jpeg,0,0.942655742,0,42,769,814,769,772,twilight sparkle
2034339.jpeg,https://derpicdn.net/img/view/2019/5/9/2034339.jpeg,0,0.985859573,0,0,581,570,581,570,twilight sparkle
2034818.jpeg,https://derpicdn.net/img/view/2019/5/9/2034818.jpeg,0,0.906071663,84,0,1086,974,1002,974,twilight sparkle
2035192.jpeg,https://derpicdn.net/img/view/2019/5/10/2035192.jpeg,0,0.979230702,59,0,840,779,781,779,twilight sparkle
2035899.jpeg,https://derpicdn.net/img/view/2019/5/11/2035899.jpeg,0,0.976863444,0,0,547,562,547,562,twilight sparkle
2036346.jpeg,https://derpicdn.net/img/view/2019/5/11/2036346.jpeg,0,0.996289849,474,572,1006,1104,532,532,twilight sparkle
2039598.jpeg,https://derpicdn.net/img/view/2019/5/15/2039598.jpeg,0,0.955601752,0,0,639,638,639,638,twilight sparkle
2043407.jpeg,https://derpicdn.net/img/view/2019/5/19/2043407.jpeg,0,0.994652689,701,36,2461,1796,1760,1760,twilight sparkle
2043837.jpeg,https://derpicdn.net/img/view/2019/5/19/2043837.jpeg,0,0.983142853,1415,0,3003,1293,1588,1293,twilight sparkle
2044230.jpeg,https://derpicdn.net/img/view/2019/5/20/2044230.jpeg,0,0.945534527,0,0,753,753,753,753,twilight sparkle
2046994.jpeg,https://derpicdn.net/img/view/2019/5/23/2046994.jpeg,0,0.995489895,846,192,1686,1032,840,840,twilight sparkle
2048038.jpeg,https://derpicdn.net/img/view/2019/5/24/2048038.jpeg,0,0.996333003,280,130,636,486,356,356,twilight sparkle
2049212.jpeg,https://derpicdn.net/img/view/2019/5/26/2049212.jpeg,0,0.998883665,911,367,1743,1199,832,832,twilight sparkle
2051685.jpeg,https://derpicdn.net/img/view/2019/5/28/2051685.jpeg,0,0.949702501,98,52,846,800,748,748,twilight sparkle
2051863.jpeg,https://derpicdn.net/img/view/2019/5/28/2051863.jpeg,0,0.95906502,174,101,834,761,660,660,twilight sparkle
2053445.jpeg,https://derpicdn.net/img/view/2019/5/30/2053445.jpeg,0,0.998604417,841,206,1081,446,240,240,twilight sparkle
2053445.jpeg,https://derpicdn.net/img/view/2019/5/30/2053445.jpeg,1,0.970309079,1058,199,1294,435,236,236,twilight sparkle
2054012.jpeg,https://derpicdn.net/img/view/2019/5/31/2054012.jpeg,0,0.985720336,0,0,493,479,493,479,twilight sparkle
2054272.jpeg,https://derpicdn.net/img/view/2019/5/31/2054272.jpeg,0,0.943946064,913,41,2293,1421,1380,1380,twilight sparkle
2054734.jpeg,https://derpicdn.net/img/view/2019/6/1/2054734.jpeg,0,0.919148386,154,0,930,712,776,712,twilight sparkle
2054909.jpeg,https://derpicdn.net/img/view/2019/6/1/2054909.jpeg,0,0.98734808,187,0,597,399,410,399,twilight sparkle
2055134.jpeg,https://derpicdn.net/img/view/2019/6/1/2055134.jpeg,0,0.954902768,298,291,758,751,460,460,twilight sparkle
2055368.jpeg,https://derpicdn.net/img/view/2019/6/1/2055368.jpeg,0,0.957080007,12,3,1099,1101,1087,1098,twilight sparkle
2057326.jpeg,https://derpicdn.net/img/view/2019/6/4/2057326.jpeg,0,0.992833376,94,51,986,943,892,892,twilight sparkle
2058664.jpeg,https://derpicdn.net/img/view/2019/6/5/2058664.jpeg,0,0.998109579,178,149,1238,1209,1060,1060,twilight sparkle
2058806.jpeg,https://derpicdn.net/img/view/2019/6/5/2058806.jpeg,0,0.99573791,0,13,615,699,615,686,twilight sparkle
2059525.jpeg,https://derpicdn.net/img/view/2019/6/7/2059525.jpeg,0,0.936575055,79,19,387,327,308,308,twilight sparkle
2059658.jpeg,https://derpicdn.net/img/view/2019/6/7/2059658.jpeg,0,0.991767287,550,62,1046,558,496,496,twilight sparkle
2059905.jpeg,https://derpicdn.net/img/view/2019/6/7/2059905.jpeg,0,0.960729957,290,171,824,705,534,534,twilight sparkle
2060526.jpeg,https://derpicdn.net/img/view/2019/6/8/2060526.jpeg,0,0.990068853,1944,1285,3668,3009,1724,1724,twilight sparkle
2060701.jpeg,https://derpicdn.net/img/view/2019/6/8/2060701.jpeg,0,0.97387445,213,65,1155,1007,942,942,twilight sparkle
2063981.jpeg,https://derpicdn.net/img/view/2019/6/12/2063981.jpeg,0,0.998515904,225,10,557,342,332,332,twilight sparkle
2066010.jpeg,https://derpicdn.net/img/view/2019/6/15/2066010.jpeg,0,0.972437084,51,0,409,357,358,357,twilight sparkle
2071494.jpeg,https://derpicdn.net/img/view/2019/6/21/2071494.jpeg,0,0.992887676,114,0,1084,879,970,879,twilight sparkle
2071833.jpeg,https://derpicdn.net/img/view/2019/6/22/2071833.jpeg,0,0.901675999,225,153,613,541,388,388,twilight sparkle
2072517.jpeg,https://derpicdn.net/img/view/2019/6/22/2072517.jpeg,0,0.953454018,0,87,1222,1481,1222,1394,twilight sparkle
2072738.jpeg,https://derpicdn.net/img/view/2019/6/23/2072738.jpeg,0,0.997093379,174,0,710,482,536,482,twilight sparkle
2072797.jpeg,https://derpicdn.net/img/view/2019/6/23/2072797.jpeg,0,0.999099433,442,83,1162,803,720,720,twilight sparkle
2073581.jpeg,https://derpicdn.net/img/view/2019/6/23/2073581.jpeg,0,0.999346018,1937,10,3599,1672,1662,1662,twilight sparkle
2074221.jpeg,https://derpicdn.net/img/view/2019/6/24/2074221.jpeg,0,0.998795748,222,0,470,247,248,247,twilight sparkle
2074847.jpeg,https://derpicdn.net/img/view/2019/6/25/2074847.jpeg,0,0.993261576,372,69,644,341,272,272,twilight sparkle
2076040.jpeg,https://derpicdn.net/img/view/2019/6/26/2076040.jpeg,0,0.920215428,62,0,822,677,760,677,twilight sparkle
2076884.jpeg,https://derpicdn.net/img/view/2019/6/27/2076884.jpeg,0,0.939996302,359,36,729,406,370,370,twilight sparkle
2077813.jpeg,https://derpicdn.net/img/view/2019/6/28/2077813.jpeg,0,0.985842645,124,0,1196,928,1072,928,twilight sparkle
2078496.jpeg,https://derpicdn.net/img/view/2019/6/29/2078496.jpeg,0,0.950401485,0,7,659,737,659,730,twilight sparkle
2078504.jpeg,https://derpicdn.net/img/view/2019/6/29/2078504.jpeg,0,0.999463677,478,75,1372,969,894,894,twilight sparkle
2078527.jpeg,https://derpicdn.net/img/view/2019/6/29/2078527.jpeg,0,0.936220765,648,80,1352,784,704,704,twilight sparkle
2078684.jpeg,https://derpicdn.net/img/view/2019/6/29/2078684.jpeg,0,0.988809109,338,0,1966,1367,1628,1367,twilight sparkle
2082257.jpeg,https://derpicdn.net/img/view/2019/7/3/2082257.jpeg,0,0.98074019,249,0,959,678,710,678,twilight sparkle
2083585.jpeg,https://derpicdn.net/img/view/2019/7/5/2083585.jpeg,0,0.96553117,59,9,523,473,464,464,twilight sparkle
2083626.jpeg,https://derpicdn.net/img/view/2019/7/5/2083626.jpeg,0,0.986243963,133,64,579,510,446,446,twilight sparkle
2083751.jpeg,https://derpicdn.net/img/view/2019/7/5/2083751.jpeg,0,0.926941514,0,0,385,364,385,364,twilight sparkle
2083940.jpeg,https://derpicdn.net/img/view/2019/7/5/2083940.jpeg,0,0.929166436,0,52,752,824,752,772,twilight sparkle
2084507.jpeg,https://derpicdn.net/img/view/2019/7/6/2084507.jpeg,0,0.994792044,118,300,470,652,352,352,twilight sparkle
2084507.jpeg,https://derpicdn.net/img/view/2019/7/6/2084507.jpeg,1,0.994783819,319,17,741,439,422,422,twilight sparkle
2084576.jpeg,https://derpicdn.net/img/view/2019/7/6/2084576.jpeg,0,0.991259813,346,50,638,342,292,292,twilight sparkle
2085076.jpeg,https://derpicdn.net/img/view/2019/7/7/2085076.jpeg,0,0.958573937,84,0,578,441,494,441,twilight sparkle
2085212.jpeg,https://derpicdn.net/img/view/2019/7/7/2085212.jpeg,0,0.978800178,626,0,1126,421,500,421,twilight sparkle
2085396.jpeg,https://derpicdn.net/img/view/2019/7/7/2085396.jpeg,0,0.997684598,372,125,688,441,316,316,twilight sparkle
2085891.jpeg,https://derpicdn.net/img/view/2019/7/8/2085891.jpeg,0,0.983384252,479,141,1309,971,830,830,twilight sparkle
2086797.jpeg,https://derpicdn.net/img/view/2019/7/8/2086797.jpeg,0,0.996942759,511,0,1447,931,936,931,twilight sparkle
2087640.jpeg,https://derpicdn.net/img/view/2019/7/10/2087640.jpeg,0,0.924086928,0,0,266,260,266,260,twilight sparkle
2088258.jpeg,https://derpicdn.net/img/view/2019/7/10/2088258.jpeg,0,0.988600194,88,0,566,457,478,457,twilight sparkle
2088566.jpeg,https://derpicdn.net/img/view/2019/7/11/2088566.jpeg,0,0.924618483,63,92,583,612,520,520,twilight sparkle
2089291.jpeg,https://derpicdn.net/img/view/2019/7/11/2089291.jpeg,0,0.99571985,649,11,1251,613,602,602,twilight sparkle
2089739.jpeg,https://derpicdn.net/img/view/2019/7/12/2089739.jpeg,0,0.928019881,116,155,1816,1855,1700,1700,twilight sparkle
2090052.jpeg,https://derpicdn.net/img/view/2019/7/12/2090052.jpeg,0,0.961957693,538,493,1214,1169,676,676,twilight sparkle
2091287.jpeg,https://derpicdn.net/img/view/2019/7/14/2091287.jpeg,0,0.995705605,597,0,1221,620,624,620,twilight sparkle
2092381.jpeg,https://derpicdn.net/img/view/2019/7/15/2092381.jpeg,0,0.936332583,118,288,516,686,398,398,twilight sparkle
2092393.jpeg,https://derpicdn.net/img/view/2019/7/15/2092393.jpeg,0,0.997642219,464,39,978,553,514,514,twilight sparkle
2093206.jpeg,https://derpicdn.net/img/view/2019/7/16/2093206.jpeg,0,0.987025082,131,440,745,1054,614,614,twilight sparkle
2093206.jpeg,https://derpicdn.net/img/view/2019/7/16/2093206.jpeg,1,0.96725601,691,104,1319,732,628,628,twilight sparkle
2093527.jpeg,https://derpicdn.net/img/view/2019/7/16/2093527.jpeg,0,0.996345758,975,586,1433,1044,458,458,twilight sparkle
2094321.jpeg,https://derpicdn.net/img/view/2019/7/17/2094321.jpeg,0,0.990827203,107,26,859,778,752,752,twilight sparkle
2096802.jpeg,https://derpicdn.net/img/view/2019/7/20/2096802.jpeg,0,0.975360274,337,198,945,806,608,608,twilight sparkle
2096879.jpeg,https://derpicdn.net/img/view/2019/7/20/2096879.jpeg,0,0.934336424,110,0,862,701,752,701,twilight sparkle
2096917.jpeg,https://derpicdn.net/img/view/2019/7/20/2096917.jpeg,0,0.997833729,980,0,1432,377,452,377,twilight sparkle
2097158.jpeg,https://derpicdn.net/img/view/2019/7/21/2097158.jpeg,0,0.983976245,153,601,939,1387,786,786,twilight sparkle
2098028.jpeg,https://derpicdn.net/img/view/2019/7/21/2098028.jpeg,0,0.997392833,789,188,1413,812,624,624,twilight sparkle
209813.jpeg,https://derpicdn.net/img/view/2013/1/12/209813.jpeg,0,0.970185697,219,272,541,594,322,322,twilight sparkle
2099458.jpeg,https://derpicdn.net/img/view/2019/7/23/2099458.jpeg,0,0.997550249,102,6,546,450,444,444,twilight sparkle
2100179.jpeg,https://derpicdn.net/img/view/2019/7/24/2100179.jpeg,0,0.997936428,636,141,1488,993,852,852,twilight sparkle
2101177.jpeg,https://derpicdn.net/img/view/2019/7/25/2101177.jpeg,0,0.997084856,877,135,1685,943,808,808,twilight sparkle
2101389.jpeg,https://derpicdn.net/img/view/2019/7/26/2101389.jpeg,0,0.997976303,414,1,708,295,294,294,twilight sparkle
2101389.jpeg,https://derpicdn.net/img/view/2019/7/26/2101389.jpeg,1,0.991589308,769,166,1077,474,308,308,twilight sparkle
2101507.jpeg,https://derpicdn.net/img/view/2019/7/26/2101507.jpeg,0,0.963218808,0,34,389,442,389,408,twilight sparkle
2103344.jpeg,https://derpicdn.net/img/view/2019/7/28/2103344.jpeg,0,0.997966528,30,9,604,583,574,574,twilight sparkle
2103581.jpeg,https://derpicdn.net/img/view/2019/7/28/2103581.jpeg,0,0.901921511,37,0,1057,975,1020,975,twilight sparkle
2104654.jpeg,https://derpicdn.net/img/view/2019/7/30/2104654.jpeg,0,0.999679387,111,2,553,444,442,442,twilight sparkle
2104747.jpeg,https://derpicdn.net/img/view/2019/7/30/2104747.jpeg,0,0.993976653,304,35,1236,987,932,952,twilight sparkle
2106584.jpeg,https://derpicdn.net/img/view/2019/8/1/2106584.jpeg,0,0.969715238,0,0,451,430,451,430,twilight sparkle
2107981.jpeg,https://derpicdn.net/img/view/2019/8/3/2107981.jpeg,0,0.975717306,78,1,498,337,420,336,twilight sparkle
2109403.jpeg,https://derpicdn.net/img/view/2019/8/5/2109403.jpeg,0,0.962670624,969,421,2835,2287,1866,1866,twilight sparkle
2109403.jpeg,https://derpicdn.net/img/view/2019/8/5/2109403.jpeg,1,0.912095189,2144,140,4036,2032,1892,1892,twilight sparkle
2110482.jpeg,https://derpicdn.net/img/view/2019/8/6/2110482.jpeg,0,0.98805064,142,35,576,469,434,434,twilight sparkle
2111020.jpeg,https://derpicdn.net/img/view/2019/8/7/2111020.jpeg,0,0.991300225,132,46,550,464,418,418,twilight sparkle
2112977.jpeg,https://derpicdn.net/img/view/2019/8/9/2112977.jpeg,0,0.987561643,0,71,770,864,770,793,twilight sparkle
2112977.jpeg,https://derpicdn.net/img/view/2019/8/9/2112977.jpeg,1,0.981709898,131,0,966,812,835,812,twilight sparkle
2113703.jpeg,https://derpicdn.net/img/view/2019/8/10/2113703.jpeg,0,0.991196275,178,0,444,265,266,265,twilight sparkle
2113724.jpeg,https://derpicdn.net/img/view/2019/8/10/2113724.jpeg,0,0.992942095,289,0,589,249,300,249,twilight sparkle
2114404.jpeg,https://derpicdn.net/img/view/2019/8/10/2114404.jpeg,0,0.997320652,486,0,1118,618,632,618,twilight sparkle
2119113.jpeg,https://derpicdn.net/img/view/2019/8/15/2119113.jpeg,0,0.981382847,323,102,2749,2528,2426,2426,twilight sparkle
2120227.jpeg,https://derpicdn.net/img/view/2019/8/17/2120227.jpeg,0,0.995718718,472,885,1118,1531,646,646,twilight sparkle
2121190.jpeg,https://derpicdn.net/img/view/2019/8/18/2121190.jpeg,0,0.98981905,1,65,859,900,858,835,twilight sparkle
2123101.jpeg,https://derpicdn.net/img/view/2019/8/20/2123101.jpeg,0,0.957154989,192,88,772,668,580,580,twilight sparkle
2124738.jpeg,https://derpicdn.net/img/view/2019/8/22/2124738.jpeg,0,0.988404751,475,82,849,456,374,374,twilight sparkle
2128229.jpeg,https://derpicdn.net/img/view/2019/8/26/2128229.jpeg,0,0.973239124,0,0,538,502,538,502,twilight sparkle
2129750.jpeg,https://derpicdn.net/img/view/2019/8/28/2129750.jpeg,0,0.985147119,15,0,323,288,308,288,twilight sparkle
2131247.jpeg,https://derpicdn.net/img/view/2019/8/30/2131247.jpeg,0,0.991909683,2763,4514,5555,7306,2792,2792,twilight sparkle
2131247.jpeg,https://derpicdn.net/img/view/2019/8/30/2131247.jpeg,1,0.990665913,926,0,3650,2702,2724,2702,twilight sparkle
2131247.jpeg,https://derpicdn.net/img/view/2019/8/30/2131247.jpeg,2,0.978022337,3614,1771,6662,4819,3048,3048,twilight sparkle
2132042.jpeg,https://derpicdn.net/img/view/2019/8/31/2132042.jpeg,0,0.965755105,292,0,1316,773,1024,773,twilight sparkle
2132647.jpeg,https://derpicdn.net/img/view/2019/8/31/2132647.jpeg,0,0.948301256,234,306,490,562,256,256,twilight sparkle
2133195.jpeg,https://derpicdn.net/img/view/2019/9/1/2133195.jpeg,0,0.983818591,805,54,1327,576,522,522,twilight sparkle
2134054.jpeg,https://derpicdn.net/img/view/2019/9/2/2134054.jpeg,0,0.951621473,354,6,1128,780,774,774,twilight sparkle
2134178.jpeg,https://derpicdn.net/img/view/2019/9/2/2134178.jpeg,0,0.970431387,299,103,789,593,490,490,twilight sparkle
2135687.jpeg,https://derpicdn.net/img/view/2019/9/3/2135687.jpeg,0,0.965428948,80,47,1364,1331,1284,1284,twilight sparkle
2136048.jpeg,https://derpicdn.net/img/view/2019/9/4/2136048.jpeg,0,0.976716757,478,39,930,491,452,452,twilight sparkle
2136120.jpeg,https://derpicdn.net/img/view/2019/9/4/2136120.jpeg,0,0.998898149,496,46,1286,836,790,790,twilight sparkle
2136222.jpeg,https://derpicdn.net/img/view/2019/9/4/2136222.jpeg,0,0.985567629,359,135,639,415,280,280,twilight sparkle
2136553.jpeg,https://derpicdn.net/img/view/2019/9/4/2136553.jpeg,0,0.999690115,297,0,805,506,508,506,twilight sparkle
2137090.jpeg,https://derpicdn.net/img/view/2019/9/5/2137090.jpeg,0,0.934003592,206,14,918,726,712,712,twilight sparkle
2138024.jpeg,https://derpicdn.net/img/view/2019/9/6/2138024.jpeg,0,0.997518718,769,399,1355,985,586,586,twilight sparkle
2138241.jpeg,https://derpicdn.net/img/view/2019/9/7/2138241.jpeg,0,0.98801142,62,0,832,735,770,735,twilight sparkle
2140226.jpeg,https://derpicdn.net/img/view/2019/9/9/2140226.jpeg,0,0.933296442,16,65,674,723,658,658,twilight sparkle
2141521.jpeg,https://derpicdn.net/img/view/2019/9/11/2141521.jpeg,0,0.998436391,269,20,1227,978,958,958,twilight sparkle
2141522.jpeg,https://derpicdn.net/img/view/2019/9/11/2141522.jpeg,0,0.998392761,269,20,1229,980,960,960,twilight sparkle
2143389.jpeg,https://derpicdn.net/img/view/2019/9/13/2143389.jpeg,0,0.987008274,351,430,759,838,408,408,twilight sparkle
2144464.jpeg,https://derpicdn.net/img/view/2019/9/15/2144464.jpeg,0,0.995744884,163,0,391,224,228,224,twilight sparkle
2144585.jpeg,https://derpicdn.net/img/view/2019/9/15/2144585.jpeg,0,0.992428243,442,155,1170,883,728,728,twilight sparkle
2144934.jpeg,https://derpicdn.net/img/view/2019/9/15/2144934.jpeg,0,0.985519469,375,0,745,367,370,367,twilight sparkle
2145800.jpeg,https://derpicdn.net/img/view/2019/9/16/2145800.jpeg,0,0.99744463,508,0,1664,1086,1156,1086,twilight sparkle
2145800.jpeg,https://derpicdn.net/img/view/2019/9/16/2145800.jpeg,1,0.936494589,680,1463,1436,2219,756,756,twilight sparkle
2146245.jpeg,https://derpicdn.net/img/view/2019/9/17/2146245.jpeg,0,0.971994817,13,0,337,309,324,309,twilight sparkle
2146556.jpeg,https://derpicdn.net/img/view/2019/9/17/2146556.jpeg,0,0.996487916,136,1239,1564,2667,1428,1428,twilight sparkle
2146556.jpeg,https://derpicdn.net/img/view/2019/9/17/2146556.jpeg,1,0.945789695,921,93,2559,1731,1638,1638,twilight sparkle
2146627.jpeg,https://derpicdn.net/img/view/2019/9/17/2146627.jpeg,0,0.997978449,262,63,2162,1963,1900,1900,twilight sparkle
2149467.jpeg,https://derpicdn.net/img/view/2019/9/21/2149467.jpeg,0,0.993265331,0,0,1302,1169,1302,1169,twilight sparkle
2152737.jpeg,https://derpicdn.net/img/view/2019/9/25/2152737.jpeg,0,0.958007753,253,73,1161,981,908,908,twilight sparkle
2153569.jpeg,https://derpicdn.net/img/view/2019/9/26/2153569.jpeg,0,0.983693779,3,0,643,600,640,600,twilight sparkle
2154937.jpeg,https://derpicdn.net/img/view/2019/9/28/2154937.jpeg,0,0.937036812,711,2,1361,652,650,650,twilight sparkle
2155685.jpeg,https://derpicdn.net/img/view/2019/9/29/2155685.jpeg,0,0.944361866,603,0,2321,1577,1718,1577,twilight sparkle
2156900.jpeg,https://derpicdn.net/img/view/2019/9/30/2156900.jpeg,0,0.997010112,565,179,2129,1743,1564,1564,twilight sparkle
2157106.jpeg,https://derpicdn.net/img/view/2019/9/30/2157106.jpeg,0,0.984071672,0,0,660,648,660,648,twilight sparkle
2157382.jpeg,https://derpicdn.net/img/view/2019/10/1/2157382.jpeg,0,0.986463428,238,0,706,434,468,434,twilight sparkle
2157383.jpeg,https://derpicdn.net/img/view/2019/10/1/2157383.jpeg,0,0.986590087,238,0,706,433,468,433,twilight sparkle
2157384.jpeg,https://derpicdn.net/img/view/2019/10/1/2157384.jpeg,0,0.987146914,238,0,704,432,466,432,twilight sparkle
2158040.jpeg,https://derpicdn.net/img/view/2019/10/2/2158040.jpeg,0,0.994002938,120,31,430,341,310,310,twilight sparkle
2158040.jpeg,https://derpicdn.net/img/view/2019/10/2/2158040.jpeg,1,0.986300826,621,473,779,631,158,158,twilight sparkle
2159560.jpeg,https://derpicdn.net/img/view/2019/10/4/2159560.jpeg,0,0.995416164,172,0,670,477,498,477,twilight sparkle
2160314.jpeg,https://derpicdn.net/img/view/2019/10/4/2160314.jpeg,0,0.992475688,0,0,1156,1212,1156,1212,twilight sparkle
2162598.jpeg,https://derpicdn.net/img/view/2019/10/7/2162598.jpeg,0,0.993780136,426,140,716,430,290,290,twilight sparkle
2163664.jpeg,https://derpicdn.net/img/view/2019/10/9/2163664.jpeg,0,0.999808252,356,347,1288,1279,932,932,twilight sparkle
2163843.jpeg,https://derpicdn.net/img/view/2019/10/9/2163843.jpeg,0,0.954491735,38,0,878,781,840,781,twilight sparkle
2163891.jpeg,https://derpicdn.net/img/view/2019/10/9/2163891.jpeg,0,0.993884265,84,0,1508,1372,1424,1372,twilight sparkle
2164510.jpeg,https://derpicdn.net/img/view/2019/10/10/2164510.jpeg,0,0.973386645,267,35,585,353,318,318,twilight sparkle
2164739.jpeg,https://derpicdn.net/img/view/2019/10/10/2164739.jpeg,0,0.982972383,0,0,1240,1464,1240,1464,twilight sparkle
2165622.jpeg,https://derpicdn.net/img/view/2019/10/11/2165622.jpeg,0,0.909782052,340,146,818,624,478,478,twilight sparkle
2167050.jpeg,https://derpicdn.net/img/view/2019/10/13/2167050.jpeg,0,0.916347563,0,0,1035,1243,1035,1243,twilight sparkle
2167190.jpeg,https://derpicdn.net/img/view/2019/10/13/2167190.jpeg,0,0.999177635,551,0,1207,636,656,636,twilight sparkle
2167996.jpeg,https://derpicdn.net/img/view/2019/10/13/2167996.jpeg,0,0.998604894,0,0,1292,1303,1292,1303,twilight sparkle
2168064.jpeg,https://derpicdn.net/img/view/2019/10/13/2168064.jpeg,0,0.998815477,888,55,1332,499,444,444,twilight sparkle
2168146.jpeg,https://derpicdn.net/img/view/2019/10/14/2168146.jpeg,0,0.905660272,50,312,848,1110,798,798,twilight sparkle
2168175.jpeg,https://derpicdn.net/img/view/2019/10/14/2168175.jpeg,0,0.980508327,348,0,1808,1288,1460,1288,twilight sparkle
2168333.jpeg,https://derpicdn.net/img/view/2019/10/14/2168333.jpeg,0,0.915475845,156,100,452,396,296,296,twilight sparkle
2169774.jpeg,https://derpicdn.net/img/view/2019/10/15/2169774.jpeg,0,0.998127341,1418,60,2704,1346,1286,1286,twilight sparkle
2170075.jpeg,https://derpicdn.net/img/view/2019/10/15/2170075.jpeg,0,0.993939757,690,609,1210,1129,520,520,twilight sparkle
2170497.jpeg,https://derpicdn.net/img/view/2019/10/16/2170497.jpeg,0,0.990958512,917,156,1371,610,454,454,twilight sparkle
2170590.jpeg,https://derpicdn.net/img/view/2019/10/16/2170590.jpeg,0,0.972042978,1147,0,2048,843,901,843,twilight sparkle
2171508.jpeg,https://derpicdn.net/img/view/2019/10/17/2171508.jpeg,0,0.993303955,191,43,1289,1141,1098,1098,twilight sparkle
2173971.jpeg,https://derpicdn.net/img/view/2019/10/19/2173971.jpeg,0,0.989241302,340,0,703,351,363,351,twilight sparkle
2173997.jpeg,https://derpicdn.net/img/view/2019/10/19/2173997.jpeg,1,0.961334288,521,67,1399,945,878,878,twilight sparkle
2174236.jpeg,https://derpicdn.net/img/view/2019/10/20/2174236.jpeg,0,0.956797421,1288,519,2678,1909,1390,1390,twilight sparkle
2174698.jpeg,https://derpicdn.net/img/view/2019/10/20/2174698.jpeg,0,0.966775715,11,4,613,606,602,602,twilight sparkle
2174800.jpeg,https://derpicdn.net/img/view/2019/10/20/2174800.jpeg,0,0.992454171,87,0,1627,1452,1540,1452,twilight sparkle
2174994.jpeg,https://derpicdn.net/img/view/2019/10/21/2174994.jpeg,0,0.985748053,270,63,900,693,630,630,twilight sparkle
2175660.jpeg,https://derpicdn.net/img/view/2019/10/21/2175660.jpeg,0,0.997535825,318,0,1210,782,892,782,twilight sparkle
2175803.jpeg,https://derpicdn.net/img/view/2019/10/22/2175803.jpeg,0,0.998432994,224,0,940,687,716,687,twilight sparkle
2175809.jpeg,https://derpicdn.net/img/view/2019/10/22/2175809.jpeg,0,0.999381542,126,28,468,370,342,342,twilight sparkle
2176595.jpeg,https://derpicdn.net/img/view/2019/10/23/2176595.jpeg,0,0.9582389,227,75,459,307,232,232,twilight sparkle
2176846.jpeg,https://derpicdn.net/img/view/2019/10/23/2176846.jpeg,0,0.968786895,1028,1269,2890,3131,1862,1862,twilight sparkle
2177346.jpeg,https://derpicdn.net/img/view/2019/10/24/2177346.jpeg,0,0.995272875,62,1047,830,1815,768,768,twilight sparkle
2177693.jpeg,https://derpicdn.net/img/view/2019/10/24/2177693.jpeg,0,0.905184269,313,353,535,575,222,222,twilight sparkle
2178949.jpeg,https://derpicdn.net/img/view/2019/10/25/2178949.jpeg,0,0.998112619,186,11,1288,1113,1102,1102,twilight sparkle
2179227.jpeg,https://derpicdn.net/img/view/2019/10/26/2179227.jpeg,0,0.98039031,340,0,700,358,360,358,twilight sparkle
2179838.jpeg,https://derpicdn.net/img/view/2019/10/26/2179838.jpeg,0,0.999520242,34,5,256,227,222,222,twilight sparkle
2180107.jpeg,https://derpicdn.net/img/view/2019/10/27/2180107.jpeg,0,0.997294366,472,53,722,303,250,250,twilight sparkle
2180107.jpeg,https://derpicdn.net/img/view/2019/10/27/2180107.jpeg,1,0.944108427,106,0,410,264,304,264,twilight sparkle
2180530.jpeg,https://derpicdn.net/img/view/2019/10/27/2180530.jpeg,0,0.990846217,205,4,629,428,424,424,twilight sparkle
2180625.jpeg,https://derpicdn.net/img/view/2019/10/27/2180625.jpeg,0,0.997960985,326,0,956,617,630,617,twilight sparkle
2181602.jpeg,https://derpicdn.net/img/view/2019/10/28/2181602.jpeg,0,0.983231664,124,19,512,407,388,388,twilight sparkle
2181824.jpeg,https://derpicdn.net/img/view/2019/10/29/2181824.jpeg,0,0.999299884,427,46,1823,1442,1396,1396,twilight sparkle
2182361.jpeg,https://derpicdn.net/img/view/2019/10/29/2182361.jpeg,0,0.982469141,324,173,878,727,554,554,twilight sparkle
2183342.jpeg,https://derpicdn.net/img/view/2019/10/31/2183342.jpeg,0,0.999230087,1095,49,1803,757,708,708,twilight sparkle
2183894.jpeg,https://derpicdn.net/img/view/2019/10/31/2183894.jpeg,0,0.975079477,189,40,541,392,352,352,twilight sparkle
2184497.jpeg,https://derpicdn.net/img/view/2019/11/1/2184497.jpeg,0,0.997025132,472,154,1782,1464,1310,1310,twilight sparkle
2185155.jpeg,https://derpicdn.net/img/view/2019/11/2/2185155.jpeg,0,0.945259988,50,43,852,845,802,802,twilight sparkle
2185839.jpeg,https://derpicdn.net/img/view/2019/11/2/2185839.jpeg,0,0.998741508,842,124,1502,784,660,660,twilight sparkle
2187467.jpeg,https://derpicdn.net/img/view/2019/11/4/2187467.jpeg,0,0.993295491,46,0,1172,1075,1126,1075,twilight sparkle
2187961.jpeg,https://derpicdn.net/img/view/2019/11/5/2187961.jpeg,0,0.994649887,340,169,684,513,344,344,twilight sparkle
2188061.jpeg,https://derpicdn.net/img/view/2019/11/5/2188061.jpeg,0,0.988207579,0,0,2613,2651,2613,2651,twilight sparkle
2188521.jpeg,https://derpicdn.net/img/view/2019/11/6/2188521.jpeg,0,0.929539561,248,0,594,310,346,310,twilight sparkle
2189125.jpeg,https://derpicdn.net/img/view/2019/11/6/2189125.jpeg,0,0.997516811,0,0,846,718,846,718,twilight sparkle
2189184.jpeg,https://derpicdn.net/img/view/2019/11/6/2189184.jpeg,0,0.980899453,424,90,2048,1836,1624,1746,twilight sparkle
2190224.jpeg,https://derpicdn.net/img/view/2019/11/8/2190224.jpeg,0,0.980136514,1985,160,3129,1304,1144,1144,twilight sparkle
2191029.jpeg,https://derpicdn.net/img/view/2019/11/9/2191029.jpeg,0,0.978168547,181,87,1105,1011,924,924,twilight sparkle
2191904.jpeg,https://derpicdn.net/img/view/2019/11/10/2191904.jpeg,0,0.992185533,614,294,878,558,264,264,twilight sparkle
2191926.jpeg,https://derpicdn.net/img/view/2019/11/10/2191926.jpeg,0,0.994060218,118,0,412,285,294,285,twilight sparkle
2192352.jpeg,https://derpicdn.net/img/view/2019/11/10/2192352.jpeg,0,0.951577604,1316,309,2222,1215,906,906,twilight sparkle
2192428.jpeg,https://derpicdn.net/img/view/2019/11/10/2192428.jpeg,0,0.987925947,198,276,1860,2094,1662,1818,twilight sparkle
2192778.jpeg,https://derpicdn.net/img/view/2019/11/11/2192778.jpeg,0,0.936029434,428,79,732,383,304,304,twilight sparkle
2193392.jpeg,https://derpicdn.net/img/view/2019/11/11/2193392.jpeg,0,0.997381508,1333,876,2255,1798,922,922,twilight sparkle
2193392.jpeg,https://derpicdn.net/img/view/2019/11/11/2193392.jpeg,1,0.996712327,2285,736,3019,1470,734,734,twilight sparkle
2193392.jpeg,https://derpicdn.net/img/view/2019/11/11/2193392.jpeg,3,0.995611072,2440,0,3220,773,780,773,twilight sparkle
2193392.jpeg,https://derpicdn.net/img/view/2019/11/11/2193392.jpeg,4,0.98896271,1616,12,2404,800,788,788,twilight sparkle
2193423.jpeg,https://derpicdn.net/img/view/2019/11/11/2193423.jpeg,0,0.990125179,1310,0,2036,693,726,693,twilight sparkle
2193538.jpeg,https://derpicdn.net/img/view/2019/11/11/2193538.jpeg,0,0.991312742,9,0,751,714,742,714,twilight sparkle
2193729.jpeg,https://derpicdn.net/img/view/2019/11/12/2193729.jpeg,0,0.923438072,66,0,1160,720,1094,720,twilight sparkle
2193811.jpeg,https://derpicdn.net/img/view/2019/11/12/2193811.jpeg,0,0.924240947,473,0,1447,837,974,837,twilight sparkle
2196339.jpeg,https://derpicdn.net/img/view/2019/11/15/2196339.jpeg,0,0.997669399,396,304,1102,1010,706,706,twilight sparkle
2196385.jpeg,https://derpicdn.net/img/view/2019/11/15/2196385.jpeg,0,0.943669796,209,110,1321,1222,1112,1112,twilight sparkle
2197511.jpeg,https://derpicdn.net/img/view/2019/11/16/2197511.jpeg,0,0.988915384,197,12,729,544,532,532,twilight sparkle
2197730.jpeg,https://derpicdn.net/img/view/2019/11/16/2197730.jpeg,0,0.986701488,630,206,1144,720,514,514,twilight sparkle
2198296.jpeg,https://derpicdn.net/img/view/2019/11/17/2198296.jpeg,0,0.97845906,218,0,714,490,496,490,twilight sparkle
2198508.jpeg,https://derpicdn.net/img/view/2019/11/17/2198508.jpeg,0,0.938369632,163,0,1247,1035,1084,1035,twilight sparkle
2199631.jpeg,https://derpicdn.net/img/view/2019/11/18/2199631.jpeg,0,0.99543494,1546,29,1904,387,358,358,twilight sparkle
2200029.jpeg,https://derpicdn.net/img/view/2019/11/19/2200029.jpeg,0,0.952418387,169,0,1467,975,1298,975,twilight sparkle
2200421.jpeg,https://derpicdn.net/img/view/2019/11/19/2200421.jpeg,0,0.980055869,308,27,1544,1263,1236,1236,twilight sparkle
2200441.jpeg,https://derpicdn.net/img/view/2019/11/19/2200441.jpeg,0,0.987609506,1698,1180,2514,1996,816,816,twilight sparkle
2200522.jpeg,https://derpicdn.net/img/view/2019/11/20/2200522.jpeg,0,0.983327448,120,0,1096,789,976,789,twilight sparkle
2200524.jpeg,https://derpicdn.net/img/view/2019/11/20/2200524.jpeg,0,0.92977196,16,33,1020,960,1004,927,twilight sparkle
2202314.jpeg,https://derpicdn.net/img/view/2019/11/21/2202314.jpeg,0,0.985869706,0,40,722,762,722,722,twilight sparkle
2202412.jpeg,https://derpicdn.net/img/view/2019/11/22/2202412.jpeg,0,0.994990051,1217,467,2673,1923,1456,1456,twilight sparkle
2202960.jpeg,https://derpicdn.net/img/view/2019/11/22/2202960.jpeg,0,0.964045942,146,92,894,840,748,748,twilight sparkle
2203949.jpeg,https://derpicdn.net/img/view/2019/11/23/2203949.jpeg,0,0.989719152,37,0,479,425,442,425,twilight sparkle
2204151.jpeg,https://derpicdn.net/img/view/2019/11/24/2204151.jpeg,0,0.98409313,516,238,2072,1794,1556,1556,twilight sparkle
2205367.jpeg,https://derpicdn.net/img/view/2019/11/25/2205367.jpeg,0,0.974746764,1908,911,2198,1201,290,290,twilight sparkle
2205398.jpeg,https://derpicdn.net/img/view/2019/11/25/2205398.jpeg,0,0.974560201,72,0,1070,975,998,975,twilight sparkle
2207248.jpeg,https://derpicdn.net/img/view/2019/11/27/2207248.jpeg,0,0.990201235,122,88,806,772,684,684,twilight sparkle
2208205.jpeg,https://derpicdn.net/img/view/2019/11/29/2208205.jpeg,0,0.988385081,2087,1096,3127,2136,1040,1040,twilight sparkle
2208205.jpeg,https://derpicdn.net/img/view/2019/11/29/2208205.jpeg,1,0.959745944,1534,512,2418,1396,884,884,twilight sparkle
2209519.jpeg,https://derpicdn.net/img/view/2019/11/30/2209519.jpeg,0,0.992019236,17,0,1057,1006,1040,1006,twilight sparkle
2211294.jpeg,https://derpicdn.net/img/view/2019/12/3/2211294.jpeg,0,0.945119977,27,40,285,298,258,258,twilight sparkle
2212715.jpeg,https://derpicdn.net/img/view/2019/12/5/2212715.jpeg,0,0.993881226,491,0,1041,521,550,521,twilight sparkle
2213095.jpeg,https://derpicdn.net/img/view/2019/12/5/2213095.jpeg,0,0.996394157,507,0,1447,928,940,928,twilight sparkle
2215024.jpeg,https://derpicdn.net/img/view/2019/12/7/2215024.jpeg,0,0.958423972,0,58,1001,1166,1001,1108,twilight sparkle
2215287.jpeg,https://derpicdn.net/img/view/2019/12/7/2215287.jpeg,0,0.995155275,120,104,646,630,526,526,twilight sparkle
2215617.jpeg,https://derpicdn.net/img/view/2019/12/8/2215617.jpeg,0,0.983950436,1384,0,2450,1035,1066,1035,twilight sparkle
2215764.jpeg,https://derpicdn.net/img/view/2019/12/8/2215764.jpeg,0,0.993523598,441,36,803,398,362,362,twilight sparkle
2216202.jpeg,https://derpicdn.net/img/view/2019/12/9/2216202.jpeg,0,0.988655746,10,0,2344,2320,2334,2320,twilight sparkle
2217313.jpeg,https://derpicdn.net/img/view/2019/12/10/2217313.jpeg,0,0.927714467,141,0,675,485,534,485,twilight sparkle
2218364.jpeg,https://derpicdn.net/img/view/2019/12/11/2218364.jpeg,0,0.999090791,828,0,1336,461,508,461,twilight sparkle
2218898.jpeg,https://derpicdn.net/img/view/2019/12/12/2218898.jpeg,0,0.960550666,0,0,876,885,876,885,twilight sparkle
2220077.jpeg,https://derpicdn.net/img/view/2019/12/14/2220077.jpeg,0,0.996618986,170,159,936,925,766,766,twilight sparkle
2221326.jpeg,https://derpicdn.net/img/view/2019/12/15/2221326.jpeg,0,0.987929702,459,565,1189,1295,730,730,twilight sparkle
2221361.jpeg,https://derpicdn.net/img/view/2019/12/15/2221361.jpeg,0,0.985591471,611,103,1089,581,478,478,twilight sparkle
2221529.jpeg,https://derpicdn.net/img/view/2019/12/15/2221529.jpeg,1,0.958469033,1622,1460,2170,2008,548,548,twilight sparkle
2221751.jpeg,https://derpicdn.net/img/view/2019/12/16/2221751.jpeg,0,0.987941146,206,0,1890,1440,1684,1440,twilight sparkle
2222721.jpeg,https://derpicdn.net/img/view/2019/12/17/2222721.jpeg,0,0.90088284,364,63,954,653,590,590,twilight sparkle
2222888.jpeg,https://derpicdn.net/img/view/2019/12/17/2222888.jpeg,0,0.973637104,76,0,436,352,360,352,twilight sparkle
2222979.jpeg,https://derpicdn.net/img/view/2019/12/17/2222979.jpeg,0,0.992417514,221,0,1377,1048,1156,1048,twilight sparkle
2223795.jpeg,https://derpicdn.net/img/view/2019/12/18/2223795.jpeg,0,0.983882189,27,7,369,349,342,342,twilight sparkle
2224393.jpeg,https://derpicdn.net/img/view/2019/12/19/2224393.jpeg,0,0.954493403,384,0,1540,1143,1156,1143,twilight sparkle
2224859.jpeg,https://derpicdn.net/img/view/2019/12/20/2224859.jpeg,0,0.994736373,343,42,839,538,496,496,twilight sparkle
225676.jpeg,https://derpicdn.net/img/view/2013/1/27/225676.jpeg,0,0.99848032,171,0,735,544,564,544,twilight sparkle
226169.jpeg,https://derpicdn.net/img/view/2013/1/28/226169.jpeg,0,0.979501426,0,0,472,462,472,462,twilight sparkle
228104.jpeg,https://derpicdn.net/img/view/2013/1/30/228104.jpeg,0,0.931362033,29,103,321,395,292,292,twilight sparkle
228815.jpeg,https://derpicdn.net/img/view/2013/1/31/228815.jpeg,0,0.964064181,958,1254,1932,2228,974,974,twilight sparkle
229157.jpeg,https://derpicdn.net/img/view/2013/1/31/229157.jpeg,0,0.956609905,126,122,402,398,276,276,twilight sparkle
230041.jpeg,https://derpicdn.net/img/view/2013/2/1/230041.jpeg,0,0.940606713,387,0,1219,799,832,799,twilight sparkle
230185.jpeg,https://derpicdn.net/img/view/2013/2/1/230185.jpeg,0,0.969067693,201,0,498,268,297,268,twilight sparkle
230346.jpeg,https://derpicdn.net/img/view/2013/2/1/230346.jpeg,0,0.973025024,231,54,393,216,162,162,twilight sparkle
230444.jpeg,https://derpicdn.net/img/view/2013/2/1/230444.jpeg,0,0.975236893,43,46,523,526,480,480,twilight sparkle
231499.jpeg,https://derpicdn.net/img/view/2013/2/2/231499.jpeg,0,0.995703697,869,0,2667,1724,1798,1724,twilight sparkle
231827.jpeg,https://derpicdn.net/img/view/2013/2/3/231827.jpeg,0,0.999222457,244,92,830,678,586,586,twilight sparkle
231987.jpeg,https://derpicdn.net/img/view/2013/2/3/231987.jpeg,0,0.999742687,331,0,731,390,400,390,twilight sparkle
235522.jpeg,https://derpicdn.net/img/view/2013/2/6/235522.jpeg,0,0.989374042,277,0,685,401,408,401,twilight sparkle
245326.jpeg,https://derpicdn.net/img/view/2013/2/16/245326.jpeg,0,0.96010983,378,96,658,376,280,280,twilight sparkle
245498.jpeg,https://derpicdn.net/img/view/2013/2/16/245498.jpeg,0,0.950668812,17,303,613,899,596,596,twilight sparkle
246373.jpeg,https://derpicdn.net/img/view/2013/2/17/246373.jpeg,1,0.986607373,509,0,985,401,476,401,twilight sparkle
246373.jpeg,https://derpicdn.net/img/view/2013/2/17/246373.jpeg,2,0.982281625,1523,782,1915,1174,392,392,twilight sparkle
246847.jpeg,https://derpicdn.net/img/view/2013/2/17/246847.jpeg,0,0.90786159,91,0,991,860,900,860,twilight sparkle
247088.jpeg,https://derpicdn.net/img/view/2013/2/17/247088.jpeg,0,0.947889626,473,34,899,460,426,426,twilight sparkle
247147.jpeg,https://derpicdn.net/img/view/2013/2/18/247147.jpeg,0,0.903213441,87,112,347,372,260,260,twilight sparkle
247451.jpeg,https://derpicdn.net/img/view/2013/2/18/247451.jpeg,0,0.962221742,577,47,1773,1243,1196,1196,twilight sparkle
247838.jpeg,https://derpicdn.net/img/view/2013/2/18/247838.jpeg,0,0.975149333,291,119,907,735,616,616,twilight sparkle
247947.jpeg,https://derpicdn.net/img/view/2013/2/18/247947.jpeg,0,0.992586136,0,0,681,597,681,597,twilight sparkle
248128.jpeg,https://derpicdn.net/img/view/2013/2/18/248128.jpeg,0,0.991306603,449,1394,1223,2168,774,774,twilight sparkle
249411.jpeg,https://derpicdn.net/img/view/2013/2/19/249411.jpeg,0,0.945286989,282,0,819,545,537,545,twilight sparkle
250213.jpeg,https://derpicdn.net/img/view/2013/2/20/250213.jpeg,0,0.955015659,324,13,510,199,186,186,twilight sparkle
253319.jpeg,https://derpicdn.net/img/view/2013/2/24/253319.jpeg,0,0.956045032,129,56,385,312,256,256,twilight sparkle
254011.jpeg,https://derpicdn.net/img/view/2013/2/24/254011.jpeg,0,0.998629451,1040,0,2308,1263,1268,1263,twilight sparkle
254204.jpeg,https://derpicdn.net/img/view/2013/2/24/254204.jpeg,0,0.939644873,383,131,1677,1425,1294,1294,twilight sparkle
258961.jpeg,https://derpicdn.net/img/view/2013/3/1/258961.jpeg,0,0.941239417,369,199,639,469,270,270,twilight sparkle
262707.jpeg,https://derpicdn.net/img/view/2013/3/4/262707.jpeg,0,0.979960501,764,104,1498,838,734,734,twilight sparkle
272240.jpeg,https://derpicdn.net/img/view/2013/3/16/272240.jpeg,0,0.989738703,80,17,376,313,296,296,twilight sparkle
272657.jpeg,https://derpicdn.net/img/view/2013/3/17/272657.jpeg,0,0.999235868,419,6,803,390,384,384,twilight sparkle
275525.jpeg,https://derpicdn.net/img/view/2013/3/20/275525.jpeg,0,0.990746021,323,0,800,496,477,496,twilight sparkle
277292.jpeg,https://derpicdn.net/img/view/2013/3/23/277292.jpeg,0,0.97012794,140,88,544,492,404,404,twilight sparkle
279638.jpeg,https://derpicdn.net/img/view/2013/3/26/279638.jpeg,0,0.902141392,170,0,458,276,288,276,twilight sparkle
281524.jpeg,https://derpicdn.net/img/view/2013/3/28/281524.jpeg,0,0.985935688,630,52,884,306,254,254,twilight sparkle
281524.jpeg,https://derpicdn.net/img/view/2013/3/28/281524.jpeg,2,0.938560545,10,205,208,403,198,198,twilight sparkle
284755.jpeg,https://derpicdn.net/img/view/2013/4/1/284755.jpeg,0,0.997722685,620,1308,1156,1844,536,536,twilight sparkle
284755.jpeg,https://derpicdn.net/img/view/2013/4/1/284755.jpeg,1,0.985727549,516,2,1118,604,602,602,twilight sparkle
284843.jpeg,https://derpicdn.net/img/view/2013/4/1/284843.jpeg,0,0.996875167,329,169,583,423,254,254,twilight sparkle
287016.jpeg,https://derpicdn.net/img/view/2013/4/3/287016.jpeg,0,0.999240756,236,132,1338,1234,1102,1102,twilight sparkle
287416.jpeg,https://derpicdn.net/img/view/2013/4/3/287416.jpeg,0,0.973153114,0,0,951,940,951,940,twilight sparkle
294041.jpeg,https://derpicdn.net/img/view/2013/4/10/294041.jpeg,0,0.996190488,559,403,755,599,196,196,twilight sparkle
294041.jpeg,https://derpicdn.net/img/view/2013/4/10/294041.jpeg,1,0.987199664,375,402,601,628,226,226,twilight sparkle
294041.jpeg,https://derpicdn.net/img/view/2013/4/10/294041.jpeg,2,0.969762683,556,9,730,183,174,174,twilight sparkle
297619.jpeg,https://derpicdn.net/img/view/2013/4/14/297619.jpeg,0,0.997474909,320,129,832,641,512,512,twilight sparkle
299391.jpeg,https://derpicdn.net/img/view/2013/4/15/299391.jpeg,0,0.942770839,262,14,808,560,546,546,twilight sparkle
299839.jpeg,https://derpicdn.net/img/view/2013/4/16/299839.jpeg,0,0.997708797,368,34,636,302,268,268,twilight sparkle
300671.jpeg,https://derpicdn.net/img/view/2013/4/17/300671.jpeg,0,0.992853701,0,21,262,293,262,272,twilight sparkle
301655.jpeg,https://derpicdn.net/img/view/2013/4/18/301655.jpeg,0,0.998981774,1095,398,1465,768,370,370,twilight sparkle
301655.jpeg,https://derpicdn.net/img/view/2013/4/18/301655.jpeg,1,0.998524547,833,284,1183,634,350,350,twilight sparkle
301655.jpeg,https://derpicdn.net/img/view/2013/4/18/301655.jpeg,3,0.91283679,532,190,850,508,318,318,twilight sparkle
308489.jpeg,https://derpicdn.net/img/view/2013/4/26/308489.jpeg,0,0.932665944,473,288,687,502,214,214,twilight sparkle
317726.jpeg,https://derpicdn.net/img/view/2013/5/6/317726.jpeg,1,0.923291981,180,0,1000,687,820,687,twilight sparkle
320461.jpeg,https://derpicdn.net/img/view/2013/5/9/320461.jpeg,0,0.969050765,48,0,412,349,364,349,twilight sparkle
324463.jpeg,https://derpicdn.net/img/view/2013/5/14/324463.jpeg,0,0.998802543,267,96,645,474,378,378,twilight sparkle
325727.jpeg,https://derpicdn.net/img/view/2013/5/15/325727.jpeg,0,0.955011308,405,222,609,426,204,204,twilight sparkle
331107.jpeg,https://derpicdn.net/img/view/2013/5/22/331107.jpeg,0,0.984054208,287,202,525,440,238,238,twilight sparkle
332571.jpeg,https://derpicdn.net/img/view/2013/5/24/332571.jpeg,0,0.978626728,426,8,824,406,398,398,twilight sparkle
332846.jpeg,https://derpicdn.net/img/view/2013/5/24/332846.jpeg,0,0.991668522,292,0,842,483,550,483,twilight sparkle
333053.jpeg,https://derpicdn.net/img/view/2013/5/25/333053.jpeg,0,0.984458685,123,47,283,207,160,160,twilight sparkle
334017.jpeg,https://derpicdn.net/img/view/2013/5/26/334017.jpeg,0,0.923145473,116,0,920,748,804,748,twilight sparkle
335524.jpeg,https://derpicdn.net/img/view/2013/5/28/335524.jpeg,0,0.994453549,134,0,596,455,462,455,twilight sparkle
336706.jpeg,https://derpicdn.net/img/view/2013/5/30/336706.jpeg,0,0.986880958,391,31,867,507,476,476,twilight sparkle
343382.jpeg,https://derpicdn.net/img/view/2013/6/8/343382.jpeg,0,0.999201,521,123,903,505,382,382,twilight sparkle
343848.jpeg,https://derpicdn.net/img/view/2013/6/9/343848.jpeg,0,0.990157306,204,0,1548,1308,1344,1308,twilight sparkle
345608.jpeg,https://derpicdn.net/img/view/2013/6/11/345608.jpeg,0,0.999019504,325,9,629,313,304,304,twilight sparkle
345608.jpeg,https://derpicdn.net/img/view/2013/6/11/345608.jpeg,1,0.959033728,88,3,396,311,308,308,twilight sparkle
346927.jpeg,https://derpicdn.net/img/view/2013/6/12/346927.jpeg,0,0.994780362,238,157,486,405,248,248,twilight sparkle
350688.jpeg,https://derpicdn.net/img/view/2013/6/17/350688.jpeg,0,0.99580729,535,1,867,333,332,332,twilight sparkle
350688.jpeg,https://derpicdn.net/img/view/2013/6/17/350688.jpeg,1,0.993672907,458,553,840,935,382,382,twilight sparkle
351186.jpeg,https://derpicdn.net/img/view/2013/6/18/351186.jpeg,0,0.94333595,482,137,1660,1315,1178,1178,twilight sparkle
352892.jpeg,https://derpicdn.net/img/view/2013/6/20/352892.jpeg,0,0.996808767,136,90,360,314,224,224,twilight sparkle
356040.jpeg,https://derpicdn.net/img/view/2013/6/24/356040.jpeg,0,0.979680896,220,30,426,236,206,206,twilight sparkle
357683.jpeg,https://derpicdn.net/img/view/2013/6/26/357683.jpeg,0,0.99868381,493,0,1129,597,636,597,twilight sparkle
360602.jpeg,https://derpicdn.net/img/view/2013/6/30/360602.jpeg,0,0.932852626,47,0,515,420,468,420,twilight sparkle
364013.jpeg,https://derpicdn.net/img/view/2013/7/4/364013.jpeg,0,0.982859015,11,33,363,385,352,352,twilight sparkle
364291.jpeg,https://derpicdn.net/img/view/2013/7/4/364291.jpeg,0,0.95905751,345,73,1015,743,670,670,twilight sparkle
364567.jpeg,https://derpicdn.net/img/view/2013/7/4/364567.jpeg,0,0.969489038,64,0,498,418,434,418,twilight sparkle
367828.jpeg,https://derpicdn.net/img/view/2013/7/9/367828.jpeg,0,0.997087479,306,0,1014,644,708,644,twilight sparkle
367828.jpeg,https://derpicdn.net/img/view/2013/7/9/367828.jpeg,1,0.993637204,1002,257,1710,965,708,708,twilight sparkle
368231.jpeg,https://derpicdn.net/img/view/2013/7/9/368231.jpeg,0,0.980689585,38,0,434,373,396,373,twilight sparkle
370411.jpeg,https://derpicdn.net/img/view/2013/7/11/370411.jpeg,0,0.915994287,110,143,454,487,344,344,twilight sparkle
377384.jpeg,https://derpicdn.net/img/view/2013/7/18/377384.jpeg,0,0.993131399,345,31,691,377,346,346,twilight sparkle
390956.jpeg,https://derpicdn.net/img/view/2013/8/4/390956.jpeg,0,0.962922633,22,12,416,406,394,394,twilight sparkle
393840.jpeg,https://derpicdn.net/img/view/2013/8/7/393840.jpeg,0,0.914966583,1178,0,3200,1847,2022,1847,twilight sparkle
400845.jpeg,https://derpicdn.net/img/view/2013/8/15/400845.jpeg,0,0.941899359,357,219,571,433,214,214,twilight sparkle
403504.jpeg,https://derpicdn.net/img/view/2013/8/18/403504.jpeg,0,0.989229083,2,16,948,962,946,946,twilight sparkle
406714.jpeg,https://derpicdn.net/img/view/2013/8/22/406714.jpeg,0,0.990930498,177,217,453,493,276,276,twilight sparkle
409194.jpeg,https://derpicdn.net/img/view/2013/8/24/409194.jpeg,0,0.980360627,1191,172,1593,574,402,402,twilight sparkle
410897.jpeg,https://derpicdn.net/img/view/2013/8/26/410897.jpeg,0,0.947351396,1032,37,1720,725,688,688,twilight sparkle
412148.jpeg,https://derpicdn.net/img/view/2013/8/27/412148.jpeg,0,0.954936922,447,314,871,738,424,424,twilight sparkle
413326.jpeg,https://derpicdn.net/img/view/2013/8/29/413326.jpeg,0,0.995333195,91,0,577,469,486,469,twilight sparkle
415016.jpeg,https://derpicdn.net/img/view/2013/8/31/415016.jpeg,0,0.987427533,12,0,518,504,506,504,twilight sparkle
422712.jpeg,https://derpicdn.net/img/view/2013/9/8/422712.jpeg,0,0.984882474,131,99,529,497,398,398,twilight sparkle
424390.jpeg,https://derpicdn.net/img/view/2013/9/10/424390.jpeg,0,0.949053943,190,211,852,873,662,662,twilight sparkle
426203.jpeg,https://derpicdn.net/img/view/2013/9/12/426203.jpeg,0,0.992993772,409,62,845,498,436,436,twilight sparkle
430021.jpeg,https://derpicdn.net/img/view/2013/9/18/430021.jpeg,0,0.995775223,337,300,637,600,300,300,twilight sparkle
430806.jpeg,https://derpicdn.net/img/view/2013/9/19/430806.jpeg,0,0.999127388,669,0,1579,867,910,867,twilight sparkle
431684.jpeg,https://derpicdn.net/img/view/2013/9/21/431684.jpeg,0,0.996870875,85,18,307,240,222,222,twilight sparkle
434489.jpeg,https://derpicdn.net/img/view/2013/9/25/434489.jpeg,0,0.999178112,184,0,630,443,446,443,twilight sparkle
443218.jpeg,https://derpicdn.net/img/view/2013/10/6/443218.jpeg,0,0.99607712,861,1537,1471,2147,610,610,twilight sparkle
445986.jpeg,https://derpicdn.net/img/view/2013/10/11/445986.jpeg,0,0.900538683,515,350,967,802,452,452,twilight sparkle
446882.jpeg,https://derpicdn.net/img/view/2013/10/12/446882.jpeg,0,0.982027292,125,0,475,333,350,333,twilight sparkle
447826.jpeg,https://derpicdn.net/img/view/2013/10/13/447826.jpeg,0,0.977996588,404,37,744,377,340,340,twilight sparkle
454903.jpeg,https://derpicdn.net/img/view/2013/10/23/454903.jpeg,0,0.993325233,276,0,964,659,688,659,twilight sparkle
456779.jpeg,https://derpicdn.net/img/view/2013/10/26/456779.jpeg,0,0.980775118,55,0,597,490,542,490,twilight sparkle
457179.jpeg,https://derpicdn.net/img/view/2013/10/26/457179.jpeg,0,0.992819488,0,0,270,239,270,239,twilight sparkle
457179.jpeg,https://derpicdn.net/img/view/2013/10/26/457179.jpeg,1,0.960271597,274,0,550,269,276,269,twilight sparkle
458253.jpeg,https://derpicdn.net/img/view/2013/10/28/458253.jpeg,0,0.97481513,3,19,507,523,504,504,twilight sparkle
462460.jpeg,https://derpicdn.net/img/view/2013/11/2/462460.jpeg,0,0.991672456,81,0,489,372,408,372,twilight sparkle
462942.jpeg,https://derpicdn.net/img/view/2013/11/2/462942.jpeg,0,0.999646306,213,0,659,437,446,437,twilight sparkle
464046.jpeg,https://derpicdn.net/img/view/2013/11/4/464046.jpeg,0,0.961747408,353,126,551,324,198,198,twilight sparkle
473553.jpeg,https://derpicdn.net/img/view/2013/11/16/473553.jpeg,0,0.997629344,732,58,1532,858,800,800,twilight sparkle
474510.jpeg,https://derpicdn.net/img/view/2013/11/17/474510.jpeg,0,0.997159243,328,0,674,333,346,333,twilight sparkle
476897.jpeg,https://derpicdn.net/img/view/2013/11/20/476897.jpeg,0,0.939369023,275,149,673,547,398,398,twilight sparkle
479334.jpeg,https://derpicdn.net/img/view/2013/11/23/479334.jpeg,0,0.985117853,0,0,399,416,399,416,twilight sparkle
479751.jpeg,https://derpicdn.net/img/view/2013/11/24/479751.jpeg,0,0.920763671,183,45,415,277,232,232,twilight sparkle
480131.jpeg,https://derpicdn.net/img/view/2013/11/24/480131.jpeg,0,0.973715484,278,16,932,670,654,654,twilight sparkle
483684.jpeg,https://derpicdn.net/img/view/2013/11/27/483684.jpeg,0,0.980940819,624,324,1118,818,494,494,twilight sparkle
483829.jpeg,https://derpicdn.net/img/view/2013/11/28/483829.jpeg,0,0.991374433,534,57,1668,1191,1134,1134,twilight sparkle
484155.jpeg,https://derpicdn.net/img/view/2013/11/28/484155.jpeg,0,0.990792751,220,257,558,595,338,338,twilight sparkle
485262.jpeg,https://derpicdn.net/img/view/2013/11/29/485262.jpeg,0,0.989861548,239,83,847,691,608,608,twilight sparkle
488437.jpeg,https://derpicdn.net/img/view/2013/12/3/488437.jpeg,0,0.997222781,325,42,823,540,498,498,twilight sparkle
491356.jpeg,https://derpicdn.net/img/view/2013/12/7/491356.jpeg,0,0.981794298,638,607,796,765,158,158,twilight sparkle
491356.jpeg,https://derpicdn.net/img/view/2013/12/7/491356.jpeg,1,0.928979337,0,145,691,869,691,724,twilight sparkle
495609.jpeg,https://derpicdn.net/img/view/2013/12/12/495609.jpeg,0,0.948561013,511,0,1943,1353,1432,1353,twilight sparkle
499706.jpeg,https://derpicdn.net/img/view/2013/12/17/499706.jpeg,0,0.960293889,19,0,341,320,322,320,twilight sparkle
500026.jpeg,https://derpicdn.net/img/view/2013/12/18/500026.jpeg,0,0.976237476,138,71,802,735,664,664,twilight sparkle
501050.jpeg,https://derpicdn.net/img/view/2013/12/19/501050.jpeg,0,0.985889912,529,0,869,318,340,318,twilight sparkle
501781.jpeg,https://derpicdn.net/img/view/2013/12/20/501781.jpeg,1,0.920639217,734,1132,1600,1998,866,866,twilight sparkle
507767.jpeg,https://derpicdn.net/img/view/2013/12/27/507767.jpeg,0,0.997120917,763,125,1831,1193,1068,1068,twilight sparkle
509126.jpeg,https://derpicdn.net/img/view/2013/12/29/509126.jpeg,0,0.941998482,329,0,848,464,519,464,twilight sparkle
511226.jpeg,https://derpicdn.net/img/view/2013/12/31/511226.jpeg,0,0.955467761,81,38,507,464,426,426,twilight sparkle
513945.jpeg,https://derpicdn.net/img/view/2014/1/3/513945.jpeg,0,0.996437728,1196,236,1654,694,458,458,twilight sparkle
518360.jpeg,https://derpicdn.net/img/view/2014/1/8/518360.jpeg,1,0.964746058,378,38,706,366,328,328,twilight sparkle
522684.jpeg,https://derpicdn.net/img/view/2014/1/12/522684.jpeg,0,0.992616177,729,227,1631,1129,902,902,twilight sparkle
524319.jpeg,https://derpicdn.net/img/view/2014/1/14/524319.jpeg,0,0.904859722,306,196,680,570,374,374,twilight sparkle
524656.jpeg,https://derpicdn.net/img/view/2014/1/15/524656.jpeg,0,0.995321512,1565,400,2701,1568,1136,1168,twilight sparkle
534080.jpeg,https://derpicdn.net/img/view/2014/1/25/534080.jpeg,1,0.969062507,92,14,359,294,267,280,twilight sparkle
539462.jpeg,https://derpicdn.net/img/view/2014/1/31/539462.jpeg,0,0.965574145,240,7,576,343,336,336,twilight sparkle
539525.jpeg,https://derpicdn.net/img/view/2014/1/31/539525.jpeg,0,0.995458603,787,205,1315,733,528,528,twilight sparkle
540008.jpeg,https://derpicdn.net/img/view/2014/2/1/540008.jpeg,0,0.991162241,284,0,946,648,662,648,twilight sparkle
544251.jpeg,https://derpicdn.net/img/view/2014/2/5/544251.jpeg,0,0.999003947,257,384,537,664,280,280,twilight sparkle
544826.jpeg,https://derpicdn.net/img/view/2014/2/6/544826.jpeg,0,0.935965776,1402,1030,1960,1588,558,558,twilight sparkle
545075.jpeg,https://derpicdn.net/img/view/2014/2/6/545075.jpeg,0,0.999836683,145,56,519,430,374,374,twilight sparkle
545105.jpeg,https://derpicdn.net/img/view/2014/2/6/545105.jpeg,0,0.997665465,677,137,1543,1003,866,866,twilight sparkle
552244.jpeg,https://derpicdn.net/img/view/2014/2/15/552244.jpeg,0,0.997977138,238,0,512,268,274,268,twilight sparkle
556763.jpeg,https://derpicdn.net/img/view/2014/2/20/556763.jpeg,0,0.998427927,889,359,1753,1223,864,864,twilight sparkle
557474.jpeg,https://derpicdn.net/img/view/2014/2/20/557474.jpeg,0,0.98423481,344,0,908,528,564,528,twilight sparkle
564118.jpeg,https://derpicdn.net/img/view/2014/3/1/564118.jpeg,0,0.978396416,172,36,600,464,428,428,twilight sparkle
565309.jpeg,https://derpicdn.net/img/view/2014/3/2/565309.jpeg,0,0.991089046,325,0,1365,956,1040,956,twilight sparkle
570695.jpeg,https://derpicdn.net/img/view/2014/3/9/570695.jpeg,0,0.986980796,67,192,433,558,366,366,twilight sparkle
573429.jpeg,https://derpicdn.net/img/view/2014/3/12/573429.jpeg,0,0.980651021,378,106,1110,838,732,732,twilight sparkle
573450.jpeg,https://derpicdn.net/img/view/2014/3/12/573450.jpeg,0,0.999471128,215,0,627,387,412,387,twilight sparkle
575372.jpeg,https://derpicdn.net/img/view/2014/3/15/575372.jpeg,0,0.921689808,705,420,1253,968,548,548,twilight sparkle
582747.jpeg,https://derpicdn.net/img/view/2014/3/23/582747.jpeg,0,0.931890607,142,4,868,730,726,726,twilight sparkle
585009.jpeg,https://derpicdn.net/img/view/2014/3/25/585009.jpeg,0,0.999114394,352,198,892,738,540,540,twilight sparkle
586765.jpeg,https://derpicdn.net/img/view/2014/3/28/586765.jpeg,0,0.95258075,231,25,975,769,744,744,twilight sparkle
587164.jpeg,https://derpicdn.net/img/view/2014/3/28/587164.jpeg,0,0.998308003,273,32,875,634,602,602,twilight sparkle
591460.jpeg,https://derpicdn.net/img/view/2014/4/3/591460.jpeg,0,0.940794945,161,0,781,542,620,542,twilight sparkle
591527.jpeg,https://derpicdn.net/img/view/2014/4/3/591527.jpeg,0,0.992177606,237,45,657,465,420,420,twilight sparkle
595228.jpeg,https://derpicdn.net/img/view/2014/4/7/595228.jpeg,0,0.938417792,286,136,486,336,200,200,twilight sparkle
597556.jpeg,https://derpicdn.net/img/view/2014/4/11/597556.jpeg,0,0.981023014,881,0,2241,1328,1360,1328,twilight sparkle
598239.jpeg,https://derpicdn.net/img/view/2014/4/12/598239.jpeg,0,0.988873363,1873,195,2631,953,758,758,twilight sparkle
602925.jpeg,https://derpicdn.net/img/view/2014/4/17/602925.jpeg,0,0.976716876,127,0,2362,2265,2235,2265,twilight sparkle
603317.jpeg,https://derpicdn.net/img/view/2014/4/18/603317.jpeg,0,0.99827069,244,1,766,523,522,522,twilight sparkle
609349.jpeg,https://derpicdn.net/img/view/2014/4/25/609349.jpeg,0,0.999367952,176,0,1130,846,954,846,twilight sparkle
609349.jpeg,https://derpicdn.net/img/view/2014/4/25/609349.jpeg,1,0.977354586,1613,12,2427,826,814,814,twilight sparkle
610576.jpeg,https://derpicdn.net/img/view/2014/4/26/610576.jpeg,0,0.983122468,66,4,490,428,424,424,twilight sparkle
613315.jpeg,https://derpicdn.net/img/view/2014/4/29/613315.jpeg,0,0.991206229,100,80,386,366,286,286,twilight sparkle
615526.jpeg,https://derpicdn.net/img/view/2014/5/2/615526.jpeg,0,0.996747851,296,57,860,621,564,564,twilight sparkle
616570.jpeg,https://derpicdn.net/img/view/2014/5/3/616570.jpeg,0,0.982171118,212,11,504,303,292,292,twilight sparkle
616933.jpeg,https://derpicdn.net/img/view/2014/5/3/616933.jpeg,0,0.998152256,152,0,522,306,370,306,twilight sparkle
617026.jpeg,https://derpicdn.net/img/view/2014/5/4/617026.jpeg,0,0.92799896,362,368,598,604,236,236,twilight sparkle
617523.jpeg,https://derpicdn.net/img/view/2014/5/4/617523.jpeg,0,0.997363925,53,67,405,419,352,352,twilight sparkle
617523.jpeg,https://derpicdn.net/img/view/2014/5/4/617523.jpeg,1,0.989468277,373,155,693,475,320,320,twilight sparkle
621929.jpeg,https://derpicdn.net/img/view/2014/5/9/621929.jpeg,0,0.994913459,117,74,549,506,432,432,twilight sparkle
621962.jpeg,https://derpicdn.net/img/view/2014/5/10/621962.jpeg,0,0.99951303,416,261,652,497,236,236,twilight sparkle
622396.jpeg,https://derpicdn.net/img/view/2014/5/10/622396.jpeg,0,0.918123782,614,123,2230,1739,1616,1616,twilight sparkle
624256.jpeg,https://derpicdn.net/img/view/2014/5/11/624256.jpeg,0,0.986990929,336,426,1066,1156,730,730,twilight sparkle
624834.jpeg,https://derpicdn.net/img/view/2014/5/12/624834.jpeg,0,0.986124694,234,0,800,548,566,548,twilight sparkle
625614.jpeg,https://derpicdn.net/img/view/2014/5/13/625614.jpeg,0,0.953411758,1770,335,2844,1409,1074,1074,twilight sparkle
626689.jpeg,https://derpicdn.net/img/view/2014/5/14/626689.jpeg,0,0.959401071,448,3,1245,961,797,958,twilight sparkle
628790.jpeg,https://derpicdn.net/img/view/2014/5/17/628790.jpeg,0,0.999189079,363,138,511,286,148,148,twilight sparkle
630719.jpeg,https://derpicdn.net/img/view/2014/5/19/630719.jpeg,0,0.996091723,470,156,735,428,265,272,twilight sparkle
630961.jpeg,https://derpicdn.net/img/view/2014/5/19/630961.jpeg,0,0.994350314,413,227,717,531,304,304,twilight sparkle
632320.jpeg,https://derpicdn.net/img/view/2014/5/20/632320.jpeg,0,0.995059609,638,168,1580,1110,942,942,twilight sparkle
633047.jpeg,https://derpicdn.net/img/view/2014/5/21/633047.jpeg,0,0.944996893,86,0,952,700,866,700,twilight sparkle
635686.jpeg,https://derpicdn.net/img/view/2014/5/24/635686.jpeg,0,0.994157255,255,21,691,457,436,436,twilight sparkle
637578.jpeg,https://derpicdn.net/img/view/2014/5/26/637578.jpeg,0,0.980369925,18,7,340,329,322,322,twilight sparkle
638375.jpeg,https://derpicdn.net/img/view/2014/5/27/638375.jpeg,0,0.982108176,284,77,796,589,512,512,twilight sparkle
640489.jpeg,https://derpicdn.net/img/view/2014/5/30/640489.jpeg,0,0.995435894,322,0,596,268,274,268,twilight sparkle
640619.jpeg,https://derpicdn.net/img/view/2014/5/30/640619.jpeg,0,0.999572098,385,0,1011,496,626,496,twilight sparkle
640622.jpeg,https://derpicdn.net/img/view/2014/5/30/640622.jpeg,0,0.923887789,148,14,500,366,352,352,twilight sparkle
645132.jpeg,https://derpicdn.net/img/view/2014/6/4/645132.jpeg,0,0.995652795,121,0,497,343,376,343,twilight sparkle
646380.jpeg,https://derpicdn.net/img/view/2014/6/6/646380.jpeg,0,0.999155641,491,24,855,388,364,364,twilight sparkle
648341.jpeg,https://derpicdn.net/img/view/2014/6/8/648341.jpeg,0,0.931683183,0,70,638,734,638,664,twilight sparkle
649370.jpeg,https://derpicdn.net/img/view/2014/6/10/649370.jpeg,0,0.980251253,0,0,1572,1570,1572,1570,twilight sparkle
656757.jpeg,https://derpicdn.net/img/view/2014/6/19/656757.jpeg,0,0.991250932,111,27,653,569,542,542,twilight sparkle
658727.jpeg,https://derpicdn.net/img/view/2014/6/22/658727.jpeg,0,0.982798576,543,523,1337,1317,794,794,twilight sparkle
658729.jpeg,https://derpicdn.net/img/view/2014/6/22/658729.jpeg,0,0.993473113,2,40,744,782,742,742,twilight sparkle
660917.jpeg,https://derpicdn.net/img/view/2014/6/25/660917.jpeg,0,0.949195981,14,0,172,151,158,151,twilight sparkle
661813.jpeg,https://derpicdn.net/img/view/2014/6/26/661813.jpeg,0,0.998715758,210,592,820,1202,610,610,twilight sparkle
661813.jpeg,https://derpicdn.net/img/view/2014/6/26/661813.jpeg,1,0.997807264,34,882,426,1274,392,392,twilight sparkle
661813.jpeg,https://derpicdn.net/img/view/2014/6/26/661813.jpeg,2,0.997716069,885,303,1545,963,660,660,twilight sparkle
661813.jpeg,https://derpicdn.net/img/view/2014/6/26/661813.jpeg,4,0.973336041,633,769,1161,1297,528,528,twilight sparkle
664184.jpeg,https://derpicdn.net/img/view/2014/6/29/664184.jpeg,0,0.989173472,319,0,885,543,566,543,twilight sparkle
667399.jpeg,https://derpicdn.net/img/view/2014/7/4/667399.jpeg,0,0.997365713,708,246,1062,600,354,354,twilight sparkle
667831.jpeg,https://derpicdn.net/img/view/2014/7/5/667831.jpeg,0,0.973011017,145,0,1027,822,882,822,twilight sparkle
670643.jpeg,https://derpicdn.net/img/view/2014/7/8/670643.jpeg,0,0.995063901,211,0,597,358,386,358,twilight sparkle
671235.jpeg,https://derpicdn.net/img/view/2014/7/9/671235.jpeg,0,0.995245993,600,0,1628,855,1028,855,twilight sparkle
671310.jpeg,https://derpicdn.net/img/view/2014/7/9/671310.jpeg,0,0.988815665,120,6,676,562,556,556,twilight sparkle
672420.jpeg,https://derpicdn.net/img/view/2014/7/11/672420.jpeg,0,0.997634053,170,110,420,360,250,250,twilight sparkle
675002.jpeg,https://derpicdn.net/img/view/2014/7/14/675002.jpeg,0,0.905058622,566,253,772,459,206,206,twilight sparkle
675093.jpeg,https://derpicdn.net/img/view/2014/7/15/675093.jpeg,0,0.941375077,851,0,1627,631,776,631,twilight sparkle
676718.jpeg,https://derpicdn.net/img/view/2014/7/17/676718.jpeg,0,0.998104632,149,0,1199,1002,1050,1002,twilight sparkle
678555.jpeg,https://derpicdn.net/img/view/2014/7/19/678555.jpeg,0,0.99452889,370,61,2162,1853,1792,1792,twilight sparkle
680509.jpeg,https://derpicdn.net/img/view/2014/7/22/680509.jpeg,0,0.996317625,425,77,935,587,510,510,twilight sparkle
680676.jpeg,https://derpicdn.net/img/view/2014/7/22/680676.jpeg,0,0.984753728,37,0,697,623,660,623,twilight sparkle
680918.jpeg,https://derpicdn.net/img/view/2014/7/22/680918.jpeg,0,0.970913827,82,134,350,402,268,268,twilight sparkle
680963.jpeg,https://derpicdn.net/img/view/2014/7/22/680963.jpeg,0,0.996907234,129,35,641,547,512,512,twilight sparkle
681647.jpeg,https://derpicdn.net/img/view/2014/7/23/681647.jpeg,0,0.93460691,977,348,1163,534,186,186,twilight sparkle
682349.jpeg,https://derpicdn.net/img/view/2014/7/24/682349.jpeg,0,0.996200204,408,62,1522,1176,1114,1114,twilight sparkle
682701.jpeg,https://derpicdn.net/img/view/2014/7/25/682701.jpeg,0,0.997050107,500,58,1362,920,862,862,twilight sparkle
683593.jpeg,https://derpicdn.net/img/view/2014/7/26/683593.jpeg,0,0.995250583,346,133,646,433,300,300,twilight sparkle
685230.jpeg,https://derpicdn.net/img/view/2014/7/28/685230.jpeg,0,0.961137474,130,22,834,726,704,704,twilight sparkle
685504.jpeg,https://derpicdn.net/img/view/2014/7/28/685504.jpeg,0,0.992514491,252,48,644,440,392,392,twilight sparkle
687045.jpeg,https://derpicdn.net/img/view/2014/7/30/687045.jpeg,0,0.99908042,557,139,1703,1285,1146,1146,twilight sparkle
687046.jpeg,https://derpicdn.net/img/view/2014/7/30/687046.jpeg,0,0.98670131,868,0,1652,774,784,774,twilight sparkle
688513.jpeg,https://derpicdn.net/img/view/2014/8/1/688513.jpeg,0,0.919692099,1023,42,1451,470,428,428,twilight sparkle
688615.jpeg,https://derpicdn.net/img/view/2014/8/1/688615.jpeg,0,0.99834007,666,123,1628,1085,962,962,twilight sparkle
689336.jpeg,https://derpicdn.net/img/view/2014/8/2/689336.jpeg,0,0.993183672,298,164,996,862,698,698,twilight sparkle
695564.jpeg,https://derpicdn.net/img/view/2014/8/9/695564.jpeg,0,0.972307861,255,58,629,432,374,374,twilight sparkle
695668.jpeg,https://derpicdn.net/img/view/2014/8/9/695668.jpeg,0,0.99959892,112,5,402,295,290,290,twilight sparkle
695913.jpeg,https://derpicdn.net/img/view/2014/8/9/695913.jpeg,0,0.998691082,471,245,1145,919,674,674,twilight sparkle
698313.jpeg,https://derpicdn.net/img/view/2014/8/13/698313.jpeg,0,0.916111827,133,6,453,326,320,320,twilight sparkle
698340.jpeg,https://derpicdn.net/img/view/2014/8/13/698340.jpeg,0,0.985014915,889,0,2095,1199,1206,1199,twilight sparkle
701487.jpeg,https://derpicdn.net/img/view/2014/8/17/701487.jpeg,1,0.992735386,300,219,594,513,294,294,twilight sparkle
706647.jpeg,https://derpicdn.net/img/view/2014/8/24/706647.jpeg,0,0.992518663,377,48,869,540,492,492,twilight sparkle
710054.jpeg,https://derpicdn.net/img/view/2014/8/28/710054.jpeg,0,0.991647184,344,7,1430,1093,1086,1086,twilight sparkle
711474.jpeg,https://derpicdn.net/img/view/2014/8/30/711474.jpeg,0,0.95891571,221,62,539,380,318,318,twilight sparkle
711877.jpeg,https://derpicdn.net/img/view/2014/8/31/711877.jpeg,0,0.98556155,48,21,664,637,616,616,twilight sparkle
716239.jpeg,https://derpicdn.net/img/view/2014/9/6/716239.jpeg,0,0.979433656,120,0,1090,918,970,918,twilight sparkle
720550.jpeg,https://derpicdn.net/img/view/2014/9/12/720550.jpeg,0,0.998260558,149,76,571,498,422,422,twilight sparkle
726241.jpeg,https://derpicdn.net/img/view/2014/9/21/726241.jpeg,0,0.992109299,262,241,632,611,370,370,twilight sparkle
726816.jpeg,https://derpicdn.net/img/view/2014/9/21/726816.jpeg,0,0.992537856,547,46,1449,948,902,902,twilight sparkle
726917.jpeg,https://derpicdn.net/img/view/2014/9/21/726917.jpeg,0,0.995735466,440,0,868,374,428,374,twilight sparkle
727516.jpeg,https://derpicdn.net/img/view/2014/9/22/727516.jpeg,0,0.940028727,20,0,358,266,338,266,twilight sparkle
731336.jpeg,https://derpicdn.net/img/view/2014/9/28/731336.jpeg,0,0.90524435,0,0,800,894,800,894,twilight sparkle
734086.jpeg,https://derpicdn.net/img/view/2014/10/2/734086.jpeg,0,0.912422895,528,0,1360,624,832,624,twilight sparkle
738903.jpeg,https://derpicdn.net/img/view/2014/10/8/738903.jpeg,0,0.988514423,1940,968,3460,2488,1520,1520,twilight sparkle
738933.jpeg,https://derpicdn.net/img/view/2014/10/8/738933.jpeg,0,0.986526072,628,236,1304,912,676,676,twilight sparkle
740240.jpeg,https://derpicdn.net/img/view/2014/10/10/740240.jpeg,0,0.983532965,1907,1501,2835,2429,928,928,twilight sparkle
741424.jpeg,https://derpicdn.net/img/view/2014/10/12/741424.jpeg,0,0.993565559,11,19,551,559,540,540,twilight sparkle
741541.jpeg,https://derpicdn.net/img/view/2014/10/12/741541.jpeg,0,0.980530798,69,134,421,486,352,352,twilight sparkle
742201.jpeg,https://derpicdn.net/img/view/2014/10/13/742201.jpeg,0,0.945922911,1072,532,1640,1100,568,568,twilight sparkle
744206.jpeg,https://derpicdn.net/img/view/2014/10/16/744206.jpeg,0,0.987558246,0,0,553,555,553,555,twilight sparkle
744289.jpeg,https://derpicdn.net/img/view/2014/10/16/744289.jpeg,0,0.925442755,282,25,730,473,448,448,twilight sparkle
744608.jpeg,https://derpicdn.net/img/view/2014/10/17/744608.jpeg,0,0.909383595,787,43,999,255,212,212,twilight sparkle
744615.jpeg,https://derpicdn.net/img/view/2014/10/17/744615.jpeg,0,0.985239446,10,43,276,300,266,257,twilight sparkle
744615.jpeg,https://derpicdn.net/img/view/2014/10/17/744615.jpeg,1,0.904541492,0,0,235,240,235,240,twilight sparkle
746288.jpeg,https://derpicdn.net/img/view/2014/10/19/746288.jpeg,0,0.993452728,1542,0,2792,1079,1250,1079,twilight sparkle
746363.jpeg,https://derpicdn.net/img/view/2014/10/19/746363.jpeg,0,0.99512279,159,15,777,633,618,618,twilight sparkle
752305.jpeg,https://derpicdn.net/img/view/2014/10/28/752305.jpeg,0,0.93056339,132,0,1300,950,1168,950,twilight sparkle
754979.jpeg,https://derpicdn.net/img/view/2014/10/31/754979.jpeg,0,0.949481487,251,0,823,530,572,530,twilight sparkle
756713.jpeg,https://derpicdn.net/img/view/2014/11/3/756713.jpeg,0,0.997666597,0,0,1201,1253,1201,1253,twilight sparkle
757501.jpeg,https://derpicdn.net/img/view/2014/11/4/757501.jpeg,0,0.98259145,1449,2138,2969,3658,1520,1520,twilight sparkle
764308.jpeg,https://derpicdn.net/img/view/2014/11/14/764308.jpeg,0,0.997121692,323,1,1061,739,738,738,twilight sparkle
772015.jpeg,https://derpicdn.net/img/view/2014/11/26/772015.jpeg,0,0.96200031,8,41,1804,2015,1796,1974,twilight sparkle
772283.jpeg,https://derpicdn.net/img/view/2014/11/26/772283.jpeg,0,0.994632602,99,0,391,279,292,279,twilight sparkle
778146.jpeg,https://derpicdn.net/img/view/2014/12/4/778146.jpeg,0,0.984433711,58,235,988,1165,930,930,twilight sparkle
779162.jpeg,https://derpicdn.net/img/view/2014/12/6/779162.jpeg,0,0.977007866,657,302,1673,1318,1016,1016,twilight sparkle
782641.jpeg,https://derpicdn.net/img/view/2014/12/11/782641.jpeg,0,0.987290263,299,0,867,505,568,505,twilight sparkle
783660.jpeg,https://derpicdn.net/img/view/2014/12/12/783660.jpeg,0,0.998119354,156,141,498,483,342,342,twilight sparkle
783851.jpeg,https://derpicdn.net/img/view/2014/12/13/783851.jpeg,0,0.999436915,637,174,1439,976,802,802,twilight sparkle
784602.jpeg,https://derpicdn.net/img/view/2014/12/14/784602.jpeg,0,0.986380935,230,32,498,300,268,268,twilight sparkle
785405.jpeg,https://derpicdn.net/img/view/2014/12/15/785405.jpeg,0,0.977578104,69,26,497,454,428,428,twilight sparkle
786230.jpeg,https://derpicdn.net/img/view/2014/12/16/786230.jpeg,0,0.994759083,221,195,1129,1103,908,908,twilight sparkle
786252.jpeg,https://derpicdn.net/img/view/2014/12/16/786252.jpeg,0,0.994798183,415,0,900,473,485,473,twilight sparkle
790745.jpeg,https://derpicdn.net/img/view/2014/12/23/790745.jpeg,0,0.997097373,70,0,821,733,751,733,twilight sparkle
791188.jpeg,https://derpicdn.net/img/view/2014/12/23/791188.jpeg,0,0.965774298,128,0,738,502,610,502,twilight sparkle
793577.jpeg,https://derpicdn.net/img/view/2014/12/27/793577.jpeg,0,0.987855852,163,118,489,444,326,326,twilight sparkle
794479.jpeg,https://derpicdn.net/img/view/2014/12/28/794479.jpeg,0,0.992635906,834,241,2466,1873,1632,1632,twilight sparkle
798468.jpeg,https://derpicdn.net/img/view/2015/1/3/798468.jpeg,0,0.995721877,266,0,730,399,464,399,twilight sparkle
799485.jpeg,https://derpicdn.net/img/view/2015/1/4/799485.jpeg,0,0.966582954,0,0,487,481,487,481,twilight sparkle
800833.jpeg,https://derpicdn.net/img/view/2015/1/6/800833.jpeg,0,0.998783588,464,0,1084,579,620,579,twilight sparkle
801606.jpeg,https://derpicdn.net/img/view/2015/1/7/801606.jpeg,0,0.997129679,272,146,762,636,490,490,twilight sparkle
801997.jpeg,https://derpicdn.net/img/view/2015/1/8/801997.jpeg,0,0.965244889,141,22,669,550,528,528,twilight sparkle
803990.jpeg,https://derpicdn.net/img/view/2015/1/11/803990.jpeg,0,0.991821885,87,0,963,823,876,823,twilight sparkle
808973.jpeg,https://derpicdn.net/img/view/2015/1/18/808973.jpeg,0,0.999356031,382,94,978,690,596,596,twilight sparkle
809282.jpeg,https://derpicdn.net/img/view/2015/1/18/809282.jpeg,0,0.988171339,236,0,1110,795,874,795,twilight sparkle
809320.jpeg,https://derpicdn.net/img/view/2015/1/18/809320.jpeg,0,0.956451058,201,39,599,437,398,398,twilight sparkle
810118.jpeg,https://derpicdn.net/img/view/2015/1/19/810118.jpeg,0,0.982996106,79,57,383,361,304,304,twilight sparkle
812221.jpeg,https://derpicdn.net/img/view/2015/1/22/812221.jpeg,0,0.912600517,2,0,700,681,698,681,twilight sparkle
813529.jpeg,https://derpicdn.net/img/view/2015/1/24/813529.jpeg,0,0.992615998,124,15,416,307,292,292,twilight sparkle
819835.jpeg,https://derpicdn.net/img/view/2015/2/2/819835.jpeg,0,0.998863995,117,28,397,308,280,280,twilight sparkle
821646.jpeg,https://derpicdn.net/img/view/2015/2/5/821646.jpeg,0,0.993137956,42,0,468,382,426,382,twilight sparkle
823478.jpeg,https://derpicdn.net/img/view/2015/2/7/823478.jpeg,0,0.932393491,79,7,497,425,418,418,twilight sparkle
823613.jpeg,https://derpicdn.net/img/view/2015/2/7/823613.jpeg,0,0.983340621,382,21,630,269,248,248,twilight sparkle
826049.jpeg,https://derpicdn.net/img/view/2015/2/11/826049.jpeg,0,0.982462347,219,9,707,497,488,488,twilight sparkle
827537.jpeg,https://derpicdn.net/img/view/2015/2/13/827537.jpeg,0,0.976121068,460,277,862,679,402,402,twilight sparkle
827929.jpeg,https://derpicdn.net/img/view/2015/2/14/827929.jpeg,0,0.999038994,346,28,672,354,326,326,twilight sparkle
828102.jpeg,https://derpicdn.net/img/view/2015/2/14/828102.jpeg,0,0.990899086,0,0,602,621,602,621,twilight sparkle
828899.jpeg,https://derpicdn.net/img/view/2015/2/15/828899.jpeg,0,0.993349612,656,110,1190,644,534,534,twilight sparkle
828899.jpeg,https://derpicdn.net/img/view/2015/2/15/828899.jpeg,1,0.954255462,289,202,763,676,474,474,twilight sparkle
828899.jpeg,https://derpicdn.net/img/view/2015/2/15/828899.jpeg,2,0.952308893,0,26,342,414,342,388,twilight sparkle
831095.jpeg,https://derpicdn.net/img/view/2015/2/17/831095.jpeg,0,0.959718287,1028,0,1946,871,918,871,twilight sparkle
831777.jpeg,https://derpicdn.net/img/view/2015/2/18/831777.jpeg,0,0.997661114,331,0,823,434,492,434,twilight sparkle
831873.jpeg,https://derpicdn.net/img/view/2015/2/18/831873.jpeg,0,0.991210341,221,0,697,476,476,476,twilight sparkle
839468.jpeg,https://derpicdn.net/img/view/2015/3/1/839468.jpeg,0,0.981431603,327,127,537,337,210,210,twilight sparkle
839512.jpeg,https://derpicdn.net/img/view/2015/3/1/839512.jpeg,0,0.994699955,336,268,636,568,300,300,twilight sparkle
840176.jpeg,https://derpicdn.net/img/view/2015/3/1/840176.jpeg,0,0.993228912,932,510,1564,1142,632,632,twilight sparkle
841641.jpeg,https://derpicdn.net/img/view/2015/3/3/841641.jpeg,0,0.999399662,47,157,477,587,430,430,twilight sparkle
845505.jpeg,https://derpicdn.net/img/view/2015/3/8/845505.jpeg,0,0.998883069,241,714,733,1206,492,492,twilight sparkle
847519.jpeg,https://derpicdn.net/img/view/2015/3/11/847519.jpeg,0,0.995401978,181,32,769,620,588,588,twilight sparkle
849888.jpeg,https://derpicdn.net/img/view/2015/3/15/849888.jpeg,0,0.952015817,0,16,800,842,800,826,twilight sparkle
850826.jpeg,https://derpicdn.net/img/view/2015/3/16/850826.jpeg,0,0.962172925,282,0,856,506,574,506,twilight sparkle
852703.jpeg,https://derpicdn.net/img/view/2015/3/19/852703.jpeg,0,0.992804229,366,0,2428,2062,2062,2062,twilight sparkle
858942.jpeg,https://derpicdn.net/img/view/2015/3/28/858942.jpeg,0,0.986226916,405,32,903,530,498,498,twilight sparkle
859195.jpeg,https://derpicdn.net/img/view/2015/3/28/859195.jpeg,0,0.996329367,892,227,1250,585,358,358,twilight sparkle
859617.jpeg,https://derpicdn.net/img/view/2015/3/29/859617.jpeg,0,0.993786335,545,0,1417,780,872,780,twilight sparkle
861069.jpeg,https://derpicdn.net/img/view/2015/3/31/861069.jpeg,0,0.997933805,1026,233,1678,885,652,652,twilight sparkle
866728.jpeg,https://derpicdn.net/img/view/2015/4/6/866728.jpeg,1,0.981082857,956,499,1200,765,244,266,twilight sparkle
867414.jpeg,https://derpicdn.net/img/view/2015/4/7/867414.jpeg,0,0.956168115,438,0,1994,1500,1556,1500,twilight sparkle
867957.jpeg,https://derpicdn.net/img/view/2015/4/7/867957.jpeg,0,0.988867819,623,458,1503,1338,880,880,twilight sparkle
867982.jpeg,https://derpicdn.net/img/view/2015/4/7/867982.jpeg,0,0.933141112,314,98,770,554,456,456,twilight sparkle
869905.jpeg,https://derpicdn.net/img/view/2015/4/9/869905.jpeg,0,0.936345041,0,0,2423,2364,2423,2364,twilight sparkle
871718.jpeg,https://derpicdn.net/img/view/2015/4/11/871718.jpeg,0,0.939039409,340,0,750,367,410,367,twilight sparkle
871855.jpeg,https://derpicdn.net/img/view/2015/4/11/871855.jpeg,0,0.906448066,0,0,7765,7067,7765,7067,twilight sparkle
871893.jpeg,https://derpicdn.net/img/view/2015/4/11/871893.jpeg,0,0.982590795,0,0,1231,1454,1231,1454,twilight sparkle
872345.jpeg,https://derpicdn.net/img/view/2015/4/12/872345.jpeg,0,0.981561601,282,85,1390,1193,1108,1108,twilight sparkle
872541.jpeg,https://derpicdn.net/img/view/2015/4/12/872541.jpeg,0,0.997245848,491,1,1037,547,546,546,twilight sparkle
875475.jpeg,https://derpicdn.net/img/view/2015/4/16/875475.jpeg,0,0.91013217,69,44,357,332,288,288,twilight sparkle
880839.jpeg,https://derpicdn.net/img/view/2015/4/23/880839.jpeg,0,0.973185956,290,13,714,437,424,424,twilight sparkle
884949.jpeg,https://derpicdn.net/img/view/2015/4/28/884949.jpeg,0,0.999148846,649,0,1319,503,670,503,twilight sparkle
885803.jpeg,https://derpicdn.net/img/view/2015/4/30/885803.jpeg,0,0.961508572,0,197,834,1146,834,949,twilight sparkle
886047.jpeg,https://derpicdn.net/img/view/2015/4/30/886047.jpeg,0,0.959733784,0,8,810,868,810,860,twilight sparkle
890067.jpeg,https://derpicdn.net/img/view/2015/5/5/890067.jpeg,0,0.992425442,199,0,939,676,740,676,twilight sparkle
891408.jpeg,https://derpicdn.net/img/view/2015/5/7/891408.jpeg,0,0.993528903,389,119,1367,1097,978,978,twilight sparkle
893281.jpeg,https://derpicdn.net/img/view/2015/5/10/893281.jpeg,0,0.991088152,73,7,341,275,268,268,twilight sparkle
898701.jpeg,https://derpicdn.net/img/view/2015/5/17/898701.jpeg,0,0.992986619,279,0,1537,1200,1258,1200,twilight sparkle
899425.jpeg,https://derpicdn.net/img/view/2015/5/18/899425.jpeg,0,0.961302996,510,0,1436,899,926,899,twilight sparkle
903187.jpeg,https://derpicdn.net/img/view/2015/5/24/903187.jpeg,0,0.980280757,17,50,549,582,532,532,twilight sparkle
904238.jpeg,https://derpicdn.net/img/view/2015/5/26/904238.jpeg,0,0.993062556,140,1,470,331,330,330,twilight sparkle
906242.jpeg,https://derpicdn.net/img/view/2015/5/29/906242.jpeg,0,0.909485579,597,57,1081,541,484,484,twilight sparkle
906309.jpeg,https://derpicdn.net/img/view/2015/5/29/906309.jpeg,0,0.99360013,188,0,588,367,400,367,twilight sparkle
907721.jpeg,https://derpicdn.net/img/view/2015/5/31/907721.jpeg,0,0.992266893,241,104,435,298,194,194,twilight sparkle
909723.jpeg,https://derpicdn.net/img/view/2015/6/4/909723.jpeg,0,0.976318419,328,57,750,479,422,422,twilight sparkle
910632.jpeg,https://derpicdn.net/img/view/2015/6/5/910632.jpeg,0,0.993628681,2435,0,4841,2269,2406,2269,twilight sparkle
920756.jpeg,https://derpicdn.net/img/view/2015/6/21/920756.jpeg,0,0.983870029,270,0,754,467,484,467,twilight sparkle
921812.jpeg,https://derpicdn.net/img/view/2015/6/22/921812.jpeg,0,0.989050984,446,0,1000,537,554,537,twilight sparkle
921812.jpeg,https://derpicdn.net/img/view/2015/6/22/921812.jpeg,1,0.972159207,0,0,600,508,600,508,twilight sparkle
923798.jpeg,https://derpicdn.net/img/view/2015/6/26/923798.jpeg,0,0.994880021,406,755,648,997,242,242,twilight sparkle
924153.jpeg,https://derpicdn.net/img/view/2015/6/26/924153.jpeg,0,0.991964042,0,1036,1054,2144,1054,1108,twilight sparkle
924844.jpeg,https://derpicdn.net/img/view/2015/6/27/924844.jpeg,0,0.989591897,686,57,876,247,190,190,twilight sparkle
925114.jpeg,https://derpicdn.net/img/view/2015/6/27/925114.jpeg,0,0.998901725,352,216,926,790,574,574,twilight sparkle
929649.jpeg,https://derpicdn.net/img/view/2015/7/4/929649.jpeg,0,0.995922744,1442,301,1994,853,552,552,twilight sparkle
929649.jpeg,https://derpicdn.net/img/view/2015/7/4/929649.jpeg,2,0.991240799,48,157,774,883,726,726,twilight sparkle
929649.jpeg,https://derpicdn.net/img/view/2015/7/4/929649.jpeg,3,0.972951472,1213,368,1633,788,420,420,twilight sparkle
929708.jpeg,https://derpicdn.net/img/view/2015/7/4/929708.jpeg,0,0.998731315,75,6,345,276,270,270,twilight sparkle
930063.jpeg,https://derpicdn.net/img/view/2015/7/5/930063.jpeg,0,0.963085234,2927,707,3600,1473,673,766,twilight sparkle
936721.jpeg,https://derpicdn.net/img/view/2015/7/14/936721.jpeg,0,0.994030893,487,525,1159,1197,672,672,twilight sparkle
938075.jpeg,https://derpicdn.net/img/view/2015/7/16/938075.jpeg,0,0.931002617,176,48,884,756,708,708,twilight sparkle
941951.jpeg,https://derpicdn.net/img/view/2015/7/23/941951.jpeg,0,0.953098416,297,1191,929,1823,632,632,twilight sparkle
949891.jpeg,https://derpicdn.net/img/view/2015/8/3/949891.jpeg,1,0.984757423,433,225,809,601,376,376,twilight sparkle
950973.jpeg,https://derpicdn.net/img/view/2015/8/5/950973.jpeg,0,0.997886956,237,342,469,574,232,232,twilight sparkle
951780.jpeg,https://derpicdn.net/img/view/2015/8/6/951780.jpeg,0,0.96956861,0,0,3709,3523,3709,3523,twilight sparkle
957434.jpeg,https://derpicdn.net/img/view/2015/8/14/957434.jpeg,0,0.996683776,190,0,638,442,448,442,twilight sparkle
959696.jpeg,https://derpicdn.net/img/view/2015/8/17/959696.jpeg,0,0.960264206,0,0,1104,768,1104,768,twilight sparkle
961763.jpeg,https://derpicdn.net/img/view/2015/8/20/961763.jpeg,0,0.994694114,630,190,928,488,298,298,twilight sparkle
961763.jpeg,https://derpicdn.net/img/view/2015/8/20/961763.jpeg,1,0.991571903,448,186,742,480,294,294,twilight sparkle
961763.jpeg,https://derpicdn.net/img/view/2015/8/20/961763.jpeg,2,0.945793331,206,147,522,463,316,316,twilight sparkle
965009.jpeg,https://derpicdn.net/img/view/2015/8/24/965009.jpeg,0,0.977427423,97,0,815,584,718,584,twilight sparkle
966391.jpeg,https://derpicdn.net/img/view/2015/8/26/966391.jpeg,0,0.974132836,26,128,632,734,606,606,twilight sparkle
967337.jpeg,https://derpicdn.net/img/view/2015/8/28/967337.jpeg,1,0.961448133,291,53,925,687,634,634,twilight sparkle
969701.jpeg,https://derpicdn.net/img/view/2015/8/31/969701.jpeg,0,0.98945713,196,107,570,481,374,374,twilight sparkle
971918.jpeg,https://derpicdn.net/img/view/2015/9/3/971918.jpeg,0,0.980475247,0,12,546,656,546,644,twilight sparkle
971918.jpeg,https://derpicdn.net/img/view/2015/9/3/971918.jpeg,1,0.97290802,183,0,768,621,585,621,twilight sparkle
972988.jpeg,https://derpicdn.net/img/view/2015/9/5/972988.jpeg,0,0.980560184,93,0,573,413,480,413,twilight sparkle
976773.jpeg,https://derpicdn.net/img/view/2015/9/10/976773.jpeg,0,0.984787226,127,278,800,1000,673,722,twilight sparkle
980175.jpeg,https://derpicdn.net/img/view/2015/9/15/980175.jpeg,0,0.998072743,683,195,1021,533,338,338,twilight sparkle
980175.jpeg,https://derpicdn.net/img/view/2015/9/15/980175.jpeg,1,0.987515867,274,217,620,563,346,346,twilight sparkle
980476.jpeg,https://derpicdn.net/img/view/2015/9/15/980476.jpeg,0,0.968928695,514,312,1722,1520,1208,1208,twilight sparkle
981138.jpeg,https://derpicdn.net/img/view/2015/9/16/981138.jpeg,0,0.99301213,2451,0,4861,2349,2410,2349,twilight sparkle
989471.jpeg,https://derpicdn.net/img/view/2015/9/27/989471.jpeg,0,0.998956025,255,0,557,289,302,289,twilight sparkle
990171.jpeg,https://derpicdn.net/img/view/2015/9/28/990171.jpeg,0,0.9857921,798,380,1444,1026,646,646,twilight sparkle
990784.jpeg,https://derpicdn.net/img/view/2015/9/29/990784.jpeg,0,0.986025393,246,88,668,510,422,422,twilight sparkle
994981.jpeg,https://derpicdn.net/img/view/2015/10/5/994981.jpeg,0,0.968127847,148,26,438,316,290,290,twilight sparkle
996414.jpeg,https://derpicdn.net/img/view/2015/10/7/996414.jpeg,0,0.914778233,503,342,751,590,248,248,twilight sparkle
998281.jpeg,https://derpicdn.net/img/view/2015/10/10/998281.jpeg,0,0.985379457,0,8,804,902,804,894,twilight sparkle
